ﺭﺪﺼﻤﻟﺍ-ﺔﻐﻴﺻ: ﺩﻭﺪﺤﻣ-ﺮﻴﻏ, ﺔﻳﺎﻬﻧ-ﻻ﻿-ﺎﻣ
ﺪﻋﺍﻮﻗ-ﻊﻓﺭ-ﺔﻟﺎﺣ: 
ﺐﺼﻨﻟﺍ-ﺔﻟﺎﺣ-ﺔﻟﺎﺣ: 
ﻉﻮﺿﻮﻣ-ﺔﻟﺎﺣ: ﻉﻮﺿﻮﻣ-ﺔﻟﺎﺣ
ﻡﻷ﻿ﺍ: ﻱﻮﺑﺃ, ﺪﺋﺍﺭ, ﺮﻴﺒﻛ
ﺏﺃ: ﺏﻵ﻿ﺍ
ﻲﻣﺃ: ﻲﻣﺃ, ﻡﺃ, ﺔﻴﻣﻮﻣﺃ
ﻼ﻿ﻫﺃ: ﺎﻋﺍﺩﻭ, ﺎﺒﺣﺮﻣ, ﺎﺒﺣﺮﻣ
ﻒﻠﺳ: ﻒﻠﺴﻟﺍ, ﺪﺟ
ﺪﺟ: ﺪﺟ, ﺓﺪﺟ
ﻊﺋﺎﺟ: ﻉﻮﺟ, ﺎﻋﻮﺟ-ﺭﻮﻀﺘﻳ
ﻑﺎﻀﻣ-ﺔﻟﺎﺣ: ﻲﻜﻠﻤﺗ-ﺔﻟﺎﺣ
ﺔﻔﺻ: 
ﻭ: ﻉﻮﻤﺠﻣ, ﺔﻄﺳﺍﻮﺑ
ﺎﻧﺃ: ﻲﺴﻔﻧ, ﺎﻧﺃ, ﻲﻟ, ﻦﺤﻧ
ﺖﻧﺃ: ﻢﻬﻨﻣ, ﻚﻴﻟﺍ, ﺖﻧﺃ
ﺎﻨﻟ: ﻦﺤﻧ, ﺎﻨﻟ, ﺎﻨﻟ
ﻮﻫ: ﻮﻫ, ﻥﺃ, ﻲﻫ, ﺍﺬﻫ, ءﻻ﻿ﺆﻫ
ﺩﻮﺼﻘﻤﻟﺍ-ﻥﺎﻜﻤﻟﺍ-ﺔﻟﺎﺣ: ﻲﻋﻮﺿﻮﻣ-ﺔﻟﺎﺣ
ﺐﺼﻨﻟﺍ-ﻝﺎﺣ-ﻲﻓ ﺔﻌﻗﺍﻭ ﺔﻤﻠﻛ ﺔﻟﺎﺣ: 
ﻲﻠﺧﺍﺩ-ﻡﻼ﻿ﻜﻟﺍ-ﻕﺎﻴﺳ: 
ﺺﺨﺷ-ﻡﻼ﻿ﻜﻟﺍ-ﻕﺎﻴﺳ: 
ﻊﺑﺎﺗ-ﺪﻨﺑ: 
ﻦﺴﺤﺘﻣ-ﺐﻧﺎﺟ: 
ﻲﺿﺎﻤﻟﺍ-ﺮﺗﻮﺗ: 
ﺮﻛﺬﻣ-ﺚﻴﻧﺄﺗ-ﻭﺃ ﺮﻴﻛﺬﺗ ﺲﻨﺟ: ﻰﺼﺧ-ﺚﻴﻧﺄﺗ-ﻭﺃ ﺮﻴﻛﺬﺗ ﺲﻨﺟ
comitative-ﺔﻟﺎﺣ: 
ﺮﺿﺎﺣ-ﺮﺗﻮﺗ: 
benefactive-ﺔﻟﺎﺣ: 
essive-ﺔﻟﺎﺣ: 
ﺲﻴﻟ: ﻻ﻿, ﺮﻴﻏ, ﺩﺎﻜﻟﺎﺑ, ﺭﺩﺎﻗ-ﺮﻴﻏ, -ﺮﻴﻏ, ﺐﻌﻠﻤﻟﺍ
ﺎﻬﻧﺍ: ﻢﻫ, ﻪﻟ, ﺎﻬﻟ, ﻪﻟ, ﻚﺌﻟﻭﺃ, ﺎﻬﻟ, ﻦﻣ
ﺢﻄﺳ-ﻡﻼ﻿ﻜﻟﺍ-ﻕﺎﻴﺳ: 
adpositional-ﺔﻟﺎﺣ: 
ﻊﻗﻮﻣ-ﺔﻟﺎﺣ: 
ءﺎﻀﻔﻟﺍ-ﻡﻼ﻿ﻜﻟﺍ-ﻕﺎﻴﺳ: 
ﻖﻳﺮﻃ-ﺔﻟﺎﺣ: 
ﻝﺎﻌﻓ-ﺭﻭﺩ-ﺔﻟﺎﺣ: 
ﻲﺘﻟﺍ: ﻯﺬﻟﺍ-ﻦﻣ, ﻞﺜﻣ, ﻦﻤﻟ, ﻱﺃ, ﻙﺍﺫ-ﻻ﻿ﻭ-ﺍﺬﻫ ﻻ﻿, ﻥﺃ, ﻦﻣ, ﻲﺘﻟﺍ-ﻚﻠﺗ, ﺍﺫﺎﻣ, ﻞﻛ, ﺎﻤﻳﺃ
ﻲﻣﺎﻬﻔﺘﺳﺍ-ﺝﺍﺰﻣ: 
ﻭ-ﻭﺃ: 
ﻭﺃ-ﻱﺮﺼﺣ: 
ﺭﺪﺼﻣ-ﺔﻟﺎﺣ: 
ﺮﺠﻟﺍ-ﺔﻟﺎﺣ: 
ﻲﻧﺎﻫﺮﺑ: ﺐﻠﺻ, ﻱﺮﻫﻮﺟ, ﺔﻧﺎﺳﺮﺨﻟﺍ, ﻊﻨﻘﻣ, ﺕﺎﻬﻴﺟﻮﺗ, ﻲﻜﻴﺗﺎﻣﺍﺭﺩ
ﻦﻜﻟ: ﻥﻵ﻿ﺍ-ﻰﺘﺣ, ﻦﻜﻟ
ﻊﻴﻤﺟ: ﺺﺨﺷ-ﻞﻛ, ﻊﻴﻤﺠﻟﺍ, ﻲﻠﻜﻟﺍ-ﻲﻟﺎﻤﺟﻹ﻿ﺍ, ﻪﻠﻤﻛﺄﺑ, ﻞﻣﺎﺷ, ﻞﻣﺎﻛ, ءﻰﺷ-ﻞﻛ, ﻱﺃ, ﺪﻳﺍﺰﺘﻣ-ﻮﺤﻧ-ﻰﻠﻋ
ﺚﻧﺆﻤﻟﺍ-ﺚﻴﻧﺄﺗ-ﻭﺃ ﺮﻴﻛﺬﺗ ﺲﻨﺟ: 
ﻢﻬﻧﺃ: ﻢﻬﻨﻣ, ﻲﻫ, ﻚﺌﻟﻭﺃ, ﻢﻫ, ﻢﻬﻟ, ﺐﻘﻟ, ءﻻ﻿ﺆﻫ
ﻊﻤﺠﻟﺍ-ﺔﻐﻴﺻ-ﺩﺪﻋ: 
ﺪﺣﺍﻭ: ﺏﺰﻋﺃ, ﺍ, ﻰﻟﺇ, ﻩﺪﺣﻭ
ﻞﺒﻘﺘﺴﻣ-ﺮﺗﻮﺗ: 
ﻲﻋﺎﻤﺘﺟﺍ-ﻡﻼ﻿ﻜﻟﺍ-ﻕﺎﻴﺳ: 
ﻰﺘﻣ: ﺎﻤﻠﻛ
imperfective-ﺐﻧﺎﺟ: 
ﻙﺎﻨﻫ: 
ﻲﻃﺮﺷ-ﺝﺍﺰﻣ: ﻲﻃﺮﺷ-ﺝﺍﺰﻣ, ﺽﺍﺮﺘﻓﻹ﻿ﺍ-ﻰﻠﻋ-ﻢﺋﺎﻗ ﺝﺍﺰﻣ
ﺮﺜﻛﺃ: ﻝﻼ﻿ﺧ, ﻢﻈﻌﻣ, ﻲﻓﺎﺿﺇ, ءﺍﺭﻭ, ﻰﻠﻋﻷ﻿ﺍ-ﻰﻟﺇ, ﺍﺪﻋﺎﺻ, ﺩﺪﻌﺘﻣ, ﻦﻣ, ﻻ﻿ﺪﺑ, ﺎﻀﻳﺃ, ﻚﻟﺫ-ﻰﻠﻋ-ﺓﻭﻼ﻿ﻋ, ﺪﺋﺍﺯ, ﻝﺍﺰﻳ-ﺎﻣ, ﻥﻵ﻿ﺍ-ﻰﺘﺣ, ﺮﺧﺁ, ﻦﻣ-ﺪﻳﺪﻌﻟﺍ, ﺩﺪﻌﺘﻣ
ﺝﺭﺎﺧ: ﺝﺭﺎﺨﻟﺍ-ﻲﻓ, ﻲﺟﺭﺎﺧ, ﻲﺟﺭﺎﺧ, ﻖﻠﻄﻟﺍ-ءﺍﻮﻬﻟﺍ-ﻲﻓ, ﻖﻠﻄﻟﺍ-ءﺍﻮﻬﻟﺍ-ﻲﻓ, ﺍﺪﻴﻌﺑ, ﺝﺭﺎﺧ, ءﺍﺭﻭ, ﻰﻠﻋﺃ-ﻰﻟﺇ, ﺪﻌﺑ, ﻰﻠﻋ
ﺐﻳﺮﻗ-ﺔﻟﺎﺣ: ﺐﻳﺮﻗ-ﺔﻟﺎﺣ
illative-ﺔﻟﺎﺣ: 
ﻞﻌﻓ: ﻞﻌﺟ, ﺬﻔﻧ, ﺪﻬﻌﺗ, ﻢﻳﺪﻘﺗ, ﻞﻌﻓ, ﺖﻠﻌﻓ, ﻡﺰﺘﻠﻳ
ﺕﺎﻬﻴﺟﻮﺗ-ﺝﺍﺰﻣ: ﻲﻟﻻ﻿ﺩ-ﺝﺍﺰﻣ
deontic-ﺝﺍﺰﻣ: 
ﻝﺍﺆﺳ-ﺔﻤﻠﻛ: 
ﻂﺑﺍﺮﻟﺍ-ﻞﻌﻔﻟﺍ: ﻞﺻﻮﻤﻟﺍ, ﻁﺎﺑﺭ, ﺔﻗﺎﺑ
ﺺﺨﺷ: ﻞﺟﺭ, ﺱﺎﻨﻟﺍ, ﻲﺼﺨﺷ, ﺎﻣ-ﺺﺨﺷ, ﺎﻣ-ﺎﺼﺨﺷ, ﺺﺨﺷ, ﻥﺎﺴﻧﻻ﻿ﺍ, ﻪﺟﻭ, ﻢﻓ, ﻥﺎﻴﻛ
ﺮﻛﺫ: ﺮﻛﺬﻣ, ﺮﻛﺫ, ﻡﺮﺘﺤﻣ-ﻥﺎﺴﻧﺍ, ﻞﺟﺭ
ﻉﺎﻄﺘﺳﺍ: ﻊﻴﻄﺘﺴﺗ, ﺎﻤﺑﺭ, ﺎﻤﺑﺭ, ﺎﻤﺑﺭ
ﺮﺧﻵ﻿ﺍ: ﺮﺧﺁ, ﺔﺣﺍﺭ, ﻲﻧﺎﺜﻟﺍ, ﺮﺧﺁ, ﻒﻠﺘﺨﻣ, ﺪﺣﺍﻭ-ﺮﺧﺁ-،
ﺩﺪﻋ: ﺔﻴﻤﻛ, ﻉﻮﻤﺠﻣ, ﻞﻜﺸﻟﺍ, ﻱﺩﺪﻋ, ﻱﺩﺪﻋ, ﺔﻴﻤﻛ
ﺍﺪﺟ: ﺍﺮﻴﺜﻛ, ﺍﺪﺟ, ﺾﻴﻐﺑ-ﻮﺤﻧ-ﻰﻠﻋ, ﺍﺮﻴﺜﻛ, ﺍﺪﺟ, ﺐﻴﻫﺭ, ﻊﺳﺍﻭ-ﻮﺤﻧ-ﻰﻠﻋ, ﺍﺪﺟ, ﺎﻘﺣ-ﻞﻫ, ﺊﻴﺳ-ﻞﻜﺸﺑ, ﻞﺋﺎﻫ, ﺍﺮﻴﺜﻛ, ﺮﻴﺜﻜﻟﺍ, ﺩﺪﻌﺘﻣ, ﻞﺋﺎﻫ-ﻞﻜﺸﺑ, ﻢﻈﻌﻣ, ﺎﻣﺎﻤﺗ, ﺎﻣﺎﻤﺗ, ﺍﺪﻴﻌﺑ, ﻞﻴﻤﺟ, ﺎﻨﺴﺣ, ﺎﻨﺴﺣ, ﺎﻨﺴﺣ
ﺓﺮﻣ: ﺎﻤﻨﻴﺑ, ﺔﻈﺤﻟ, ءﺎﻨﺛﺃ, ﻪﻨﻴﺣ-ﻲﻓ, ﺔﻴﻨﻣﺰﻟﺍ-ﺓﺪﻤﻟﺍ, ﻞﺋﺍﺯ, ﺮﺗﻮﺗ, ﻲﻨﻣﺰﻟﺍ-ﻝﻭﺪﺠﻟﺍ, ﺓﺮﺘﻓ, ﺲﻘﻃ
ﺓﺮﻣ-ﻡﻼ﻿ﻜﻟﺍ-ﻕﺎﻴﺳ: 
ﻞﺋﺍﺯ-ﺔﻟﺎﺣ: 
ﻝﻮﺣ: ﺹﻮﺼﺨﺑ, ﺹﻮﺼﺨﺑ, ﺎﺒﻳﺮﻘﺗ, ﻲﻟﺍﻮﺣ, ﻦﻣ, ﺔﻄﺳﺍﻮﺑ, ﻦﻣ, ءﺎﺤﻧﺃ, ﻰﻟﺇ, ﻞﻤﻌﺘﺴﻤﻟﺍ, ﻯﻮﻜﺷ, ﻰﻠﻋ
ﻲﻓﺮﻌﻤﻟﺍ-ﺝﺍﺰﻣ: 
ﻂﻘﻓ: ﻂﻘﻓ, ﺩﺮﺠﻣ, ﺔﻃﺎﺴﺒﺑ, ﺔﻄﻘﻧ, ﺩﺮﺠﻣ, ﺖﺤﺑ, ﺲﻴﺒﺣ
ﻞﻴﻠﻘﻟﺍ: ﺮﻴﻐﺻ, ﺮﻴﻐﺻ, ﻒﻴﻔﻃ, ﻼ﻿ﻴﻠﻗ, ءﺰﺟ, ﻲﻧﻮﻧﺎﻘﻟﺍ-ﻦﺴﻟﺍ-ﺖﺤﺗ, ﻪﻓﺎﺗ, ﺮﻴﻐﺼﺘﻟﺍ-ﺔﻐﻴﺻ, ﻝﻮﻤﺤﻤﻟﺍ, ﻞﻴﻠﻗ
ﻢﺛ: ﺔﻴﻧﺎﺛ, ﺓﺩﺎﻋﺇ, ﺎﻳ, ﺬﻨﻣ, ﺬﻨﻣ, ﻖﺣﻻ﻿-ﺖﻗﻭ-ﻰﻟﺍ, ﻚﻟﺫ-ﺪﻌﺑ
hortative-ﺝﺍﺰﻣ: 
ءﺍﺭﻮﻟﺍ-ﻰﻟﺍ-ﻊﻠﻄﺘﻣ ﺐﻧﺎﺟ: 
ﺔﻌﺋﺍﺭ: ﺮﻴﺒﻛ, ﺮﻴﺒﻛ, ﻞﻴﺒﻨﻟﺍ, ﻱﺪﺟ, ﻉﺎﺴﺗﺍ, ﻝﺎﻋ-ﺕﻮﺻ, ﻞﺋﺎﻫ, ﻕﻼ﻿ﻤﻋ, ﻞﺋﺎﻫ, ﺓﺪﺋﺎﺴﻟﺍ, ﺪﻴﺟ, ﺔﻣﺍﺮﻏ, ﺮﻴﺒﻛ, ﻢﺨﺿ, ﻱﺮﻫﻮﺟ, ﻊﺋﺍﺭ, ﺯﺎﺘﻤﻣ, ﻞﺜﻣﻷ﻿ﺍ, ﺮﻴﺒﻛ, ﺪﺋﺍﺭ, ﻝﺍﻮﺣﻻ﻿ﺍ-ﻦﺴﺣﺍ-ﻲﻓ, ﻊﺋﺍﺭ, ﻱﺮﻘﺒﻋ
volitive-ﺝﺍﺰﻣ: 
ﻞﺒﻗ: ﻞﺒﻗ, ﻞﺒﻗ, ﺬﻨﻣ, ﻖﺒﺳ, ﻰﺘﺣ, ﺔﻬﺒﺟ, ﺎﻘﺑﺎﺳ, ﺪﺿ
ﺐﺠﻳ: ﺐﺠﻳ, ﺓﺭﻭﺮﻀﻟﺎﺑ, ﻱﺭﻭﺮﺿ-ﺮﻴﻏ, ﻥﺃ-ﺐﺠﻳ, ﺔﺟﺎﺣ, ﻑﻮﺳ, ﻥﺍ-ﺐﺠﻳ, ﺪﻳﺮﺗ, ﻰﻟﺇ
ﻥﺎﻨﺛﺍ: ﺝﻭﺩﺰﻣ, ﺎﻤﻫﻼ﻿ﻛ
ﺪﻫﺎﺷ: ﺚﺤﺑ, ﻱﺃﺭ, ﺪﻬﺸﻣ, ﺭﺎﻌﺷﺇ, ﺭﻮﺼﺗ, ﺐﻗﺍﺭ
ﻢﻠﻋ: ﺪﻛﺄﺗ, ﻢﻠﻋ, ﻢﻠﻋ, ﻢﻠﻋ, ﻲﺋﺮﻣ
ﻞﻔﺳﺃ: ﻻ﻿ﻭﺰﻧ, ﻞﻔﺳﺃ-ﻰﻟﺇ, ﺖﺤﺗ, ﻩﺎﻧﺩﺃ, ﺖﺤﺗ, ﺖﺤﺗ, ﻞﻗﺃ, ﻞﻔﺳﺃ, ﻲﻠﻔﺴﻟﺍ, ﻞﻔﺳﻷ﻿ﺍ-ﻖﺑﺎﻄﻟﺍ
ﺪﻌﺑ: ﻲﻔﻠﺧ, ﺪﻌﺑ, ﺪﻌﺑ, ﺪﻌﺑ, ﻖﺣﻻ﻿-ﺖﻗﻭ-ﻰﻟﺍ, ﻚﻟﺫ-ﺪﻌﺑ, ﺬﺋﺪﻌﺑ, ﻲﻟﺎﺘﻟﺍ, ﻲﺿﺎﻤﻟﺍ, ﺖﺤﺗ, ﺖﺤﺗ
ﻝﻭﻷ﻿ﺍ: ﺓﺮﻣ-ﻝﻭﻻ﻿, ﻝﻭﺃ, ﺬﻨﻣ, ﺍﺪﻋﺎﺼﻓ, ﺔﻀﺒﻗ
ﻚﻠﺘﻤﻳ: ﻪﺴﻔﻧ, ﻚﺴﻔﻧ, ﻚﻠﻤﺗ, ﺎﻴﺼﺨﺷ, ﻪﻟ, ﺎﻬﺗﺍﺫ-ﺪﺤﺑ, ﺲﻔﻨﻟﺍ
ﻞﻳﻮﺤﺘﻠﻟ-ﻞﺑﺎﻗ-ﺓﺯﺎﻴﺣ: 
ﺍﺪﺑﺃ: ﺍﺪﺑﺃ
ﻞﻳﻮﻤﺘﻟﺍ-ﻭ-ﺓﺭﺩﺎﺼﻤﻠﻟ ﻞﺑﺎﻗ ﺮﻴﻏ ﺓﺯﺎﻴﺣ: 
ﻢﻳﺪﻗ: ﻞﻤﻌﺘﺴﻣ, ﺔﻤﻳﺪﻘﻟﺍ, ﻦﺴﻣ, ﻦﺴﻟﺍ-ﺭﺎﺒﻛ, ﻖﺑﺎﺳ, ﻖﺑﺎﺴﻟﺍ, ﻖﺑﺎﺳ, ﻦﺳ
ﻝﻭﺍﺪﺗ-ﺝﺍﺰﻣ: 
ﻡﻮﻳ: ﺎﻴﻣﻮﻳ, ﻡﻮﻴﻟﺍ, ءﺎﺴﻤﻟﺍ-ﺍﺬﻫ
ﻦﻳﺃ: ﺎﻤﻨﻳﺃ, ﻪﺘﻄﺳﺍﻮﺑ, ﻥﺎﻜﻣ
ﻝﺎﻌﺗ: ﻰﻟﺇ, ﻰﻟﺇ-ﻝﻮﺻﻭ, ﻝﻮﺻﻭ, ﻞﺻﻭ, ﺢﺒﺼﻳ, ﺔﺿﻮﻣ, ﺙﺪﺤﺗ
ﻖﻳﺮﻃ: ﺔﻘﻳﺮﻃ, ﺔﻴﺠﻬﻨﻤﻟﺍ, ﻲﻨﻌﻳ, ﺭﺎﺴﻣ, ﻖﻳﺮﻃ, ﺯﺎﻬﺠﻟﺍ, ﺮﻤﻣ, ﺮﺛﺃ, ﺏﻮﻠﺳﺃ, ﻖﻳﺮﻃ, ﻉﺭﺎﺷ, ﺮﻜﺴﻟﺍ, ﺭﺎﺴﻣ, ﺭﺎﺴﻣ, ﺓﺩﺎﻋ
ﻞﻤﻋ: ﺔﻔﻴﻇﻭ, ﺔﻤﻬﻣ, ﻂﺸﻧ, ﺔﻤﻬﻣ, ﻞﻤﻋ, ﻞﻤﻋ, ﺔﻨﻬﻣ-،ﻲﻨﻬﻤﻟﺍ-ﺭﺍﻮﺸﻤﻟﺍ, ﺔﻔﻴﻇﻮﻟﺍ, ﻞﻤﻌﻟﺍ, ﻲﻔﻴﻇﻭ, ﻞﻤﻋ, ﻞﻤﻋ, ﻞﺣ---ﻒﺸﺘﻛﺍ, ﻒﻴﻇﻮﺗ, ﻲﻨﻬﻣ, ﻞﻣﺎﻋ, ﻲﻨﻔﻟﺍ-ﻞﻤﻌﻟﺍ
ﻙﺮﺤﺘﻣ-ﻑﺮﺣ: ﺭﻮﻬﺸﻣ, ﺓﺎﻴﺣ, ءﺎﻘﺑ
ﺐﻫﺫﺍ: ﺮﻴﺳ, ﺓﺮﺟﺃ, ﺭﺩﺎﻐﺗ
perlative-ﺔﻟﺎﺣ: 
ﺔﻴﻣﺪﻘﺗ-ﺐﻧﺎﺟ: 
ﻞﻳﻮﻃ: ﻝﻮﻄﻣ, ﻞﻤﺤﺘﻣ, ﻞﻳﻮﻃ, ﻝﻮﻃ-ﻰﻠﻋ
ﻞﻗ: ﻕﻮﻄﻨﻣ, ﻝﻮﻗﺃ, ﺙﺪﺤﺗ
ﻒﻴﻛ: ﺐﺣﺍ, ﻞﺜﻣ, ﻦﻣ
ﻰﺘﺣ: ﺎﻀﻳﺃ, ﺎﻣﺇ, ﻰﺘﺣ, ﻚﻟﺫ-ﻰﻠﻋ-ﺓﻭﻼ﻿ﻋ, ﺍﺪﺟ
ﻒﻠﺨﻟﺍ-ﻰﻟﺍ: ﻒﻠﺧ, ﻲﻔﻠﺧ, ءﺍﺭﻮﻟﺍ-ﻰﻟﺍ, ءﺍﺭﻮﻟﺍ-ﻰﻟﺍ, ﺓﺩﻮﻋ, ﺓﺩﺎﻋﺇ, ﺓﺩﺎﻌﺘﺳﺍ, ﻚﻓ, ﺔﻴﻧﺎﺛ, ﺭﺮﻛ, ﺬﻨﻣ, ﻰﻟﺍ-ﺔﺒﺴﻨﻟﺎﺑ
ﺎﻨﻫ: 
ﻲﻓ-ﺮﻜﻓ: ﺮﻴﻜﻔﺗ, ﺪﻘﺘﻌﻳ, ﺮﺒﺘﻌﻳ, ﻞﻴﺨﺗ, ﺭﻮﺼﺗ, ﻞﻣﺄﺗ, ﻑﻮﺳ, ﺎﻋﺩ, ﻞﻘﻋ
ﻪﺴﻔﻧ: ﻖﺑﺎﻄﻣ, ﻞﺛﺎﻤﻣ, ﻱﻭﺎﺴﺘﻣ, ﻝﺩﺎﻌﻳ-ﺎﻣ, ﻖﺤﺑ, ﺎﻨﺴﺣ, ﺎﻨﺴﺣ, ﻪﺴﻔﻧ, ﻱﻭﺎﺴﺘﻟﺎﺑ, ﻞﺜﻤﻟﺎﺑ
ﺮﺧﺁ: ﺔﻳﺎﻬﻨﻟﺍ, ﺮﻴﺧﺃ, ﻲﺋﺎﻬﻧ, ﻰﺼﻗﺃ, ﺮﺧﺁ, ﺮﺧﺁ, ﺮﺧﺁ, ﺚﻳﺪﺣ, ءﺎﻬﻧﺇ, ﻲﺿﺎﻤﻟﺍ, ﻝﺍ-ﻲﺿﺎﻤﻟﺍ, ﻞﻤﺤﺗ, ﺩﻮﻤﺼﻟﺍ, ﻊﺿ, ﺮﺑﺎﺛ
ﺍﺪﻴﻌﺑ: ﺍﺪﻴﻌﺑ, ﺪﻴﻌﺑ, ﺍﺪﻴﻌﺑ, ﺍﺪﻴﻌﺑ, ﻝﺰﻌﻤﺑ, ﺭﺎﺴﻴﻟﺍ, ﺭﺩﺎﻏ, ﺐﺋﺎﻏ
ﺖﺤﺗ-ﻡﻼ﻿ﻜﻟﺍ-ﻕﺎﻴﺳ: 
ﺬﺧﺃ: ﻊﺠﺘﻨﻣ, ﻝﻼ﻿ﺘﺣﺍ, ﺐﻠﺟ, ﻰﻨﺒﺗ, ﻉﺍﺰﺘﻧﺍ, ﻝﻮﺼﺤﻟﺍ, ﻢﻠﺴﺗ, ﺭﺎﻴﺘﺧﺍ, ﻰﻠﻋ-ﺾﺒﻗ, ﺮﺳﺃ, ﻞﺒﻘﺗ, ﻞﺼﺤﺗ, ﺔﻤﻬﺗ
ﺕﺪﺟﻭ: ﺩﺎﺠﻳﺇ, ﻒﺸﺘﻛﺍ, ﻑﺎﺸﺘﻛﺍ, ﻒﺸﻛ, ﺎﻬﻴﻟﺇ-ﻝﻮﺻﻮﻟﺍ-ﻦﻜﻤﻳ
ﺪﻳ: ﻉﺍﺭﺫ, ﻢﺼﻌﻣ
ﺏﺎﺷ: ﺏﺎﺒﺷ, ﺉﺪﺘﺒﻣ, ﻖﻫﺍﺮﻣ, ﻖﻫﺍﺮﻣ, ﺪﻳﺪﺟ
ﻥﺃ-ﻢﻏﺭ: ﻦﻣ-ﻢﻏﺮﺑ, ﻚﻟﺫ-ﻊﻣﻭ, ﺖﺑﺎﺛ, ﺖﺑﺎﺜﻟﺍ, ﺐﻠﺻ, ﻡﺰﺤﺑ, ﻦﻣ-ﻢﻏﺮﻟﺍ-ﻰﻠﻋ, ﻦﻜﻟ, ﺎﻣ-ﺎﺼﺨﺷ
ﺢﻨﻣ: ﺽﺍﺮﻗﺇ, ﺩﻭﺰﺗ, ﺽﺮﻋ, ﺮﻴﻓﻮﺗ, ﻢﻴﻠﺴﺗ, ﻢﻳﺪﻘﺗ, ﻞﻤﺤﺗ, ﻊﺿ, ﻉﺮﺒﺗ, ﺢﻤﺳ
ﻪﻠﻟﺍ: 
delative-ﺔﻟﺎﺣ: 
ﻰﺷ-ﻻ﻿: ﺎﻣ-ﺎﺌﻴﺷ, ﻢﺴﺟ, ﺪﺣﺃ-ﻻ﻿, ﺊﺷ-ﻯﺍ, ءﻲﺷ-ﻻ﻿, ﺪﺣﺃ-ﻻ﻿
ﺢﻴﺤﺼﻟﺍ: ﺝﻭﺯ, ﺢﻴﺤﺻ, ﺔﻗﺪﺑ, ﺽﺮﻌﻣ, ﺔﻟﺍﺪﻋ, ﻍﻮﺴﻣ, ﻒﺼﻨﻣ-ﺮﻴﻏ, ﻞﻫﺆﻣ, ﻕﺎﻘﺤﺘﺳﺍ, ﻥﻮﻧﺎﻘﻟﺍ, ﺢﻴﺤﺻ-ﻞﻜﺸﺑ, ﺢﻴﺤﺻ, ﺪﻛﺆﻤﻟﺍ, ﺪﻴﻛﺄﺘﻟﺎﺑ, ﻝﻮﺨﺗ, ﻦﺴﺣ
ﺓﺮﻣ-ﺕﺍﺫ: ﺭﻮﻔﻟﺍ-ﻰﻠﻋ, ﻻ﻿ﺎﺣ, ﺔﻘﻳﺮﻃ, ﻂﻤﻧ, ﺔﻴﺠﻬﻨﻤﻟﺍ, ﺔﻴﻧﺎﺛ
semelfactive-ﺐﻧﺎﺟ: 
ءﺰﺟ: ﻢﺴﻗ, ﺎﻴﺋﺰﺟ, ءﺰﺟ, ﺎﻴﺋﺰﺟ, ءﺰﺟ, ءﺰﺟ, ﻢﺳﺎﻘﺘﻳ, ءﺰﺟ, ﺔﻌﻄﻗ, ﺭﻭﺮﻣ, ﺔﻴﻋﺮﻔﻟﺍ-ﺔﻋﻮﻤﺠﻤﻟﺍ, ﺏﺎﺑ, ﻢﺴﻗ, ﺔﻘﻠﺤﻟﺍ, ﻲﺋﺰﺟ, ﻢﻴﺴﻘﺗ, ﺡﺎﻨﺟ, ﻉﺎﻄﻗ, ﺔﺒﺴﻧ, ﻢﺳﺎﺑ
ﺭﺎﺸﻨﻣ: 
ﺖﻴﺑ: ﺖﻴﺒﻟﺍ, ﻰﻨﺒﻣ, ﺪﺒﻌﻣ, ﻥﺎﻜﺳﺇ, ﻲﻟﺰﻨﻣ
ﻢﻟﺎﻌﻟﺍ: ﺔﻜﻠﻤﻣ, ﻲﻤﻟﺎﻋ, ﻥﻮﻜﻟﺍ
ﺱﺃﺭ: ﻥﺍﻮﻨﻋ, ﻲﺴﻴﺋﺭ, ﺲﻴﺋﺭ, ﺏﺎﺑ, ﻢﻴﻋﺯ, ﺲﻴﺋﺭ, ﺲﻴﺋﺭ, ﺮﻳﺪﻤﻟﺍ, ﺲﻴﺋﺭ, ﺮﻴﺒﻛ, ﻢﻠﻗ
ﺔﺛﻼ﻿ﺛ: ﺚﻠﺛ
ﺩﺪﺠﻟﺍ: ﺪﻳﺪﺟ, ﺎﺜﻳﺪﺣ
ﺰﻛﺮﺗ: ﺩﻮﺼﻘﻣ, ﻑﺪﻫ, ﻑﺪﻫ, ﻲﻋﻮﺿﻮﻣ, ﺰﻛﺮﺗ, ﻩﺎﺒﺘﻧﺍ, ﺰﻴﻛﺮﺗ, ﺔﺠﻬﻟ, ﺏﺭﺎﻘﺗ
ﺐﺤﻟﺍ: ﺔﻔﻃﺎﻋ, ﺔﻳﺮﻴﺨﻟﺍ-ﻝﺎﻤﻋﻻ﻿ﺍ, ﺐﺣﺍ
ﺎﻤﺋﺍﺩ: ﺪﺑﻷ﻿ﺍ-ﻰﻟﺇ, ﺭﺍﺮﻤﺘﺳﺎﺑ, ﺍﺪﺑﺃ, ﺩﺎﺘﻌﻣ
ﻞﻴﻟ: ﺭﺎﻬﻨﻟﺍ-ﺮﺧﺍ, ءﺎﺸﻌﻟﺍ-ﻡﺎﻌﻃ, .ءﺎﺴﻣ
ﻞﻛ: ﻞﻜﻟ, ﻞﻛ, ﻱﺃ
ﻚﻠﻣ: ﻚﻠﻣ, ﺏﺭ, ﻞﻫﺎﻌﻟﺍ, ﺮﻴﻧﻮﻴﻠﻣ
ﻦﻴﺑ-ﺎﻣ: ﻦﻴﺑ-ﻦﻣ, ﻂﺳﻭ, ﻦﻣ
ﺐﻠﻗ: ﺝﺎﻬﺘﺑﺍ, ﻊﺠﺸﻣ, ﺐﻠﻗ
paucal-ﺩﺪﻋ: 
ﺐﺒﺴﺑ: ﺐﺒﺴﺑ, ﺬﻨﻣ, ﺔﻴﻀﻗ---ﺔﻟﺎﺣ, ﺐﺒﺳ
ﻲﺒﺒﺳ-ﺔﻟﺎﺣ: 
ءﻲﺷ: ﺔﻟﺄﺴﻣ, ﺔﻴﻣﺍﺮﻏ-ﺔﻗﻼ﻿ﻋ, ﺓﺮﻫﺎﻇ, ءﺎﻴﺷﺃ, ﺍﺫﺎﻣ
ﺔﻋﻮﻤﺠﻣ: ﺔﻋﻮﻤﺠﻣ, ﻊﺿ, ﻆﻔﺘﺣﺍ, ﻊﺿﻭ, ﻥﻮﺠﻌﻣ, ﺔﻋﻮﻤﺠﻣ, ﺔﻋﻮﻤﺠﻣ, ﺔﻋﻮﻤﺠﻣ, ﺡﺎﻨﺟ, ﺔﻣﺯﺭ, ﺔﻈﻔﺤﻣ, ﺐﻴﻛﺮﺗ, ﺎﻳﻮﺳ, ﺔﻠﺴﻠﺳ, ﻒﻄﻌﻨﻣ, ﻕﺎﻄﻧ, ﻒﺻ, ﻂﻴﺧ, ﺓﺪﻋ, ﺭﺎﻀﺣﻹ﻿ﺍ
ﻢﺳﺍ: ﺐﻘﻟ, ﻢﺳﺇ
ﻖﺋﻻ﻿-ﻢﺳﺇ: 
hortative: exhortative
ﺪﻠﺑ: ﺔﻟﻭﺩ, ﺽﺭﺃ, ﺽﺭﺃ, ﺔﻟﺎﺣ, ﺽﺭﺃ, ﺔﻌﻃﺎﻘﻣ, ﺔﺑﺮﺗ, ﺏﺰﺣ
ﺖﺒﻠﻃ: 
ﻲﺋﺮﻣ-ﺮﻫﺎﻇ: 
ﻞﻀﻓﺃ: ﻕﻮﻔﺘﺗ, ﻞﻀﻓﺃ, ﺯﺎﺘﻤﻣ, ﻲﻟﺎﺜﻤﻟﺍ, ﺔﻘﻠﻌﻣ
ﺐﻧﺎﺟ: ﻲﺒﻧﺎﺟ, ﺓﺎﺑﺎﺤﻣ, ﺓﺎﺑﺎﺤﻣ, ﻢﺳﺎﺑ, ﻒﻄﻌﻨﻣ, ﺔﺤﻔﺻ, ﺐﻧﺎﺟ, ﻒﺼﻧ, ﻪﻴﺟﻭ
ﺱﺭﺩ: ﻲﺳﺍﺭﺩ-ﺞﻬﻨﻣ, ﺱﺭﺩ, ﺓﺮﺿﺎﺤﻣ, ﺪﻴﻛﺄﺘﻟﺎﺑ, ﺪﻴﻛﺄﺘﻟﺎﺑ, ﺎﻌﻄﻗ, ﻝﺪﻌﻣ
ﻰﺜﻧﺃ: ﺓﺪﻴﺳ, ﺚﻧﺆﻤﻟﺍ, ﺚﻧﺆﻤﻟﺍ, ءﺎﺴﻨﻟﺍ, ﺓﺎﺘﻓ, ﺔﺟﻭﺯ
ﻲﻔﻜﻳ: ﻑﺎﻛ, ﻲﻓﺎﻛ-ﻞﻜﺸﺑ, ﻑﺎﻛ, ﺢﻴﺴﻓ, ﺎﻣﺎﻤﺗ, ﺓﺮﻓﻭ, ﻑﺎﻛ-ﺮﻴﻏ, ﺎﻣﺎﻤﺗ, ﻞﻴﻤﺟ
ﺍﺬﻜﻫ: ﺎﺒﻳﺮﻗ, ﻊﻳﺮﺳ, ﻪﺟﻮﻣ, ﺔﻋﺮﺴﺑ, ﺔﻋﺮﺴﺑ, ﻱﺭﻮﻓ, ﻊﻳﺮﺳ, ﻞﺠﻋ, ﻞﺟﺎﻋ, ﺍﺬﻜﻫ, ﺭﻮﻔﻟﺍ-ﻰﻠﻋ, ﺔﻟﻮﻬﺴﺑ, ﺐﻳﺮﻗ, ﺮﻜﺒﻣ-ﺖﻗﻭ-ﻲﻓ, ﺔﻌﻗﺮﻓ
ﻞﻣﺎﻛ: ﻞﻣﺎﻛ-ﻞﻜﺸﺑ, ﻲﻓﺎﻛ-ﻞﻜﺸﺑ, ﻖﻠﻄﻣ, ﻞﻣﺎﻛ, ﻡﺎﺗ-ﺮﻴﻏ, ﻞﻣﺎﻛ, ﻂﺒﻀﻟﺎﺑ, ﻖﻴﻗﺩ, ﺚﻔﻧ, ﻖﻴﻗﺩ-ﻞﻜﺸﺑ, ﻞﻣﺎﺷ, ﻪﻠﻤﻛﺄﺑ, ﻞﻣﺎﺷ, ﻢﺠﺣ
ﺔﻓﺮﻏ: ﺔﻓﺮﻏ, ﻊﺑﺍﺭ, ﻡﻮﻧ-ﺔﻓﺮﻏ, ﻡﻼ﻿ﺳ
ﺎﺒﻳﺮﻗ: ﺎﺒﻳﺮﻘﺗ, ﺎﻴﻠﻤﻋ, ﺎﺒﻳﺮﻘﺗ, ﻲﻟﺍﻮﺣ, ﺏﺮﻗ, ءﺎﺤﻧﺃ, ﻖﻠﻏﺃ, ﻢﺧﺎﺘﻣ, ﺎﻴﻠﻤﻋ, ﺐﻳﺮﻗ, ﺎﺒﻳﺮﻗ, ﺔﻴﻧﺍﺪﻟﺍ, ﺎﺒﻳﺮﻘﺗ, ﺩﺎﻜﻟﺎﺑ
ﻦﻜﻤﻳ-ﻻ﻿: ﺭﺩﺎﻗ-ﺮﻴﻏ
ءﺎﻣ: ﻞﺋﺎﺳ, ﻊﺋﺎﻣ, ﻝﻮﺤﺗ-ﺔﻄﻘﻧ
desiderative-ﺝﺍﺰﻣ: 
ﺭﻮﻧ: ﺞﻫﻮﺗ, ﻕﺮﺸﻣ, ﺔﻌﻤﺷ, ﻒﻴﻔﻃ, ﻂﻤﻧ, ﺔﻔﺨﺑ, ﻝﺪﺘﻌﻣ, ﺔﻋﻻ﻿ﻭ, ﺖﻫﺎﺑ, ﻲﻓﺎﺻ
ﻻ﻿ﻭ: ﻙﺍﺫ-ﻻ﻿ﻭ-ﺍﺬﻫ ﻻ﻿, -ﺮﻴﻏ, ﻥﻵ﻿ﺍ-ﻰﺘﺣ, ﺍﺫﺎﻣ, ﺙﺪﺤﻳ, ﻭﺃ
ﺔﻤﻠﻛ: ﻲﻤﺠﻌﻣ
ﺏﺎﺑ: ﺔﺑﺍﻮﺑ, ﻞﺧﺪﻣ, ﻞﺧﺪﻣ, ﺏﺎﺑ, ءﺎﻨﻴﻣ
ﻡﺍﺪﺨﺘﺳﺍ: ﻡﺍﺪﺨﺘﺳﺍ, ﻝﺎﻤﻌﺘﺳﺍ, ﻙﻼ﻿ﻬﺘﺳﺍ, ﻕﺎﻔﻧﺇ, ﻚﻠﻬﺘﺴﻣ, ﺏﺬﺟ, ﻖﻴﺒﻄﺗ, ﺯﺎﻐﻟﺍﻭ-ءﺎﺑﺮﻬﻜﻟﺍ-ﻞﺜﻣ ﺕﺎﻣﺪﺧ, ﻖﻴﺒﻄﺗ, ﻒﻴﻇﻮﺗ
ﺡﺎﺒﺻ: .ﺎﺣﺎﺒﺻ, ﺭﺎﻄﻓﺍ-ﺔﺒﺟﻭ
terminative-ﺔﻟﺎﺣ: 
ﺔﻄﻠﺳ: ﺓﻮﻗ, ﺔﻗﺎﻃ, ﺎﻤﺑﺭ, ﻱﻮﻗ, ﺽﺮﻓ, ﻱﻮﻗ, ﻲﻜﻴﻣﺎﻨﻳﺩ, ﺔﻄﻠﺳ, ﺔﻨﻤﻴﻫ, ﺔﺌﻴﻫ
ﻢﻬﺴﻔﻧﺃ: ﺎﻨﺴﻔﻧﺃ, ﻚﺴﻔﻧ, ﻪﺴﻔﻧ, ﻲﺴﻔﻧ, ﺎﻬﺴﻔﻧ, ﺎﻬﺗﺍﺫ-ﺪﺤﺑ, ﺲﻔﻨﻟﺍ, ﺎﻧﻷ﻿ﺍ, ﺏﺎﺑ
ﻲﻟﺎﺤﻟﺍ: ﺭﺎﻴﺘﻟﺍ, ﻝﺍ-ﺮﺿﺎﺣ, ﻥﻵ﻿ﺍ, ﺎﻴﻟﺎﺣ, ﺔﻳﺪﻫ, ﺓﺩﻮﺟﻮﻣ, ﺡﺎﺘﻣ
ﺕﻮﺻ: ﺕﻮﺻ, ﻝﺎﻋ-ﺕﻮﺼﺑ, ﺖﻳﻮﺼﺗ, ﻲﻌﻤﺳ, ﺖﻳﻮﺼﺗ, ﺮﺼﻨﻌﻟﺍ, ﺔﻌﺋﺎﺷ, ﺔﻌﺋﺎﺷ
ﺾﻴﺑﺃ: ﻍﺍﺮﻓ, ﻯﻮﻜﺷ
ﻝﺎﻣ: ﺓﻭﺮﺛ, ﻲﻀﻓ, ﻲﻟﺎﻣ, ﺔﻳﺪﻘﻨﻟﺍ-ﺔﻟﻮﻴﺴﻟﺍ, ﺔﻠﻤﻋ, ﻞﻳﻮﻤﺗ, ﻱﺪﻘﻧ
ﻰﻟﺎﺘﻟﺍ: ﺐﻧﺎﺠﺑ, ﺐﻨﺟ-ﻰﻟﺇ-ﺎﺒﻨﺟ, ﺭﺍﻮﺠﺑ, ﻲﻟﺎﺘﻟﺍ, ﻖﺣﻻ﻿-ﺖﻗﻭ-ﻰﻟﺍ, ﺪﻌﺑ, ﺍﺪﻋﺎﺼﻓ, ﻊﺑﺎﺗ-ﻖﺣﻻ﻿
ﺮﻴﻘﻓ: ﻉﺍﺭﺫ, ﺮﻘﻓ, ﺊﻴﺳ, ﺃﻮﺳﺃ, ﺪﺳﺎﻓ, ﻒﻴﻌﺿ
ﺕﻮﻤﻟﺍ: ﺕﺎﻴﻓﻮﻟﺍ-ﻝﺪﻌﻣ, ﺓﺎﻓﻭ, ﻰﻟﺎﻌﺗ-ﻪﻠﻟﺍ-ﺔﻣﺫ ﻲﻓ
ﻞﻜﺷ: ﻞﻜﺷ, ﺐﻟﺎﻗ, ﻞﻜﺷ, ﻑﺎﻔﻛ, ﻂﻤﻧ
inessive-ﺔﻟﺎﺣ: 
ﺐﻠﻘﻟﺍ-ﺐﻴﻃ: ﻞﺼﻔﻟﺍ, ﺯﺮﻓ, ﻉﻮﻧ, ﺔﻠﻴﻜﺸﺗ, ﺐﺘﻛﺍ, ﺩﻭﺩﻭ, ﺮﺼﻨﻌﻟﺍ, ﺪﻴﺟ, ﺔﻌﺘﻤﻣ, ﺭﺎﺳ, ﻊﺘﻤﻣ
ﺎﺒﻟﺎﻏ: ﺍﺮﻴﺜﻛ, ﺭﺍﺮﻤﺘﺳﺎﺑ, ﻡﺎﻈﺘﻧﺎﺑ, ﺭﺮﻜﺘﻣ, ﺓﺩﺎﻋ, ﻲﻌﻴﺒﻃ-ﻞﻜﺸﺑ, ﺓﺩﺎﻋ
ﺔﻨﺳ: ﻱﻮﻨﺳ, ﺎﻳﻮﻨﺳ, ﺔﺴﻤﺧ
ﻖﻳﺪﺻ: ﻒﻴﻠﺣ, ﻞﻴﻠﺧ, ﻞﻴﻣﺯ, ﻞﻴﻣﺯ
ﻡﺎﻈﻨﻟﺍ: ﻡﺎﻈﻧ, ﺐﻴﺗﺮﺗ, ﺐﺗﺭ, ﺪﻘﻋ, ﺔﻋﻮﻤﺠﻣ, ﺮﻣﺃ, ﻒﻄﻌﻨﻣ, ﻒﺻ, ﺭﻮﺑﺎﻃ
ﺐﺟﺍﻭ-ﺝﺍﺰﻣ: 
ﺔﻟﻮﺠﻟﺍ: ﺐﻳﺮﻘﺗ, ﺓﺮﺋﺍﺩ, ﻦﻀﺣ
ﻦﻣﺅﺃ: ﺔﻘﺛ, ﺪﻘﺘﻋﺍ, ﺽﺮﺘﻓﺍ, ﻥﺎﻤﻳﺇ, ﻥﺎﻤﻳﺇ, ﺲﻔﻨﻟﺎﺑ-ﺔﻘﺜﻟﺍ, ﻖﺛﺍﻭ, ﻝﺅﺎﻔﺘﻟﺍ, ﻞﺋﺎﻔﺘﻣ
ﺔﻣﺎﻋ: ﻝﺍ-ﺔﻣﺎﻋ, ءﺍﻮﻟ-ﻝﺍﺮﻨﺟ, ﺭﻮﻬﻤﺟ
ﺔﻟﺎﺣ-ﻡﻼ﻿ﻜﻟﺍ-ﻕﺎﻴﺳ: 
ﻦﺑﺍ: ﺏﺮﺳ, ﻲﺒﺻ
ﺔﺋﺎﻣ: ﺔﺌﻣ-ﻦﻣ-ءﺰﺟ, ﻪﺟﻭ, ﺖﻨﺳ
ﻝﺎﻔﻃﻷ﻿ﺍ: ﻞﻔﻃ, ﺔﻳﺭﺫ, ﻞﻔﻃ, ﻲﺒﻴﺒﺣ
ﺍﺬﻜﻫﻭ: ﻲﻟﺎﺘﻟﺎﺑﻭ, ﺍﺬﻜﻫ, ﻲﻟﺎﺘﻟﺎﺑ, ﻩﺬﻫ, ﻼ﻿ﻌﻓ-ﻢﻌﻧ
ﻞﻣﺃ: ﺔﺒﻏﺭ, ﻝﺎﻤﺘﺣﺍ, ﻊﻗﻮﺗ, ﻝﺅﺎﻔﺘﻟﺍ, ﻞﺋﺎﻔﺘﻣ
ﻕﻮﻓ: ﻰﻠﻋﺃ-ﻰﻟﺇ, ﻝﻼ﻿ﺧ, ﻱﻮﻠﻌﻟﺍ-ﻖﺑﺎﻄﻟﺍ, ﻲﻟﺎﻋ, ﻰﻠﻋﺃ, ﻡﺪﻘﺘﻣ, ﻰﻠﻋﺃ, ﺮﺒﻋ, ﺹﻮﺼﺨﺑ, ﺔﻄﺳﺍﻮﺑ, ﺪﻌﺑ, ﻝﺎﻤﺣﺃ, ﻰﻠﻋ, ﺎﻣﺪﻗ, ﺍﺪﻋﺎﺻ
ﺰﻳﺰﻌﻟﺍ: ﺐﻴﺒﺣ, ﺔﻔﻠﻜﻣ
ﺃﺮﻗﺍ: ﺓءﺍﺮﻗ, ﻰﻨﻏ, ﻖﺒﻧﺯ
ﺔﻨﻳﺪﻤﻟﺍ: ﺓﺪﻠﺑ, ﻲﻠﺤﻣ, ﺔﻌﻃﺎﻘﻣ
ﻞﻌﻔﻟﺎﺑ-،ﺎﻘﺑﺎﺳ: ﺩﺍﺪﻌﺘﺳﺍ, ﺪﻌﻣ, ﺐﻏﺍﺭ, ﻝﺎﺣ-ﻱﺃ-ﻰﻠﻋ
ﺔﻘﻴﻘﺣ: ﺔﻘﻴﻘﺣ, ﻊﻗﺍﻮﻟﺍ, ﺔﻴﻗﺍﺪﺼﻣ, ﺢﻴﺤﺻ, ﻝﺎﻳﺭ, ﻲﻠﻌﻓ, ﺎﻌﺒﻃ, ﺎﻘﺣ-ﻞﻫ, ﻼ﻿ﻌﻓ, ﺖﻠﻌﻓ
factive-ﺮﻫﺎﻇ: 
ﻊﻤﺳ: ﻊﻤﺘﺳﺍ, ﻊﻤﺳ, ﺮﻌﺸﻳ
ﻞﻗﻷ﻿ﺍ: ﻰﻧﺩﺃ, ﻰﻧﺩﺍ-ﺪﺣ, ﺾﻔﺧ, ﺺﻗﺎﻧ, ﻞﻗﺃ
ﺎﻤﺑﺭ: ﻞﻤﺘﺤﻤﻟﺍ, ﺎﻤﺑﺭ, ﻞﻤﺘﺤﻣ, ﺎﻤﺑﺭ, ﺎﻤﺑﺭ, ﻦﻜﻤﻣ, ﺢﺟﺭﻷ﻿ﺍ-ﻰﻠﻋ, ﻞﻤﺘﺤﻣ
ﺢﺘﻓ: ﻲﻓﺎﺻ, ﻱﺩﺎﻋ, ﺮﺜﻛﺍ-ﺢﺿﻭﺍ, ﺭﺎﻋ, ﻅﻮﺤﻠﻣ-ﻞﻜﺸﺑ, ﺮﻏﺎﺷ, ﺢﻳﺮﺻ, ﺢﺿﺍﻭ, ﻖﻠﻄﻟﺍ-ءﺍﻮﻬﻟﺍ-ﻲﻓ, ﺰﺠﻌﻟﺍ, ﺖﻫﺎﺑ, ﺔﺣﺍﺮﺻ-ﻞﻜﺑ, ﻒﺸﻜﺗ
ﻢﺴﺠﻟﺍ: ﻢﺤﻟ, ﻱﺪﺴﺟ, ﻱﺪﺴﺟ, ﺎﻴﻧﺪﺑ, ﺭﺎﻀﺣﻹ﻿ﺍ, ﻮﻀﻋ, ﺔﺜﺟ
ءﺍﻮﻫ: ﺢﻳﺭ, ﻢﻴﺴﻧ, ﻥﺍﺮﻴﻃ, ﺲﻘﻃ, ﻥﺍﺮﻴﻃ-ﺔﻛﺮﺷ
ﺔﻌﻴﺒﻃ: ﻲﻌﻴﺒﻃ, ﻱﺪﻠﺑ-ﻭﺃ-ﻲﻠﺤﻣ ﻦﻃﺍﻮﻣ, ﻝﺎﺤﻟﺍ-ﺔﻌﻴﺒﻄﺑ, ﻞﺻﻷ﻿ﺍ, ﻝﻭﺰﻧ, ﻦﻴﻴﻠﺻﻷ﻿ﺍ-ﻥﺎﻜﺴﻟﺍ, ﺔﻳﺮﺒﻟﺍ-ﺓﺎﻴﺤﻟﺍ, ﺔﻴﺼﺨﺸﻟﺍ
ﺓﺪﻋﺎﺴﻣ: ﺓﺪﻋﺎﺴﻣ, ﺪﻴﻔﻣ, ﺓﺪﻋﺎﺴﻣ, ﺓﺪﻋﺎﺴﻣ, ﺪﻋﺎﺴﻣ, ﻊﺿﻭ
ﺔﻟﺎﺳﺭ: ﺪﻳﺮﺑ, ﺔﺑﺎﺘﻜﻟﺍ-ﻱﺭﺎﺟ
ﺔﻌﺑﺭﺃ: ﻊﺑﺍﺭ
ﻲﻨﻤﺘﻟﺍ-ﻰﻠﻋ-ﻝﺍﺩ ﺝﺍﺰﻣ: ﻲﻃﺮﺷ-ﺝﺍﺰﻣ
ﻖﻳﺮﺣ: ﺭﺎﺣ, ﺭﺎﻧ-ﺔﻠﻌﺷ, ﻰﻤﺣ
ﺍﺬﻟ: ﻲﻟﺎﺘﻟﺎﺑ
ﺔﻋﺎﺳ: ﻂﺋﺎﺣ-ﺔﻋﺎﺳ, ﺔﻋﺎﺴﻟﺍ, ﺱﺮﺟ
ﺮﺣ: ﺔﻳﺮﺣ, ﺔﻳﺮﺣ, ﻰﻔﻌﻣ, ﻲﻧﺎﺠﻣ, ﺎﺜﺒﻋ, ﺔﻳﺮﺤﺑ, ﺮﻏﺎﺷ, ﺔﺿﺎﻔﻀﻓ, ﻕﻼ﻿ﻃﺇ
ﺏﺮﺣ: ﺔﻛﺮﻌﻣ, ﻉﺍﺮﺻ
ءﺍﻮﺳ: ﺍﺫﺇ, ﺎﻬﺗﺍﺫ-ﺪﺤﺑ
ﺐﺒﺳ: ﺐﺒﺳ, ﺏﺎﺴﺣ, ﻞﻣﺎﻋ, ﻝﻮﻘﻌﻣ, ﺭﺬﻋ, ﺱﺎﺳﺃ, ﺭﺎﺸﺘﻧﺍ, ﻰﻋﺪﻣ
ﺪﺤﺘﻣ: ﺩﺮﻔﻤﻟﺍ-ﺔﻐﻴﺻ, ﺓﺪﺣﻭ, ﻞﻣﺎﺷ, ﺩﺎﺤﺗﻻ﻿ﺍ, ﻒﻴﻠﺣ, ﻒﻴﻠﺣ, ﺪﻳﺮﻓ, ﻉﺎﻤﺟﻹ﻿ﺎﺑ
ﺔﻤﻟﺎﻜﻣ: ﻱﺪﺤﺘﻟﺍ, ﺪﺴﻛﺃ, ﺓﺪﺷﺎﻨﻣ, ﻰﻠﻋ, ﻝﺎﺼﺗﻻ﻿ﺍ, ﺔﻋﻮﻤﺠﻣ, ﻙﺮﺘﺸﻣ, ﺭﺎﻬﺼﻧﺍ, ﺓﻮﻋﺩ-ﺔﻟﺎﺳﺭ
ﺍ-ﺍﺫﺎﻤﻟ: 
ﻊﺋﺎﺿ: ﻥﺍﺪﻘﻓ, ﺩﻮﻘﻔﻣ
ﻒﻟﺃ: ﻒﻟﺃ-ﻦﻣ-ءﺰﺟ
ﺔﻠﺋﺎﻋ: ﻲﻟﺰﻨﻣ, ﻲﺟﺎﻧ
ﺡﻭﺭ: ﺡﻭﺭ, ﺢﺒﺷ, ﺮﺑﺪﻤﻟﺍ-ﻞﻘﻌﻟﺍ
ﻝﺍﺆﺳ: ﺔﻴﻀﻘﻟﺍ, ﺐﻠﻄﻟﺍ, ﺓءﺍﺮﻗ, ﺔﻟﺄﺴﻣ
ﺔﻳﺎﻋﺭ: ﺔﻴﻨﻌﻤﻟﺍ-ﻑﺍﺮﻃﻷ﻿ﺍ, ﺔﻳﺎﻨﻋ-،ﻥﺄﺷ-،ﻡﺎﻤﺘﻫﺍ, ﻩﺎﺒﺘﻧﺍ, ﻞﻣﺄﺗ, ﺔﻣﺪﺧ, ﺔﻳﺎﻋﺭ, ﺱﺮﺤﻟﺍ, ﺔﻣﻼ﻿ﺳ, ﺔﻳﺎﻤﺣ, ﻦﻣﺃ, ﻆﻔﺣ, ﻆﻔﺣ, ﺔﻴﻄﻐﺗ, ﻉﺎﻓﺩ, ﺭﺬﺤﻟﺍ, ءﺎﻔﺷ, ﺝﻼ﻿ﻋ, ﺲﺒﺣ
REALIS-ﺝﺍﺰﻣ: 
ﻲﻨﻌﺗ: ﻲﻨﻌﻳ, ﺱﺎﺴﺣﺇ, ﻰﻨﻌﻣ, ﻯﺰﻐﻣ-ﺕﺍﺫ, ﻝﺩ, ﻂﺳﻭ, ﻞﻴﻛﻭ, ﻂﺳﻮﺘﻣ, ﻂﺳﻮﺘﻣ, ﻝﺪﺘﻌﻣ
ﻞﻤﺘﺤﻣ-ﺝﺍﺰﻣ: 
ﻩﺎﺠﺗ: ﻮﺤﻧ, ﺪﺿ, ﺽﺭﺎﻌﻣ, ﺔﺿﺭﺎﻌﻣ, ﻞﻜﻟ, ﻡﺍﺮﺘﺣﺍ, ﻰﻟﺇ
allative-ﺔﻟﺎﺣ: 
ﻲﺴﻧﺇ-ﺚﻴﻧﺄﺗ-ﻭﺃ ﺮﻴﻛﺬﺗ ﺲﻨﺟ: 
ﺮﻴﺼﻗ: ﻞﻗﺃ, ﺾﻔﺨﻨﻣ, ﺓﺬﺒﻧ, ﺎﺒﻳﺮﻗ, ﺰﺟﻮﻣ, ﺔﻗﺎﻄﺑ, ﻖﻴﺿ, ﻒﻴﻔﻃ
ﺭﺩﺎﻗ: ﻊﻴﻄﺘﺴﺗ, ﻞﻫﺄﺗ, ﻞﻫﺆﻣ, ﻰﻠﻋ-ﺭﺩﺎﻗ, ﺔﻌﺳ, ﺓﺭﺪﻘﻟﺍ, ﺭﺩﺎﻗ-ﺮﻴﻏ, ﺺﺘﺨﻣ, ﻞﻤﺘﺤﻣ, ﺔﻴﻧﺎﻜﻣﺇ, ﺔﻴﺤﺟﺭﺃ, ﻱﻮﻗ, ﻱﻮﻗ, ﺮﻫﺎﻣ, ﺪﻗ
ﻲﺣ: ﺓﺎﻴﺣ, ءﺎﻘﺒﻟﺍ, ﻑﺮﺼﺗ, ﺔﺸﻴﻌﻤﻟﺍ, ﺶﻋ, ﻲﺣ, ﻲﺣ, ﻲﺣ, ﺓﺎﻴﺤﻟﺍ-ﺪﻴﻗ-ﻰﻠﻋ, ﻂﻴﺸﻧ, ﻡﺎﺨﻟﺍ, ﻢﻴﻘﻳ
ﻉﻮﺿﻮﻤﻟﺍ: ﺐﻳﺩﺄﺗ, ﻉﻮﺿﻮﻣ, ﻉﻮﺿﻮﻣ, ﺱﺭﺩ, ﺓﺩﺎﻣ, ﺔﻴﻀﻘﻟﺍ, ﻢﺴﺟ, ﻰﻨﻌﻣ, ﺓﺩﺎﻣ, ﻅﺎﻔﻟﻷ﻿ﺍ-ﺕﻻ﻿ﻻ﻿ﺩ, ﺔﻟﺄﺴﻣ, ﺔﻴﻣﺍﺮﻏ-ﺔﻗﻼ﻿ﻋ, ﻥﺍﻮﻨﻋ
ﻪﺴﻔﻧ-ﻉﻮﺿﻮﻣ-ﺔﻣﻼ﻿ﻋ: 
ﻒﻠﺘﺨﻣ-ﻉﻮﺿﻮﻣ: 
ﺔﺑﺎﺟﺇ: ﻝﺎﻤﺷ, ﺩﺭ, ﺔﺑﺎﺠﺘﺳﺍ, ﻞﺣ, ﻖﺑﺎﻄﺗ, ﺩﺭ
ﺮﺤﺑ: ﻂﻴﺤﻣ, ﻱﺮﺤﺑ
ﻑﻮﺧ: ﻉﺰﻓ, ﻒﺋﺎﺧ, ﺐﻋﺭ, ﺐﻋﺭ, ﺔﻔﺋﺎﺧ, ﻊﻠﻫ, ﻖﻠﻗ, ﻖﻠﻘﻟﺍ, ﺐﻋﺭ, ﻉﺰﻓ
ﻢﻬﻔﺗ: ﻢﻬﻓ, ﻢﻬﻓ, ﺭﻮﺼﺗ, ﻢﻬﻓ, ﺭﻮﺼﺗ, ﻪﻤﻬﻓ-ﻦﻜﻤﻳ-ﻻ﻿, ﻦﻤﻀﺘﺗ, ﻙﺭﺩﺃ
ﻕﺎﺷ: ﺐﻌﺻ, ﺐﻠﺻ, ﺪﻘﻌﻣ, ﺱﺎﻗ, ﻝﺎﻋ-ﺕﻮﺻ, ﻒﻨﻌﺑ, ﻒﻴﻨﻋ, ﻲﺳﺎﻗ, ﻡﺭﺎﺻ, ﻱﺪﺤﺘﻟﺍ, ﺐﻌﺻ, ﻞﻴﻘﺛ, ﺮﺒﻗ, ﺓﺪﻳﺪﺷ, ﺮﻘﺘﺴﻣ-ﺮﻴﻏ
ﻁﻭﺮﺷ: ﺮﻴﺒﻌﺗ, ﺕﺎﺤﻠﻄﺼﻣ, ﺔﻴﻀﻘﻟﺍ, ﺪﻨﺘﺴﺗ, ﺱﺎﺳﺃ, ﺱﺎﺳﺃ, ﺎﻴﺳﺎﺳﺃ, ﺱﺎﺳﻷ﻿ﺍ-ﻲﻓ, ﺱﺎﺳﻷ﻿ﺍ-ﻲﻓ
ﻚﺷ: ﻩﺎﺒﺘﺷﺍ, ﺔﻘﺜﻟﺍ-ﻡﺪﻋ, ﻪﺑ-ﻪﺒﺘﺸﻣ
dubitative-ﺝﺍﺰﻣ: 
ﺐﻠﻄﺗ: ﻰﻠﺻ, ﺐﻠﻄﺗ, ﻊﻤﺘﺳﺍ, ﻚﻠﻀﻓ-ﻦﻣ
ﺔﺤﻠﺳﺃ: ﺡﻼ﻿ﺳ, ﺡﻼ﻿ﺴﻟﺍ-ﻉﺰﻧ, ﺢﻠﺴﻣ, ﻉﺍﺭﺫ
ﺩﻮﺳﺃ: 
ﺮﻀﺣﺍ: ﺐﻠﺟ, ﻞﻤﺣ, ﻑﻮﺳ, ﺓﺩﺎﻴﻗ
ﻞﻴﻤﺟ: ﺪﻴﺟ, ﻒﻴﻄﻟ, ﻞﻴﻤﺟ, ﻞﻴﻤﺟ, ﺔﻗﺮﺑ, ﻞﻴﻤﺟ, ﺓﻭﺰﻧ, ﺩﺭﺎﺑ, ﻒﻳﺮﺿ
ﻦﻛﺍﺩ: ﺔﺑﺂﻛ
ﺪﻘﻋ: ﻆﻔﺘﺣﺍ, ﺔﻈﻓﺎﺤﻤﻟﺍ, ﻰﻠﻋ-ﺾﺒﻗ, ﺔﻀﺒﻗ, ﺪﻘﻋ, ﺪﻘﻋ, ﺪﻘﻋ, ﺪﻘﻋ, ﻲﻓ-ﻊﻤﺟ, ﺮﻈﺘﻧﺍ, ﺐﺣﺍ, ﻞﻤﺤﺗ
ﺓﺮﺸﻋ: ﺪﻘﻋ, ﺮﺷﺎﻌﻟﺍ, ﺽﺮﻌﻣ
ﻦﻴﺒﺗ: ﺽﺮﻋ, ﺬﻔﻧ, ءﺍﺩﺃ, ﺓﺮﻫﺎﻈﻣ, ﺽﺮﻋ, ﺮﻴﺸﺗ, ﻝﺩ, ﺙﺪﺣ, ﻁﺎﻘﺳﺇ
ﺔﺼﻗ: ﺓﺭﻮﻄﺳﺃ, ﺦﻳﺭﺎﺘﻟﺍ, ﻝﺎﻴﺧ, ﺔﻌﻄﻗ
ﻙﺮﺘﺸﻣ: ءﺍﻮﻟ-ﻝﺍﺮﻨﺟ, ﺩﺎﺘﻌﻣ, ﻦﻴﺗﻭﺭ, ﺓﺩﺎﻋ, ﻱﺩﺎﻋ, ﻱﺩﺎﻋ-ﺮﻴﻏ, ﺓﺩﺎﻋ, ﻊﺿﺍﻮﺘﻣ, ﻲﻌﻴﺒﻃ, ﻢﻈﺘﻨﻣ-ﺮﻴﻏ, ﻱﺪﻴﻠﻘﺗ, ﻲﺟﺫﻮﻤﻧ, ﻲﻌﻴﺒﻃ-ﻞﻜﺸﺑ, ﺓﺩﺎﻋ, ﻙﺮﺘﺸﻣ, ﻚﻳﺮﺷ, ﺪﻋﺎﺴﻣ, ﻉﻮﻤﺠﻣ, ﻞﻣﺎﺷ, ﻝﺩﺎﺒﺘﻣ, ﺔﻛﺮﺸﻟﺍ
ﺏﺎﺘﻛ: ﺮﻳﺮﻤﺘﻟﺍ, ﻲﻃﺎﻴﺘﺣﻻ﻿ﺍ, ﻪﻴﻨﺟ, ﻲﺳﺭﺪﻤﻟﺍ-ﺏﺎﺘﻜﻟﺍ
ﻲﻧﻭﺮﺘﻜﻟﺇ: ﺕﺎﻴﻧﻭﺮﺘﻜﻟﺇ, ﻥﻭﺮﺘﻜﻟﻹ﻿ﺍ, ﺔﻘﻋﺎﺻ, ﺔﻴﺋﺎﺑﺮﻬﻛ, ءﺎﺑﺮﻬﻛ, ﻲﺋﺎﺑﺮﻬﻛ
ﻢﻠﻜﺘﺗ: ﺔﺛﺩﺎﺤﻣ, ﺔﺷﺩﺭﺩ, ﺽﻭﺎﻔﺗ, ﻞﻋﺎﻔﺗ, ﻞﻋﺎﻔﺗ, ﺽﻭﺎﻔﺗ, ﺙﺪﺤﺗ, ﺏﺎﻄﺧ, ﻕﻮﻄﻨﻣ, ﺚﻳﺪﺣ
ﺔﻣﻼ﻿ﻋ: ﺔﻣﻼ﻿ﻋ, ﺮﺛﺃ, ﺮﺛﺃ, ًﺎﻓﺪﻫ-ﺯﺮﺣﺃ, ءﻮﻀﻟﺍ-ﻂﻴﻠﺴﺗ, ﺔﻣﻼ﻿ﻋ, ﻪﺘﻓﻻ﻿, ﺓﺭﺎﺷﺇ, ﺔﻟﻻ﻿ﺩ, ﺔﻠﻳﺪﺟ, ﺔﻳﺭﺎﺠﺗ-ﺔﻣﻼ﻿ﻋ, ﺔﻴﺼﺨﺸﻟﺍ, ﻖﺼﻠﻣ
ﻡﺎﻤﺘﻫﺍ: ﺓﺮﻫﺯ, ﻢﺘﻬﻣ, ﺔﻳﺎﻨﻋ-،ﻥﺄﺷ-،ﻡﺎﻤﺘﻫﺍ
ﺐﺘﻛﺍ: ﻞﻜﺸﺗ, ﺔﺑﺎﺘﻜﻟﺍ-ﻱﺭﺎﺟ, ﺐﺘﻛﺍ, ﻲﺑﺎﺘﻛ
ﺮﻳﺮﺳ: 
ﻱﺭﻭﺮﺿ: ﻲﺳﺎﺳﺃ, ﻢﻬﻣ, ﺪﻴﻔﻣ, ﺝﺮﺣ, ﻱﻮﻴﺣ, ﺮﻴﺒﻛ, ﻢﻬﻣ-ﺮﻴﻏ, ﻞﻣﺎﻜﺘﻟﺍ, ﻱﺮﻴﺼﻣ, ﻢﻫﻷ﻿ﺍ, ﺔﺟﺎﺣ, ﺓﺭﻭﺮﻀﻟﺎﺑ, ﺪﻌﺘﻣ-ﺮﻴﻏ, ﺪﻌﺘﻣ-ﺮﻴﻏ, ﺪﻌﺘﻣ-ﺮﻴﻏ
ﺓﺮﻜﻓ: ﺪﻘﺘﻌﻳ, ﺭﺎﺒﺘﻋﻻ﻿ﺍ, ﻖﻄﻨﻣ, ﻱﺃﺭ, ﻡﻮﻬﻔﻣ, ﻲﻨﻫﺬﻟﺍ-ﻒﺼﻌﻟﺍ
ﻦﻓ: ﺔﻓﺮﺣ, ﻲﻨﻓ
vialis-ﺔﻟﺎﺣ: 
ﺥﺃ: ﺓﻮﺧﻷ﻿ﺍ, ﺖﺧﺃ
ﺎﻧﺎﻴﺣﺃ: ﺎﻣ-ﺍﺭﺩﺎﻧ, ﺎﻧﺎﻴﺣﺃ, ﺎﻣ-ﺖﻗﻭ-ﻲﻓ
ﻂﺧ: ﻙﻼ﻿ﺳﻷ﻿ﺍ, ﻂﻴﺧ, ﻒﺻ, ﻂﺧ, ﻞﻴﺻﻮﺘﻟﺍ, ﻉﺎﻓﺪﻧﺍ, ﻂﻳﺮﺷ, ﺔﺒﻳﺮﺿ, ﻲﺼﻨﻟﺍ
ﻝﻭﺪﺟ: ﺐﺘﻜﻣ-ﺔﻟﻭﺎﻃ, ﻲﻨﻣﺰﻟﺍ-ﻝﻭﺪﺠﻟﺍ, ﺱﺮﻬﻓ
ﺮﻬﻧ: ﺓﺩﺎﺳﻭ, ﺓﺩﺎﺳﻭ, ﻖﻓﺪﺗ
ﻦﻴﻋ: ﻦﻴﻋ, ءﺎﺤﻧﺃ
ﺕﺎﻣﻮﻠﻌﻣ: ﺔﻟﺎﺳﺮﻟﺍ, ﺡﺮﺷ, ﻒﺻﻮﻟﺍ, ﺓﺮﺸﻧ, ﺔﻓﺮﻌﻣ, ﺕﺎﻧﺎﻴﺒﻟﺍ
ﺓﺄﺠﻓ: ﺊﺟﺎﻔﻣ
ﺐﻳﺮﻏ: ﺐﻳﺮﻐﻟﺍ, ﺊﺟﺎﻔﻣ, ﺐﻳﺮﻏ-ﻞﻜﺸﺑ, ﺐﻳﺮﻏ, ﺐﺠﻋ, ﻊﺋﺍﺭ, ﻊﺋﺍﺭ, ﻲﺋﺎﻨﺜﺘﺳﺍ, ﻕﺪﺼﻳ-ﻻ﻿, ﺎﻘﺣ-ﺔﻌﺋﺍﺭ, ﺐﻳﺮﻏ, ﻚﺤﻀﻣ, ﺐﻳﺮﻏ, ﺐﻳﺮﻏ, ﻢﺋﻼ﻿ﻣ-ﺮﻴﻏ
ﻖﻴﻤﻋ: ﺓﺪﺸﺑ, ﻖﻤﻋ, ﻕﺎﻄﻨﻟﺍ-ﺔﻌﺳﺍﻭ, ﻞﺤﺿ, ﻞﻣﺎﺷ, ﻞﺼﻔﻣ, ﻞﻣﺎﺷ, ﺓﺮﻴﻄﺧ, ﻖﻴﻤﻋ, ﻦﻤﺿ, ﻞﺧﺍﺩ-ﻲﻓ, ﻲﻠﺧﺍﺩ, ﺓﺩﻭﺩ
ﺮﻴﻴﻐﺗ: ﻞﻳﺪﻌﺗ, ﻑﻼ﻿ﺘﺧﺍ, ﻞﻳﻮﺤﺗ, ﻝﻮﺤﺗ, ﻝﻮﺤﺗ, ﺔﺑﻮﻧ, ﺮﻴﻐﺗ, ﻞﻳﺪﻌﺗ, ﻝﺎﻘﺘﻧﺍ, ﻞﻳﺪﻌﺗ, ﻝﺍﺪﺒﺘﺳﻻ﻿ﺍ
ﺭﻮﻌﺷ: ﺮﻌﺸﻳ, ﺱﺎﺴﺣﺇ, ﻙﺍﺭﺩﻹ﻿ﺍ, ﻉﺎﺒﻄﻧﻻ﻿ﺍ, ﺔﻔﻃﺎﻋ, ﺝﺍﺰﻣ, ﺕﺮﺛﺄﺗ, ﻲﻔﻃﺎﻋ, ﻲﺴﺣ, ﺔﻔﻃﺎﻋ, ﺱﺎﺴﺣﺇ, ﻒﻐﺷ, ﻲﻋﺍﻭ, ﻲﻋﻭ
ﻊﻤﺘﺠﻳ: ﻝﻮﺼﺤﻟﺍ, ﺏﺭﺎﻘﺗ, ءﺎﻘﻟ, ﻝﺎﺜﺘﻣﻻ﻿ﺍ, ﺽﻮﻋ, ﻉﺎﻤﺘﺟﺍ-ﺪﻘﻋ
ﺽﺮﻏ: ﻢﺴﺟ, ﻑﺪﻫ, ﻲﻋﻮﺿﻮﻣ, ﻑﺪﻫ, ﺩﻮﺼﻘﻤﻟﺍ-ﻥﺎﻜﻤﻟﺍ, ﺔﻴﻧ, ﺩﻮﺼﻘﻣ, ﻊﻓﺍﺩ, ﻑﺪﻬﻟﺍ
ﺪﻴﻌﺳ: ﺡﺮﻣ, ﻊﺘﻤﺘﺴﻣ, ﺔﻌﺘﻣ, ﺪﻴﻌﺳ, ﺔﺣﺮﻓ, ﺓﺩﺎﻌﺳ, ﺔﺠﻬﺑ, ﺓﺩﺎﻌﺴﻟﺍ-ﻰﻬﺘﻨﻣ-ﻲﻓ, ﺡﺮﻣ, ﺓﺩﺎﻌﺴﺑ, ﻆﺤﻟﺍ-ﺪﻴﻌﺳ, ﺭﻭﺮﺴﻣ
ﺍﺪﺑ: ﻲﺟﺭﺎﺧ-ﺮﻬﻈﻣ, ﺮﻬﻇ, ﻭﺪﺒﻳ-ﺎﻣ-ﻰﻠﻋ
ﻡﺩ: ﻑﺰﻨﻳ, ﻡﺮﺠﻣ
ﻊﻔﺗﺭﺍ: ﻱﺩﺭﻭ
ﺏﻮﻨﺟ: ﻲﺑﻮﻨﺟ, ﺓﺮﻴﻬﻈﻟﺍ-ﺖﻗﻭ, ﺭﺎﻬﻨﻟﺍ-ﻒﺼﺘﻨﻣ
ﺩﺮﺑ: ءﺎﺘﺸﻟﺍ, ﺩﺭﺎﺑ, ﺩﺮﺒﻟﺎﺑ-ﺮﻌﺸﻣ
ﻡﺎﻣﻷ﻿ﺍ-ﻰﻟﺇ: ﻲﻓﺎﺿﺇ, ﺪﻌﺑﺃ, ﺎﻣﺪﻗ, ﺪﻬﺸﻣ, ﺔﻬﺒﺟ, ﻡﺪﻘﺘﻣ, ﺬﻨﻣ, ﺵﺎﻔﺧ, ﻰﻠﻋ, ﺍﺪﻋﺎﺼﻓ
ﻊﺿﻮﻣ: ﻊﻗﻮﻣ, ﺔﻟﺎﺣ, ﺔﻟﺎﺤﻟﺍ, ﺔﺻﺮﻓ, ﺔﺻﺮﻓ, ءﺎﻀﻔﻟﺍ, ﻒﻗﻮﻣ, ﻊﺿﻭ, ﻥﺎﻜﻣ, ﺪﻌﺑ, ﺮﺼﻨﻌﻟﺍ
ﺮﺧﺄﺘﻣ: ءﻂﺒﺑ, ﺔﻳﺎﻬﻨﻟﺍ
ﻒﻗﻮﻣ: ﺔﻄﺤﻣ, ﻱﺩﻮﻤﻋ, ﻒﻗﻮﻣ, ﻒﻗﻮﻣ, ﻒﻗﻮﺗ, ﻊﺿﻭ, ﻞﻜﺸﺗ, ﻞﻄﻌﺗ-ﻭﺃ-ﺔﻠﻃﺎﻤﻣ
ﺽﺮﺘﻓﺍ: ﺽﺍﺮﺘﻓﺍ, ﺔﻴﺿﺮﻓ, ﺽﺮﺘﻓﺍ, ﻰﻨﺒﺗ, ﺽﺮﺘﻓﺍ, ﺽﺮﺘﻓﺍ, ﺡﺮﺘﻗﺍ
ﺔﻨﺑﺍ: ﺓﺎﺘﻓ, ءﺍﺭﺬﻋ
ﻲﺑ-ﺹﺎﺨﻟﺍ: ﻲﻟ
ﻊﻄﻗ: ﺺﻘﻧ, ﻰﻟﺇ-ﺮﻘﺘﻔﺗ, ﺾﻴﻔﺨﺗ, ﺺﻘﻧ, ﻥﺎﺼﻘﻧ, ﺺﻘﻧ, ﺔﺴﻧﻵ﻿ﺍ, ﻊﻄﻗ, ﻊﻄﻗ, ﻊﻄﻘﻳ, ﺾﻔﺧ, ﻝﻮﺼﺤﻣ, ﻢﻴﻠﻘﺗ, ﺭﻮﺴﻜﻣ, ﻙﺎﻬﺘﻧﺍ
ﺦﺴﻧ: ﺦﺴﻧ, ﺭﺍﺮﻜﺗ, ﺭﺍﺮﻜﺗ, ﺦﺴﻧ, ﺓﺭﻮﺻ, ﺥﺎﺴﻨﺘﺳﺍ, ﺭﺍﺪﺻﻹ﻿ﺍ, ﺔﻴﺒﻃ-ﺔﻔﺻﻭ
ﺝﻭﺰﻟﺍ: ﻞﺟﺭ, ﺝﻭﺰﻟﺍ
ﺔﺘﺳ: ﺲﻨﺟ
ﺮﻛﺬﺗ: ﺔﻈﺣﻼ﻿ﻣ, ﺕﺎﻤﻟﺎﻜﻤﻟﺍ-ﺓﺩﺎﻋﺇ, ﺮﻴﻛﺬﺗ, ﻆﻔﺣ
ﺮﻴﺛﺄﺗ: ﺮﻴﺛﺄﺗ, ﺮﺛﺆﺗ, ﻉﺎﺒﻄﻧﻻ﻿ﺍ, ﻡﺩﺎﺼﺗ-ﻭﺃ-ﺮﻴﺛﺄﺗ, ﺔﻨﻤﻴﻫ, ﻝﺎﻌﻓ, ﻝﺎﻌﻓ-ﻮﺤﻧ-ﻰﻠﻋ, ﺔﻴﻟﺎﻌﻓ, ﺔﺠﻴﺘﻧ, ﺔﺠﻴﺘﻧ, ﺽﺮﻌﺗ
ﻊﻘﺗ: ﻒﻳﺮﺨﻟﺍ, ﺔﻴﻀﻗ---ﺔﻟﺎﺣ, ﻊﻘﺗ, ﻢﻄﺤﺗ, ﺮﺜﻌﺗ, ﻝﺎﺼﻔﻧﺍ, ﺭﺎﻴﻬﻧﺍ, ﻁﺎﻘﺳﺇ, ﺾﻓﺭ, ﻥﺎﺼﻘﻧ
ﺍﺪﻋ-ﺎﻣ: ﻻ﻿ﺇ, ﺝﺭﺎﺨﻟﺍ-ﻲﻓ, ﺝﺭﺎﺧ, ﻦﻋ-ﺍﺪﻴﻌﺑ, ﺍﺪﻴﻌﺑ, ﺎﻌﻧﺎﻣ, ﺐﻧﺎﺠﺑ, ﺎﺒﻧﺎﺟ, ﻦﻣ---ﺎﺒﻧﺎﺟ
ﺮﻌﺷ: 
ﺯﺎﻴﺘﺟﺍ: ﺔﻄﺳﺍﻮﺑ, ﻝﻼ﻿ﺧ, ﺮﺑﺎﻋ, ﺔﻄﺳﺍﻮﺑ, ﺏﺮﻗ, ﺐﻧﺎﺠﺑ, ﻒﻟﺄﺘﺗ, ﺝﺮﺨﺗ, ﺃﺪﺻ, ﺐﻴﻠﺼﻟﺍ, ﺭﻭﺮﻣ, ﻡﺪﻘﺗ
ﺮﺸﻨﻟﺍ-ﻖﺣ: 
ﺶﻴﺟ: ﺕﺍﻮﻘﻟﺍ, ﺕﺍﻮﻗ, ﻒﻴﻀﻣ, ﻱﺪﻨﺟ
ﺾﻛﺭﺍ: ﺏﺮﻫ, ﻑﺍﺰﻨﺘﺳﺍ, ﻞﻴﻐﺸﺗ, ﺬﻔﻧ, ﻞﻤﻌﻟﺍ, ﺔﻠﻤﺣ, ﺐﺋﺍﺫ, ﺕﺍﺪﻌﻣ
ﻥﺎﺼﺣ: ﺓﻭﺪﺣ, ﻲﻓ
ﻞﺒﻘﺘﺴﻣ: ﻝﺍ-ﻞﺒﻘﺘﺴﻣ, ﻖﺣﻻ﻿-ﺖﻗﻭ-ﻰﻟﺍ, ﺬﺋﺪﻌﺑ, ﻚﻟﺫ-ﺪﻌﺑ
ﺏﺮﻏ: ﻲﺑﺮﻐﻟﺍ
ﻊﻓﺩ: ﺭﻮﺟﺃ, ﺓﺮﺟﺃ, ﺐﺗﺍﺭ, ﻊﻓﺩ, ﻊﻓﺩ, ﺄﻓﺎﻛ, ﻡﻮﺳﺭ, ﺔﻔﻠﻛ
ﺮﻤﺣﺃ: 
ﺐﻫﺫ: 
ﺔﺒﻏﺭ: ﺓﺩﺍﺭﺇ, ﺺﻳﺮﺣ, ﺔﻴﻬﺷ, ﺔﺒﻏﺭ, ﻦﺣ, ﺚﺣ
ﺐﻌﻟ: ﺺﻗﺭ, ﺓﺮﻣﺎﻐﻣ, ﺔﺒﻌﻟ, ﺪﺨﻟﺍ, ﻪﺒﻌﻟ-ﻪﺳﻭﺮﻋ
ﻲﺴﻴﺋﺭ: ﺏﺭ, ﻲﺋﺍﺪﺘﺑﺍ, ﻲﺴﻴﺋﺭ, ﻰﻌﻣﺎﺟ-ﺭﻮﺘﻛﺩ, ﺮﻄﻴﺳ, ﻢﻜﺤﻳ, ﺪﻴﺴﻟﺍ, ﻡﺮﺘﺤﻣ-ﻥﺎﺴﻧﺍ, ﺓﺩﺎﻴﻗ, ﺪﻴﺳ
ﺐﺘﻜﻣ: ﺔﻟﺎﻛﻭ, ﺐﺘﻜﻣ-ﺔﻟﻭﺎﻃ
ﺔﻣﻮﻜﺣ: ﺔﻟﺎﺣ, ﻒﺻ
ﺔﺴﻴﻨﻛ: 
ﻝﻮﻄﻟﺍ: ﻉﺎﻔﺗﺭﺍ, ﻉﺎﻔﺗﺭﺍ, ﺪﺘﻤﺗ, ﻝﻮﻃ-ﻰﻠﻋ, ﺔﻴﻨﻣﺰﻟﺍ-ﺓﺪﻤﻟﺍ
ﺔﻛﺮﺷ: ﺖﺑﺎﺜﻟﺍ, ﺔﻛﺮﺷ, ﻊﻤﺘﺠﻤﻟﺍ, ﻞﻤﻋ, ﺔﻛﺮﺸﻟﺍ, ﻥﺎﻴﻛ, ﺔﺴﺳﺆﻣ, ﺔﻟﺎﻛﻭ, ﺪﻬﻌﻣ, ﻉﻭﺮﺸﻣ
ﺔﻗﺭﻭ: ﺔﻗﺭﻭ, ﺔﻗﺎﻄﺑ, ﻕﺎﺜﻴﻣ
ﻝﺎﻤﺘﺣﺍ: ﺔﻴﻧﺎﻜﻣﺇ, ﺔﻴﺤﺟﺭﺃ, ﺢﺟﺭﻷ﻿ﺍ-ﻰﻠﻋ, ﺎﻤﺑﺭ, ﺢﺟﺮﻤﻟﺍ-ﺮﻴﻏ-ﻦﻣ, ﻝﺎﻤﺘﺣﺍ, ﺔﺻﺮﻓ
ﺔﺻﺎﺧ: ﺹﺎﺧ, ﺎﺼﻴﺼﺧ, ﺪﻳﺪﺤﺘﻟﺍ-ﻪﺟﻭ-ﻰﻠﻋ, ﺔﺻﺎﺧ, ﻦﻴﻌﻣ-،ﺺﺼﺨﻣ, ﻂﺒﻀﻟﺎﺑ, ﻲﺳﺎﺳﺍ-ﻞﻜﺸﺑ, ﺔﺻﺎﺧ, ﻰﻟﻭﻷ﻿ﺍ-ﺔﺟﺭﺪﻟﺎﺑ, ﺓﺩﺪﺤﻣ
ﻞﻤﺤﺘﻳ: ﻞﻤﺣ, ﻞﻤﺤﺗ, ﺩﻮﻤﺼﻟﺍ, ﺢﻣﺎﺴﺗ, ﺢﻣﺎﺴﺗ, ﻚﻳﺪﻟ, ﻚﻠﻤﺗ, ﻞﻤﺤﺗ
ﺓﺬﻓﺎﻧ: 
ﺔﻴﻗﺎﻔﺗﻻ﻿ﺍ: ﻝﻮﻛﻮﺗﻭﺮﺑ, ﺔﻨﻃﻮﺘﺴﻣ, ﻂﺳﻭ-ﻞﺣ, ﻉﺎﻤﺟﺇ, ﺓﺪﻫﺎﻌﻣ, ﻰﻠﻋ-ﻖﻓﺍﻮﻳ, ﺔﻘﻔﺻ, ﻕﺎﻔﺗﺍ, ﺔﺼﻗﺎﻨﻣ, ﺮﺗﻭ, ﺪﻘﻋ, ﺔﻴﻗﺎﻔﺗﺍ, ﺐﻴﺗﺮﺗ
ﻝﺎﻤﺟ: ﻞﻴﻤﺟ, ﻖﻟﺄﺗ, ﻲﻟﺎﻤﺟ
ﺐﺟﺍﻭ: ﺔﻴﻟﻭﺆﺴﻣ, ﺔﻴﻟﻭﺆﺴﻣ, ﻡﺍﺰﺘﻟﺍ, ﻝﻭﺆﺴﻣ, ﻙﺭﺎﻤﺠﻟﺍ, ﺔﻤﻬﻣ, ﺔﻤﻬﻣ, ﻦﻳﺩ, ﻦﻳﺪﻧ, ﻥﺃ-ﺐﺠﻳ
ﻝﺎﺳﺭﺇ: ﺚﺑ-.ﻝﺎﺳﺭﺍ-.ﻞﻘﻧ, ﻢﻴﻠﺴﺗ, ﺪﻌﺑ, ﺚﺒﻟﺍ, ﻲﻧﻭﺮﺘﻜﻟﻻ﻿ﺍ-ﺪﻳﺮﺑ
ﺕﺎﻓﺎﺴﻤﻟﺍ: ﺔﻟﺍﺯﺇ, ﻕﺎﻄﻧ, ﻞﺼﻔﻟﺍ
ﺖﻤﺼﻟﺍ: ﻥﻮﻜﺳ
ﻡﺪﻗ: ﻕﺎﺳ, ﻒﻗﻭ, ﺬﺨﻓ, ﻡﺪﻘﻟﺍ-ﻊﺒﺻﺍ, ﻊﺑﺭ, ﺮﻴﺳ, ﻲﺸﻤﻟﺍ
ﻱﺮﺑ: ﻒﻨﻌﺑ, ﻰﻧﻮﻧﺎﻗ-ﺮﻴﻏ, ﻒﻴﻨﻋ, ﺔﻳﺮﺒﻟﺍ-ﺓﺎﻴﺤﻟﺍ
ﺕﻮﻤﻳ: ﻰﻟﺎﻌﺗ-ﻪﻠﻟﺍ-ﺔﻣﺫ ﻲﻓ, ﺓﺎﻓﻭ
ﻆﻔﺣ: ﺮﻴﻓﻮﺗ, ﻆﻔﺣ, ﺓﺩﺎﻌﺘﺳﺍ, ﻆﻔﺣ, ﻆﻔﺣ, ﻆﻔﺣ, ﻦﻳﺰﺨﺗ, ﺺﻠﺧ, ﺫﺎﻘﻧﺇ, ﻞﺠﺳ
ﺮﻀﺧﺃ: ﻡﺎﺨﻟﺍ, ﻡﺎﺧ-ﻂﻔﻧ
ﺔﻠﻜﺸﻣ: ﺞﻋﺰﻳ, ﺔﻴﻀﻘﻟﺍ, ﺔﻠﻜﺸﻣ, ﺔﻘﺋﺎﺿ, ﺔﺑﻮﻌﺻ, ﻚﻟﺩ, ﺓﺎﻧﺎﻌﻣ
ﺔﻣﺎﺴﺘﺑﺍ: ﺔﻣﺎﺴﺘﺑﺍ
ﺊﻃﺎﺧ: ﺄﻄﺧ, ﺄﻄﺧ, ﺊﻄﺨﻣ, ﺊﻴﺳ-ﻞﻜﺸﺑ, ﻑﺮﺼﺘﻟﺍ-ءﺎﺳﺃ, ﺔﺌﻃﺎﺧ, ﺄﻄﺧ, ﻞﺸﻓ, ﺐﻴﻋ, ﺄﻄﺧ-ﻰﻠﻋ, ﺔﻗﺎﻤﺣ
ﻒﻠﺘﺨﻣ: ﻒﻠﺘﺨﻣ, ﻉﻮﻨﺘﻣ, ﺩﺪﻌﺘﻣ, ﻕﺎﻄﻧ, ﻉﻮﻨﺘﻣ, ﺩﺪﻌﺘﻣ, ﻒﻠﺘﺨﻣ, ﻒﻠﺘﺨﻣ, ﻒﻠﺘﺧﺍ, ﺕﻭﺎﻔﺗ, ﺔﻠﻴﻜﺸﺗ
ﻡﻮﻧ: ﻢﺋﺎﻧ, ﻢﻠﺣ
quotative-ﺔﻟﺎﺣ: 
ﺔﻳﺍﺪﺒﻟﺍ: ﺃﺪﺑﺍ, ﺔﻳﺍﺪﺑ, ﺪﻬﻌﺗ, ﺵﺪﺧ, ﺔﻳﺍﺪﺑ, ﺮﻜﺒﻣ-ﺖﻗﻭ-ﻲﻓ, ﻝﻭﺃ, ﻉﻭﺮﺸﻟﺍ, ﺓﺮﻣ-ﻝﻭﻻ﻿, ﺃﺪﺒﻣ
ءﺍﺮﺟﺇ: ﺔﻤﻬﻣ, ﺔﻄﻘﻧ, ﺓﻮﻄﺧ, ﺡﺮﺴﻤﻟﺍ, ﻞﻤﻋ, ءﺍﺮﺟﺇ, ﻂﺸﻧ, ﺔﻴﻠﻤﻋ, ﻞﻴﻐﺸﺗ, ﻞﻌﻓ, ﻂﺷﺎﻧ, ﺓﻮﻄﺧ, ﺔﺳﺭﺎﻤﻣ, ﺔﺳﺭﺎﻤﻣ, ﻞﻤﻌﻟﺍ, ﻥﻭﺰﺨﻣ, ﻊﻤﺠﺗ, ﻡﺍﺪﻋﺇ, ﺬﻔﻧ
ﺓﺭﺎﻳﺯ: ﻝﻮﺻﻭ, ﺔﻠﺑﺎﻘﻣ, ﺎﻬﻴﻟﺇ-ﻝﻮﺻﻮﻟﺍ-ﻦﻜﻤﻳ, ﺮﻔﺳ, ﺔﻠﺣﺭ, ﺔﻠﺣﺭ, ﺔﻟﻮﺟ
ﻊﺒﺗﺇ: ﻡﺍﺰﺘﻟﻻ﻿ﺍ, ﻡﺰﺘﻠﺗ, ﻲﻟﺎﺘﻟﺍ, ﺐﻘﻌﺗ, ﺭﺎﺴﻣ, ﺔﻘﻓﺍﺮﻣ
ﻝﻭﺎﺣ: ﺔﻟﻭﺎﺤﻣ, ﻝﻭﺎﺣ, ﺩﻮﻬﺠﻣ, ﺭﺩﺎﺒﻣ, ﺔﺑﺮﺠﺗ, ﺭﺎﺒﺘﺧﺍ, ﺔﻨﻴﻋ
ﺭﻮﻀﺣ: ﺩﻮﺟﻭ, ﺓﺩﻮﺟﻮﻣ, ﻥﺎﻴﻛ, ﻝﻮﺻﻷ﻿ﺍ
ﻮﻠﺣ: ﻯﻮﻠﺣ, ﻒﻴﻄﻟ, ﻒﻴﻄﻟ, ﻒﻳﺮﺿ
ﻲﻨﻏ: ﺓﺮﻓﻭ, ﺮﻴﺜﻛ, ءﺎﻳﺮﺛﻷ﻿ﺍ
ﻭﺪﻌﻟﺍ: 
ﺔﻨﻴﻔﺳ: ﺏﺭﺎﻗ, ﺮﺤﺒﻳ, ﻝﻮﻄﺳﺃ, ﺭﺎﺤﺑﺇ, ءﺎﻋﻭ, ﺔﻳﺮﺤﺑ-ﺔﻠﺣﺭ, ﺓﺭﺎﺒﻌﻟﺍ
ﺔﻟﺎﺣ: ﻥﺎﻫﺭ, ﻥﺎﻫﺭ, ﺔﻟﺎﺣ, ﺔﻟﺎﺣ, ﻑﺮﻇ, ﺔﻟﺎﺤﻟﺍ, ﺓﻭﺮﺛ, ﺡﺮﺴﻤﻟﺍ, ﻯﻮﺘﺴﻣ, ﻪﻴﻧﺪﺒﻟﺍ-ﻪﻗﺎﻴﻠﻟﺍ, ﺕﺎﺒﻠﻄﺘﻤﻟﺍ
ﺎﻬﻨﻤﺿ-ﻦﻣ: ﻱﻮﺘﺤﻳ, ﻦﻤﻀﺘﺗ, ﻦﻤﻀﺘﺗ, ﻲﻤﺘﻨﺗ
ﻞﻣﺎﺷ-ﺺﺨﺷ: 
ﺮﺳ: ﺾﻣﺎﻏ, ﺽﻮﻤﻐﻟﺍ, ﺱﻮﺑﺩ, ﺽﺭﻻ﻿ﺍ-ﺖﺤﺗ, ﺯﺮﻔﺗ
precative-ﺝﺍﺰﻣ: 
ﺏﺬﻬﻣ-ﻞﻴﺠﺴﺗ: 
ﺮﺷ: ﺭﺮﺿ, ﺮﻳﺮﺷ, ﺮﻳﺮﺷ, ﺊﻴﺳ, ﺊﻴﺳ-ﻞﻜﺸﺑ
ﻡﺪﻘﺘﻳ-،ﺮﻴﺴﻳ-،ﺱﺭﺎﻣ: ﺐﻛﻮﻣ, ﺝﺎﺠﺘﺣﺍ, ﺓﺮﻫﺎﻈﻣ, ﺦﻳﺮﻤﻟﺍ
ﻥﺎﻛ-ﺎﻳﺍ: ﺊﺷ-ﻯﺍ, ﺎﻤﻳﺃ
ءﺎﻘﺒﻟﺍ: ﻞﻈﺗ, ﺱﻮﻠﺠﻟﺍ, ﺔﻳﻮﺴﺗ, ءﺎﻘﺒﻟﺍ, ﻢﻴﻘﻳ, ﺮﻈﺘﻧﺍ
ﻦﻣ-ﻻ﻿ﺪﺑ: ﻦﻣ-ﻻ﻿ﺪﺑ, ﻻ﻿ﺪﺑ, ﻞﻳﺪﺑ, ﻝﺍﺪﺒﺘﺳﻻ﻿ﺍ
ﻕﺭﺯﺃ: ﺔﻴﻨﺟ
ﻦﻜﻤﻣ-ﺮﻴﻏ: 
ﺔﺳﺭﺪﻤﻟﺍ: ﺔﻌﻣﺎﺠﻟﺍ-ﻡﺮﺣ, ﻢﻠﺳ
ﺔﺒﺳﺎﻨﻣ: ﺔﺻﺮﻓ, ﺙﺪﺣ, ﺭﻮﻬﻇ, ﺔﺻﺮﻓ, ﻞﻴﺒﺳ, ﺔﻘﻔﺻ
ﺝﻭﺰﺘﻣ: ﺝﺍﻭﺯ, ﺝﻭﺰﺗ, ﺝﺍﻭﺯ-ﻞﻔﺣ
ﻡﺎﻌﻃ: ﺔﺒﺟﻭ, ﺔﻴﻤﺣ, ﻖﺒﻃ, ﺔﻳﺬﻐﺗ, ﺬﻐﻣ
ﻥﻭﺮﺸﻋ: 
ﺉﺩﺎﻫ: ﺏﺎﺼﻋﻻ﻿ﺍ-ﺩﺭﺎﺑ, ﺉﺩﺎﻫ, ﺭﺍﺮﻘﺘﺳﺍ, ﺖﻣﺎﺻ, ﻲﻤﻠﺳ, ءﻲﻄﺑ, ءﺎﺧﺮﺘﺳﺍ, ءﻭﺪﻬﺑ
ﺔﻟﻮﻬﺴﺑ: ﺢﺟﺭﻷ﻿ﺍ-ﻰﻠﻋ, ﺔﻟﻮﻬﺴﺑ, ﺔﺿﺮﻋ, ﻞﻬﺳ, ﺔﺣﺍﺮﻟﺍ-ﻞﺋﺎﺳﻭ, ﻒﻴﻔﻃ, ﻼ﻿ﻴﻠﻗ, ﺔﻔﺨﺑ, ﺐﺳﺎﻨﻣ, ﻂﻴﺴﺑ
ﻞﻤﺘﺤﻣ-ﺐﻧﺎﺟ: 
ﺔﻐﻟ: ﻱﻮﻐﻟ, ﻥﺎﺴﻟ
ﺮﻴﺒﻌﺘﻟﺍ: ﺮﻴﺒﻌﺘﻟﺍ, ﻥﺎﻴﺑ, ﺓﺭﺎﺒﻌﻟﺍ, ﺢﻴﺿﻮﺗ, ﻲﺣﻭ, ﺽﺮﻌﺗ, ﻡﻼ﻿ﻛ
ﻉﻮﺒﺳﺃ: ﺪﺣﻷ﻿ﺍ
ﺔﻋﺎﻗ: ﻕﺍﻭﺭ, ﺡﺮﺴﻣ, ﻞﺧﺪﻣ, ءﺎﻀﻔﻟﺍ, ﺔﻓﺮﻏ, ﻥﻮﻟﺎﺻ, ﺔﺣﺍﺮﺘﺳﺍ, ﻰﺸﻤﻣ, ءﺍﺪﻋ, ﺔﻫﺩﺭ
ﺮﻄﺧ: ﺮﻴﻄﺧ, ﺮﻄﺧ, ﻡﺍﺮﺘﺣﺍ, ﺪﻳﺪﻬﺘﻟﺍ
ﺔﻴﻜﻠﻤﻟﺍ: ﻝﻮﺻﻷ﻿ﺍ, ﻲﻤﺘﻨﺗ, ﺔﻴﻜﻠﻤﻟﺍ-ﻖﺣ, ﺔﻴﻜﻠﻤﻟﺍ, ﺓﺯﺎﻴﺣ, ﺔﻴﺻﺎﺧ, ﺔﻤﺳ, ﺔﺑﺰﻋ, ﺓﻭﺮﺛ, ﺓﻭﺮﺛ
ﺪﻴﻟﺍﻮﻣ-ﻦﻣ: ﺓﺩﻻ﻿ﻮﻟﺍ
ﺔﻤﻜﺤﻣ: ﻲﺋﺎﻀﻗ, ﻖﺒﻃ, ﻯﺪﺘﻨﻣ, ﺔﺑﺮﺠﺘﻟﺍ
ﻡﻮﻤﻌﻟﺍ-ﻰﻠﻋ: ﺩﺎﺘﻌﻣ, ﺓﺩﺎﻋ, ءﺍﻮﻟ-ﻝﺍﺮﻨﺟ, ﻞﻣﺎﺷ, ﻊﺳﺍﻭ-ﻮﺤﻧ-ﻰﻠﻋ, ﺓﺩﺎﻋ, ﺓﺩﺎﻋ, ﻲﻌﻴﺒﻃ-ﻞﻜﺸﺑ, ﺔﻣﺎﻋ-ﺓﺭﻮﺼﺑ
ﺭﻮﺛﺄﻣ-ﺐﻧﺎﺟ: 
ﺔﻤﻴﻗ: ﻖﺤﺘﺳﺍ, ﺔﻤﻴﻘﻟﺍ, ﺔﻤﻴﻗ-ﻭﺫ, ﺔﻴﺣﻼ﻿ﺻ, ﺓﺭﺍﺪﺟ
ﻂﻴﺴﺑ: ﺔﻃﺎﺴﺑ, ﻂﻴﺴﺑ, ﺐﺳﺎﻨﻣ, ﻥﺮﻣ, ﻞﻬﺳ, ﻂﻘﻓ, ﺔﻃﺎﺴﺒﺑ, ﻱﺩﺎﻋ, ﻊﺿﺍﻮﺘﻣ, ﺩﺮﺠﻣ, ﺩﺮﺠﻣ, ﺓﺮﺷﺎﺒﻣ, ﻱﺩﺎﻋ
ﺓﺮﺠﺷ: ﺕﺎﺒﻨﻟﺍ, ﺐﺸﺧ, ﺢﻣﺭ, ﺐﺸﺧ
ﺏﺭﺎﺣ: ﻉﺍﺮﺻ, ﺔﻛﺮﻌﻣ, ﺔﻬﺟﺍﻮﻣ, ﺭﺎﺠﺷ, ﻢﺣﺍﺰﺗ
ﺭﺍﺪﺠﻟﺍ: 
ﺔﻨﺠﻟﺍ: ءﺎﻤﺳ
inchoative-ﺐﻧﺎﺟ: 
jussive-ﺝﺍﺰﻣ: 
ﺔﻤﻐﻧ: ﺐﻌﻠﻤﻟﺍ, ﻦﺤﻟ, ﻦﻃ, ﻦﻃ, ﻞﻇ
ﺭﺎﺒﺘﻋﺍ: ﻡﺍﺮﺘﺣﺍ, ﺽﺮﺘﻓﺍ, ﺽﺮﺘﻓﺍ, ﻩﺎﺒﺘﻧﺍ, ﺭﺎﺒﺘﻋﻻ﻿ﺍ, ﺮﺒﺘﻌﻳ, ﺔﻗﻼ﻿ﻋ, ﻥﺍﺮﺘﻗﺍ, ﺔﻗﻼ﻿ﻋ, ﺹﻮﺼﺨﺑ, ﺹﻮﺼﺨﺑ, ﻖﻴﻠﻌﺗ, ﺔﻴﻄﻐﺗ
ﻊﻗﻮﺘﻣ: ﻊﻗﻮﺗ
ﺮﻬﺷ: ﺮﻤﻘﻟﺍ
ﺓﺮﺒﺧ: ﻲﺒﻳﺮﺠﺗ, ﻲﺒﻳﺮﺠﺗ, ﺓﺮﺒﺨﻟﺍ-ﻱﻭﺫ, ﺓﺮﺒﺧ, ﺫﺬﻠﺗ, ﺔﺑﺮﺠﺗ
ﺎﻣﺎﻤﺗ: ﺎﻣﺎﻤﺗ, ﺯﺎﺘﻤﻣ-ﻞﻜﺸﺑ, ﻞﻣﺎﻛ-ﻞﻜﺸﺑ, ﺎﻣﺎﻤﺗ, ﺎﻣﺎﻤﺗ, ﺎﻣﺎﻤﺗ, ﺎﻗﻼ﻿ﻃﺇ, ﻖﻠﻄﻣ, ﻪﻠﻤﻛﺄﺑ, ﺎﻣﺎﻤﺗ, ﺎﻣﺎﻤﺗ, ﺖﺤﺑ, ﻂﺒﻀﻟﺎﺑ
ﺝﺯﺎﻃ: ﺝﺯﺎﻄﻟﺍ, ﻲﻘﻧ, ﻒﻴﻈﻧ, ﺶﻌﺘﻨﻣ, ﺪﻳﺪﺟ, ﺉﺪﺘﺒﻣ
ﻕﻭﺩ: ﺓﺮﻄﺴﻣ, ﺮﻴﻣﺃ
ﻰﻄﻐﻣ: ﺔﻴﻄﻐﺗ, ﺔﻴﻄﻐﺗ, ﺍﺪﻴﻌﺑ, ﻖﻠﻐﻣ, ﻲﻠﺧﺍﺩ
ﺪﻴﻘﻣ: ﻯﺪﻣ, ﺪﻳﺪﺤﺗ, ﺪﺣ, ﺩﻭﺪﺤﻟﺍ, ﺪﻴﻴﻘﺗ, ﺪﻴﻘﻣ, ﻞﺼﺘﻣ, ﺪﻤﺘﻌﺗ, ﻂﺑﺭ
ﻕﺮﺸﻟﺍ: ﺔﻴﻗﺮﺸﻟﺍ, ﺬﻨﻣ, ﻖﺑﺎﺳ, ﻞﺒﻗ, ﻞﺒﻗ, ﻪﻴﺟﻮﺗ
ﺮﺠﺣ: ﻡﺎﺧﺭ, ﺓﺮﺨﺻ, ﺓﺮﻫﻮﺟ
ﺾﻌﺑ: ﺎﻣ-ﺎﺌﻴﺷ, ﺊﺷ-ﻯﺍ, ﺾﻌﺑ, ﺎﻣﺎﻤﺗ, ﻻ﻿ﺪﺑ, ﻼ﻿ﻴﻠﻗ, ﺎﻴﺋﺰﺟ, ﺎﻣ-ﺔﻘﻳﺮﻄﺑ
ﻩﺎﺠﺗﺍ: ﻩﺎﺠﺗﺍ, ﺪﻌﺑ, ﻩﺎﺠﺗﺍ, ﻪﻴﺟﻭ, ﺕﺎﻤﻴﻠﻌﺗ
ﻲﺳﺮﻛ: ﺪﻌﻘﻣ, ﺔﻜﻳﺭﺃ, ﺯﺍﺮﺑ
ﻢﻋﺪﻟﺍ: ﻞﻤﺤﺗ, ﺪﻴﻳﺄﺗ, ﺓﺪﻋﺎﺴﻣ, ﺓﺪﻋﺎﺴﻣ, ﺱﻮﻗ, ﺓﺪﻋﺎﺴﻣ
ﺦﻳﺭﺎﺘﻟﺍ: ﺦﻳﺭﺎﺘﻟﺍ, ءﺎﻘﻟ
ﺔﻳﺮﻗ: ﺔﻳﺮﻗ, ﻒﻳﺮﻟﺍ
ﻝﺎﺠﻣ-،ﻞﻘﺣ: ﻥﺍﺪﻴﻣ, ﺔﻜﻠﻤﻣ, ﺔﻘﻄﻨﻣ, ﻢﻴﻠﻗﺇ, ﺔﻘﻄﻨﻣ, ﺔﻘﻄﻨﻣ, ﻉﺎﻄﻗ, ﻕﺎﻄﻧ, ﺔﺒﻠﺣ, ﺐﻌﻠﻣ, ءﺎﻀﻔﻟﺍ, ﺶﻣﺎﻫ, ﻒﻳﺮﻟﺍ, ﻢﻴﺨﻣ
ﻥﺫﺇ: ﺡﺎﻤﺴﻟﺍ, ﻥﺫﺇ, ﺢﻳﺮﺼﺗ, ﺺﻴﻠﺨﺗ, ﺭﺩﺎﻏ, ﺔﺼﺧﺭ, ﺔﺼﺧﺭ, ﺔﻘﻓﺍﻮﻣ, ﺭﺍﺪﺻﺇ
ﻞﻫﺎﺴﺘﻣ-ﺝﺍﺰﻣ: 
ﺡﺎﺠﻧ: ﺢﺟﺎﻧ, ﺢﺠﻧ, ﺭﺎﻫﺩﺯﺍ, ﺯﺎﺠﻧﺇ, ﺯﻮﻓ, ﺮﺼﺘﻧﺍ, ﺏﺮﺿ, ﺯﻮﻓ, ﺰﺋﺎﻔﻟﺍ
ﻖﺋﻻ﻿: ﻢﻴﻠﺳ-ﻞﻜﺸﺑ, ﺢﻴﺤﺻ, ﻝﻮﻘﻌﻣ, ﺐﺳﺎﻨﻣ, ﻖﻴﻗﺩ, ﻖﻴﻗﺩ, ﻕﺎﻘﺤﺘﺳﺍ, ﻖﻴﻗﺩ, ﻖﻴﻗﺩ-ﻞﻜﺸﺑ, ﻻ﻿ﺎﺣ, ﺔﻧﺎﻣﺄﺑ, ﻖﺤﺑ, ﺢﻴﺤﺻ-ﻞﻜﺸﺑ, ﻦﻳﺎﺒﺘﻟﺍ, ﺐﺳﺎﻨﺗ, ﺐﺳﺎﻨﻣ, ﺐﺳﺎﻨﻣ, ﺐﺳﺎﻨﻣ, ﻖﺑﺎﻄﺗ, ﻞﻫﺆﻣ, ﺔﻠﺻ, ﻝﺍﻮﺣﻻ﻿ﺍ-ﻦﺴﺣﺍ-ﻲﻓ, ﻑﺎﻛ, ﻡﺎﻈﺘﻧﺎﺑ
ﻞﺗ: ﻞﺒﺟ, ﻞﺒﺟ
ﻰﻘﻴﺳﻮﻣ: ﻲﻘﻴﺳﻮﻣ
ﻲﺻﺎﻘﻟﺍ-ﻲﻧﺎﻫﺮﺑ: 
ﻝﺍﻭﺰﻟﺍ-ﺪﻌﺑ: .ءﺎﺴﻣ, ﺓﺮﻴﻬﻈﻟﺍ-ﺖﻗﻭ, ﺭﺎﻬﻨﻟﺍ-ﻒﺼﺘﻨﻣ, ﺭﺎﻬﻨﻟﺍ-ﺮﺧﺍ
ءﺎﻜﺑ: ﺏﺪﻧ, ﺔﺤﻴﺻ, ﺔﺧﺮﺻ
ﻑﺮﺷ: ﻑﺮﺷ, ﻡﺍﺮﺘﺣﺍ, ﺔﻣﺍﺮﻛ, ﻡﺮﺘﺤﻣ, ﻑﺮﺸﻣ, ﻲﻔﻳﺮﺸﺗ, ﺔﻠﻣﺎﺠﻣ, ﺪﺠﻣ, ﻝﺪﻌﻣ, ﺮﻌﺴﻟﺍ
ﺔﻌﺒﺳ: 
ﺹﺎﺧ: ﺔﻴﺼﺨﺸﻟﺍ, ﺲﻔﻨﻟﺍ, ﺎﻴﺼﺨﺷ, ﻲﺗﺍﺬﻟﺍ, ﺹﺎﺧ, ﺔﻴﺻﻮﺼﺧ, ﺓﺩﺪﺤﻣ, ﺔﻳﺮﺼﺣ
ﺭﺎﺒﺧﺃ: ﺔﻟﺎﺳﺮﻟﺍ
ﺪﻬﺸﻣ: ﻊﻗﻮﻣ, ﺪﻬﺸﻣ, ﻕﺎﻴﺴﻟﺍ, ﺽﺮﻋ, ﻱﺮﺼﺑ, ﺡﺮﺴﻤﻟﺍ, ﻱﺃﺭ, ﻝﺎﻤﺘﺣﺍ, ﺔﻤﻴﺧ
ﺔﻘﻳﺪﺣ: ﻩﺰﺘﻨﻣ
ﻕﺎﺒﺳ: ﻲﻗﺮﻋ, ﻕﺎﺒﺳ, ﻞﻴﻐﺸﺗ, ﺔﻘﺑﺎﺴﻣ, ﺓﺍﺭﺎﺒﻣ, ﺔﺼﻗﺎﻨﻣ, ﺮﺛﺎﻜﺗ, ﺓﺍﺭﺎﺒﻣ
ﻲﻌﻳﺯﻮﺗ-ﺔﻟﺎﺣ: 
ﻢﻠﻌﺗ: ﺔﺳﺍﺭﺩ, ﻢﻠﻋ
ﻲﺳﺎﻴﺳ: ﺔﺳﺎﻴﺳ, ﻲﺳﺎﻴﺳ, ﻲﺳﺎﻴﺳ, ﺕﺎﺳﺎﻴﺳ
ﺔﺑﺬﻛ: ﺔﺌﻃﺎﺧ
ﺏﻮﺒﺼﻤﻟﺍ: ﻞﺠﻌﺘﺳﺍ, ﻲﻣﺭ, ﻑﺬﻗ, ﺔﻋﺮﻗ, ﻞﻜﺷ, ﺐﻟﺎﻗ, ﻕﻼ﻿ﻃﺇ, ﻚﻔﺳ, ﻝﺎﻘﺘﺳﺍ
ﻞﻛﺃ: ﺔﺒﺟﻭ, ﺔﻳﺬﻐﺗ, ﻖﺒﻃ, ﻡﺎﻌﻄﻟﺍ-ﻝﻭﺎﻨﺗ, ﻙﻼ﻿ﻬﺘﺳﺍ
ﺔﻴﺿﺭﺃ: ﺓﺩﺎﺠﺳ, ﺽﺭﺃ, ﻞﻔﺳﺃ, ﺔﺑﺮﺗ, ﺮﻴﺳ, ﻲﻟﺎﻋ, ﻞﻳﻮﻃ
ءﻮﺳ: ﺾﻳﺮﻣ, ﺾﻳﺮﻤﻟﺍ, ﺔﺣﺮﻗ, ﺽﺮﻣ, ﺔﺌﻃﺎﺧ, ﺊﻴﺳ-ﻞﻜﺸﺑ
ﻲﻠﺻﺃ: ﻞﺻﻷ﻿ﺍ, ﻼ﻿ﺻﺃ, ﻱﺪﻴﻬﻤﺗ, ﻝﻭﺃ, ﺐﻴﻛﺮﺗ, ﺔﻳﺍﺪﺒﻟﺍ-ﻲﻓ, ﻱﺪﻠﺑ-ﻭﺃ-ﻲﻠﺤﻣ ﻦﻃﺍﻮﻣ, ﻲﻘﻴﻘﺣ, ﻲﻌﻴﺒﻃ-،ﻱﺮﻄﻓ, ﻦﻴﻴﻠﺻﻷ﻿ﺍ-ﻥﺎﻜﺴﻟﺍ, ﻲﺴﻴﺋﺭ, ﻲﺋﺍﺪﺘﺑﺍ, ﺝﺫﻮﻤﻨﻟﺍ
ﻒﻴﺼﻟﺍ: ﺓﺭﺍﺮﺣ
ﻦﻳﺩ: ﻦﻳﺪﺘﻣ, ﻦﻳﺩ
ﺓﺭﻮﺻ: ﺓﺭﻮﺻ, ﺔﺣﻮﻟ, ﺓﺭﻮﺻ, ﺮﻳﻮﺼﺗ, ﻲﻓﺍﺮﻏﻮﺗﻮﻓ, ﺮﻳﻮﺼﺘﻟﺍ, ﺭﻮﺻ, ﺓﺭﻮﺻ, ﻢﺳﺭ, ﺔﻌﻗﺮﻓ, ﻢﻠﻴﻓ, ﺢﻴﺿﻮﺗ, ﺮﻳﻮﺼﺗ, ﻦﻴﺗ, ﻞﻜﺸﻟﺍ
ﺏﺮﻫ: ﺏﺮﻫ
ﻒﻟﺆﻣ: ﺐﺗﺎﻜﻟﺍ, ﺱﺭﺪﻣ, ﺭﺮﺤﻣ
ﻰﻨﺑ: ﻱﺩﺎﻣﺭ, ﻱﺩﺎﻣﺮﻟﺍ-ﻥﻮﻠﻟﺍ, ﻊﻔﺳ, ﺰﻧﻭﺮﺑ
ﻢﻤﺼﻣ: ﺮﻳﺮﻘﺗ, ﺭﺮﻗ, ﺩﺪﺣ, ﺢﺿﺍﻭ, ﻡﺯﺎﺟ, ﻢﻤﺼﻣ, ﺩﺪﺤﻣ, ﺪﻛﺄﺗ, ﺮﻘﺘﺴﻣ, ﺪﻛﺆﻤﻟﺍ
ﻢﻟﺃ: ﺡﺮﺟ, ﺏﺮﻛ, ﻢﻟﺆﻣ, ﻥﺰﺣ, ﺔﺣﺮﻗ
ﻊﻴﺑﺭ: ﺔﺸﻳﺭ, ﺎﻨﻟ, ﺎﻨﻟ
ﻥﺮﻗ: ﻦﺳ
ﻢﻋﺎﻧ: ﺢﻨﻤﻣ, ﻢﻋﺎﻧ, ﺎﻤﻋﺎﻧ, ﺔﺼﻗﺎﻨﻣ, ﻒﻄﻠﺑ, ءﻭﺪﻬﺑ, ﻒﻴﻄﻟ, ﻒﻴﻄﻟ, ﻝﺪﺘﻌﻣ
ﻦﻛﺭ: ﺔﻳﻭﺍﺯ, ﺪﺗﻭ, ﻕﺮﻏ
ﺝﺎﺘﻧﺇ: ﺝﺎﺘﻧﺇ, ﺪﻴﻟﻮﺗ, ﺮﻤﺜﻣ, ﻊﻨﺻ, ﺔﻋﺎﻨﺻ, ﻊﻴﻨﺼﺗ
ﻚﺤﺿ: ﺡﺍﺰﻣ
ﻰﺴﻨﻧ: ﻞﻄﺗ
ﺎﺑﻭﺭﻭﺃ: 
ﺔﻴﻧﺎﻤﺛ: ﻦﻣﺎﺛ
ﻥﺎﺘﺴﻓ: ﻱﺯ, ﺲﺑﻼ﻿ﻣ, ﺏﻮﺛ, ءﺍﺩﺭ, ﻱﺪﺗﺮﻳ, ﺪﺣﻮﻤﻟﺍ-ﻱﺰﻟﺍ, ﺲﺑﻼ﻿ﻣ
ﺐﻴﻫﺭ: ﻒﻴﺨﻣﻭﺍ-ﻊﻳﺮﻣ, ﻊﻴﻈﻓ, ﺐﻴﻫﺭ, ﻒﻴﺨﻣ, ﻞﺋﺎﻫ, ﻱﻭﺎﺳﺄﻣ, ﻖﻠﻘﻠﻟ-ﺓﺮﻴﺜﻣ, ﻉﺰﻓ, ﻊﻴﻨﺷ, ﺾﻴﻐﺑ-ﻮﺤﻧ-ﻰﻠﻋ
ﺲﻔﻨﺗ: ﻲﺴﻔﻨﺗ, ﺲﻔﻨﺗ, ﺲﻔﻨﺗ, ﺮﻓﺯ, ﺎﻧﻷ﻿ﺍ, ﺙﺎﻬﻟ
ﻢﻴﻜﺣ: ﻝﻮﻘﻌﻣ, ﻝﻮﻘﻌﻣ, ﻆﻔﺤﺘﻣ, ﺱﻭﺭﺪﻣ, ﻲﻛﺫ, ﻲﻛﺫ, ﻲﻛﺫ
ﻲﻜﻠﻤﺗ-ﺔﻣﻼ﻿ﻋ: 
ﺓﺮﻛﺍﺫ: ﻆﻔﺣ, ﻊﺟﺮﻣ, ﻱﺭﺎﻛﺬﺘﻟﺍ-ﺐﺼﻨﻟﺍ
ﺚﻳﺪﺣ: ﺮﺻﺎﻌﻣ, ﺭﻮﻄﺘﻣ, ﺚﻳﺪﺤﺗ, ﺔﺿﻮﻤﻟﺍ, ﺚﻳﺪﺣ, ﺚﻳﺪﺣ
ﺔﻌﻘﺑ: ﺔﻄﻘﻧ, ﺔﻄﻘﻧ, ﺔﻋﺎﺴﻟﺍ, ﻊﻗﻮﻣ, ﺔﻤﺻﻭ, ﺐﻴﻋ, ﺔﻌﻘﺑ, ﻥﺎﻜﻣ, ﻥﺎﻜﻣ-ﻻ﻿, ﻰﻨﺒﻣ, ﻥﺎﻜﻣ, ﻊﻗﻮﻣ, ﻲﻠﺤﻣ, ﺩﺪﺣ, ﻪﺘﻓﻻ﻿, ﺽﺭﺃ
ﻊﻔﺗﺮﺗ: ﺕﺎﺒﻨﻟﺍ, ﻖﻠﺴﺘﻟﺍ, ﺓﺮﻳﺰﻨﺧ, ﻖﻠﺴﺗ, ﻰﻠﻋﺃ-ﻰﻟﺇ, ﺲﻠﺠﻣ, ﺏﻮﻛﺭ, ﻊﻓﺭ, ﺄﺸﻨﺗ, ﻊﻓﺭ, ﻍﻭﺰﺑ, ﻮﻤﻨﻟﺍ
ﺔﺣﺍﺮﺘﺳﺍ: ﻢﺤﺘﻘﻳ, ﻞﻣﺍﺮﻓ, ﻊﺠﺘﻨﻣ, ﺔﺣﺍﺮﺘﺳﺍ, ﺔﻗﺎﻋﺇ, ﺓﺮﺘﻓ, ﻍﺍﺮﻓ, ﻖﺤﺳ, ﻢﻴﻄﺤﺗ, ﻒﻗﻮﺗ, ﺔﻔﻗﻭ, ﻊﻄﻗ
ﻥﻮﺴﻤﺧ: 
ﺓﺮﻳﺰﺟ: 
ﺲﻤﻟ: ﻝﺎﺼﺗﺍ
ﺪﻋﻭ: ﻡﺰﺘﻠﻳ, ﻡﺍﺰﺘﻟﺍ, ﺪﻬﻌﺗ, ﺪﻋﻮﻣ
commissive-ﺝﺍﺰﻣ: 
ﺔﻴﻤﻠﻌﻟﺍ-ﺔﺟﺭﺪﻟﺍ: ﻱﻭﺎﺴﺘﻣ, ﻯﺪﻣ, ﺔﺟﺭﺩ, ﺓﺩﻮﺟ
ﺔﻄﺧ: ﻂﻄﺨﻣ, ﺔﻘﻔﺻ, ﺞﻣﺎﻧﺮﺑ, ﺞﻣﺎﻧﺮﺑ, ﺭﺩﺎﺒﻣ, ﻂﻄﺨﻣ, ﺡﺮﺘﻘﻣ, ﻉﻭﺮﺸﻣ, ﺔﻌﻄﻗ, ﻢﺳﺭ, ﻁﺎﻘﺳﺇ, ﻢﻴﻤﺼﺗ, ﺔﻘﺸﻟﺍ, ﻢﺳﺭ, ﻢﻴﻤﺼﺗ
ﻙﻮﻠﺳ: ﻩﺎﺠﺗﺍ, ﻙﻮﻠﺳ, ﻙﻮﻠﺳ, ﺔﻴﻛﻮﻠﺴﻟﺍ
ﺓﺄﺟﺎﻔﻣ: ﻞﻫﺬﻣ, ﻊﻗﻮﺘﻣ-ﺮﻴﻏ, ﻲﺿﺮﻋ, ﺊﺟﺎﻔﻣ
ﺔﻘﻴﻗﺩ: 
ﺭﺎﻨﻟﺍ-ﻕﻼ﻿ﻃﺍ: ﺭﺎﻨﻟﺍ-ﻖﻠﻃﺃ, ﺹﺎﺻﺮﻟﺍ-ﻕﻼ﻿ﻃﺍ, ﺔﺻﺎﺻﺭ, ﺓﺮﻴﺧﺫ, ﺮﻳﻮﺼﺗ, ﺭﻮﺻ, ﺔﺑﺮﺿ, ﺔﻌﻗﺮﻓ, ﺏﻼ﻿ﻘﻧﺍ, ﻲﻣﺭ, ﻞﻜﻴﻫ
ﺃﻮﺳﺃ: ﺊﻴﺳ, ﺃﻮﺳﺃ, ﺞﺋﺎﻫ, ﺲﻛﺎﻌﻣ, ﺊﻴﺳ-ﻞﻜﺸﺑ, ﺐﻴﻫﺭ, ﻲﻠﻔﺴﻟﺍ, ﻰﻠﻋﺃ-ﻰﻟﺇ, ﻱﻮﻠﻌﻟﺍ-ﻖﺑﺎﻄﻟﺍ
ﺝﺎﺟﺯ: ﺓﺁﺮﻣ, ﺭﻮﻠﺑ, ءﺎﻧﺇ, ﺕﺍﺭﺎﻈﻧ, ﺔﻴﺒﻃ-ﺓﺭﺎﻈﻧ
ﻞﺜﻣ: ﻝﺎﺜﻣ, ﺢﻴﺿﻮﺗ, ﺝﺫﻮﻤﻧ, ﻂﻤﻧ, ﺓﺭﺎﻌﺘﺳﺍ, ﺝﺫﻮﻤﻨﻟﺍ, ﻞﺜﻣ, ﻞﺜﻣ, ﺔﻨﻴﻋ, ﺔﻴﻀﻗ---ﺔﻟﺎﺣ, ﺔﻘﺑﺎﺳ, ﺔﻨﻴﻋ, ﺝﺫﻮﻤﻧ, ﻝﺎﺜﻤﻟﺍ-ﻞﻴﺒﺳ-ﻰﻠﻋ
ﻦﻣﺁ: ﻦﻴﻣﺄﺗ, ﺔﻣﻼ﻿ﺳ, ﻦﻣﺃ, ﻡﻼ﻿ﺴﺑ, ﻖﺛﺍﻭ, ﻦﻴﻣﺄﺗ
ﺭﻮﺘﻛﺩ: ﺞﻟﺎﻌﻤﻟﺍ-ﺐﻴﺒﻄﻟﺍ, ﺞﻟﺎﻌﻤﻟﺍ, ﺱﺭﺎﻤﻣ, ﻲﺒﻃ
ﻝﺎﻤﻛﻷ﻿ﺍ-ﺐﻧﺎﺟ: 
ﺭﺮﻜﺘﻣ: ﺍﺮﻴﺜﻛ, ﻢﻈﺘﻨﻣ, ﺖﺑﺎﺛ, ﺭﺍﺮﻤﺘﺳﺎﺑ, ﺎﻧﺎﻴﺣﺃ, ﺭﺮﻜﺘﻣ, ﻡﺎﻈﺘﻧﺎﺑ, ﺭﺮﻛ
ﺮﻜﺴﻋ: ﺕﺍﻮﻗ, ﻞﺗﺎﻘﻣ
ﺊﻓﺍﺩ: ﺭﺎﺣ, ﺊﻓﺍﺩ, ﺓﺭﺍﺮﺣ, ءﻑﺩ, ﺓﺭﺍﺮﺤﻟﺍ-ﻪﺟﺭﺩ, ﺔﺌﻓﺪﺗ, ﻡﺍﺮﻏ, ﺭﺎﺣﻭ-ﺐﻃﺭ
ﺏﺮﺷ: ﺏﺍﺮﺷ
ﺔﻠﺌﺳﺃ: 
ﺐﻀﻏ: ﺐﺿﺎﻏ, ﺐﻀﻏ, ﺐﻀﻏ, ﺐﻀﻏ, ﻢﻏﺭ
ﺓﺮﺷﺎﺒﻣ: ﺓﺮﺷﺎﺒﻣ, ﺓﺮﺷﺎﺒﻣ, ﺮﺷﺎﺒﻣ-ﺮﻴﻏ, ﻲﻜﻴﺗﺎﻣﻮﺗﻭﺃ, ﻂﻴﺴﺑ, ﻱﺭﻮﻓ
ﺔﻌﺒﻗ: ﺔﻌﺒﻗ, ﺓﺫﻮﺧ
ﺐﻠﻜﻟﺍ: 
ﻡﺩﺎﺧ: ﻒﻴﻀﻣ, ﻝﺩﺎﻨﻟﺍ, ﺔﻓﺎﻈﻧ-ﺔﻠﻣﺎﻋ
ءﺎﻳﺮﺒﻛ: ﻑﺮﺠﻌﺘﻤﻟﺍ, ﺭﻮﺨﻓ, ﺮﺨﻔﺑ
ﺪﺸﺣ: ﻉﺎﻓﺪﻧﺍ, ﻢﺣﺩﺰﻣ, ﺮﻬﻤﺠﺗ, ﺔﻴﻤﻛ, ﺔﻴﻤﻛ, ﻥﺎﻜﺴﻟﺍ-ﺩﺪﻋ, ﻒﻴﻀﻣ, ﺔﻣﻮﻛ
ﺭﺎﻄﻗ: ﻞﻘﻧ, ﺓﺭﺎﻴﺳ, ﺔﺑﺮﻋ, ﺔﺑﺮﻋ, ﺔﻳﺪﻳﺪﺣ-ﺔﻜﺳ, ﺔﻳﺪﻳﺪﺣ-ﺔﻜﺳ, ﻒﻴﻘﺜﺗ
ﻲﻗﻼ﻿ﺧﺃ: ﺔﻴﻗﻼ﻿ﺧﺃ, ﺎﻳﻮﻨﻌﻣ, ﻲﻗﻼ﻿ﺧﺃ, ﺔﻨﻬﻤﻟﺍ-ﺏﺍﺩﺁ, ﺔﻳﻮﻨﻌﻣ-ﺡﻭﺭ, ﻲﺣﻭﺭ
ﺔﻄﺒﺗﺮﻤﻟﺍ: ﺪﻋﺎﺴﻣ, ﺔﻴﻤﻫﺃ, ﻂﺑﺍﺮﺗ, ﺔﻠﺻ-ﺕﺍﺫ, ﺔﻴﻨﻌﻤﻟﺍ-ﻑﺍﺮﻃﻷ﻿ﺍ, ﺔﻳﺎﻨﻋ-،ﻥﺄﺷ-،ﻡﺎﻤﺘﻫﺍ, ﺔﻠﺻ, ﻝﻮﻃ-ﻰﻠﻋ, ﻞﺼﺘﻣ, ﻂﺑﺭ, ﻒﻴﻠﺣ
ﻞﺧﺩﺃ: ﻞﺠﺳ, ﻝﻮﺧﺩ, ﺔﻟﺎﺣ, ﺮﻴﺸﺗ, ﻞﺧﺩﺃ, ﻦﻤﻀﺘﺗ
ﻢﻜﺣ: ﺓﺭﺍﺩﺇ, ﺔﻨﻤﻴﻫ, ﻢﻛﺎﺤﻟﺍ-ﻡﺎﻈﻨﻟﺍ, ﻢﻜﺣ, ﻢﻜﺣ, ﻢﻜﺣ, ﻢﻜﺣ, ﻢﻜﺣ, ﻢﻜﺤﻳ, ﻥﻮﻧﺎﻘﻟﺍ, ﻊﻳﺮﺸﺗ, ﺭﺎﻴﻌﻣ
ﻒﻴﺳ: ﺓﺮﻔﺷ
ﻡﻮﺠﻫ: ﻭﺰﻏ, ﺍﺰﻏ, ﻥﺍﻭﺪﻋ, ﺔﻤﻳﺮﺟ, ءﺍﺪﺘﻋﺍ, ﺔﻤﻳﺮﺟ, ﺏﺍﺮﺿﺇ, ﺔﻳﺍﺪﺑ, ﻲﻣﻮﺠﻫ
ﺔﺤﺼﻟﺍ: ﻲﺤﺻ, ﺎﻴﺣ
ﺓﺮﻘﻓ: ﺔﻳﺁ, ﺪﻨﺑ, ﺔﻌﻄﻗ, ﺔﻄﻘﻧ, ﻒﻗﻮﻣ, ﻒﻗﻮﻣ
ﻲﻋﺎﻤﺘﺟﺍ: ﻊﻤﺘﺠﻤﻟﺍ, ﺎﻴﻋﺎﻤﺘﺟﺍ
ﺩﺭ: ﺩﺭ, ﺩﺭ, ﺓﺩﻮﻋ
ﻒﺳﺁ: ﻒﺳﺄﻧ, ﺩﻮﻤﻋ, ﺍﺭﺬﻋ-ﻚﺤﻴﻤﺘﺳﺍ, ﺭﺬﻋ, ﺭﺍﺬﺘﻋﺍ
ﺔﻋﺎﺠﺷ: ﻒﺘﻧ, ءﻱﺮﺟ, ﻖﺛﺍﻭ, ﺐﺼﻌﻟﺍ, ﺪﻠﺟ, ﺓﺭﺎﺴﺟ
ﺔﻤﻌﻧ: ﺓﺎﺑﺎﺤﻣ, ﺓﺎﺑﺎﺤﻣ, ﺔﻤﺣﺭ, ﻒﻄﻟ, ﺮﻴﺧ, ﻢﺳﺎﺑ, ﺍﺭﺬﻋ-ﻚﺤﻴﻤﺘﺳﺍ
ﻲﻤﺳﺭ: ﻲﻤﺳﺭ, ﺎﻴﻤﺳﺭ, ﻲﻤﺳﺭ-ﻞﻜﺸﺑ, ﻂﺑﺎﺿ, ﺐﺗﺎﻛ
ﺔﻣﺪﻘﻤﻟﺍ: ﺩﻭﺰﺗ, ﺽﺮﻋ, ﺮﻴﻓﻮﺗ, ﺔﻣﺪﻘﻤﻟﺍ, ﺡﺎﺘﻣ, ﺽﺮﻌﻟﺍ, ﻢﻳﺪﻘﺗ, ﺔﻴﺒﻠﺗ, ﺍﺫﺇ
ﺐﻠﻃ: ﺓﻼ﻿ﺻ, ﺐﻠﻄﻟﺍ, ﺐﻟﺎﻄﻳ, ﺐﻠﻄﺗ, ﺕﺎﺒﻠﻄﺘﻤﻟﺍ, ﺭﺎﺴﻔﺘﺳﺍ, ﺭﺎﺴﻔﺘﺳﺍ, ﻪﺟﻮﻣ, ﺔﻟﻭﺎﺤﻣ, ﻖﻴﺒﻄﺗ
ﺔﺤﻤﻟ: ﺔﺤﻤﻟ, ﻱﺃﺭ, ﻒﻗﻮﻣ, ﻙﺍﺭﺩﻹ﻿ﺍ, ﻙﻮﻟ-ﺕﻭﺍ, ﺪﻬﺸﻣ, ﺚﺤﺑ
ﺔﻛﺮﺣ: ﺔﻛﺮﺣ, ﺔﻴﺑﺎﺨﺘﻧﻻ﻿ﺍ-ﺔﻠﻤﺤﻟﺍ, ﺔﺿﺎﻳﺭ, ﺔﻴﺒﻴﻠﺻ-ﺔﻠﻤﺣ, ﻞﻤﻋ, ﺓﻮﻄﺧ, ﺔﻴﻛﺮﺤﺗ, ﻞﻤﻋ, ﻙﺮﺤﺘﻣ
ﻊﻗﻮﺗ: ﻊﻗﻮﺗ, ﻊﻗﻮﺗ, ﻊﻗﻮﺗ, ﺮﻈﺘﻧﺍ
ﻞﺑﺎﻘﻣ: ﺔﻬﺒﺟ, ﺽﺭﺎﻌﻣ, ﺲﻜﻋ, ﺔﺿﺭﺎﻌﻣ, ﺮﺒﻋ, ﺩﺍﺪﻋ
ﺮﺸﻋ-ﻲﻨﺛﺍ: 
ﺏﻮﻄﺨﻣ: ﻙﺎﺒﺘﺷﺍ, ﻝﻮﻐﺸﻣ, ﻁﺭﻮﺘﻣ, ﻙﺭﺎﺷ, ﻞﺘﺤﻣ
ﺬﻴﺒﻧ: ﺐﻨﻋ, ﻝﻮﺤﻛ, ﺮﻴﻜﺳ
ﻢﻌﻃ: ﺔﻬﻜﻧ, ﺔﻬﻜﻧ, ﺬﻳﺬﻟ, ﻢﻌﻃ, ﺫﺬﻠﺗ
ﺪﻳﺪﺣ: ﺐﻠﺻ, ﻥﺪﻌﻣ
ﺮﺸﻧ: ﺚﺑ-.ﻝﺎﺳﺭﺍ-.ﻞﻘﻧ, ﺮﺸﻧ, ﺮﺸﻧ, ﺮﺸﻧ, ﺮﺸﻧ, ﺮﺸﻧ, ﻊﻳﺯﻮﺗ, ﺺﻴﺼﺨﺗ, ﻢﺳﺎﻘﺘﻳ, ﻕﺮﻓ, ﻡﺎﺴﻘﻧﻻ﻿ﺍ, ﻡﺎﺴﻘﻧﺍ-ﻝ, ﻒﻨﺻ
ﺓﺭﺎﺠﺗ: ﺓﺭﺎﺠﺗ, ﻞﻤﻋ, ﺓﺭﺎﺠﺗ, ﻊﺋﺎﻀﺑ, ﺖﻧﺮﺘﻧﻹ﻿ﺍ, ﺔﻘﻔﺻ, ﺔﻘﻔﺻ, ﺮﺟﺎﺗ, ﻕﻮﺴﺘﻟﺍ, ﻖﻳﻮﺴﺗ
ﺓﺰﻴﻣ: ﺐﺴﻛ, ﺢﺑﺭ, ﺔﻌﻔﻨﻤﻟﺍ, ﺓﺎﻴﺤﻠﻟ-ﻞﺑﺎﻗ, ﺡﻼ﻿ﺻ, ﻝﻮﺻﻷ﻿ﺍ, ﻞﻴﻀﻔﺗ, ﺔﻨﻤﻴﻫ
ﺏﺎﻴﺛ-،ﺲﺑﻼ﻿ﻣ: ﺔﻧﺍﺰﺧ, ﺵﺎﻤﻗ, ﺲﺑﻼ﻿ﻣ, ﺲﺑﻼ﻿ﻣ, ﺲﺑﻼ﻿ﻣ, ﺮﺜﻌﺗ
ﻲﺿﺎﻘﻟﺍ: ﻢﻜﺣ, ﻢﻜﺣ, ﻢﻜﺣ, ﻢﻜﺣ
ﻕﺮﻓ: ﻕﺭﺎﻔﻟﺍ, ﺰﻴﻤﺗ, ﻒﻠﺘﺨﻣ, ﻞﺼﻓ, ﺰﻴﻤﺘﻣ, ﻒﻠﺘﺧﺍ, ﻑﻼ﻿ﺘﺧﺍ, ﺓﺪﺣ-ﻰﻠﻋ, ﺐﻠﻘﺗ, ﻦﻳﺎﺒﺘﻟﺍ, ﻕﺮﻓ
ﻖﻠﻗ: ﺉﺭﺍﻮﻄﻟﺍ, ﺡﺎﺤﻟﺇ, ﺔﻴﻨﻌﻤﻟﺍ-ﻑﺍﺮﻃﻷ﻿ﺍ, ﻖﻠﻗ, ﻖﻠﻗ, ﻖﻠﻗ, ﺔﻳﺎﻨﻋ-،ﻥﺄﺷ-،ﻡﺎﻤﺘﻫﺍ, ﻖﻠﻗ, ﺱﻭﺭﺪﻣ, ﺢﻳﺮﻣ-ﺮﻴﻏ, ﻖﻠﻘﻣ, ﻒﺋﺎﺧ, ﺲﻤﺤﺘﻣ, ﻖﻠﻘﻣ, ﻖﻠﻘﻠﻟ-ﺓﺮﻴﺜﻣ, ﺲﻤﺤﺘﻣ, ﺺﻳﺮﺣ, ﺃﺪﻬﻳ-ﻻ﻿, ﺮﻘﺘﺴﻣ-ﺮﻴﻏ
ﻥﺎﻄﺒﻗ: 
ﻦﻣ-ءﺎﻬﺘﻧﻻ﻿ﺍ-ﻢﺗ: ءﺎﻬﻧﺇ, ﺔﻳﺎﻬﻨﻟﺍ, ﺩﻭﺪﺤﻣ, ﺩﺍﺪﻌﺘﺳﺍ
ﻒﻗﻭ-ﺐﻧﺎﺟ: 
ﻲﻟﻮﻀﻓ: ﺺﻳﺮﺣ, ﺏﺎﺠﻋﻺ﻿ﻟ-ﺮﻴﺜﻣ, ﺮﻴﺜﻣ
ﻲﺒﻨﺟﺃ: ﺩﻼ﻿ﺒﻟﺍ-ﺝﺭﺎﺧ, ﻲﺋﺎﻀﻓ-ﻦﺋﺎﻛ, ﻲﺒﻨﺟﺃ, ﺐﻳﺮﻏ, ﺐﻳﺮﻏ, ﻲﺟﺭﺎﺧ
ﻒﻴﺜﻜﺗ: ﻒﻴﺜﻜﺗ
ﺔﻴﻤﻫﺃ: ﺓﺭﻭﺮﺿ, ﺔﻴﻤﻫﺃ, ﻰﻨﻌﻣ, ﺔﻤﻴﻘﻟﺍ
ﺍﺮﻴﺧﺃ: ﺔﻳﺎﻬﻨﻟﺍ-ﻲﻓ, ﺔﻳﺎﻬﻨﻟﺍ-ﻲﻓ, ﺩﻭﺪﺤﻣ, ﻲﺋﺎﻬﻧ, ﻰﺼﻗﺃ, ﺔﻄﺤﻣ, ﺎﻤﻋﺎﻧ
ﺓﺭﻮﺗﺎﻓ: ﻞﻤﻋ, ﺔﻃﻮﻄﺨﻣ, ﺏﺎﺴﺣ, ﻞﻣﺎﻜﺘﻟﺍﻭ-ﻞﺿﺎﻔﺘﻟﺍ-ﺏﺎﺴﺣ
ﺖﺒﺛ: ﻞﻴﻟﺩ, ﺪﻴﻛﺄﺗ, ﺪﻛﺃ, ﺮﻫﺎﻈﺘﻟﺍ, ﺪﻬﺷ
ﻥﻭﺩ-ﻝﻮﺤﻳ: ﻒﻗﻭ, ﻊﻨﻣ, ﺰﺠﺣ, ﻊﻤﻗ, ﺮﺼﺣ, ﻊﻨﻣ, ﻊﻨﻣ, ﺢﺒﻛ, ﻉﺩﺭ, ﺮﻈﺣ, ﺐﻨﺠﺗ, ﺪﺻ, ﻊﻤﻗ, ﻖﻴﻠﻌﺗ
ﻖﻨﻌﻟﺍ: ﻖﻠﺣ
ﻲﻧﻮﻧﺎﻗ: ﻲﺋﺎﻀﻗ, ﻥﻮﻧﺎﻘﻟﺍ, ﻲﻋﺮﺷ, ﻞﻜﻴﻫ
ﻑﺎﺟ: ﻉﺬﺟ
ﺔﻣﺪﺧ: ﺔﻣﺪﺧ, ﺐﺴﻛ, ﺔﻴﺒﻠﺗ, ﺽﺮﻋ
ﺮﺴﺨﺗ: ﺔﺴﻧﻵ﻿ﺍ, ﻪﻧﺎﻜﻣ-ﺮﻴﻏ-ﻲﻓ ءﻲﺸﻟﺍ ﻊﺿﻭ
ﻞﻴﻟﺩ: ﺮﻫﺎﻇ, ﻞﻴﻟﺩ, ﻞﻴﻟﺩ, ﻞﻴﻟﺩ, ﻞﻴﻟﺩ, ﺽﺮﻋ, ﺪﻫﺎﺸﻟﺍ
ﺮﻫﺎﻇ-ﺔﻟﺎﺣ: 
ﻡﺪﻘﺗ: ﺓﻮﻄﺧ, ﻡﺪﻘﺗ, ﺮﻳﻮﻄﺘﻟﺍ, ﺔﻴﻣﺪﻘﺗ, ﺔﻳﻮﻤﻨﺘﻟﺍ, ﻡﺪﻘﺗ, ﻡﺪﻘﺗ, ﻦﻴﺴﺤﺗ, ﻊﻓﺭ
ءﺎﻨﺑ: ءﺎﻨﺑ, ءﺎﻨﺑ, ءﺎﻨﺑ, ﺕﺍءﺎﺸﻧﺇ, ﻰﻨﺒﻣ
ﻦﻋ-ﺚﺤﺒﻟﺍ: ﺩﺎﺠﻳﺇ, ﻒﺸﺘﻛﺍ, ﻑﺎﺸﺘﻛﺍ, ﺚﺤﺑ, ﻒﺸﻛ, ﺚﺤﺑ, ﺐﻠﻃ-،ﻰﻌﺴﻳ, ﺚﺤﺑ, ﺔﻴﺋﺎﺼﻘﺘﺳﻻ﻿ﺍ-ﺔﺳﺍﺭﺪﻟﺍ, ﺓﺩﺭﺎﻄﻣ, ﺭﺎﺴﻔﺘﺳﺍ, ﻖﻴﻘﺤﺗ, ﺭﺎﺴﻔﺘﺳﺍ
ﻦﻳﺰﺣ: ﺐﺌﺘﻜﻣ, ﻒﺳﻸ﻿ﻟ, ﺲﺋﺎﺑ, ﺞﻋﺰﻣ, ﺏﺍﺮﻄﻀﻣ, ﻡﺪﻧ, ﻥﺰﺤﻣ
ﺔﺌﻴﻄﺧ: ﻢﺛﺇ
ﻥﻮﺛﻼ﻿ﺛ: 
ﻕﺩﺎﺻ: ﻕﺩﺎﺻ, ﺺﻠﺨﻣ, ﺔﺣﺍﺮﺼﺑ, ﺢﻳﺮﺻ
ﻕﻼ﻿ﻏﺇ: ﻖﻠﻏﺃ, ﻖﻠﻐﻣ, ﻕﻼ﻿ﻏﺇ, ﺍﺪﻴﻌﺑ, ﺖﻴﺒﺜﺘﻟﺍ, ﺐﻳﺮﻗ-ﻝ, ﺔﻣﺰﺣ, ﺔﻣﺰﺣ, ءﺰﺟ, ﺔﻣﺰﺣ, ﺔﻣﺯﺭ, ﻲﻓ-ﻊﻤﺟ
ﻚﻨﺑ: ﺪﻌﻘﻣ, ﺮﻳﺪﺼﻗ
ﺮﻴﺼﻣ: ﺓﻭﺮﺛ, ﻆﺣ, ﻱﻮﺤﻧ, ﺩﻮﺼﻘﻤﻟﺍ-ﻥﺎﻜﻤﻟﺍ, ﺮﻴﺜﻜﻟﺍ
ﺔﺑﺎﻏ: ﻝﺎﻏﺩﺃ
ﺲﻴﻘﻳ---ﺱﺎﻴﻗ: ﺱﺎﻴﻘﻣ, ﺱﺎﻴﻗ, ﻥﺰﻳ, ﺮﺘﻣ, ﺮﺘﻣ
ﻚﻟﺫ-ﻑﻼ﻿ﺧ: ﻚﻟﺫ-ﻦﻣ-ﻻ﻿ﺪﺑ
ﻯﺮﺠﻣ: ﻖﻓﺪﺗ, ﺪﻨﺑ, ﺭﺎﻴﺘﻟﺍ, ءﺎﺑﺮﻬﻛ, ﻖﻓﺪﺗ, ﺔﺛﺎﻔﻧ-ﺓﺮﺋﺎﻃ
ﺰﺒﺧ: ﺰﺒﺧ, ﺓﺮﻳﺰﻨﺧ, ﺓﺮﻴﻄﺷ
ﻲﻓﺎﺿﺇ: ﻲﻓﺎﺿﺇ, ﻲﻓﺎﺿﺇ, ﻚﻟﺫ-ﻰﻠﻋ-ﺓﻭﻼ﻿ﻋ, ﺾﺋﺎﻓ, ﺾﺋﺎﻓ, ﻲﻓﺎﺿﺇ, ﺔﻓﺎﺿﺇ, ﻲﻠﻴﻤﻜﺗ, ﺔﻓﺎﺿﺇ, ﻖﺤﻠﻣ
ﺮﺘﺧﺃ: ﺭﺎﻴﺘﺧﻻ﻿ﺍ, ﺭﺎﻴﺘﺧﺍ, ﺭﺎﺘﺧﺍ, ﻲﺋﺎﻘﺘﻧﺍ, ﺭﺎﻴﺘﺧﺍ, ﺐﺨﺘﻨﻣ, ﻲﻔﺗﺎﻬﻟﺍ-ﻝﺎﺼﺗﻻ﻿ﺍ, ﺖﻳﻮﺼﺗ, ﺺﺤﻓ, ﻞﻴﻀﻔﺗ
ﻥﺍﻮﻴﺣ: 
zoic-ﺚﻴﻧﺄﺗ-ﻭﺃ ﺮﻴﻛﺬﺗ ﺲﻨﺟ: 
eventive-ﺝﺍﺰﻣ: 
ﻪﺴﻔﻧ-ﺙﺪﺣ-ﺔﻣﻼ﻿ﻋ: 
ﻒﻋﺎﻀﻤﻟﺍ-ﺔﻟﺎﺣ: 
ﻚﻴﻤﺳ: ﻦﻳﺪﺑ, ﺍﺮﻳﺰﻏ, ﻒﻴﺜﻛ, ﻦﻫﺩ
ﻕﻮﻠﺨﻣ: ﻲﺣ-ﻦﺋﺎﻛ, ﺮﻫﻮﺟ
ﺮﻄﻣ: ﻞﻠﺒﻣ, ﺭﺎﻄﻣﻷ﻿ﺍ-ﻝﻮﻄﻫ, ﺵﺩ
ﺢﻄﺳ: ﻪﺟﻭ, ﻯﻮﺘﺴﻣ, ﺓﺮﺋﺎﻃ, ﺔﻘﻄﻨﻣ
ﺱﺪﻘﻣ: ﺱﺪﻘﻣ, ﺔﻜﺒﺷ, ﺖﺤﺑ
ﻮﻴﻟﻮﻳ: 
ﺮﻳﺮﻘﺗ: ﺮﻳﺮﻘﺗ, ﻥﺎﻴﺑ, ﺔﺒﺴﻧ, ﺔﻗﻼ﻿ﻋ, ﺔﻗﻼ﻿ﻋ, ﺽﺮﻌﻣ, ﺽﺮﻌﻣ, ﻝﺎﻘﻣ, ﺽﺮﻌﺗ, ًﺎﻓﺪﻫ-ﺯﺮﺣﺃ
ﻞﺣﺎﺳ: ﻞﺣﺎﺳ, ﺊﻃﺎﺷ
ﻒﻠﻣ: ﺔﻘﻴﺛﻭ, ﻒﻠﻣ, ﺥﻮﻛ, ﻲﺼﺨﺸﻟﺍ-ﻒﻠﻤﻟﺍ, ﻒﻴﺷﺭﺃ
ﻒﺘﻛ: ﺢﻣﺭ, ﺭﻮﺤﻣ, ﺮﻳﻮﺼﺗ, ﻂﺸﻣ, ﻉﺍﺭﺫ
ﺶﻫﺪﻨﻣ: ﺶﻫﺪﻨﻣ, ﺐﺠﻋ
ﻲﻜﻠﻣ: ﻱﺭﻮﻃﺍﺮﺒﻣﺇ, ﺔﻴﻜﻠﻤﻟﺍ, ﺔﻜﻠﻤﻣ, ﺔﻳﺭﻮﻃﺍﺮﺒﻣﺇ, ﻝﺎﻳﺭ, ﻲﻠﻌﻓ
ﺔﻴﻨﻏﺃ: ﻢﻐﻧ, ﺭﺎﺴﻣ, ءﺎﻨﻐﻟﺍ, ﺓﺪﻴﺼﻗ
ﺔﺣﺍﺭ: ﺔﻟﻮﻬﺳ, ءﺎﺧﺮﺘﺳﺍ, ﺢﻳﺮﻣ, ﻊﻴﺠﺸﺗ, ﺔﺣﺍﺮﻟﺍ-ﻞﺋﺎﺳﻭ, ﺔﺣﺍﺭ, ﺔﺣﺍﺭ
ﺪﺣﺍﻭ-ﻱﺃ: ﺺﺨﺷ-ﻱﺍ, ﺎﻣ-ﺺﺨﺷ, ﺎﻣ-ﺎﺼﺨﺷ, ﺪﺣﺃ-ﻻ﻿, ﻊﻴﻤﺠﻟﺍ
ﺐﺸﻋ: ﻦﺒﺗ, ﺓﺭﺎﺿ-ﺔﺒﺸﻋ, ﺐﺸﻋ, ﺐﺸﻌﻟﺍ, ﻡﺍﺮﻏ
ﻝﺩﺎﻌﺗ: ﺐﺤﺳ, ﺐﺤﺳ, ﺐﺤﺳ, ﺏﺎﺠﻋﻺ﻿ﻟ-ﺮﻴﺜﻣ, ﺓﺪﺷﺎﻨﻣ, ﺏﺍﺬﺟ, ﺐﺤﺳ, ﺮﻴﺜﻣ, ﺏﺬﺟ, ﻡﺎﻤﺘﻫﻼ﻿ﻟ-ﺮﻴﺜﻤﻟﺍ-ﻦﻣﻭ, ﻢﺳﺭ, ﻉﺰﻧ, ﺡﺮﻃ
ﺡﺎﺘﺘﻓﺍ: ﻱﺪﻴﻬﻤﺗ, ﻝﻭﺃ, ﻑﺎﺸﺘﻛﺍ, ﻍﺍﺮﻓ, ﺔﺤﺘﻓ, ﺔﺣﺍﺮﺻ-ﻞﻜﺑ
ﻮﻴﻧﻮﻳ: 
ﻚﻤﺳ: ﻙﺎﻤﺳﺍ-ﺽﻮﺣ
ﻝﺎﻤﻟﺍ-ﺱﺃﺭ: ﺏﺎﺑ, ﻕﻭﺪﻨﺻ, ﻝﻮﺻﻷ﻿ﺍ
ﻱﺪﺛ: ﺭﺪﺻ
ﺞﻠﺛ: ﺞﻠﺜﻟﺍ
ﻢﻴﻠﻌﺘﻟﺍ: ﻒﻴﻘﺜﺗ, ﺱﺭﺩ, ﻱﻮﺑﺮﺗ, ﺔﺑﺎﺘﻜﻟﺍﻭ-ﺓءﺍﺮﻘﻟﺍ-ﺔﻓﺮﻌﻣ, ﻞﻴﻜﺸﺗ, ﺐﻳﺭﺪﺗ, ﻢﻠﻌﺘﻣ, ﻲﻤﻳﺩﺎﻛﺃ
ﺩﺎﺣ: ﻕﺮﺸﻣ, ﻒﻴﻨﻋ, ﻡﺭﺎﺻ, ﺓﺪﺤﺑ, ﺭﺎﺣ, ﺩﺎﺣ, ﺩﺎﺣ, ﺲﻤﺤﺘﻣ, ﺶﻫ
ﺔﻘﻔﺷ: ﺔﻤﺣﺭ, ﺔﻘﻔﺷ, ﻒﻃﺎﻌﺗ, ﻒﻃﺎﻌﺘﻣ, ﻢﻴﺣﺭ, ﻒﻴﺨﻣﻭﺍ-ﻊﻳﺮﻣ, ءﺍﺰﺟ-ﺔﻠﻛﺭ, ﺔﺸﻳﺭ, ﻪﻟ-ﻒﺳﺆﻳ, ﺮﻜﻨﺘﺴﻧ, ﺭﺮﺿ, ﺭﺮﺿ, ﻡﺪﻧ
ﻑﻭﺮﺼﻣ: ﻡﻮﺳﺭ, ﻕﺎﻔﻧﺇ, ﺔﻔﻠﻛ, ﺭﺍﺪﺻﺇ, ﺞﺗﺎﻨﻟﺍ, ﺔﻤﻬﺗ
ﻚﺑ-ﺔﺻﺎﺧ: ﻙ
ﻥﻮﻴﻠﻣ: ﻥﻮﻴﻠﻣ
ﺐﻌﺘﻣ: ﺐﻌﺗ, ﺐﻌﺘﻣ
ﻞﺘﻗ: ﺪﻤﻌﻟﺍ-ﻞﺘﻘﻟﺍ, ﻞﺘﻗ
ﻞﻇ: ﻞﻇ
ﻥﺯﻮﻟﺍ: ﻞﻤﺣ, ﻞﻴﻘﺛ, ﺮﻴﺒﻛ-ﻞﻜﺸﺑ, ﻥﺰﻳ, ﻂﻐﻀﻟﺍ
ﺔﻠﺘﻛ: ﺓﺩﻮﺟ, ﻲﻋﺎﻤﺟ, ﺔﻴﻤﻛ, ﻢﺠﺣ, ﻊﻤﺠﻟﺍ-ﺔﻐﻴﺻ, ﺮﻴﺜﻜﻟﺍ, ﺔﻠﺘﻛ, ﺔﻠﺘﻛ, ﺮﻬﻤﺠﺗ, ﺔﻤﻳﺮﺟ, ﺔﻨﻴﺠﻋ, ﺔﻧﻭﺮﻜﻌﻣ
ﺄﺸﻧﺃ: ﺖﻴﺒﺜﺘﻟﺍ, ﺐﻠﺻ, ﻡﺰﺤﺑ, ﺮﻘﺘﺴﻣ, ﻖﻠﺧ, ءﺎﺸﻧﺇ, ﻞﻏﺎﺷ
ﻉﺎﺠﺷ: ءﻱﺮﺟ
ﻒﻴﺤﻧ: ﻒﻴﺤﻧ, ﻊﻴﻴﻤﺗ, ﺐﺑﺪﻣ, ﻖﻴﺿ, ﻞﻴﻣ, ﺔﻣﺍﺮﻏ, ﻖﻴﻗﺭ, ﺎﻤﻋﺎﻧ, ﻒﻴﻔﻃ, ﺔﻨﻌﻠﻟﺍ, ﻞﺨﻠﺨﻣ, ﺱﺎﺴﺣ, ﺱﺎﻴﻘﻣ
ﺽﺍﺭ: ﺭﻭﺮﺴﻣ, ﺎﺿﺭ, ﺔﻋﺎﻨﻗﻭ-ﺎﺿﺭﻭ-ﻥﺎﻨﺌﻤﻃﺍ, ﺪﻴﻌﺳ, ﺽﻮﻋ, ﺽﺮﻣ
ﺭﺎﻴﺘﺧﻻ﻿ﺍ: ﺭﺎﻴﺘﺧﻻ﻿ﺍ, ﺚﺤﺑ, ﺐﻗﺍﺭ, ﺭﺎﻴﺘﺧﻻ﻿ﺍ, ﺚﺤﺑ, ﺺﺤﻓ, ﺺﺤﻓ, ﺭﺎﺒﺘﺧﺍ, ﻖﻴﻗﺪﺘﻟﺍ, ﻂﺳﻮﺘﻣ, ﺔﻴﺋﺎﺼﻘﺘﺳﻻ﻿ﺍ-ﺔﺳﺍﺭﺪﻟﺍ, ﻖﻴﻘﺤﺘﻟﺍ, ﺪﻛﺄﺗ, ﻊﺟﺍﺭ, ﻢﻜﺤﺘﻟﺍ
ﺔﻠﻴﻀﻓ: ﻒﻄﻟ, ﻞﺿﺎﻓ, ﺡﻼ﻿ﺻ, ﺮﻴﺧ
ﻲﻨﻃﻮﻟﺍ: ﺔﻟﻭﺩ, ﺔﻴﺴﻨﺟ, ﻲﻗﺮﻋ, ﻲﻠﺤﻣ
ﻲﻬﻟﺇ: ﺱﺪﻘﻣ
ﻱﺩﺍﻮﻟﺍ: ﺽﻮﺣ
ﻦﻤﺨﻳ: ﻝﻻ﻿ﺪﺘﺳﺍ, ﻪﺑ-ﻪﺒﺘﺸﻣ, ﺽﺮﺘﻓﺍ, ﺮﻳﺪﻘﺗ, ﺮﻳﺪﻘﺗ, ﺆﺒﻨﺗ, ﺆﺒﻨﺗ, ﺕﺎﻌﻗﻮﺗ, ﻞﻣﺄﺗ
ﺔﺑﺭﺎﻀﻤﻟﺍ-ﺝﺍﺰﻣ: ﺽﺍﺮﺘﻓﻹ﻿ﺍ-ﻰﻠﻋ-ﻢﺋﺎﻗ ﺝﺍﺰﻣ
ﺮﻔﺻﺃ: ﺖﻫﺎﺑ, ﻥﺎﻣﺮﻬﻛ, ءﺍﺮﻘﺷ
ﺎﻳﺎﻘﺑ: ﺎﻳﺎﻘﺑ, ﻲﻘﺒﺘﻤﻟﺍ, ﺔﻴﻘﺒﺘﻤﻟﺍ, ﻡﺎﻌﻄﻟﺍ-ﺎﻳﺎﻘﺑ, ﺔﺣﺍﺭ
ﻰﻨﺤﻧﺍ: ﻦﺤﻨﻣ, ﻲﻨﺤﻨﻳ, ﺕﺎﺟﺮﻌﺘﻟﺍ, ﻩﺎﺠﺗﺍ, ﻑﻮﻔﻠﻣ, ﻞﻴﻣ, ﺭﺪﺤﻨﻣ, ﻞﺋﺎﻣ, ﻲﻄﻠﻟ-ﺔﻠﺑﺎﻗ
ﻕﻭﺪﻨﺻ: ﺮﻔﺳ-ﺔﺒﻴﻘﺣ, ﺝﺭﺩ, ﻕﻭﺪﻨﺻ, ﺓﺪﻋ, ﻊﻴﻄﺘﺴﺗ, ﻦﺑ
ﻢﺳﻮﻤﻟﺍ: ﻲﻤﺳﻮﻣ, ﺏﺎﺑ, ﺔﻄﺤﻣ, ﺮﺼﻋ
ﻡﻮﻠﻌﻟﺍ: ﻲﻤﻠﻋ
ﻒﻳﻮﺠﺗ: ﺐﻘﺛ, ﺮﻔﺣ, ﻞﻤﻣ, ﻞﻤﻣ, ﺐﻘﺛ, ﺞﻋﺰﻳ, ﻯﺪﺘﻨﻣ
ﻡﻻ﻿ﺍ-ﻮﺧﺍ: 
ﺔﻤﺋﺎﻗ: ﺱﺮﻬﻓ, ﺱﺮﻬﻓ, ﻡﺎﻌﻄﻟﺍ-ﺔﻤﺋﺎﻗ, ﻞﺠﺳ
ﺲﻄﺴﻏﺃ: 
ﻲﺒﻌﺷ: ﺭﺎﺸﺘﻧﺍ, ﺭﻮﻬﺸﻣ, ﺯﺭﺎﺑ, ﻡﻮﻗ
ﻑﻭﺮﻌﻣ-ﺮﻴﻏ: ﺐﻳﺮﻏ
ﻑﻮﻟﺄﻣ: ﻑﺭﺎﻌﺘﻟﺍ, ﺐﺴﻧ, ﻞﻴﻠﺴﻟﺍ
ﻑﻮﻟﺄﻣ-ﻞﻴﺠﺴﺗ: 
ﺉﺭﺎﻗ: ﺏﺮﻄﻣ
ﺔﺑﺭﺎﻘﻣ: ﻰﻟﺇ-ﻝﻮﺻﻭ, ﻝﻮﺻﻭ, ﺔﻴﻨﻘﺗ, ﻚﻴﺘﻜﺗ, ﺔﻴﺠﻬﻨﻤﻟﺍ, ﻒﻗﻮﻣ, ﺏﻮﻠﺳﺃ, ﺔﻘﻳﺮﻃ, ﺔﺿﻮﻣ, ءﺍﺮﺟﺇ, ﺐﻳﺮﻘﺗ, ﻲﻨﻴﺒﻟﺍ-ﺢﻄﺴﻟﺍ
ﻦﻴﺗﺮﻣ: ﻲﺟﻭﺯ-ﺩﺪﻋ
ﺮﻜﻔﻣ: ﻞﻘﻋ, ﺕﺍﺭﺎﺒﺨﺘﺳﺍ, ﻲﻠﻘﻋ, ﻲﻛﺫ, ﺲﻔﻨﻟﺍ-ﺐﻄﺑ-ﻖﻠﻌﺘﻣ ﻲﻠﻘﻋ ﺐﻴﺒﻃ, ﺮﻜﻔﻣ, ﺔﻤﻜﺣ, ﻲﺣﻭﺭ
ﺎﻘﺣ: ﺎﻘﺣ-ﻞﻫ, ﺎﻌﺒﻃ, ﻂﺒﻀﻟﺎﺑ, ﻼ﻿ﻌﻓ, ﺎﻴﻠﻤﻋ, ﺎﻴﻠﻤﻋ, ﺢﻴﺤﺻ, ﻕﺩﺎﺻ, ﻲﻌﻗﺍﻭ, ﺯﺎﺘﻤﻣ-ﻞﻜﺸﺑ, ﺎﻌﻄﻗ, ﺪﻴﻛﺄﺘﻟﺎﺑ, ﺪﻴﻛﺄﺘﻟﺎﺑ, ﺪﻴﻛﺄﺘﻟﺎﺑ
ﻦﻫﺎﻛ: ﻦﻳﺪﻟﺍ-ﻝﺎﺟﺭ
ﺢﻳﺮﺟ: ﺔﺑﺎﺻﺇ, ﺡﺮﺟ, ﺡﺮﺟ
ﻥﺰﺣ: ﻥﺰﺣ, ﻥﺰﺣ, ﺏﺎﺌﺘﻛﺍ, ﺐﺌﺘﻜﻣ, ﺩﺍﺪﺤﻟﺍ, ﺏﺮﻛ
ﺮﺼﻗ: 
ﺏﺮﻀﻳ: ﺔﻤﻳﺰﻫ, ﺔﻤﻜﻟ, ﺔﻌﻔﺻ, ﻕﺮﻃ, ﺔﻔﻴﻨﻋ-ﺔﺑﺮﺿ, ﻉﺎﻘﻳﺇ, ﺐﻠﻐﺗ
؟-ﻪﻳﺇ: 
ﻞﻘﻌﻟﺍ-ﻞﺘﺨﻣ: ﻒﻴﺨﺳ, ﺔﻋﺪﺨﻟﺍ, ﻉﺪﺨﻳ, ﻉﺍﺪﺧ, ﻲﺒﻏ, ﻖﻤﺣﺃ, ﻥﻮﻨﺠﻣ, ﻞﻗﺎﻋ-ﺮﻴﻏ, ﻥﻮﻨﺠﻣ, ﻞﻴﻠﻀﺗ
ﺔﻓﺎﺣ: ﺔﻓﺎﺣ, ﺏﺪﻫ, ﻲﺸﻣﺎﻫ, ﺪﻳﺪﺷ, ﺩﻭﺪﺤﻟﺍ, ﺶﻣﺎﻫ, ﺲﻠﺠﻣ
ﺔﻌﺴﺗ: ﻊﺳﺎﺗ, ﺪﻳﺪﺟ
ﺭﺎﺠﻔﻧﺍ: ﺭﺎﺠﻔﻧﺍ, ﺭﺎﺠﻔﻧﺍ, ﺮﺠﻔﻨﻳ, ﻕﻮﻘﺸﻣ, ﺭﺎﻫﺩﺯﺍ, ﺞﻨﺸﺗ, ﺔﻌﻗﺮﻓ
ﻰﻧﺎﻋ: ﻞﻤﺤﺗ, ﻞﻤﺤﺗ
ﺞﻴﺠﺿ: ﺔﺒﺧﺎﺻ, ﺔﺤﻴﺻ, ﺞﻴﺠﺿ, ﺮﻳﺪﻫ
ﺏﺩﺃ: ﻲﺑﺩﺃ
ﺔﺤﻴﺼﻨﻟﺍ: ﺲﻠﺠﻣ, ﻲﺻﻮﻧ, ﺔﻴﺻﻮﺗ, ﺢﺼﻧ, ﺭﻭﺎﺸﺗ, ﺲﻠﺠﻣ, ﺢﻴﻤﻠﺗ
ﺔﻏﺭﺎﻓ: ﻍﺍﺮﻓ, ﺮﻏﺎﺷ, ﻞﺒﻃ, ﻍﺍﺮﻔﻟﺍ-ﺖﻗﻭ, ءﻲﺷ-ﻻ﻿, ﻍﺍﺮﻓ, ﻍﺍﺮﻓ, ﺎﺜﺒﻋ
ﺔﺒﺗﺮﻣ: ﺪﻌﺑ, ﺔﺟﺭﺩ, ﺯﺎﺠﻧﺇ, ﺔﺌﻓ, ﺔﻤﻴﻘﻟﺍ, ﻞﺼﻔﻟﺍ
ﻡﺎﺤﺘﻗﺍ: 
ﺐﻴﺟ: ﺔﺒﻴﻘﺣ, ﺔﻣﺰﺣ
ﻝﺎﻴﺧ: ﺓﻭﺰﻧ, ﻞﻴﺨﺗ, ﺽﺍﺮﺘﻓﺍ, ﻝﺎﻴﺧ, ﻝﺎﻴﺧ, ﻲﻠﻴﺨﺗ
ﻰﻠﻋ-ﻢﻜﺣ-ﻭﺍ ﺔﻠﻤﺟ: ﻢﻜﺣ, ﻢﻜﺣ, ﺡﺍﺮﺘﻗﺍ, ﺔﻳﺮﻈﻧ, ﺡﺍﺮﺘﻗﺍ, ﺡﺮﺘﻘﻣ, ﺏﺎﻘﻋ, ﻉﺎﻨﻗﺇ, ﺓﺭﺎﺒﻌﻟﺍ, ﺐﺠﺷ, ﺐﺠﺷ, ءﺍﺰﺟ-ﺔﻠﻛﺭ
ﻲﻧﺎﺜﻟﺍ-ﻦﻳﺮﺸﺗ: 
ﺮﺒﻤﺴﻳﺩ: 
ﺏﺎﻴﻏ: ﺐﺋﺎﻏ, ﺺﻘﻧ, ﺺﻘﻧ
ﺍﺮﻜﺷ: ﺮﻜﺷ, ﻦﺘﻤﻣ---ﺮﻛﺎﺷ, ﺮﻜﺷ, ﺍﺮﻜﺷ
ﻥﺍﻮﻨﻌﻟﺍ: 
ﺮﺋﺎﻃ: ﺔﻠﺣﺭ, ﺓﺮﺋﺎﻃ, ﺔﺛﺎﻔﻧ-ﺓﺮﺋﺎﻃ, ﺕﺍﺮﺋﺎﻄﻟﺍ, ﺓﺮﺋﺎﻃ, ﻥﺍﺮﻴﻃ-ﺔﻛﺮﺷ
ﻚﻟﺎﻣ: ﺲﻴﺋﺭ, ﻚﻟﺎﻤﻟﺍ
ﻒﻄﻌﻣ: ﺏﻮﺛ, ﺪﻤﻏ, ﻲﻄﻐﻳ-،ءﺎﻄﻏ, ﻒﻄﻌﻣ, ﻭﺮﻓ
ﺩﺍﺪﻋﺇ: ﺩﺍﺪﻌﺘﺳﺍ, ﺪﻌﻣ, ﻢﻈﻨﺗ, ﺩﺍﺪﻋﺇ, ﺔﻏﺎﻴﺻ
ﺕﺎﻗﻼ﻿ﻋ: ﺔﻗﻼ﻿ﻋ, ﺔﻗﻼ﻿ﻋ, ﺔﺒﺴﻧ, ﺔﻴﻤﻫﺃ, ﻂﺑﺭ, ﺔﻴﻣﺍﺮﻏ-ﺔﻗﻼ﻿ﻋ, ﺕﻻ﻿ﺎﺼﺗﻻ﻿ﺍ, ﻞﺻﺍﻮﺘﻟﺍ
ﻥﺎﺧﺩ: ﻦﻴﺧﺪﺗ, ﻎﺒﺗ, ﻕﺮﺣ
ﻲﻧﺎﺜﻟﺍ-ﻥﻮﻧﺎﻛ: 
ﺔﻟﺁ: ﺔﻴﻟﺁ, ﻙﺮﺤﻣ, ﺓﺮﺋﺎﻃ, ﺔﺒﻛﺮﻣ
ﻯﻮﺘﺤﻣ: ﺓﺩﺎﻣ, ءﺎﻴﺷﺃ, ﻝﺎﺜﺘﻣﻻ﻿ﺍ, ﺽﻮﻋ, ﻱﻮﺘﺤﻳ, ﻦﻤﻀﺘﺗ, ﻒﻟﺄﺘﺗ, ﻦﻤﻀﺘﺗ
ﻥﺎﻨﺳﺃ: ﻦﺳ, ﺕﺍﺪﻌﻣ
ﺭﺎﻋ: ﺭﺎﻋ, ﻥﻼ﻿ﺠﺧ, ﻝﻮﺠﺧ, ﺝﺮﺤﻟﺎﺑ, ﻚﺑﺮﻣ, ﺓﺮﻴﺣ, ﺭﺎﻋ, ﺭﺎﻋ, ﺔﻧﺎﻫﺇ, ﺐﻀﻏ
ﺞﻴﻠﺧ: ﺔﺒﺣ, ﻞﺒﻬﻤﻟﺍ
ﻍﺎﻣﺩ: ﺮﺑﺪﻤﻟﺍ-ﻞﻘﻌﻟﺍ, ﻉﺎﺨﻧ
ﺔﻘﻠﺣ: ﻪﻓﺎﺗ, ﻲﻔﺗﺎﻬﻟﺍ-ﻝﺎﺼﺗﻻ﻿ﺍ, ﺔﻘﻴﻠﺣ, ﺔﻃﻮﺸﻧﺃ, ﺔﻠﺠﻌﻟﺍ-ﺭﺎﻃﺇ, ﺔﻠﺠﻌﻟﺍ-ﺭﺎﻃﺇ, ﺮﺤﺒﻟﺍ-ﻊﺒﺳ, ﻢﺘﺧ
ﺓﺭﺎﺒﻌﻟﺍ-ﺔﻣﻼ﻿ﻋ: 
ﻊﺑﺮﻣ: 
ﺔﻬﻛﺎﻓ: 
ﻱﺎﺷ: 
ﺡﺮﺷ: ﺡﺮﺷ, ﺢﻴﺿﻮﺗ, ﺮﻴﺒﻌﺘﻟﺍ, ﺢﻴﺿﻮﺗ, ﻦﻠﻋﺃ, ﺢﺿﻭ, ﺮﺴﻓ, ﻖﻴﻠﻌﺘﻟﺍ
ﺎﺒﺣﺮﻣ: ﺔﻴﺤﺗ, ﻝﺎﺒﻘﺘﺳﺍ, ﻪﻴﻓﺮﺗ, ﺎﺒﺣﺮﻣ, ﺎﺒﺣﺮﻣ, ﺎﻴﺣ
ﺮﻌﺸﻟﺍ: ﺓﺪﻴﺼﻗ, ﺔﻳﺁ
ءﺍﺮﺷ: ءﺍﺮﺷ, ﺐﺴﻛ, ﻞﻤﺤﺗ, ﻕﻮﺳ
ﻦﻣﺆﻣ: ﻦﻴﻣﺃ-ﺮﻴﻏ, ﺺﻠﺨﻣ, ﺔﻧﺎﻣﺄﺑ, ﺱﺮﻛ, ﺢﻴﺤﺻ, ﻕﻮﺛﻮﻣ
ﺓﺭﺎﺛﺇ: ﻪﻴﺒﻨﺗ, ﻞﻌﻔﻨﻣ, ﺞﻴﺠﺿ, ﺮﺗﻮﺗ, ﺓﺭﺎﺛﺇ, ﺔﺣﺮﻓ, ﺓﺭﺎﺛﻹ﻿ﺍ, ﺓﺭﻮﻓ, ﻖﻠﻗ
ﻥﻮﻌﺑﺭﺃ: 
ﻞﻳﺮﺑﺃ: 
ﻰﺟﺮﻳ: ﻚﻠﻀﻓ-ﻦﻣ, ﺩﻭﺩﻭ, ﻒﻄﻠﺑ
ﺮﺑﻮﺘﻛﺍ-ﺮﻬﺷ: 
ﺓﺭﺍﺮﻣ: ﺔﻘﺋﺎﺿ, ﺏﺍﺬﻋ, ﺏﺮﻛ, ﺮﻳﺮﻣ, ﺓﺎﻧﺎﻌﻣ, ﻢﻟﺆﻣ, ﺔﻏﺪﻟ
ﺪﺒﻋ: ﺔﻳﺩﻮﺒﻋ
ﺽﺎﻔﻀﻓ: ﻞﻘﺘﺴﻣ, ﺔﺿﺎﻔﻀﻓ, ﻞﺣ, ﻞﺣ, ﺩﻮﻛﺭ-ﺓﺮﺘﻓ, ﺮﻏﺎﺷ, ﺔﻳﺮﺤﺑ
ﺺﻧ: ﺔﻏﺎﻴﺻ
ﻥﺎﻤﺘﺋﺍ: ﻦﻫﺭ, ﻥﺎﻤﺘﺋﺍ-ﺔﻗﺎﻄﺑ, ﻦﻳﺩ, ﺽﺍﺮﻗﺇ, ﺽﺍﺮﺘﻗﺍ, ﺽﺮﻗ, ﺔﺒﻴﻫ, ﺔﻴﺣﻼ﻿ﺻ, ﺔﻴﻗﺍﺪﺼﻣ
ﺮﺸﻋ-ﺔﺴﻤﺧ: 
ﺔﻴﺳﺎﻗ: ﻒﻴﻨﻋ, ﻲﺳﺎﻗ
ﻢﻀﻧﺍ: ﻙﺭﺎﺷ, ﺮﻀﺣ, ﻁﺭﻮﺘﻣ, ﻉﻭﺮﺸﻟﺍ, ﻡﺰﺘﻠﺗ, ﻙﺭﺎﺸﻣ, ﺔﻛﺭﺎﺸﻣ, ﺪﺣﻮﺗ, ﻂﺑﺭ
ﺔﻴﻠﻤﻋ: ﺾﺒﻘﻣ, ءﺍﺮﺟﺇ, ﺞﻟﺎﻋ, ﺔﻴﻠﻤﻋ, ﺔﺑﺮﺠﺘﻟﺍ
ﺔﻤﻳﺮﺟ: ﻢﺛﺇ, ﺔﻤﻳﺮﺟ, ﺔﻤﻳﺮﺟ
ﺭﺎﺒﻏ: ﺪﺳ, ﻕﻮﺤﺴﻣ
ﻲﻠﻤﻋ: ﻲﻔﻴﻇﻭ, ﻲﻌﻗﺍﻭ, ﺎﻴﻠﻤﻋ, ﺐﺳﺎﻨﻣ, ﺎﻴﻠﻤﻋ, ﻝﻭﺎﻨﺘﻤﻟﺍ-ﻲﻓ, ﻲﻘﻴﺒﻄﺗ
ﻥﻮﻠﻟﺍ: ﻥﻮﻠﻟﺍ, ﻢﺳﺭ, ﺓﻭﺰﻧ, ﻎﺒﺻ, ﺖﻫﺎﺑ, ﻥﻮﻠﻣ, ﻥﺍﻮﻟﻷ﻿ﺎﺑ-ﻲﻨﻏ, ﺓﺭﻮﻓ, ءﺎﻬﻧﺇ
ﻡﺪﻫ: ﺮﻴﻣﺪﺗ, ﺾﻳﻮﻘﺗ, ﺐﻳﺮﺨﺗ, ﻞﻠﺤﺘﺗ, ﻡﺪﻫ, ﻖﺤﺳ, ﻖﺤﺳ, ﺏﺮﺧ, ﻚﺑﺭﺃ, ﻮﺤﻣ, ﻲﻔﻨﻳ, ﺮﻴﻣﺪﺗ
ﺓﺩﺎﻳﺯ: ﻡﺪﻘﺗ, ﻦﻴﺴﺤﺗ, ﻞﺒﺟ, ﻊﻓﺭ, ﺔﻓﺎﺿﺇ, ﻞﺧﺩﺃ, ﻮﻤﻧ, ﺮﻴﺒﻜﺗ
ﻒﻧﺃ: 
ﻑﺮﺘﻋﺍ: ﻑﺍﺮﺘﻋﺍ, ﻝﺯﺎﻨﺗ, ﻞﺒﻘﺗ, ﻰﻠﻋ-ﻑﺮﻌﺗﺍ, ﻑﺮﺘﻋﺍ, ﻖﻳﺪﺼﺗ, ﺪﻴﻳﺄﺗ, ﺢﻨﻤﻳ, ﺓﺰﺋﺎﺟ
ﻖﺑﺎﺴﻟﺍ-ﻡﻮﻴﻟﺍ: ﺪﻏ-ﻡﻮﻳ
hesternal-ﺮﺗﻮﺗ: 
ﻞﺸﻓ: ﻞﺸﻓ, ﺢﺟﺎﻧ-ﺮﻴﻏ, ﺔﻤﻳﺰﻫ, ﺔﺴﻜﻧ, ﺭﺩﺎﻗ-ﺮﻴﻏ, ﻚﺑﺭﺃ, ﺐﻴﺨﻳ
ﻞﻤﻛﺃ: ﻡﺪﻘﺗ, ﻞﺻﺍﻮﺘﻣ, ﺮﻤﺘﺴﻣ, ﺭﺍﺮﻤﺘﺳﺍ, ﺭﺍﺮﻤﺘﺳﺎﺑ, ﺮﺑﺎﺛ
ءﺍﺪﺗﺭﺍ: ﻞﻤﺣ, ﻝﺎﻤﺣ
ﺪﻨﻴﻠﺑ: 
ﺔﻨﻳﺯﺩ: ﻦﻣ-ﺪﻳﺪﻌﻟﺍ
ﺮﻴﻄﻳ: ﻥﺍﺮﻴﻃ, ﺰﻔﻗ, ﺔﻠﺣﺭ, ﻥﺍﺮﻴﻃ
ﺡﺪﻣ: ﺏﺎﺠﻋﺇ, ﺐﺠﻌﻣ, ﺔﻌﻤﺳ, ﺓﺭﺍﺪﺟ, ﺄﻨﻫ, ﻢﻜﻴﻠﻋ-ﻙﻭﺮﺒﻣ, ﺪﺠﻣ, ﺓﺮﻬﺷ
ﺲﻴﻠﺑﺇ: 
ﺎﻴﺠﻳﺭﺪﺗ: ءﻂﺒﺑ, ﻲﺠﻳﺭﺪﺗ
ﺔﻴﺤﻀﺗ: ﺔﻴﺤﺿ, ﺔﺴﻳﺮﻓ, ﺏﺎﺼﻣ
ﺔﺳﺭﺎﻤﻣ: ﺔﻴﺿﺎﻳﺮﻟﺍ-ﺏﺎﻌﻟﻻ﻿ﺍ, ﻞﺣ---ﻒﺸﺘﻛﺍ, ﺔﻤﻬﻣ, ﺔﺳﺭﺎﻤﻣ, ﺔﺳﺭﺎﻤﻣ, ﺔﺿﺎﻳﺭ, ﻪﻴﻧﺪﺒﻟﺍ-ﻪﻗﺎﻴﻠﻟﺍ, ﺔﻓﻭﺮﺑ
ﺮﻴﻤﺿ: ﺮﻴﻤﺿ, ﻲﻋﻭ
ﺔﻳﺮﻈﻧ: ﺃﺪﺒﻣ, ﺮﻈﻨﻤﻟﺍ, ﺔﻳﺮﻈﻧ
ﺮﻳﺯﻭ: 
ﺔﻴﻫﺍﺮﻛ: ﺮﻳﺮﺷ, ﻑﺮﻘﻣ-ﺊﺷ, ﺔﻴﻫﺍﺮﻛ, ﻰﻨﺒﺠﻌﻳ-ﻢﻟ, ﺰﻴﺤﺗ, ﺔﻨﻴﻐﺿ, ءﺎﺘﺳﺍ, ﺰﺌﻤﺸﻣ, ﺯﺍﺰﺌﻤﺷﺍ, ﻑﺮﻗ
ﺓﺮﻴﺤﺑ: 
ﺰﻛﺮﻣ: ﻂﺳﻭ, ﺰﻛﺮﻣ, ﺔﻄﺤﻣ, ﻲﺴﻴﺋﺮﻟﺍ-ﺮﻘﻤﻟﺍ
ﺖﻓﺎﺧ: ﻲﻋﻮﻟﺍ-ﺪﻗﺎﻓ, ﺱﺄﻳ, ﺲﺋﺎﻳ, ﻒﻴﻌﺿ, ﺖﻫﺎﺑ
ﻲﻧﻼ﻿ﻘﻋ-ﺚﻴﻧﺄﺗ-ﻭﺃ ﺮﻴﻛﺬﺗ ﺲﻨﺟ: 
ﺭﺬﺣ: ﺱﻭﺭﺪﻣ, ﻪﺒﺘﻨﻣ, ﺰﻛﺮﺗ, ﺭﺬﺣ, ﻖﻴﻗﺩ, ﻖﻴﻗﺩ, ﻖﻴﻗﺩ, ﻞﺼﻔﻣ
ﻊﺘﻤﺘﺳﺍ: ﺔﻌﺘﻣ, ﺭﺪﻘﻧ
ﺓﺩﺎﺒﻋ: ﺱﻮﻘﻃ
ﻊﺋﺎﻀﺑ: ﺞﺘﻨﻤﻟﺍ, ﺮﺼﻨﻌﻟﺍ, ﻊﺋﺎﻀﺑ, ﺔﻌﻠﺳ, ءﺎﻴﺷﺃ
ﺓﺮﺸﺑ: ﺪﻠﺟ, ﺹﺎﺼﺘﻣﺍ, ﺡﺎﺒﻧ, ﺓﺮﺸﻗ, ﺮﺸﻗ, ﻭﺮﻓ, ﺫﺬﻠﺗ
ﺖﻴﺒﻟﺍ-ﺢﻄﺳ: ﺔﻓﺮﺷ, ﻒﻘﺳ, ﺔﻴﻄﻐﺗ, ﺔﻴﻄﻐﺗ, ﻦﻴﻌﻟﺍ-ﻦﻔﺟ
ﺝﺎﺗ: 
ﺔﻌﻠﻗ: ﺺﻔﻗ, ﻉﺩﺎﺨﻣ, ﻞﻔﻗ
ﺵﺮﻋ: 
ﻖﻓﺮﻤﻟﺍ: ﺏﺬﺟ, ﻲﻃﺮﺷ, ﻖﻓﺮﻳ, ﻞﺼﺘﻣ, ﻊﺑﺎﺗ, ﺪﻋﺎﺴﻣ
ﻞﻴﻣ: ﻞﻴﻣ, ﻞﻴﻣ, ﻞﻴﻣ, ﻞﻴﻣ, ﺐﻏﺍﺭ
ﻰﺼﻗﺃ: ﻰﺼﻗﺃ, ﻰﺼﻗﺃ, ﺩﻮﻤﻋ, ﻲﺒﻄﻗ, ﻑﺮﻄﺘﻣ, ﻱﺪﺟ, ﺪﻳﺪﺷ, ﻒﻴﺜﻛ, ﻢﻬﻓﺍﺮﻃﺃ, ﺢﻴﻤﻠﺗ
ﻦﺠﺴﻟﺍ: ﻦﺠﺳ
ﺏﻮﻛ: ﺮﺸﻛ, ءﺎﻋ
ﻮﻀﻋ: ﻮﻀﻋ, ﺔﻳﻮﻀﻋ, ﻢﻬﻓﺍﺮﻃﺃ, ﻊﻠﻄﻣ
ﻲﻧﺪﻣ: ﻲﻠﺤﻣ, ﻦﻃﺍﻮﻣ, ﻲﻧﺪﻣ, ﻲﻧﺪﻣ
ﻥﺎﻜﻣ-ﻞﻛ-ﻰﻓ: ﻝﺍﻮﻃ, ﻥﺎﻜﻣ-ﻯﺃ-ﻲﻓ
ﺢﺿﺍﻭ: ﺢﺿﺍﻭ, ﻅﻮﺤﻠﻣ-ﻞﻜﺸﺑ, ﺮﻫﺎﻇ, ﺓﺮﺷﺎﺒﻣ, ﺢﺿﺍﻭ, ﺎﻌﻄﻗ, ﺢﺿﺍﻭ, ﻲﻓﺎﺻ, ﺮﺜﻛﺍ-ﺢﺿﻭﺍ, ﻑﺎﻔﺷ, ﺢﺿﺍﻭ-ﺮﻴﻏ, ﺔﻈﺣﻼ﻿ﻤﻟﺎﺑ-ﺮﻳﺪﺟ
ﻥﺎﺟﻭﺯ: ﺝﻭﺯ, ﺓﺍﻭﺎﺴﻤﻟﺍ-ﻡﺪﻗ, ﻲﺟﻭﺯ-ﺩﺪﻋ, ﺝﻭﺩﺰﻣ, ﻞﻴﻠﻗ, ﻦﻣ-ﺪﻳﺪﻌﻟﺍ, ﺭﺎﺨﺑ
ﺕﻮﺼﻟﺍ: ﻒﻟ, ﺍﺮﻴﺜﻛ, ﻯﺪﻣ, ﺔﻴﻤﻛ, ﺎﻴﺒﺴﻧ, ﻲﻤﻛ, ﻊﻨﻣ, ﺔﻌﻓﺩ, ﺓﺪﺣﻭ, ﻢﺠﺣ, ﺔﻌﺳ, ﺔﻴﻄﻐﺗ
ﻑﺮﻋ: ﻥﻮﺑﺯ, ﻱﺭﺎﻴﺘﺧﺍ, ﻱﺯ, ﻙﺭﺎﻤﺠﻟﺍ, ﺔﺳﺭﺎﻤﻣ, ﺓﺩﺎﻋ, ﺩﺎﺘﻋﺍ
ﺓءﺎﻨﺤﻧﺍ: ﺱﻮﻗ, ﻞﺼﺑ, ﻰﻨﺤﻨﻣ
ﺔﻟﺪﺑ: ﺐﺳﺎﻨﺗ, ﻱﺯ, ﺐﺳﺎﻨﻣ, ﻕﺎﻔﺗﺍ, ﻖﺑﺎﻄﺗ, ﺔﻘﺑﺎﻄﻣ, ﺔﻴﻀﻗ---ﺔﻟﺎﺣ, ﺓﺎﺿﺎﻘﻣ, ﻯﻮﻋﺩ, ﺏﻮﺛ, ﺐﻟﺎﻄﻳ
ﻢﺤﻟ: ﻢﺤﻟ, ﻱﺮﻘﺑ-ﻢﺤﻟ
ﺐﻴﻠﺣ: ﻥﺎﺒﻟﻷ﻿ﺍ-ﺕﺎﺠﺘﻨﻣ, ﺭﻮﺒﻨﺻ, ﻡﻼ﻿ﻫ
ﻲﺗﺎﺒﻧ-ﺚﻴﻧﺄﺗ-ﻭﺃ ﺮﻴﻛﺬﺗ ﺲﻨﺟ: 
ﺔﻳﺅﺭ: ﺪﻬﺸﻣ, ﺓﻮﺸﻧ, ﺔﻳﺅﺭ, ﻒﺋﺍﺯ-ﺮﻬﻈﻣ, ﻱﺃﺭ, ﺔﺤﻤﻟ, ﻝﺎﻤﺘﺣﺍ, ﻪﻴﻌﻴﺒﻄﻟﺍ-ﺮﻇﺎﻨﻤﻟﺍ, ﻙﻮﻟ-ﺕﻭﺍ
ﺭﺩﺎﻧ: ﺍﺭﺩﺎﻧ, ﺩﺎﻜﻟﺎﺑ
ﻪﻟﺎﺨﻟﺍ-ﻪﻨﺑﺍ: ﺐﻳﺮﻗ
ﺮﺴﺟ: ﺔﺟﺭﺩ, ﺔﻨﻴﻔﺴﻟﺍ-ﺢﻄﺳ
ﻲﻤﺤﻳ: ﺔﻳﺎﻤﺣ, ﻆﻔﺣ, ﺱﺮﺤﻟﺍ, ﻉﺭﺩ, ﻉﺎﻓﺪﻟﺍ, ﻰﻠﻋ-ﻅﺎﻔﺤﻟﺍ, ﺔﻈﻓﺎﺤﻤﻟﺍ, ﻆﻔﺣ, ﻦﻴﻣﺄﺗ
ﺢﻠﻣ: ﻪﻴﻓ-ﻎﻟﺎﺒﻣ, ﺔﻐﻟﺎﺒﻣ, ﺢﻟﺎﻣ
ﺉﺮﺑ: 
ﺔﻜﻠﻣ: 
ﺪﻋ: ﻢﻴﺴﻘﺗ, ﺪﻘﺘﻋﺍ, ﺏﺎﺴﺣ, ﺪﻤﺘﻋﺍ, ﻞﻣﻻ﻿ﺍ-ﺔﺒﻴﺧ, ﺏﺎﺴﺣ
ﻉﻼ﻿ﻄﺘﺳﻻ﻿ﺍ-ﺐﺣ: ﺐﻘﻧ
ﺺﻗﺭ: ﻞﺒﻃ, ﺺﻗﺭ, ﺰﻔﻗ, ﻰﻄﺨﺗ
ﻕﺪﻨﻔﻟﺍ: ﺔﻣﺎﻗﻹ﻿ﺍ, ﺓﺭﺎﻤﺧُ
ﺔﺌﺒﻌﺗ: 
ﻦﻴﺠﺳ: 
ﺮﺠﺘﻣ: ﻦﻳﺰﺨﺗ, ﻞﻄﻌﺗ-ﻭﺃ-ﺔﻠﻃﺎﻤﻣ, ﻞﻤﻋ, ﺔﻘﻔﺻ, ﻕﻮﺴﺘﻟﺍ
ﺝﺭﺩ: ﻢﻠﺳ, ﻢﻠﺳ, ﻢﻠﺳ, ﺝﺭﺩ
ﻉﺮﻀﺗ: ﺚﺤﺑ, ﺽﺮﺘﻓﺍ, ﻉﺮﻀﺗ
ﻞﻣﺭ: 
ﻒﻴﻨﻋ: ﻒﻨﻋ, ﻒﻴﻨﻋ, ﻒﻴﻨﻋ, ﻊﺋﺍﺭ, ﺓﺪﻳﺪﺷ, ﻱﻮﻗ, ﺪﻳﺪﺷ, ﻱﻮﻗ, ﻒﻨﻌﺑ, ﻒﻴﺜﻛ
ﺮﺒﻤﺘﺒﺳ: 
ﺓﺭﺩﺎﻐﻣ: ﺭﺩﺎﻏ, ﺭﺩﺎﻐﺗ, ﺬﻔﻨﻣ, ﺞﺗﺎﻨﻟﺍ
ﺏﺍﺮﺧ: ﺮﻴﻣﺪﺗ, ﺐﻳﺮﺨﺗ, ﺭﺮﺿ, ﺩﺎﺴﻓﺇ, ﺔﺛﺭﺎﻛ, ﻡﺎﻄﺣ
ﺓﺭﺎﻬﻣ: ﺓﺭﺪﻘﻟﺍ, ﻰﻠﻋ-ﺭﺩﺎﻗ, ﺔﻌﺳ, ﺔﻴﻟﺎﻌﻓ, ﺹﺎﺼﺘﺧﺍ, ﺔﻓﺮﺣ, ﺓﺮﺒﺧ
ﺔﻴﺷﺎﻣ: ﺓﺮﻘﺑ
ﺕﺍﺪﻌﻣ: ﺯﺎﻬﺟ, ﺯﺎﻬﺟ, ﺓﺪﻋ, ﺕﺍﺪﻌﻣ, ﺲﺑﻼ﻿ﻣ, ﺔﺠﻟﺎﻌﻣ, ﺕﺍﺪﻌﻤﻟﺍ, ﺔﻴﻨﻘﺗ, ﺎﻴﺟﻮﻟﻮﻨﻜﺗ, ﺓﺄﺸﻨﻣ, ﺕﺍﺰﻴﻬﺠﺗ
ﺦﺒﻄﻣ: ﻡﺎﻌﻄﻟﺍ-ﻲﻬﻃ, ﺥﺎﺒﻃ
ﻊﻴﺒﻳ: ﺮﻌﺴﻟﺍ-ﺾﻴﻔﺨﺗ, ﻒﺼﻧ
ﺔﻋﺮﺳ: ﺔﻋﺮﺳ, ﺔﻋﺮﺳ, ﻊﻓﺪﻟﺍ-ﺓﻮﻗ, ﺓﺪﺤﺑ
ﺔﺻﻼ﻿ﺨﻟﺍ: ﻝﻻ﻿ﺪﺘﺳﺍ, ﺏﺎﺤﺴﻧﺍ, ﺞﺗﺎﻨﻟﺍ, ﻂﻳﺭﻮﺗ, ﺭﺍﺮﻗ, ﺔﺠﻴﺘﻧ, ﺔﺠﻴﺘﻧ, ﺔﻋﻮﻤﺠﻣ, ﺪﻘﻋ, ﺡﺮﺘﻘﻣ
ﺏﻮﺳﺎﺤﻟﺍ: ﺔﺒﺳﻮﺤﻟﺍ
ﻱﺪﺑﺃ: ﺍﺪﺑﺃ, ﺪﺑﻷ﻿ﺍ-ﻰﻟﺇ, ﺩﻭﺪﺤﻣ-ﺮﻴﻏ
ﺩﻭﺪﺤﻣ: ﺩﻭﺪﺤﻣ, ﺲﻴﺒﺣ, ﺰﺠﺣ, ﺩﺪﺤﻣ, ﺪﻴﻘﻣ, ﺪﻴﻘﺗ
ﺔﺒﺘﻜﻣ: ﺐﺘﻜﻟﺍ-ﺔﻧﺍﺰﺧ
ﺓﺪﻋﺎﻗ: ﺱﺎﺳﺃ, ﺱﺎﺳﺃ, ﺪﻨﺘﺴﺗ, ﻲﺳﺎﺳﺃ, ﻲﺋﺍﺪﺘﺑﺍ, ﻲﺋﺍﺪﺘﺑﺍ, ﺓﺍﻮﻨﻟﺍ, ﺔﻴﺳﺎﺳﻷ﻿ﺍ, ﻞﻔﺳﺃ
ﻙﺎﺒﺗﺭﺍ: ﺚﺒﻌﺗ, ﻰﺿﻮﻓ, ﺞﻴﺠﺿ, ﺮﻴﺤﻣ
ﺪﻴﺠﻤﻟﺍ: ﻱﺮﻘﺒﻋ, ﻞﻴﻤﺟ, ﻞﻴﺒﻨﻟﺍ
ﺎﻀﻳﺃ: ﻞﺜﻤﻟﺎﺑ, ﺎﻀﻳﺃ, ﻱﻭﺎﺴﺘﻟﺎﺑ
ﻒﺋﺎﺧ: ﻒﺋﺎﺧ, ﺔﻔﺋﺎﺧ, ﻉﺰﻓ, ﻉﺰﻓ
ﺲﻴﻌﺗ: ﻪﻟ-ﻒﺳﺆﻳ, ﻆﺤﻟﺍ-ﻞﻴﻠﻗ, ﺲﺋﺎﺑ
ﺔﻟﺎﻘﻣ: ﻝﺎﻘﻣ, ﺮﺼﻨﻌﻟﺍ
ﺦﺒﻃ: ﻡﺎﻌﻄﻟﺍ-ﻲﻬﻃ, ﺰﺒﺧ, ﻲﻠﻐﻳ---ﻖﻠﺴﻳ
ﺔﻗﺮﻓ: ﻡﺍﺰﺣ, ﻂﻳﺮﺷ, ﻂﻳﺮﺷ, ﺔﻗﺮﻓ, ﺔﻋﻮﻤﺠﻣ, ﻉﺎﻄﻗ, ﻂﻳﺮﺷ, ﺔﻘﻄﻨﻣ, ﻞﺣﺎﺳ, ﺔﻗﺎﺑ, ﺔﻠﺘﻛ, ﻂﺧ
ءﺍﺮﺤﺻ: ﺔﻳﺮﺑ, ﺭﻮﺠﻬﻣ
ﺔﻠﺒﻗ: 
ﺓﺮﻛ: ﻁﺎﻄﻣ, ﻥﺍﺪﻴﻣ, ﻊﻓﺪﻣ, ﺔﺻﺎﺻﺭ
ﺎﺼﻋ: ﻥﻭﺰﺨﻣ, ﺐﺼﻗ, ﻡﺰﺘﻠﺗ, ﺐﺸﺧ, ﺐﺸﺧ, ﺵﺎﻔﺧ, ﺔﻠﻳﺪﺟ
ﻝﺍﺪﺟ: ﻖﻄﻨﻣ, ﺓﻮﻄﺧ, ﻖﻄﻨﻣ, ﻝﺍﺪﺟ, ﺵﺎﻘﻧ, ﺔﺸﻗﺎﻨﻣ, ﻑﻼ﻿ﺧ, ﺯﺎﻬﺠﻟﺍ
ﺪﺻﺭ: ﺺﺤﻓ, ﺚﺤﺑ, ﻑﺎﺸﻜﺘﺳﺇ, ﻖﻴﻘﺤﺘﻟﺍ, ﺔﻈﺣﻼ﻿ﻤﻟﺍ
ﺔﻛﺮﺒﻟﺍ-ﺢﻨﻣ-ﺝﺍﺰﻣ: 
ﺶﻫﺪﻣ: ﺔﻘﻠﻌﻣ, ﻞﻫﺬﻣ, ﺏﺍﺮﺿﺇ, ﺮﻴﺒﻛ, ﺮﻴﺒﻛ, ﻱﺮﻫﻮﺟ, ﺔﻈﺣﻼ﻿ﻤﻟﺎﺑ-ﺮﻳﺪﺟ, ﺏﺎﺠﻋﻺ﻿ﻟ-ﺮﻴﺜﻣ, ﺊﺟﺎﻔﻣ, ﻞﻫﺬﻣ, ﻲﻓﺎﺻ, ﻕﺮﺸﻣ
ﺐﻧﺬﻣ: ﻢﺛﺇ, ﻦﻳﺪﻧ, ﺓءﺎﺳﻹ﻿ﺍ, ﺐﻧﺬﻤﻟﺍ, ﻡﻮﻜﺤﻤﻟﺍ
ﺔﻴﻗﺪﻨﺑ: ﺔﻴﻗﺪﻨﺑ, ﺡﻼ﻿ﺳ, ﻊﻓﺪﻣ, ﻉﺩﺎﺨﻣ
ﺔﻃﺮﺷ: ﺽﺮﻓ, ﻑﺍﺮﺷﻹ﻿ﺍ
ءﺎﻔﺧﺇ: ءﺎﻔﺧﺇ, ﺯﺮﻔﺗ, ﻪﻳﻮﻤﺗ
ﺔﻠﻤﺣ: ﺔﻴﺑﺎﺨﺘﻧﻻ﻿ﺍ-ﺔﻠﻤﺤﻟﺍ, ﺔﻠﻤﺣ, ﺔﻠﺣﺭ, ﺔﻠﺣﺭ, ﺔﻠﺣﺭ, ﺔﻟﻮﺟ
ﻞﻫﺎﺟ: ﻞﻬﺟ, ﻙﺭﺪﻣ-ﺮﻴﻏ, ﻞﻫﺎﺟ, ﻖﻤﺣﺃ, ﻒﻴﺨﺳ, ﻲﺒﻏ, ﻒﻴﺨﺳ
ﺔﻤﻳﺮﻛ: ﺔﻳﺭﺮﺤﺗ, ﻡﺮﻛ, ﺮﻴﺧ
ﺔﺑﺎﺤﺳ: 
ﺕﺎﻔﻠﺨﻤﻟﺍ: ﺓﺪﺋﺎﻓ-ﻥﻭﺪﺑ, ﻱﺭﻭﺮﺿ-ﺮﻴﻏ, ﺾﻓﺭ, ﺾﻓﺭ, ﺾﻓﺮﻟﺍ, ﺎﻳﺎﻘﺑ, ﻡﺎﻌﻄﻟﺍ-ﺎﻳﺎﻘﺑ, ﺔﻣﺎﻤﻗ
ﺮﻳﺍﺮﺒﻓ: 
ﺽﺮﻣ: ﺽﺮﻣ, ﺽﺮﻣ, ﻲﻠﻴﻠﻛﺇ, ﺽﺮﻣ, ﺽﺮﻣ, ﺔﻣﺯﻼ﻿ﺘﻣ
ءﺎﻀﻗ: ﺓﺮﻫﺯ, ﻡﺍﺪﺨﺘﺳﺍ, ﻕﺎﻔﻧﺇ, ﺐﻘﻌﺗ, ﻰﻄﺨﺗ, ﺔﺴﻧﻵ﻿ﺍ
ﺭﺪﺼﻣ: ﺩﺭﻮﻣ, ﻡﺎﺨﻟﺍ, ﺓﺭﻮﻓﺎﻧ
ﺓﺭﺩﺎﺒﻣ-ﺔﻟﺎﺣ: 
ﺔﻤﻋ: 
ﺮﻴﺧﺄﺗ: ﻞﻴﺟﺄﺗ
ﺮﻴﺧﺄﺗ-ﺐﺟﺍﻭ: 
ﺕﺮﻛﺫ-ﺮﻫﺎﻇ: 
ﻞﻴﻠﻟﺍ-ﻒﺼﺘﻨﻣ: ﻝﺎﻤﺷ
ﻞﻄﺑ: ﺏﺭﺎﺤﻣ, ﻞﻄﺑ
ﺔﻔﺴﻠﻓ: ﻲﻔﺴﻠﻓ
ﺪﻴﻟﺍ-ﻊﺒﺻﺍ: ﻡﺪﻘﻟﺍ-ﻊﺒﺻﺍ
ﺢﻳﺮﻣ: ﻦﺴﺣ, ﺎﻣﺎﻤﺗ, ﻢﻴﻠﺳ-ﻞﻜﺸﺑ, ﺔﺳﻼ﻿ﺴﺑ, ﺢﻳﺮﻣ, ﺐﺳﺎﻨﻣ, ﺢﻳﺮﻣ, ﺔﻌﺘﻤﻣ, ﺊﻓﺍﺩ, ﻝﻭﺎﻨﺘﻤﻟﺍ-ﻲﻓ
ﺎﻣ-ﻥﺎﻜﻣ: ﻥﺎﻜﻣ-ﻯﺃ-ﻲﻓ
ﺔﻓﺎﺤﺻ: ﻡﻼ﻿ﻋﻹ﻿ﺍ-ﻞﺋﺎﺳﻭ, ﺔﻠﺠﻣ, ﺔﻠﺠﻣ, ﻊﺒﻃ, ﺐﺘﻛﺍ, ﺔﻟﺩﺎﻌﻣ
ﻦﻴﻠﻣﺎﻌﻟﺍ: ﻞﻤﻌﻟﺍ-ﻢﻗﺎﻃ, ﺔﻴﺼﺨﺸﻟﺍ
ﺓﺎﻓﺎﻜﻣ-ﻭﺍ-ﺓﺰﺋﺎﺟ: ﺓﺰﺋﺎﺟ, ﺔﻳﺪﻫ, ﺓﺰﺋﺎﺟ, ﺓﻭﻼ﻿ﻋ
ﻰﻠﻋ-ﻡﻮﻠﻟﺍ-ءﺎﻘﻟﺇ: ﺄﻄﺧ, ﻞﻠﺧ, ﺐﻴﻋ, ﻦﻳﺩ, ﻢﺛﺇ, ﺲﻄﻓﺃ, ﺔﻴﺋﺎﻀﻗ-ﻯﻮﻋﺩ-ﻊﻓﺭ, ﺔﻴﻟﻭﺆﺴﻣ, ﺔﻴﻟﻭﺆﺴﻣ
ﺱﺆﺑ: ﺔﻘﺋﺎﺿ, ﺓﺎﻧﺎﻌﻣ, ﺏﺮﻛ, ﺲﺋﺎﺑ, ﻞﻠﻣ
ﺱﺃﺮﻟﺍ-ﺔﻬﺒﺟ: 
ﻱﺩﻼ﻿ﻴﻣ: ﻥﻼ﻿ﻋﺇ, ﻥﻼ﻿ﻋﺇ, ﻦﻠﻋﺃ, ﻥﻼ﻿ﻋﻹ﻿ﺍ, ﻥﻼ﻿ﻋﺇ, ﺔﻳﺎﻋﺩ, ﺭﺎﻌﺷﺇ, ﻥﻼ﻿ﻋﺇ
ﻙﻼ﻿ﻣ: ﻙﻼ﻿ﻣ, ﺔﻴﻨﺟ
ﺩﺮﻔﻤﻟﺍ-ﺔﻐﻴﺻ-ﺩﺪﻋ: 
ﺮﺠﻓ: ﻖﻔﺸﻟﺍ
ﻱﺭﺎﺠﺗ: ﻲﻨﻬﻣ, ﻥﻼ﻿ﻋﺇ, ﺓﺭﺎﺠﺗ, ﻞﻤﻋ
ﺮﻔﻏ: ﺭﺬﻋ, ﺍﺭﺬﻋ-ﻚﺤﻴﻤﺘﺳﺍ, ﻞﻤﺤﺗ, ﻰﻔﻌﻣ, ﻒﻴﻔﺨﺗ, ﺮﻈﻨﻟﺍ-ﻑﺮﺻ
ﻑﻭﺮﺧ: ﻑﻭﺮﺧ
ﺮﺒﺻ: ﺪﻠﺟ, ﺢﻣﺎﺴﺗ
ﺔﻋﺭﺰﻣ: ﺔﻋﺭﺰﻣ, ﻉﺭﺯ, ﺔﻋﺭﺰﻣ, ﻲﻋﺍﺭﺯ
ﻲﻌﺟﺮﻣ: ﻊﺟﺮﻣ, ﻉﻮﺟﺮﻟﺍ
ﺓﺭﺫ-ﺏﻮﺒﺣ: ﺢﻤﻗ, ﻕﻮﺑ
ﺡﺎﺘﻔﻣ: ﻁﺎﺑﺭ, ﺭﺯ, ﻂﺑﺮﻟﺍ-ﺡﺎﺘﻔﻣ, ﻝﻮﺤﺗ, ﻲﺴﻴﺋﺭ, ﻱﻮﻴﺣ, ﺯﺭﺎﺑ, ﺱﺎﺴﺣ, ﺪﺋﺍﺭ, ﺏﺍﺮﺤﻣ, ﺭﺎﻴﺘﻟﺍ, ﻞﻴﻟﺩ
ﺔﻴﺒﻠﻏﺃ: ﺮﻴﺜﻛ, ﻢﻈﻌﻣ
ﻒﻌﺿ: ﺰﺠﻋ
ﻮﺠﻟﺍ: ﺔﺌﻴﺑ, ءﺎﻤﺳ, ﻥﺍﺮﻴﻃ, ﻲﻧﺎﻜﻣ
ﺪﻬﻨﺗ: ﺙﺎﻬﻟ
ﻱﺮﺸﺒﻟﺍ-ﺲﻨﺠﻟﺍ: ﻥﺎﺴﻧﻻ﻿ﺍ
ﺔﺿﺭﺎﻌﻣ: ﺽﺭﺎﻌﻣ, ﺽﺭﺎﻋ, ﺔﺿﺭﺎﻌﻣ, ﻦﻳﺎﺒﺗ, ﻡﻭﺎﻘﻳ, ﺝﺎﺠﺘﺣﺍ, ﺲﻜﻋ, ﺔﻣﻭﺎﻘﻣ, ﺩﺍﺪﻋ, ﻢﺼﺨﻟﺍ, ﺭﺎﻜﻨﺘﺳﺍ, ﺩﺎﻀﻣ, ﻡﻭﺎﻘﻣ, ﺔﺤﻓﺎﻜﻣ, ﺽﺍﺮﺘﻋﺍ
ﺔﻧﺍﻮﻄﺳﺃ: ﺹﺮﻘﻟﺍ, ﺔﺤﻳﺮﺷ, ﺩﺍﺪﻋ, ﺔﻧﺍﻮﻄﺳﺃ, ﻖﺒﻃ, ﻞﺠﺳ, ﺔﻴﻨﻴﺻ, ﺔﻠﻤﺣ
ﺍﺪﻴﺣﻭ: ﻩﺪﺣﻭ, ﺔﻟﺰﻋ, ﺓﺪﺣ-ﻰﻠﻋ, ﺏﺰﻋﺃ, ﺩﺮﺠﻣ
ﻥﺎﻨﻓ: ﺩﺆﻣ, ﻡﺎﺳﺭ, ﻥﺎﻨﻔﻟﺍ
ﺱﺭﺎﻓ: ﺐﻛﺍﺭ
ﺮﺤﺳ: ﺔﻴﻣﺰﻳﺭﺎﻜﻟﺍ, ﻩﺎﺒﺘﻧﺍ-ﺏﺬﺟ, ﺮﺤﺳ, ﺮﺤﺳ
ﺭﺍﺮﻗ: ﺭﺮﻗ, ﻢﻜﺣ, ﻢﻜﺣ, ﻢﻜﺣ, ﺮﻳﺮﻘﺗ, ﺭﺍﺮﻗ, ﻞﺣ
ﻆﻓﺎﺤﻣ: ﻆﻓﺎﺤﻣ, ﺓﺮﻄﺴﻣ
ﻉﺮﻓ: 
ﺐﻴﺗﺮﺗ: ﺐﻴﺗﺮﺗ, ﺐﻴﺗﺮﺗ, ﻞﻴﻣ, ﻩﺎﺠﺗﺍ, ﻢﻳﺪﻘﺗ, ﻢﻴﻤﺼﺗ, ﺝﺍﺰﻣ, ﻲﻨﻣﺰﻟﺍ-ﻝﻭﺪﺠﻟﺍ, ﻲﻨﻣﺰﻟﺍ-ﻝﻭﺪﺠﻟﺍ
ﺱﺎﻤﺣ: ﺔﺳﺎﻤﺣ, ءﻑﺩ, ﺲﻤﺤﺘﻣ, ﺫﺬﻠﺗ, ﺓﻮﺸﻨﻟﺍ, ﻒﻐﺷ, ﺓﻮﺸﻧ, ﺝﺎﻬﺘﺑﺍ
ﻲﺜﺣ-ﺝﺍﺰﻣ: ﻲﺟﺎﺘﻨﺘﺳﺍ-ﺝﺍﺰﻣ, ﻲﺟﺎﺘﻨﺘﺳﺍ-ﺝﺍﺰﻣ
ﻊﻤﺘﺠﻣ: ﻊﻤﺘﺠﻤﻟﺍ, ﺔﺌﻓ, ﺱﺎﻨﻟﺍ
ﻂﻔﻧ: ﻦﻫﺩ, ﺩﻮﻗﻭ, ﺭﻮﻔﺣﻷ﻿ﺍ, ﻉﺎﺨﻧ, ﻱﺭﺍﺮﺣ, ﺓﺪﺑﺯ
ﺏﻮﺒﻧﺃ: ﺏﻮﺒﻧﺃ, ﺭﻮﺒﻨﺻ, ﺭﻮﺒﻨﺻ, ﺏﻮﺒﻧﺃ, ﺓﺎﻨﻗ
ﺔﻋﺎﺒﻃ: ﺭﺍﺪﺻﺇ, ﻂﻐﻀﻟﺍ, ﻊﺒﻃ, ﺭﻮﺤﻣ, ﺐﻟﺎﻗ, ﻉﺎﺒﻄﻧﻻ﻿ﺍ
ﺎﻳ: ﺎﻳ
ﺭﺍﻮﺤﻟﺍ-ﻡﻼ﻿ﻜﻟﺍ-ﻕﺎﻴﺳ: 
ﻲﺋﺍﺪﻧ-ﺔﻟﺎﺣ: 
ﺓﺮﻤﻗ: ﺥﻮﻛ, ﺔﻤﻴﺧ, ﺥﻮﻛ
ﺭﺍﺬﻧﺇ: ﺱﺮﺟ, ﺭﺍﺬﻧﺇ, ﺐﻋﺭﺃ, ﺐﻫﺭﺃ
ﻲﺒﺼﻋ: ﺮﺗﻮﺗ, ﺮﺋﺎﺣ, ﺞﻋﺯﺃ, ﺏﺍﺮﻄﻀﻣ, ﺝﺮﺤﻟﺎﺑ, ﻖﻠﻘﻣ, ﺔﻘﻳﺎﻀﻣ, ﺞﻋﺰﻣ, ﻲﺒﺼﻋ, ﻖﻠﻗ, ﺐﺼﻌﻟﺍ
ﻢﺋﺍﺩ: ﺔﻴﻨﻣﺰﻟﺍ-ﺓﺪﻤﻟﺍ, ﺍﺮﻴﺜﻛ, ﻡﺎﻈﺘﻧﺎﺑ, ﺮﻤﺘﺴﻣ, ﺖﺑﺎﺛ, ﺖﺑﺎﺛ, ﺖﺑﺎﺛ
ﻦﻴﻜﺳ: ﺔﺤﻴﺻ, ﺓﺮﻔﺷ
ﺮﻳﺮﺣ: 
ءﺍﺭﺩﺯﺍ: ﺮﻘﺘﺣﺍ, ﺔﻴﻫﺍﺮﻛ, ﻰﻨﺒﺠﻌﻳ-ﻢﻟ, ﻑﺮﻗ, ﺯﺍﺰﺌﻤﺷﺍ, ﺲﻄﻓﺃ, ﺔﻧﺎﻫﺇ, ﺐﻀﻏ, ﻝﺎﻤﻫﺇ
ﻢﻴﺤﺠﻟﺍ: 
ﻞﺼﻔﻨﻣ: ﻞﺼﻓ, ﺎﺒﻧﺎﺟ, ﺍﺪﻴﻌﺑ, ﺰﻴﻤﺘﻣ, ﻒﻠﺘﺧﺍ, ﺓﺪﺣ-ﻰﻠﻋ, ﻝﺰﻌﻤﺑ, ﻞﺼﻔﻨﻣ, ﻝﺰﻋ, ﺫﻮﺒﻨﻣ, ﺩﺪﺤﻣ, ﻞﺼﻔﻟﺍ
ﺩﺎﺟ-ﻞﻜﺸﺑ: ﻱﺪﺟ, ﺹﻼ﻿ﺧﺈﺑ, ﻞﻴﻘﺛ, ﺮﻴﺒﻛ-ﻞﻜﺸﺑ, ﺓﺪﺤﺑ, ﻁﺎﺸﻨﺑ
ﻂﻠﺘﺨﻣ: ﻂﻴﻠﺧ, ﺔﻋﻮﻤﺠﻣ, ﺐﻛﺮﻣ, ﺝﺰﻣ, ﻙﺮﺘﺸﻣ
ﻲﺒﺸﺧ: ﺐﺸﺧ, ﺐﺸﺧ
ﻞﻀﻔﺗ: ﻞﻴﻀﻔﺗ
ﺮﻳﺬﺤﺗ: ﺭﺬﺤﻟﺍ, ﺮﻳﺬﺤﺗ, ﺭﺍﺬﻧﺇ, ﻱﺭﺎﻛﺬﺘﻟﺍ-ﺐﺼﻨﻟﺍ, ﺭﺎﻌﺷﺇ
ﺏﺎﺘﻋ-ﺝﺍﺰﻣ: 
ﺔﻌﻓﺩ: ﻡﺎﻬﻟﺇ, ﺾﺒﻧ, ﺔﻌﻓﺩ, ﺚﺣ, ﻊﻓﺪﻟﺍ-ﺓﻮﻗ, ﻊﻓﺩ
ﺡﻮﻤﻃ: ﻞﻣﻻ﻿ﺍ-ﺐﺋﺎﺧ, ﻞﻣﻻ﻿ﺍ-ﺔﺒﻴﺧ, ﺓﻮﻬﺷ, ﻉﺎﻤﻃ, ﻂﻴﺒﺜﺗ, ﺡﻮﻤﻃ
ﺾﻓﺭ: ﺾﻓﺭ, ﺾﻓﺭ, ﺭﺎﻜﻧﺇ, ﺾﻓﺮﻟﺍ, ﻲﻔﻧ, ﺾﻓﺭ, ﻲﻔﻨﻳ, ﺾﻓﺭ, ﺾﻓﺭ, ﺮﻈﻨﻟﺍ-ﻑﺮﺻ, ﻊﻨﻣ, ﺮﻈﺣ, ﺮﻈﺣ, ﺽﺭﺎﻌﺗ
ﺭﻮﺘﺳﺩ: ﻕﺎﺜﻴﻣ, ﻱﺭﻮﺘﺳﺩ
ﻚﺻ: ﺓﺍﺩﺃ, ءﺎﻋﻭ, ﻥﺎﻴﻛ, ﻮﻀﻋ, ﺔﻳﻭﺎﺣ, ﺯﺎﻐﻟﺍﻭ-ءﺎﺑﺮﻬﻜﻟﺍ-ﻞﺜﻣ ﺕﺎﻣﺪﺧ
ﺮﻤﺘﺴﻣ-ﺐﻧﺎﺟ: 
ﺭﺰﺟ-ﻭ-ﺪﻣ: ﺔﺟﻮﻣ, ﺔﻌﻗﺮﻓ
ﺔﻴﻠﻛ: ﺔﻴﻠﻛ, ﺔﻴﻤﻳﺩﺎﻛﻷ﻿ﺍ, ﺔﻌﻣﺎﺠﻟﺍ-ﻡﺮﺣ, ﺔﻌﻣﺎﺟ
ﻞﻳﺫ: ﺭﻮﺑﺎﻃ
ﻞﻴﺟ: ﻞﻴﻠﺴﻟﺍ
ﻂﻗ: 
ﺓﺮﺷﺎﺒﻣ-ﺮﻫﺎﻇ: 
ﺔﻟﻮﻫﺄﻣ-ﺮﻴﻏ: ﻝﺎﻤﻫﺇ, ﺭﺩﺎﻏ, ﺭﻮﺠﻬﻣ, ﻝﺎﻘﺘﺳﺍ, ﻦﻋ-ﻲﻠﺨﺘﻟﺍ
ﺓﺮﺸﻋ-ﻯﺪﺣﺍ: 
ﺱﺪﺣ: ﻱﻮﻔﻋ
ﺓﺰﻴﻤﻣ-ﺔﻔﺻ: ﺔﻤﺳ, ﺺﺼﺨﺗ, ﺔﻴﺼﺨﺸﻟﺍ, ﺓﺩﺎﻋ, ﻞﻴﻣ, ﻙﻮﻠﺳ, ﻙﻮﻠﺳ, ﺔﻴﺻﺎﺧ, ﻒﺻﻭ, ﻲﻋﻮﻧ, ﻲﺟﺫﻮﻤﻧ
ﺔﻠﻴﺒﻗ: ﻉﺬﺟ, ﻉﺬﺟ, ﻞﻤﺣ
ﻖﻠﻗ-ﺝﺍﺰﻣ: 
ﻯﻭﺄﻣ: ﻊﺠﺘﻨﻣ, ﻦﻜﺳ, ﺔﻨﻃﻮﺘﺴﻣ, ﻦﻃﻮﻣ, ﻲﻨﻜﺳ, ﺔﻳﺎﻤﺣ, ﻡﻮﻨﻟﺍ, ﻲﺳﺎﻴﺴﻟﺍ-ءﻮﺠﻠﻟﺍ-ﻖﺣ
ﺏﺬﻬﻣ-ﺮﻴﻏ: ﺔﺣﺎﻗﻮﺑ, ﺞﺋﺎﻫ, ﻒﻴﻄﻟ-ﺮﻴﻏ
ﺐﻛﺮﻳ: ﺏﻮﻛﺭ, ﺐﻛﺍﺭ
ﺓﺰﻫ: ﻲﻨﻫﺬﻟﺍ-ﻒﺼﻌﻟﺍ
ﺔﻋﺎﻨﺻ: ﻉﺎﻄﻗ, ﺔﻋﺎﻨﺻ, ﺔﻴﻋﺎﻨﺼﻟﺍ, ﻊﻴﻨﺼﺘﻟﺍ
ﺔﻨﻬﻣ: ﻲﻨﻬﻣ, ﺔﻨﻬﻣ-،ﻲﻨﻬﻤﻟﺍ-ﺭﺍﻮﺸﻤﻟﺍ, ﻝﻼ﻿ﺘﺣﺍ, ﻑﺮﺘﺤﻣ
ﺝﺍﺮﺳ: ﺡﺎﺒﺼﻣ
ﺓﻮﻬﻗ: ﻰﻬﻘﻣ
ﻉﺎﻃﺃ: ﻢﻴﻠﺴﺗ, ﻝﺎﺜﺘﻣﻻ﻿ﺍ, ﻊﻤﺘﺳﺍ
ﻲﻟﺎﻤﺷ: ﻝﺎﻤﺷ
ﺽﺮﻤﻣ: 
ﻥﺎﻤﺿ: ﺪﻴﻛﻮﺗ, ﺓﺮﻛﺬﻣ, ﺪﻬﻌﺗ, ﻥﺎﻤﺿ, ﻦﻴﻣﺄﺗ, ﻥﺎﻤﺿ, ﺪﻛﺄﺗ, ﺪﻴﻛﺄﺗ, ﺩﻭﺰﺗ, ﺔﻴﺒﻠﺗ, ﺪﻴﻛﺄﺘﻟﺎﺑ, ﻉﺎﻨﻗﺇ, ﺪﻛﺃ, ﻦﻴﻣﺄﺗ
ﺔﻠﺴﻠﺳ: ﻞﺴﻠﺴﺗ, ﺔﻠﺴﻠﺳ, ﻂﻴﺧ, ﻦﺠﺳ
ﺲﻳﺭﺪﺗ: ﺕﺎﻤﻴﻠﻌﺗ, ﻒﻴﻘﺜﺗ, ﺐﻳﺭﺪﺗ
ﺔﻳﺬﺣﺃ: ءﺍﺬﺣ, ﻝﺪﻨﺻ
ﻝﺰﻨﻣ-ﺔﻘﻳﺪﺣ: ﺰﻣﺭ, ﺔﺤﻔﺻ, ﺩﺩﻮﺗ
ﺾﻣﺎﻏ: ﺽﻮﻤﻏ, ﺾﻣﺎﻏ, ﺾﻣﺎﻏ, ﺢﺿﺍﻭ-ﺮﻴﻏ, ﺾﻣﺎﻏ, ﺪﻛﺆﻣ-ﺮﻴﻏ, ﺩﺪﺤﻣ-ﺮﻴﻏ, ﺔﺟﻮﻣ, ﺮﻏﺎﺷ
ﺮﺧﺍ-ﻥﺎﻜﻣ: ﺮﺧﺁ
ﺔﻘﺷ: ﺔﻘﺸﻟﺍ, ﺓﺮﺋﺍﺩ, ﺓﺭﻮﺼﻘﻣ, ﺡﺎﻨﺟ
ﻁﺎﺸﻧ: ﺔﻘﻔﺻ, ﺔﻔﻴﻇﻮﻟﺍ
ﺖﺒﺴﻟﺍ-ﻡﻮﻳ: ﺖﺒﺴﻟﺍ-ﻡﻮﻳ
ﻕﺍﺮﺷﺇ: ﻲﺴﻤﺷ
ﺔﻠﻣﺭﺃ: 
ﺮﺼﻨﻌﻟﺍ: ﺐﻧﺎﺟ, ﺔﻴﺻﺎﺧ, ﺮﺼﻨﻌﻟﺍ, ﺮﺼﻨﻋ, ﻮﻀﻋ
ﺱﺎﻜﻌﻧﺍ: ﻞﻣﺄﺗ
ﻢﻴﻈﻨﺘﻟﺍ: ﺔﺠﺴﻧﻷ﻿ﺍ, ﻢﻴﻈﻨﺘﻟﺍ, ﻢﻈﻨﺗ, ﺲﺑﻼ﻿ﻣ, ﺔﻛﺮﺷ, ﺯﺎﻐﻟﺍﻭ-ءﺎﺑﺮﻬﻜﻟﺍ-ﻞﺜﻣ ﺕﺎﻣﺪﺧ, ﺔﻟﺎﻛﻭ, ﻥﺎﻴﻛ, ﻡﺎﻈﻧ, ءﺎﻨﺑ, ﺲﻤﻠﻤﻟﺍ, ﻢﻴﻤﺼﺗ, ﺔﺴﺳﺆﻣ, ﺪﻬﻌﻣ
ﺔﻤﺠﻧ: 
ﺙﺩﺎﺣ: ﺙﺪﺣ, ﺭﻮﻬﻇ, ﺓﺮﻫﺎﻇ, ﺙﻭﺪﺣ, ﺙﺩﺎﺣ, ﺔﻴﻀﻗ---ﺔﻟﺎﺣ
ﻒﻴﺿ: ﺐﻳﺮﻏ, ﺮﺋﺍﺯ, ﻲﺋﺎﻀﻓ-ﻦﺋﺎﻛ, ﻲﺒﻨﺟﺃ, ﺪﻓﺍﻮﻟﺍ, ﻥﻮﺑﺯ, ﻥﻮﺑﺯ, ﻒﻴﻀﻣ
ﺭﺎﺑ: ﺭﺎﻋ, ﺔﻧﺎﺣ, ﻞﻤﺣ, ﻦﺤﺷ, ﻰﻬﻘﻣ, ﻡﻮﻳﺭﺎﺒﻟﺍ
ﺔﺟﺎﺟﺯ: ءﺎﻧﺇ
ﻙﺭﺎﺑ: ﺔﻛﺮﺑ
ﺔﺠﺿ: ﺔﺠﻟﺎﻌﻣ, ﺝﺰﻣ, ﺭﺎﻀﺤﺘﺳﺍ, ﺐﻐﺷ-ﻝﺎﻤﻋﺍ-ﺐﻐﺷ
ﻲﻠﺧﺍﺩ: ﻦﻤﺿ, ﻞﺧﺍﺩ-ﻲﻓ, ﻲﻠﺧﺍﺩ, ﻲﻠﺧﺍﺩ, ﻲﻠﺤﻣ, ﻲﻠﺤﻣ, ﻲﻠﺧﺍﺩ, ﻲﻠﻘﻋ, ﻊﻠﻄﻣ
ﻞﺣ: ﺖﺑﺎﺛ, ﻂﺒﺿ, ﻊﺟﺍﺭ, ﻞﺣ, ﻞﺣ, ﻞﺣ, ﺝﻼ﻿ﻋ, ﻦﺴﺤﺗ, ﻝﺪﺘﻋﺍ, ﺎﻨﺴﺣ, ﺎﻨﺴﺣ, ﺖﺑﺎﺛ, ﺖﺑﺎﺛ, ﻖﻳﺪﺤﺘﻟﺍ, ﺢﻴﺤﺻ, ﺩﺪﺣ, ءﺎﺸﻧﺇ, ﺪﻳﺪﺤﺗ, ﺪﻛﺄﺗ
ﺹﻼ﻿ﺨﺘﺳﺍ: ﻞﺼﺤﺗ, ﺐﺴﻛ, ﻖﺘﺸﻤﻟﺍ, ﻝﻮﺼﺤﻟﺍ, ﻢﻠﺴﺗ
ﻑﻮﺟﺃ: ﻱﺩﺎﻋ, ﺭﺎﻋ, ﻍﺍﺮﻓ, ﻞﺑﺎﻛ
ﺔﻳﻻ﻿ﻭ: ﻲﻔﻳﺭ
ﺓﺭﺎﻀﺣ: 
ﻖﻠﻋ: 
ﺔﻣﺪﺻ: ﺔﺑﺮﺿ, ﺔﺴﻜﻧ, ﺔﻣﺪﺻ, ﺎﻣﺩﺎﺻ, ﻙﺎﺒﺘﺷﺍ
ءﺎﻨﺜﺘﺳﺍ: ﻲﺋﺰﺟ, ﺰﻴﻴﻤﺗ, ﺔﻴﻄﻤﻨﻟﺍ-ﺓﺭﻮﺼﻟﺍ, ءﺎﻔﻋﺇ
ﺔﻟﻼ﻿ﺳ: ﺩﺎﻬﺟﺇ, ﺮﺗﻮﺗ, ﻞﻤﺣ, ﺐﻌﺗ, ﺩﻮﻬﺠﻣ, ﺔﻓﺎﺜﻛ
ﺭﺎﻴﻌﻣ: ﺭﺎﻴﻌﻣ, ﺮﻴﻳﺎﻌﻤﻟﺍ, ﻝﺪﻌﻣ, ﻯﻮﺘﺴﻣ, ﻲﺿﺍﺮﺘﻓﻻ﻿ﺍ, ﺭﺎﻴﻌﻣ, ﺖﺑﺎﺛ, ﺖﺑﺎﺛ, ﺖﺑﺎﺛ, ﺮﻘﺘﺴﻣ, ﻦﻛﺎﺳ, ﺔﻣﺍﺪﺘﺳﺍ, ﺪﻴﺣﻮﺗ, ﻂﻤﻧ
ﺓﺩﺎﻴﻘﻟﺍ: ﺔﻠﻤﺣ, ﻖﺋﺎﺳ, ﻞﻴﻟﺩ, ﺓﺭﺍﺩﺇ, ﺏﻮﻛﺭ
ﻦﻣ-ﺺﻠﺨﺗ: ﻉﺰﻧ, ﺐﺤﺳ, ءﺎﻀﻘﻟﺍ, ﺔﻟﺍﺯﺇ, ﻰﻔﻌﻣ, ﻒﻴﻔﺨﺗ, ﺉﺮﺑﺃ
ﻢﺴﻗﺃ: ﺔﻳﺭﻮﺘﺳﺪﻟﺍ-ﻦﻴﻤﻴﻟﺍ-ءﺍﺩﺃ
ﺰﻨﻛ: ﺓﺮﻫﻮﺟ
ﺓﺭﺬﺑ: ﺔﻔﻄﻧ, ﻕﺪﻨﺒﻟﺍ, ﻢﻴﺴﺟ
ﺝﺮﺑ: ﻉﺩﺎﺨﻣ
ﻞﻀﻔﻤﻟﺍ: ﻞﻀﻔﻤﻟﺍ
ﺎﺜﻳﺪﺣ: ﺚﻳﺪﺣ, ﺝﺯﺎﻄﻟﺍ, ﺎﺜﻳﺪﺣ
ﺓﺮﻴﺧﻷ﻿ﺍ-ﻲﺿﺎﻤﻟﺍ-ﺮﺗﻮﺗ: 
ﻆﻘﻴﺘﺴﻣ: ﻲﻋﺍﻭ, ﺔﻳﻮﻨﻌﻣ-ﺡﻭﺭ, ﻆﻘﻴﺘﺳﺍ, ﺭﺍﺬﻧﺇ
ﺙﺎﺛﺃ: 
ﻞﺒﺣ: ﻞﺒﺣ, ﻂﻴﺧ, ﻡﺍﺰﺣ
ﺓﺮﻣﺎﻐﻣ: ﻉﻭﺮﺸﻣ, ﺓﺮﻣﺎﻐﻣ
ﺔﻴﻜﻠﻣ: ﻚﻠﻣ
ﺪﻴﻋ: ﺏﺰﺣ, ﻝﺎﻔﺘﺣﺍ, ﺔﺑﺩﺄﻣ, ﺔﻠﻄﻋ
ﻒﺻﻭ: ﻒﺻﻮﻟﺍ, ﻒﺻﻭ, ﻒﺻﻭ, ﻒﺻﻭ, ﺩﺪﺣ
ﻥﻮﺘﺳ: 
ﺱﺎﻴﻘﻣ: ﻞﻜﻴﻫ, ﺱﺎﻴﻘﻣ, ﺔﺒﺴﻧ, ﻢﻠﺳ, ﻢﻠﺳ, ﻢﻠﺳ
ﻢﻳﺮﻜﺗ-ﻞﻔﺣ: ﺱﻮﻘﻃ, ﺔﻔﻴﻇﻮﻟﺍ
ﺪﻴﺼﻟﺍ: ﺓﺩﺭﺎﻄﻣ, ﺔﻴﺤﺿ, ﺔﺴﻳﺮﻓ, ﺓﺩﺭﺎﻄﻣ, ﺹﺎﺻﺮﻟﺍ-ﻕﻼ﻿ﻃﺍ
ﺲﻤﻫ: ﻢﺘﻤﺗ
ﺮﻴﺒﻛ-ﺪﺣ-ﻰﻟﺇ: ﺎﻳﺮﻫﻮﺟ, ﻅﻮﺤﻠﻣ-ﻞﻜﺸﺑ, ﻢﻈﻌﻣ, ﻲﺳﺎﺳﺍ-ﻞﻜﺸﺑ, ﺔﺻﺎﺧ, ﺍﺮﻴﺜﻛ, ﻊﺳﺍﻭ-ﻮﺤﻧ-ﻰﻠﻋ, ﺐﻟﺎﻐﻟﺍ-ﻲﻓ
ﺔﻴﺤﻴﺴﻤﻟﺍ-ﺔﻧﺎﻳﺪﻟﺍ: 
ﻡﺎﺤﻣ: ﻡﺎﺤﻣ, ﻡﺎﺤﻣ
ﻞﻴﺻﺎﻔﺘﻟﺍ: ﺭﺎﺸﺘﻧﺍ, ﺪﻳﺪﻤﺗ, ﺪﻳﺪﻤﺗ, ﻊﻴﺳﻮﺗ, ﻊﺳﻭ, ﺓﺪﺸﺑ, ﻞﺼﻔﻣ
ﺓﺮﻴﻣﺃ: 
ﺢﺑﺬﻣ: ﺫﻼ﻿ﻣ
ﺔﻜﺒﺷ: ﺔﻜﺒﺷ, ﺔﻜﺒﺷ, ﺔﻜﺒﺷ, ﺔﺠﺴﻧﻷ﻿ﺍ, ﺵﺎﻤﻗ, ﻖﺼﻠﻤﻟﺍ
ﻲﺠﺴﻔﻨﺑ: ﻲﻧﺍﻮﺟﺭﺃ
ﻊﻤﺟ: ﻊﻤﺟ, ﻊﻤﺟ, ﺵﺎﻤﻜﻧﺍ, ﻲﻔﺗﺎﻬﻟﺍ-ﻝﺎﺼﺗﻻ﻿ﺍ
ﺏﺎﺨﺘﻧﺍ: ﺭﺎﻴﺘﺧﻻ﻿ﺍ, ﺐﺨﺘﻨﻣ, ﺮﺛﺃ, ﺖﻳﻮﺼﺗ, ﺕﻮﺣ, ﺭﺎﻴﺘﺧﺍ, ﺖﻳﻮﺼﺗ
ﺭﻮﺼﺗ: ﻡﻮﻬﻔﻣ, ﻡﻮﻬﻔﻣ, ﺭﻮﺼﺗ, ﻙﺍﺭﺩﻹ﻿ﺍ, ﺭﻮﺼﺗ, ﻲﻤﻴﻫﺎﻔﻤﻟﺍ, ﻢﻴﻤﺼﺗ, ﻰﻠﻋ-ﺾﺒﻗ, ﻝﺎﻘﺘﻋﺍ, ﺮﺳﺃ
ﻥﺍﺮﻜﺳ: ﺮﻴﻜﺳ
ﺐﺼﻳ: ﺐﻠﻗ, ﻚﻔﺳ, ﺏﺮﺴﺗ, ﻁﺎﻘﺳﺇ
ﻊﻓﺭ: ﻲﺋﺎﺑﺮﻬﻜﻟﺍ-ﺪﻌﺼﻤﻟﺍ, ﻊﻓﺭ, ﻊﻓﺭ, ﻊﻓﺭ, ﻊﻓﺭ
ﺪﺴﺠﻟﺍ-ﺔﻐﻠﺑ-ﺮﻴﺒﻌﺗ: ﻪﺘﻓﻻ﻿, ﺓﺭﺎﺷﺇ, ﺰﻣﺭ, ﻱﺰﻣﺭ, ﻒﻗﻮﻣ, ﻊﺿﻭ
ﺓﺭﺍﺩﺇ: ﺓﺭﺍﺩﺇ, ﻑﺍﺮﺷﻹ﻿ﺍ, ﺾﺒﻘﻣ, ﺓﺭﺍﺩﺇ, ﻢﻜﺤﻳ, ﺓﺩﺎﻴﻗ, ﻢﻜﺤﺘﻟﺍ
ﻝﺩﺎﺒﺗ: ﺔﻟﺩﺎﺒﻣ, ﻝﺩﺎﺒﺘﻣ, ﻢﻟﺎﻌﻟﺍ-ﻥﺎﻜﺳ-ﺔﻟﺎﺣ, ﻞﻳﺪﺑ
ﺓﺪﻴﻛﺃ-ﺔﻟﺎﻘﻣ: 
ﺭﻮﻃﺍﺮﺒﻣﺇ: ﻞﻫﺎﻌﻟﺍ
ﺪﻌﺑ-ﻦﻋ: ﺪﻴﻌﺑ, ﺍﺪﻴﻌﺑ, ﻝﺰﻌﻤﺑ
ﺢﻴﺒﻗ: ﺮﻳﺮﺷ, ﻑﺮﻘﻣ-ﺊﺷ
ﺓﺭﺎﺿ-ﺮﻴﻏ: 
ﺔﻔﻟ: ﺮﻳﺮﻤﺘﻟﺍ, ﻒﻠﻣ
ﺔﺻﻮﺑ: ﻙﺭﺎﻤﺠﻟﺍ, ﻡﺎﻬﺑﻻ﻿ﺍ-ﻊﺒﺻﺍ
ﺓﺪﻳﺮﺟ: ﺔﻠﺠﻣ, ﻎﻠﺒﻳ, ﺕﺍﺮﻛﺬﻣ
ﺔﻴﺤﻟ: ﺢﻴﻤﻠﺗ, ﻦﻗﺫ
ﻕﺰﻤﺗ: ﻉﺰﺘﻧﺍ
ﺔﺌﻴﻫ-ﻭﺃ-ﺔﻟﻮﻤﻋ: ﺔﻨﺠﻟ, ﺲﻠﺠﻣ
ﺎﻤﻨﻴﺑ: ﺎﻤﻨﻴﺑ, ءﺎﻨﺛﺃ
ﺮﺒﻌﻣ: ﺐﻴﻠﺼﻟﺍ, ﻊﻃﺎﻘﺗ, ﺭﻭﺮﻣ, ﺮﺑﺎﻋ, ﻝﺎﻘﺘﻧﺍ, ﻰﺸﻤﻣ
ﻝﻼ﻿ﻘﺘﺳﺍ: ﻞﻘﺘﺴﻣ, ﺔﻳﺮﺣ, ﺔﻳﺮﺤﺑ, ﺔﻳﺮﺣ, ﻲﺗﺍﺬﻟﺍ-ﻢﻜﺤﻟﺍ
ﺔﺤﺋﺍﺭ: ﻦﺘﻧ, ﺮﻄﻋ
ﺓﺮﺸﻋ-ﺔﻴﻧﺎﻤﺛ: 
ﻲﺨﻳﺭﺎﺗ: ﺎﻴﺨﻳﺭﺎﺗ, ﺦﻳﺭﺎﺘﻟﺍ, ﺥﺭﺆﻣ
ﻲﻟﺎﻤﺟﺇ: ﻲﻠﻜﻟﺍ-ﻲﻟﺎﻤﺟﻹ﻿ﺍ, ﻉﻮﻤﺠﻣ, ﺭﺬﻗ, ﻡﺎﺨﻟﺍ, ﻡﺎﺧ-ﻂﻔﻧ
ﺭﺬﺟ: ﻉﺬﺟ, ﺝﺯﺎﻄﻟﺍ
ﻦﻴﻃ: ﺔﺑﺮﺗ, ﻪﺑﺎﻌﻟ-ﻝﺎﺳ, ﻦﻴﻃ, ﺥﺎﺳﻭﻻ﻿ﺍ, ﺓﺮﻫﺯ
ﺱﻭﺮﻋ: ﺓﺪﺟ
ﺏﺎﺠﺣ: ﺓﺭﺎﺘﺳ, ﺮﺤﺒﻳ, ﺭﺎﺤﺑﺇ
ﺡﺮﺴﻣ: ﺡﺮﺴﻣ
ﺔﻧﺭﺎﻘﻣ: ﻥﺭﺎﻗ, ﻥﺭﺎﻘﻣ, ﻁﺎﺒﺗﺭﺍ, ﺔﺒﺴﻧ, ﺔﻬﺟﺍﻮﻣ
ﺲﻓﺎﻨﻣ: ﻢﺼﺨﻟﺍ, ﻖﺸﻨﻣ, ﺔﻘﺑﺎﺴﻣ, ﻲﺴﻓﺎﻨﺗ, ﺲﻓﺎﻨﺗ
ﺪﻴﺻﺮﻟﺍ: ﻥﺯﺍﻮﺗ, ﻱﻭﺎﺴﺘﻟﺎﺑ, ﺓﺍﻭﺎﺴﻣ, ﻲﻘﻓﺃ, ﺐﺳﺎﻨﺘﻣ, ﺓﺍﻭﺎﺴﻤﻟﺍ-ﻡﺪﻗ, ﺔﻴﻧﺍﺰﻴﻣ
ﺏﺭﺪﻣ: ﺏﺭﺪﻣ, ﺱﺭﺎﻤﻣ, ﺱﺭﺪﻣ, ﺢﺻﺎﻨﻟﺍ
ﺔﻫﺎﻜﻓ: ﺔﻫﺎﻜﻓ, ﺔﺑﺎﻋﺪﻟﺍ-ﺡﻭﺭ, ﺝﺍﺰﻣ, ﺎﻳﺪﻴﻣﻮﻛ
ﺔﻳﺍﻭﺭ: ﻝﺎﻴﺧ, ﺪﻳﺪﺟ, ﺎﺜﻳﺪﺣ
ﻡﺎﻘﺘﻧﺍ: ﺔﻨﻴﻐﺿ
ﺭﻮﻴﻏ: ﺓﺮﻴﻐﻟﺍ, ﺪﺴﺣ
ﺔﻠﺠﻋ: ﺔﻴﺋﺍﻮﻫ-ﺔﺟﺍﺭﺩ, ﺓﺮﺋﺍﺩ
ﻕﺮﺣﺃ: ﻕﺮﺣ, ﻞﻌﺘﺷﺍ
ﺵﻼ﻿ﻓ: ﺔﻘﻋﺎﺻ, ﺞﻫﻮﺗ, ﻖﻟﺄﺗ
ﻖﻠﺧ: ﻖﻠﺧ, ءﺎﻨﺑ, ءﺎﻨﺑ, ﻲﻟﻻ﻿ﺪﺘﺳﺍ, ﻞﻌﺟ, ﻊﻨﺻ, ﻞﻜﺸﺗ, ﻞﻴﻜﺸﺗ, ﺪﻴﻟﻮﺗ
ﻉﺍﺮﺻ: ﻙﺎﺒﺘﺷﺍ, ﻉﺍﺮﺻ, ﺔﻬﺟﺍﻮﻣ, ﻦﻳﺎﺒﺗ, ﻢﻄﺤﺗ, ﻡﺩﺎﺼﺗ-ﻭﺃ-ﺮﻴﺛﺄﺗ
ﺔﻨﻌﻟ: 
ﻦﻋﺍ-ﺝﺍﺰﻣ: 
ﺰﺟﺎﻋ: ﺲﺋﺎﺑ
ﻲﺑﺎﺠﻳﺇ: ﻲﺑﺎﺠﻳﺍ-ﻞﻜﺸﺑ
ﻱﺩﺎﻨﻟﺍ: ﺵﺎﻔﺧ, ﻞﺠﺳ
ﻥﺎﻀﻴﻓ: 
ﺏﻮﺒﺣ: ﺏﻮﺒﺣ, ﺢﻤﻗ
ﺓﻻ﻿ﺎﺒﻣ-ﻻ﻿: ﺓﻻ﻿ﺎﺒﻣ-ﻻ﻿, ﻲﻟﺎﺒﻣ-ﺮﻴﻏ, ﻝﺎﻤﻫﺇ
ﻲﻠﻘﻌﻟﺍ-ءﺮﻤﻟﺍ-ﻖﻓﺃ: 
ﻪﺑ-ﻢﻠﺴﻣ-ﺝﺍﺰﻣ: ﺽﺍﺮﺘﻓﻹ﻿ﺍ-ﻰﻠﻋ-ﻢﺋﺎﻗ ﺝﺍﺰﻣ
ﺭﺪﺤﻟﺍ: ﻉﺎﻔﺗﺭﺍ, ﺭﺪﺤﻨﻣ
ﻡﺎﺠﺴﻧﻻ﻿ﺍ: ﻂﺳﻭ-ﻞﺣ, ﻢﻐﻧ
ﺪﻋﺮﻟﺍ-ﺕﻮﺻ: 
ﺔﻟﻮﻔﻄﻟﺍ-ﺔﻠﺣﺮﻣ: 
ﺔﺒﻛﺭ: ﻦﻀﺣ
ﺕﺎﻴﺠﻣﺮﺒﻟﺍ: ﻖﻴﺒﻄﺗ, ﺓﺮﻴﺧﺫ
ﺡﺮﺟ: ﺡﺮﺟ, ﺭﺮﺿ, ﺭﺮﺿ, ﺡﺮﺟ, ﺡﺮﺟ, ﺔﻣﺪﺻ, ﺔﺑﺎﺻﺇ, ﻙﺎﻬﺘﻧﺍ
ﻝﺎﺼﻳﺇ: ﻢﻠﺴﺗ, ﻞﺧﺪﻣ, ﻝﺎﺒﻘﺘﺳﺍ, ﻝﻮﺒﻗ, ﻝﻮﺒﻗ, ﺔﻤﻴﺴﻗ, ﻲﻨﺒﺗ
ﻦﻴﻜﻤﺗ: ﻰﻠﻋ-ﺭﺩﺎﻗ, ﺺﺘﺨﻣ, ﻞﻌﻓ, ﺡﺎﻤﺴﻟﺍ, ﻝﻮﺨﺗ, ﻞﻤﺣ, ﺽﺮﻓ, ﺢﻤﺳ, ﻥﺫﺄﻳ
protasis: 
ﻕﻻ﻿ﺰﻧﺍ: ﻖﻟﺯ, ﻕﻻ﻿ﺰﻧﻻ﻿ﺍ, ﺔﻘﻠﺣﺯ
ﺓﺭﻮﺛ: ﻱﺭﻮﺛ, ﺏﻼ﻿ﻘﻧﺍ, ﻥﺍﺭﻭﺩ, ﺓﺭﻮﺛ, ﺩﺮﻤﺗ
ﻉﺭﺍﺰﻣ: ﺡﻼ﻿ﻓ
ﺔﻴﻏﺎﻣﺪﻟﺍ-ﺔﺘﻜﺴﻟﺍ: ﺔﺑﺮﺿ, ﺏﻼ﻿ﻘﻧﺍ, ﻉﺎﻓﺪﻧﺍ, ﻢﺣﺍﺰﺗ
ﺔﺼﻨﻣ: ﺡﺮﺴﻤﻟﺍ, ﻯﺪﺘﻨﻣ, ﺱﺎﺳﺃ
ﻝﻮﺳﺭ: ﺏﻭﺪﻨﻣ, ﺮﻴﻔﺳ, ﻲﺳﺎﻣﻮﻠﺑﺩ
ﺯﺎﻴﺘﻣﺍ: ﺎﻈﺣ, ﻞﻴﻀﻔﺗ, ﺎﺗﻮﻛ, ﺯﺎﻴﺘﻣﺍ, ﺽﺮﻋ, ﻝﺯﺎﻨﺗ
ﻢﻈﻨﻣ: ﺔﺴﺳﺆﻣ, ﻢﻈﻨﺗ, ﺪﻬﻌﻣ, ﺐﻴﺗﺮﺗ, ﺐﺗﺭ
ﻢﻠﻋ-ﺐﻟﺎﻃ: ﻦﻴﻌﻟﺍ-ﺆﺑﺆﺑ, ﻢﻟﺎﻋ, ﺔﻴﻌﻣﺎﺠﻟﺍ
ﻒﻬﻛ: 
ﺪﻴﻠﻘﺘﻟﺍ: ﻱﺪﻴﻠﻘﺗ, ﺎﻳﺪﻴﻠﻘﺗ, ﻙﺭﺎﻤﺠﻟﺍ, ﻡﻼ﻿ﺴﺘﺳﺍ
ﺓﺎﺳﺄﻣ: ءﺎﺑﻭ, ﻥﺰﺣ
ﻊﻳﺩﻮﺗ: ﺔﻣﻼ﻿ﺴﻟﺍ-ﻊﻣ, ﺎﻋﺍﺩﻭ
ﺪﻘﻧ: ﺪﻘﺘﻨﻳ, ﺪﻘﻧ, ﺽﺍﺮﻌﺘﺳﺍ
ﻦﻄﻗ: ﻑﻮﺻ
ﻰﻔﺸﺘﺴﻣ: ﻲﺳﺎﻴﺴﻟﺍ-ءﻮﺠﻠﻟﺍ-ﻖﺣ
ﺭﺎﺠﻳﺇ: ﺓﺮﺟﺃ, ﺮﻴﺟﺄﺗ, ﺔﺒﻳﺮﺿ, ﺔﻴﺤﺗ, ﺭﺎﺠﻳﻹ﻿ﺍ-ﺪﻘﻋ, ﻒﻴﻇﻮﺗ, ﺏﺬﺟ, ﺮﺟﺆﻣ, ﻕﺎﺜﻴﻣ
ﺯﺎﻏ: 
ﻪﻨﻣ-ﺮﻔﻣ-ﻻ﻿: ﺔﻟﺎﺤﻣ-ﻻ﻿
ﺖﻴﻤﻣ: 
ﺮﺠﺸﻟﺍ-ﺔﻗﺭﻭ: ﺔﻗﺭﻭ, ﺓﺮﻔﺷ
ﺭﻮﺸﻨﻣ: ﺮﺸﻧ, ﺮﺸﻧ, ﻊﺒﻃ, ﻦﻠﻋﺃ, ﺚﺒﻟﺍ, ﻕﻼ﻿ﻃﺇ, ﺞﺗﺎﻨﻟﺍ, ﺮﺸﻧ, ﺭﺍﺪﺻﺇ, ﻦﻠﻋﺃ
ﻲﺋﺍﺪﻋ: ﻱﺩﻭ-ﺮﻴﻏ, ءﺍﺪﻋ
ﺔﻤﺟﺮﺗ: ﻢﺟﺮﺗ, ﻢﺟﺮﺗ, ﺮﻴﺴﻔﺘﻟﺍ, ءﺎﺑﻭ, ﻞﻳﻮﺤﺗ
ﺓﺯﺎﻨﺟ: ﻦﻓﺩ, ﺓﺮﺒﻘﻣ
ﻖﻴﻗﺩ: ﻕﻮﺤﺴﻣ, ﺔﻨﻴﺠﻋ, ﻖﻴﻗﺩ, ﻖﻴﻗﺩ, ﻖﻴﻗﺩ, ﺔﺒﺟﻭ
ﺔﻠﺳﺍﺮﻣ: ﻖﺑﺎﻄﺗ, ﻝﺎﺼﺗﺍ, ﺕﻻ﻿ﺎﺼﺗﻻ﻿ﺍ, ﺢﻳﺮﺻ
ﻲﺴﻧﺎﻣﻭﺭ: 
ﺥﻮﻛ: ﺥﻮﻛ, ﺥﻮﻛ
ﺡﺮﺘﻗﺍ: ﻞﻜﺸﺗ, ﺽﺮﻋ, ﺔﻛﺮﺣ, ﺡﺍﺮﺘﻗﺍ, ﺡﺮﺘﻘﻣ, ﺡﺮﺘﻗﺍ, ﻲﺻﻮﻧ, ﺡﺍﺮﺘﻗﺍ, ﺔﻟﻭﺎﺤﻣ, ﺢﺷﺮﺗ
ﺪﻴﻠﻘﺘﻟﺎﺑ-ﻢﺴﺘﻣ: 
ﺭﻻ﻿ﻭﺩ: 
ﺭﺎﻬﻨﻟﺍ-ءﻮﺿ: 
ﺮﺸﻋ-ﺱﺩﺎﺴﻟﺍ: 
ﺔﻴﻌﻤﺟ: ﻉﺎﻤﺘﺟﺍ-ﺪﻘﻋ, ﺮﻤﺗﺆﻣ, ﺮﻤﺗﺆﻣ, ﺐﻴﺗﺮﺗ
ﺓﺮﻤﻌﺘﺴﻣ: 
ﺡﺎﻨﺟ: ﺡﺎﻨﺟ, ﺡﺎﻨﺟ
ﺪﺳﺃ: 
ﺔﻓﺎﻘﺛ: ﻲﻓﺎﻘﺛ
ﺩﻮﻤﻋ: ﺔﻋﻮﻤﺠﻣ, ﺔﻘﺒﻃ, ﺩﻮﻤﻋ, ﺭﻭﺮﻣ
ﺮﻜﻣ: ﺐﻌﺻ, ﺔﻋﺪﺨﻟﺍ, ﺮﻫﺎﻣ
ﺎﻣﺍﺭﺩ: ﺮﻫﺎﻈﺗ, ﻲﻜﻴﺗﺎﻣﺍﺭﺩ
ﺔﺘﻜﻧ: ﺡﺍﺰﻣ, ﺔﻋﺭﺎﺑ-ﺔﻈﺣﻼ﻿ﻣ
ﺏﺎﺒﺿ: ﺏﺎﺒﺿ
ءﺍﻭﺪﻟﺍ: ﺭﺎﻘﻋ, ﺝﻼ﻿ﻋ, ﺫﺍﺫﺭ, ﺔﻴﺒﻃ-ﺔﻔﺻﻭ
ﺓﺮﺸﻋ-ﺔﻌﺑﺭﺃ: 
ﺾﻣﺎﺣ: ﺾﻣﺎﺣ, ﺔﻴﻀﻤﺤﻟﺍ
ﻱﺃ: ﻱﺃ, ﻱﺃ, ﻦﻴﻌﻣ-،ﺺﺼﺨﻣ
ﻞﺧﺩ: ءﺍﺬﺤﻟﺍ-ﻂﺑﺭ
ﻒﻘﺳﺃ: 
ﻲﻟﺎﻘﺗﺮﺒﻟﺍ: 
ﻡﺎﻤﺣ: ﻡﺎﻤﺣ, ﺵﺩ, ﻡﺎﻤﺤﺘﺳﺍ-ﺽﻮﺣ
ﻲﺋﺍﺪﺑ: ﺮﻜﺒﻣ-ﺖﻗﻭ-ﻲﻓ, ﻝﻭﺃ
ﺔﻠﺳ: ﻦﺑ, ﺔﺒﻴﻘﺣ
ﻦﻴﻣﺃ: 
ﺶﻗ: ﻦﺒﺗ
ﺭﻮﺒﺻ-ﺮﻴﻏ: ﺺﻳﺮﺣ
ﺹﻼ﻿ﺧ: ﺔﻣﻼ﻿ﺳ, ﺮﻳﺮﺤﺗ, ﺎﺒﺣﺮﻣ
hodiernal-ﺮﺗﻮﺗ: 
ﻡﺰﺘﻋﺍ: ﺩﻮﺼﻘﻣ, ﺔﻴﻧ, ﻢﺘﻬﻣ, ﺲﻤﺤﺘﻣ, ﻊﻓﺍﺩ, ﺔﺒﻏﺍﺭ-ﺮﻴﻏ, ﺱﺮﻛ, ﺱﺮﻛ
ﺭﺎﺨﺑ: ﺭﺎﺨﺑ
ﻢﺳ: ﻡﺎﺳ, ﻡﺎﺳ, ﺏﺎﺸﻋﻷ﻿ﺍ-ﺕﺍﺪﻴﺒﻣ
ﺔﺒﻫﻮﻣ: ﻖﻟﺄﺗ, ﺏﻮﻫﻮﻣ, ﻰﻤﻠﻌﻟﺍ-ﻞﻫﺆﻤﻟﺍ, ﺓﺭﺪﻘﻟﺍ, ﺓﺮﻴﺧﺫ
ﺥﺎﻨﻣ: ﺲﻘﻃ
ﻝﺎﻌﻓ: ﻝﻮﻌﻔﻤﻟﺍ-ﺔﻳﺭﺎﺳ, ﻝﺎﻌﻓ-ﻮﺤﻧ-ﻰﻠﻋ, ﻝﺎﻌﻓ, ﺔﻴﻟﺎﻌﻓ, ﺮﺛﺆﻣ, ﺪﻴﻔﻣ, ﺓﺎﻴﺤﻠﻟ-ﻞﺑﺎﻗ
ﺰﻴﻤﺗ: ﺰﻴﻤﺗ, ﺰﻴﻤﺗ, ﺰﻴﻴﻤﺗ, ﻞﺿﺎﻔﺘﻟﺍ, ﺺﻴﺼﺨﺗ, ﻡﺎﺴﻘﻧﺍ-ﻝ, ﺮﻈﻨﻟﺍ-ﻑﺮﺻ, ﺪﻌﺒﺘﺳﺍ, ﺯﺮﻔﺗ
ﻞﺴﻏ: ﻞﺴﻏ
ﻑﺍﺮﺘﻋﺍ: ﻑﺮﺘﻋﺍ, ﺓﺪﻴﻘﻌﻟﺍ, ﻑﺍﺮﺘﻋﺍ
ﻍﺭﺎﻓ-ﻡﻼ﻿ﻛ: ﺔﻣﺎﻤﻗ, ﻰﻘﻄﻨﻣ-ﺮﻴﻏ, ﻖﺋﻻ﻿-ﺮﻴﻏ
ﻢﺤﻓ: ﻥﻮﺑﺮﻛ
ﻒﻴﻔﺧ-ﻞﻳﻮﻃ-ﻕﺭﻭﺯ ﻮﻨﻜﻟﺍ: 
ﺖﻗﺆﻣ: ﺓﺮﺘﻓ, ﺔﻴﻨﻣﺰﻟﺍ-ﺓﺪﻤﻟﺍ, ﻞﺋﺍﺯ, ﻲﺿﺮﻋ, ﺎﻤﻨﻴﺑ
delimitative-ﺐﻧﺎﺟ: 
ﻢﻈﻋ: ﻕﺎﺳ
ﻦﻴﻨﺛﻹ﻿ﺍ: 
ءﺎﺛﻼ﻿ﺜﻟﺍ: ﺚﻠﺛ
ءﺎﻌﺑﺭﻷ﻿ﺍ: ﻊﺑﺍﺭ
ﻲﻟﺍﺭﺪﻔﻟﺍ: ﺩﺎﺤﺗﺍ, ﻂﺳﻭ
ﻪﻴﻓ-ﺏﻮﻏﺮﻣ: ﺏﺍﺬﺟ, ﻢﺋﻼ﻿ﻣ
ﻞﺜﻤﻣ: ﻞﺜﻣ, ﻢﺳﺎﺑ, ﺏﻭﺪﻨﻣ, ﻡﺎﺤﻣ, ﺐﺋﺎﻨﻟﺍ, ﻢﺳﺎﺑ-ﺙﺪﺤﺘﻤﻟﺍ
ﻥﺎﺘﻛ: ﻥﺎﺘﻛ, ﺔﻴﻠﺧﺍﺩ-ﺏﺎﻴﺛ
ﺔﻋﻮﻟﺎﺑ: ﻕﺮﻏ, ﺽﻮﺣ, ﻚﻧﺯ
ﺖﺧ-ﻷ﻿ﺍ-ﻭﺃ ﺥﻷ﻿ﺍ ﻦﺑﺇ: ﺖﺧﻷ﻿ﺍ-ﻭﺃ-ﺥﻷ﻿ﺍ ﺔﻨﺑﺃ, ﺪﻴﻔﺣ, ﺪﻴﻔﺣ
ﻡﺍﺩ: ءﺎﻣﺪﻟﺍ-ﺔﻗﺍﺭﺇ, ﻑﺰﻨﻳ
ﺭﺎﺼﺣ: ﻕﻮﻃ, ﺪﻌﻘﻣ
ﺓﺪﻌﻣ: ﻦﻄﺑ, ﻦﻄﺑ, ﻦﻄﺒﻟﺍ, ﺔﻓﻮﻔﺼﻣ
ﺱﺎﺤﻧ: ﺰﻧﻭﺮﺑ, ﺱﺎﺤﻧ, ﺯﺭﻷ﻿ﺍ
ﺔﻤﻗ: ﺔﻤﻗ, ﻰﻠﻋﺃ, ﺢﻴﻤﻠﺗ
ﺲﻣﺎﺨﻟﺍ: ﺔﺴﻤﺧ
ﺺﻴﺧﺭ: ﺲﺨﺑ-ﻦﻤﺜﺑ, ﺾﻔﺨﻨﻣ
ﺔﻳﺮﺼﺣ-ﺺﺨﺷ: 
ﺰﺠﺣ: ﺔﺠﻟﺎﻌﻣ, ﺰﺠﺣ, ﺰﺠﺣ, ﺰﺠﺣ, ﻉﺰﺘﻧﺍ, ﻞﺘﺤﻣ, ﻝﻼ﻿ﺘﺣﺍ, ﻲﻓ-ﻊﻤﺟ, ﻉﺍﺰﺘﻧﺍ, ﻢﻬﻓ
ﺝﺎﻴﺳ: ﻁﻮﺤﺘﻟﺍ
ﻝﺎﺜﻤﺗ: ﺖﺤﻧ
ﺔﻴﻌﻓﺪﻤﻟﺍ-ﺡﻼ﻿ﺳ: ﻊﻓﺪﻣ
ﻖﻧﺎﻌﺗ: ﺏﺎﻌﻴﺘﺳﺍ, ﺐﺒﻜﺗ
ﻂﻴﺤﻤﻟﺍ: ءﺎﺤﻧﺃ, ﻲﺣ, ﻥﺍﺮﻴﺠﻟﺍ, ﺭﺎﺟ, ﻲﺣ, ﻲﻄﻴﺤﻣ, ﻂﻴﺤﻣ, ﻢﺧﺎﺘﻣ, ﺐﻳﺮﻗ
ﺔﻗﺪﺑ: ﻡﺭﺎﺻ, ﻚﺳﺎﻤﺘﻣ, ﺔﻗﺪﺑ, ﻖﻴﺿ, ﺓﺪﻳﺪﺷ, ﺪﻴﻛﺄﺘﻟﺎﺑ, ﺎﻗﻼ﻿ﻃﺇ, ﺎﻌﻄﻗ, ﻡﺎﻜﺣﺈﺑ, ﺱﺎﻗ
ﻝﺍﺰﻐﻟﺍ: 
ﺓﺮﻴﺠﺷ: 
ﺔﻳﺪﻳﺪﺤﻟﺍ-ﺔﻜﺴﻟﺍ: ﺔﻳﺪﻳﺪﺣ-ﺔﻜﺳ, ﺔﻳﺪﻳﺪﺣ-ﺔﻜﺳ
ﻎﻳﺮﻔﺗ: ﺮﻳﺮﺤﺗ, ﻎﻳﺮﻔﺗ, ﻕﻼ﻿ﻃﺇ, ﻦﻋ-ﻰﻠﺨﺘﻳ, ﺩﺮﻃ
ﺚﻳﺭﻭ: ﺔﺛﺍﺭﻭ
ﻁﻮﻠﺑ: 
ﺾﻴﻐﺑ: ﺔﺠﻬﺑ, ﺭﺎﺳ, ﺮﻘﺘﺴﻣ-ﺮﻴﻏ, ﺞﻋﺰﻨﻣ, ﺞﻋﺰﻣ, ﺮﻳﺮﺷ, ﺢﻳﺮﻣ-ﺮﻴﻏ
ﻉﺍﺮﺘﺧﺍ: ﻉﺮﺘﺧﺍ, ﻑﺎﺸﺘﻛﺍ, ﺭﺎﻜﺘﺑﺍ
ﻮﻧﺎﻴﺑ: 
ﻉﺎﻨﻗﺍ: ﻉﺎﻨﻗﺇ, ﻞﻔﺘﺣﺍ, ﻯﺮﻛﺫ-ءﺎﻴﺣﺇ
ﻰﺋﺮﻣ-ﺮﻴﻏ: ﺾﻣﺎﻏ
ﺭﻮﻬﺸﻣ: ﺭﻮﻬﺸﻣ, ﺔﻌﻤﺴﻟﺍ-ﺔﺌﻴﺳ, ﺯﺭﺎﺑ
ﺓﻮﺴﻗ: 
ءﺍﺮﻏﺇ: 
ﻚﻴﻠﻴﺗ-ﺐﻧﺎﺟ: 
ﻱﺩﺎﺼﺘﻗﺍ: ﺩﺎﺼﺘﻗﺍ, ﺔﻳﺩﺎﺼﺘﻗﻻ﻿ﺍ-ﺔﻴﺣﺎﻨﻟﺍ-ﻦﻣ, ﻱﺩﺎﺼﺘﻗﺍ-ﺮﻴﺒﺧ, ﻲﻟﺎﻣ
ﻲﻟﻭﺩ: ﻲﻤﻟﺎﻋ, ﺕﺎﻴﺴﻨﺠﻟﺍ-ﺩﺪﻌﺘﻣ
ﻞﺧﺪﺗ: ﻞﺧﺪﺗ, ﻞﺧﺪﺗ, ﻞﺧﺪﺗ, ﺞﻋﺯﺃ, ﺞﻋﺰﻳ, ﻖﻠﻘﻣ, ﻊﻄﻗ, ﺞﻋﺰﻳ, ﺐﻀﻏ, ﺔﻘﻳﺎﻀﻣ, ﻙﺎﺒﺘﺷﺍ
ﻑﻮﺴﻠﻴﻓ: ﻲﻔﺴﻠﻓ
ﻖﻴﻧﻷ﻿ﺍ: ﺔﺿﻮﻤﻟﺍ, ﺱﺎﺴﺣ
ﺮﻴﺧ: ﺮﻴﺧ, ﺭﺎﻫﺩﺯﺍ, ﻢﻳﺪﻘﺗ
ﻚﻤﺴﻟﺍ-ﺪﻴﺻ: 
ﺔﻗﺮﺳ: ﺔﻗﺮﺳ, ﺐﻠﺳ, ﻩﺍﺮﻛﻹ﻿ﺎﺑ-ﺔﻗﺮﺳ, ﺔﻌﻔﺻ
ﺔﻔﺷ: ﺭﺎﻘﻨﻣ, ﻲﻬﻔﺷ, ﺔﻓﺎﺣ
ﺪﻋﺎﻘﺗ: ﺪﻋﺎﻘﺗ, ﺪﻋﺎﻘﺘﻣ, ﺪﻋﺎﻘﺘﻣ, ﻊﺟﺍﺮﺗ, ﺔﺣﺍﺭ, ﻍﺍﺮﻔﻟﺍ-ﺖﻗﻭ, ﺐﺤﺳ, ﻝﺎﻘﺘﺳﺍ
ﺩﺍﺪﺘﻣﺍ: ﻝﺪﺘﻋﺍ, ﺪﻳﺪﻤﺗ, ﺯﺎﻬﺠﻟﺍ, ﺔﻤﺳ, ﺔﻌﻄﻗ, ﺭﻭﺮﻣ, ﺔﻴﻈﺷ, ﺔﻌﻄﻗ
ﺽﺮﻋ-ﺔﻟﺎﺻ: ﺔﻋﻮﻤﺠﻣ
ﻯﺯﺍﻮﻣ: ﺐﻨﺟ-ﻰﻟﺇ-ﺎﺒﻨﺟ, ﻖﻓﺍﻮﺘﻣ, ﺪﻋﺎﺴﻣ, ﻖﺼﻟ
atelic-ﺐﻧﺎﺟ: 
ﺓﺭﺎﻗ: ﻱﺭﺎﻗ
ﻲﻤﻳﺮﺤﺗ-ﺝﺍﺰﻣ: ﻲﻤﻳﺮﺤﺗ-ﺝﺍﺰﻣ
ﻝﺩﺎﻌﺘﻟﺍ: ﻖﻨﻋ-ﺔﻄﺑﺭ, ﺮﺴﻧ
ﺔﻧﺍﺰﻧﺯ: ﺮﻫﻮﺟ, ﺓﺍﻮﻧ, ﺺﻔﻗ, ﺭﺍﺪﺻﻹ﻿ﺍ, ﻝﻮﻤﺤﻤﻟﺍ-ﻥﻮﻔﻴﻠﺘﻟﺍ, ﻱﻮﻠﺨﻟﺍ-ﻒﺗﺎﻬﻟﺍ, ﻱﻮﻠﺨﻟﺍ-ﻒﺗﺎﻬﻟﺍ
ﺔﻀﻴﺑ: ﺔﻴﺼﺧ
ﻊﻨﻄﺼﻣ: ﻲﻋﺎﻨﻄﺻﺍ
ﻥﻮﻀﻏ-ﻲﻓ: ﺎﻌﻣ
ﺔﻣﺯﺃ: ﺩﻮﻛﺭ, ﻢﻜﺣ, ﻢﻜﺣ, ﺉﺭﺍﻮﻄﻟﺍ
ﺏﺬﻬﻣ: ﺔﻠﻣﺎﺠﻣ, ﻢﻠﻌﺘﻣ
ءﺍﺪﻏ: ﺭﺎﻄﻓﺍ-ﺔﺒﺟﻭ, ءﺎﺸﻌﻟﺍ-ﻡﺎﻌﻃ
ﺮﺑﻮﻨﺻ: ﻚﻓ
ﻊﻓﺩﺇ: ﻂﻐﺿ, ﺔﻠﻤﺣ, ﻊﺠﺷ, ﺞﻳﻭﺮﺗ, ﻊﻓﺩ, ﻂﻐﻀﻟﺍ
ﻒﻟﺎﺤﺗ: ﺩﺎﺤﺗﻻ﻿ﺍ, ﺔﺒﺼﻋ, ﻒﻟﺎﺤﺘﻟﺍ, ﺞﻣﺩ, ﺔﻛﺍﺮﺷ
ﺮﺼﺨﻟﺍ: ءﻮﺘﻧ-ﻭﺍ-ﻙﺭﻭ, ﺓﺎﻴﺣ, ﺔﺸﻴﻌﻤﻟﺍ, ﻂﺳﻭ, ﻒﺼﺘﻨﻣ, ﻒﺼﺘﻨﻣ
ﺓﺰﺠﻌﻣ: ﺐﺠﻋ
ﺭﺎﺤﺑ: 
ءﺎﻘﻧ: ﺔﻔﻋ
ﺔﻳﺭﻮﻬﻤﺟ: ﺔﻴﻃﺍﺮﻘﻤﻳﺩ
ﻒﺗﺎﻫ: ﻒﺗﺎﻬﻟﺍ, ﻝﻮﻤﺤﻤﻟﺍ-ﻥﻮﻔﻴﻠﺘﻟﺍ
ﻁﻮﺳ: 
ﺺﻴﻤﻗ: ﺕﺮﻴﺷ-ﻰﺗ
ﻢﻳﺪﻘﺗ: ﺔﻣﺪﻘﻤﻟﺍ, ﺽﺮﻋ, ءﺎﺸﻧﺇ, ءﺪﺑ, ﻢﻳﺪﻘﺗ, ﻢﻳﺪﻘﺗ, ﻲﺻﻮﻧ, ﺔﻟﺎﺣﺇ, ﻦﻘﺣ, ﻢﻴﻠﺴﺗ, ﻞﻴﺻﻮﺗ, ﻒﺻﻭ, ﻒﺻﻭ
ﺔﻜﻳﺭﺃ: ﺔﻜﻳﺭﺃ
ﺢﺴﻣ: ﺢﺴﻣ, ﺭﺎﻨﻟﺍ-ﻞﻌﺷﺃ, ﺺﺤﻔﺗ
ﻕﺭﺎﺴﻟﺍ: ﺲﻴﺋﺭ
ﻆﻔﺘﺣﺍ: ﻰﻠﻋ-ﻅﺎﻔﺤﻟﺍ, ﻲﻃﺎﻴﺘﺣﻻ﻿ﺍ, ﺰﺠﺣ, ﺓﺩﺎﻌﺘﺳﺍ, ﻆﻔﺘﺣﺍ, ﺢﺒﻛ, ﺰﺠﺣ, ﺩﻮﻤﺼﻟﺍ, ﺏﺬﺟ, ﻆﻔﺣ, ﻞﻤﺤﺗ, ﻆﻔﺣ, ﺔﻈﻓﺎﺤﻤﻟﺍ, ﻡﺰﺘﻠﺗ
ﺓﺎﻨﻗ: ﺓﺎﻨﻗ
ﺔﻴﺼﺨﺷ: ﺔﻴﺼﺨﺸﻟﺍ
ﺡﻼ﻿ﺻﺇ: ﻦﻴﺴﺤﺗ, ﺢﻴﺤﺼﺗ, ﺭﻮﻄﺗ, ﻞﻳﺪﻌﺗ
ﺩﺪﻬﻣ: ﺪﻳﺪﻬﺘﻟﺍ, ﺩﺪﻫ, ﺮﻴﻄﺧ, ﻒﻴﺨﻣ
ﻒﻛ: ﺐﻘﻴﻘﻟﺍ-ﺐﺸﺧ
ﺙﺪﺤﺘﻤﻟﺍ: ﻢﺳﺎﺑ-ﺙﺪﺤﺘﻤﻟﺍ
ﺔﺒﺘﻋ: ﺰﺟﺎﺣ
ﺚﺣ: ﺔﻫﺩﺭ, ﺚﺣ, ﺐﺒﺳ, ﺮﻳﺬﺤﺗ, ﺭﺎﺛﺃ, ﻞﻜﺸﺗ, ﺓﺩﺎﻴﻗ, ﺏﺬﺟ, ﺭﺎﻀﺤﺘﺳﺍ
ﺔﺑﺮﺣ: ﻲﻓﺎﺿﺇ
ﻖﻴﻧﺃ: ﻖﻴﻧﺃ, ﻒﻴﻈﻧ, ﺩﻭﺪﺸﻣ
ﺔﺴﻠﺟ: ﻉﺎﻤﺘﺟﺍ-ﺪﻘﻋ, ﺮﻤﺗﺆﻣ
ﺐﻳﺬﻌﺗ: ﺓﺎﻧﺎﻌﻣ
ﺐﻃﺭ: ﺥﺎﺳﻭﻻ﻿ﺍ, ﻞﻠﺒﻣ, ﺐﺋﺍﺫ, ﺭﺎﺣﻭ-ﺐﻃﺭ
ﻞﺒﺟ-ﺔﻤﻗ: ﻰﻠﻋﺃ, ﺔﻠﻳﺪﺟ, ﺔﻣﻮﻛ, ﻂﺸﻣ
ﺮﻓﺎﺴﻣ: ﺮﺋﺍﺯ, ﺮﻓﺎﺴﻣ, ﻲﺣﺎﻴﺳ, ﺐﻛﺍﺭ
ﺔﻨﺤﻄﻣ: ﻊﻨﺼﻣ, ﻊﻴﻨﺼﺗ, ﺕﺎﺒﻨﻟﺍ
ﺔﻄﻳﺮﺧ-ﻢﺳﺭ: ﺔﻗﺎﻄﺑ, ﻲﻧﺎﻴﺑ-ﻢﺳﺭ, ﻲﻧﺎﻴﺑ-ﻢﺳﺭ, ﺓﺮﺟﺃ, ﺓﺮﻛﺬﺗ
ﻕﻮﻃ: ﻕﻮﻃ
ﻞﺤﻣ-ﻞﺤﻳ: ﻞﻳﺪﺑ, ﺮﻴﺠﻬﺗ, ﻲﻓﺎﺿﺇ, ﻞﻳﺪﺒﻟﺍ, ﻝﺪﺑ, ﻝﺍﺪﺒﺘﺳﻻ﻿ﺍ, ﺔﺣﺍﺯﻹ﻿ﺍ, ﺮﻴﻐﺗ, ﺕﻭﺎﻔﺗ, ﻞﻳﺪﻌﺗ, ﺔﻴﻋﺮﻔﻟﺍ
ﺪﻤﻌﺘﺑ: ﺩﻮﺼﻘﻣ, ﺪﻤﻌﺘﻣ, ﻢﻠﻋ, ﻲﻋﺍﻭ, ﺔﻓﺩﺎﻫ
ﺓﺮﻴﺑ: ﺮﺘﻟ-ﻒﺼﻧ
ﻞﻤﺨﻣ: 
ﺔﻴﺑﺫﺎﺠﻟﺍ: ﻩﺎﺒﺘﻧﺍ-ﺏﺬﺟ, ﻖﺤﺳ
ﺔﺒﻄﺧ: ﻆﻋﻭ
ﺓءﺎﺳﺇ: ﺊﻄﺨﻣ, ﺄﻄﺧ-ﻰﻠﻋ
ﻊﻴﻄﻗ: ﺔﻋﻮﻤﺠﻣ, ﻊﻴﻄﻗ, ﺔﻌﻓﺩ, ﺏﺮﺳ
ﺮﺸﻋ-ﺔﺛﻼ﻿ﺛ: 
ﺮﻳﺮﺒﺗ: ﺓﺮﻛﺬﻣ, ﻉﺮﻀﺗ, ﻡﺎﺤﻣ, ﺭﺮﺒﻣ, ﻍﻮﺴﻣ
ﺔﻌﻤﺠﻟﺍ: ﻲﻀﻓ, ﺓﺮﻫﺰﻟﺍ-ﺐﻛﻮﻛ
ﺓﺎﺷﺮﻓ: ﻂﺸﻣ
ﻞﻴﻤﺤﺗ: 
ﻢﻳﺮﻛ: ﺔﻇﻮﺑ
ﻑﺮﺟ: ﺓﺮﺨﺻ, ﺔﻓﺎﺣ
ﻦﻴﻔﻠﺤﻤﻟﺍ-ﺔﺌﻴﻫ: 
ﺦﺴﻣ: ﻕﻼ﻿ﻤﻋ, ﻊﻴﻨﺷ
ﺪﻤﺠﻣ: ﺪﻤﺠﺗ
ﺺﻴﺻﺃ: ءﺎﻧﺇ, ءﺎﻧﺇ, ﺔﻳﻭﺎﺣ
ﺵﺮﻗ: ﺖﻨﺳ
ﺮﺻﺃ: ﻝﺎﻋ-ﺕﻮﺻ, ﻊﻓﺩ, ﺪﻛﺃ, ﺪﻛﺃ, ﺪﻴﻛﺄﺘﻟﺍ, ﺮﺑﺎﺛ, ﺭﺍﺮﺻﺇ, ﺐﻠﻄﺗ, ﻝﺩﺎﺠﺗ
ﺔﺣﺎﻔﺗ: 
ﺶﻗﺎﻨﺗ: ﺵﺎﻘﻧ, ﺽﻭﺎﻔﺗ, ﻝﺩﺎﺠﺗ
ﺔﻴﻔﻠﺧ: 
ﺦﺴﻨﻳ: ﻒﻴﻜﺗ, ﺔﺑﺎﺘﻛ
ﻱﺭﻭﺩ: ﻢﻈﺘﻨﻣ, ﻱﺭﻭﺩ
ﺔﻴﻠﺴﺗ: ﻡﺎﻤﺠﺘﺳﺍ, ﻥﺎﻨﻔﻟﺍ, ﻍﺍﺮﻔﻟﺍ-ﺖﻗﻭ, ﻲﻠﺴﻣ, ﻪﻴﻓﺮﺗ, ﺡﺮﻣ, ﺔﻳﺍﻮﻫ
ﺱﻭﺮﻴﻓ: 
ﻲﻟﻮﻔﻃ: ﻱﻮﻳﺪﻧ
ﺲﻜﻌﺗ: ﻞﻣﺄﺗ, ﻞﻣﺄﺗ, ﻞﻣﺄﺗ, ﺢﻴﺿﻮﺗ, ﻒﺻﻭ
ﻝﻮﺤﺗ: ﺮﻴﻐﺗ, ﻝﻮﺤﺗ, ﻝﻮﺤﺗ, ﻝﻮﺤﺗ
ﺔﻀﻳﺮﻌﻟﺍ-ﻁﻮﻄﺨﻟﺍ: ﻲﺼﺨﺸﻟﺍ-ﻒﻠﻤﻟﺍ, ﻑﺎﻔﻛ, ﺺﺨﻠﻣ, ﻢﺳﺭ, ﻒﺸﻜﺗ, ﺔﻣﺎﻋ-ﺓﺮﻈﻧ, ﺓﺩﻮﺴﻣ
ﺍﺮﺑﻭﻷ﻿ﺍ-ﺭﺍﺩ: 
ﺔﻘﻓﺍﻮﻣ: ﻖﻳﺪﺼﺗ, ﺾﻓﺍﺭ, ﺔﻘﻓﺍﻮﻣ, ﻝﻮﺒﻗ, ﺪﻴﻛﻮﺗ, ﺔﻘﻓﺍﻮﻤﻟﺍ, ﺪﻴﻳﺄﺗ, ﻲﻨﺒﺗ, ﻖﻴﻔﺼﺗ
ﺍﺮﺳ-ﻰﺸﻓﺃ: ﻒﺸﻛ, ﻉﺪﺨﻳ, ﺐﻴﺨﻳ
ﺔﺒﻗﺎﻌﻣ: ﻡﻮﻜﺤﻤﻟﺍ
ﻉﻮﻛ: ﺱﻮﻗ
ﻖﻠﻌﺘﻟﺍ: ﻖﺤﻠﻣ, ﻝﺎﺼﺗﻻ﻿ﺍ, ﺔﻌﻘﺑ, ﻞﺻﻮﻟﺍ-ﺔﻘﻠﺣ, ﻞﺻﻮﻤﻟﺍ
ﺢﻠﺼﻳ: ﺓﺩﺎﻌﺘﺳﺍ, ﻦﻴﺴﺤﺗ, ﺓﺩﺎﻋﺇ, ﺢﻴﺤﺼﺗ
ﻩﻮﺒﺸﻣ: ﻩﺎﺒﺘﺷﺍ, ﻪﺑ-ﻪﺒﺘﺸﻣ
ﻥﻮﻌﺒﺳ: 
ﺱﺪﻘﻤﻟﺍ-ﺏﺎﺘﻜﻟﺍ: ﺱﺪﻘﻤﻟﺍ-ﺏﺎﺘﻜﻟﺍ, ﻲﺼﻨﻟﺍ
ﺓﺮﻔﺣ: ﺐﻘﺛ, ﺕﺎﻳﺮﻔﺣ, ﺔﺣﺎﺒﺴﻟﺍ-ﺽﻮﺣ
ﺏﺍﺮﻄﺿﺍ: ﻰﺿﻮﻓ, ﻰﺿﻮﻓ, ﺏﺍﺮﻄﺿﺍ, ﺝﺎﻋﺯﺇ, ﺚﺒﻌﺗ, ﺞﻋﺰﻣ, ﻞﺧﺪﺗ, ﺓﺮﻴﺣ
ﻲﺋﺎﻨﺛ: ﻲﺋﺎﻨﺛ-ﻲﻠﻣﺎﻜﺗ
ﺮﻳﺩ: ﺮﻳﺩ
ﻢﻬﺳ: 
ﻞﻴﻤﺗ: ﺔﺿﺮﻋ, ﺓﺩﺎﻋ, ﻲﻌﻴﺒﻃ-ﻞﻜﺸﺑ, ﺓﺩﺎﻋ
ﺢﺿﻭ: ﻞﺼﻔﻣ, ﺩﺪﺣ, ﺢﺿﻭ, ﺭﻮﻃ, ﺪﻘﻌﻣ, ﺐﻌﺻ, ﻞﺣ---ﻒﺸﺘﻛﺍ
ءﺎﻓﻭ: ﺱﺮﻛ, ﺺﻠﺨﻣ, ﺔﻘﺛ, ﺔﻧﺎﻣﺄﺑ, ﺔﺣﺍﺮﺼﺑ, ﺔﻘﺜﻟﺍ-ﻡﺪﻋ, ﺔﻴﻗﺍﺪﺼﻣ, ﻥﺎﻤﻳﺇ, ﻥﺎﻤﻳﺇ
ﺔﻴﻧﺪﻌﻣ-ﺔﻠﻤﻋ: ﺔﻠﻤﻋ
ﺶﻌﺗﺮﺗ: ﺔﻔﺟﺭ
ﻰﻔﻨﻣ: ﺭﺎﻨﻟﺍ-ﻖﻠﻃﺃ, ﺩﻼ﻿ﺒﻟﺍ-ﺝﺭﺎﺧ
ﻰﻜﻴﻧﺎﻜﻴﻣ: ﺔﻴﻟﺁ, ﻲﻜﻴﻧﺎﻜﻴﻣ, ﺱﺪﻨﻬﻣ
ﺦﻓ: ﺔﻀﺒﻗ, ﻡﻮﻜﺤﻤﻟﺍ
ﺔﻜﻌﻛ: ﺓﺮﻴﻄﻓ, ﻲﻛﻮﻛ, ﺔﻨﻴﺠﻋ
ﻱﺪﻴﺳ: ﺪﻴﺴﻟﺍ, ﺪﻴﺳ, ﺏﺭ, ﻡﺮﺘﺤﻣ-ﻥﺎﺴﻧﺍ
ﺩﺩﺮﺗ: ﻕﺮﻃ, ﺩﺩﺮﺗ, ﺩﺩﺮﺗ, ﻡﻮﺤﻳ
ﺮﺸﻋ-ﻪﻌﺒﺳ: 
ﻞﺴﻋ: 
ﺪﺗﻭ: ﻥﺎﻫﺭ, ﺔﺒﺴﻧ, ﺪﺗﻭ, ﺔﻣﻮﻛ, ﻢﺳﺎﻘﺘﻳ, ءﺰﺟ, ﻡﺎﻬﺳﺇ
ﺓﻮﻄﺧ: ﺓﻮﻄﺧ, ﺔﻋﺪﺨﻟﺍ, ﺮﻴﺳ, ﻲﺸﻤﻟﺍ, ﺔﺳﺍﻭﺩ, ﺓﻮﻄﺧ, ﺓﻮﻄﺧ, ﺔﺟﺭﺪﻟﺍ
ﺔﻨﺒﻟ: ﺓﺪﻴﻣﺮﻗ
ﻥﻮﻧﺎﻤﺛ: 
ﻆﺤﻟﺍ-ءﻮﺴﻟ: ﻪﻟ-ﻒﺳﺆﻳ, ﻆﺤﻟﺍ-ﻞﻴﻠﻗ, ﻒﺳﻸ﻿ﻟ
ﺭﻭﺎﺸﺗ: ﺭﻭﺎﺸﺗ, ﻉﻮﺟﺮﻟﺍ
ﺓﺭﻮﻄﺳﺃ: ﺓﺭﻮﻄﺳﺃ
ﺩﺎﺼﺣ: ﻝﻮﺼﺤﻣ
ﺔﻴﻔﻴﻇﻭ-ﺔﻴﻗﺮﺗ: ﻊﻓﺭ, ﺞﻳﻭﺮﺗ, ﺔﻣﺪﻘﻤﻟﺍ, ﺽﺮﻋ, ﺔﻳﺎﻋﺩ
ﺪﻗﻮﻣ: ﺥﺎﺒﻃ, ﺡﻮﻟ, ﻥﺮﻓ
ﺩﺮﻤﺘﻣ: ﺓﺭﻮﺛ, ﺩﺮﻤﺗ
ﺯﺍﺮﻄﻟﺍ-ﻢﻳﺪﻗ: ﺔﻤﻳﺪﻘﻟﺍ
ﻢﺨﻀﺗ: ﻢﺨﻀﺗ, ﻡﺭﻮﺘﻣ, ﻢﺨﻀﺘﻟﺍ, ﻡﺭﻮﺗ, ﺮﻴﺒﻜﺗ
ﻊﻘﻨﺘﺴﻣ: ﻊﻘﻨﺘﺴﻣ
ﺔﺼﻠﺻ: ﺔﺼﻠﺻ, ﻪﺑﺎﺼﻋ---ﺓﺩﺎﻤﺿ
ﺪﻫﺍﺯ: ﻚﺳﺎﻨﻟﺍ
ﺮﻳﺪﻣ: ﻒﻴﻀﻣ, ﺲﻴﺋﺭ, ﺲﻴﺋﺭ, ﺮﻳﺪﻣ, ﺮﻳﺪﻤﻟﺍ, ﻂﻴﺳﻭ, ﻢﻴﻋﺯ, ﻱﺬﻴﻔﻨﺗ
ﺔﻗﻮﺟ: ﺔﻠﻤﺣ, ﻖﻳﺮﻔﻟﺍ
ﻲﻧﻼ﻿ﻘﻋ: ﻍﻮﺴﻣ, ﻖﻄﻨﻣ, ﻲﻘﻄﻨﻣ, ﻰﻘﻄﻨﻣ-ﺮﻴﻏ, ﻝﻮﻘﻌﻣ, ﻝﻮﻘﻌﻣ, ﻝﻮﻘﻌﻣ
ﺔﺠﻟﺎﻌﻣ: 
ﺐﺋﺬﻟﺍ: 
ﺓﺩﺎﺠﺳ: ﺓﺩﺎﺠﺳ
ﺔﻤﻳﺪﻘﻟﺍ-ﺭﻮﺼﻌﻟﺍ: 
ﺐﺼﺧ: 
ﺓﺭﺎﻔﺻ: ﺭﺎﻣﺰﻣ
ﻦﺒﺟ: 
ﺔﻀﻋ: ﻊﻄﻘﻳ, ﺶﻘﻧ, ﺔﻏﺪﻟ
ﻮﻋﺪﻳ: ﺓﻮﻋﺩ-ﺔﻟﺎﺳﺭ
ﺔﻴﺋﺍﺭﺪﺗﺎﻛ: ﺪﺒﻌﻣ
ءﺎﻨﻴﻣ: ءﺎﻨﻴﻣ
ﻝﻮﺠﺗ: ﻩﺰﻨﺗ, ﺓﺮﺠﻬﻟﺍ, ﻊﻓﺭ
ﻞﻴﺻﺎﺤﻤﻟﺍ: ﻝﻮﺼﺤﻣ
ﺔﻳﺮﺤﺒﻟﺍ-ﺕﺍﻮﻘﻟﺍ: ﻱﺮﺤﺑ, ﻝﻮﻄﺳﺃ
ﻉﺎﻨﻗ: ﻒﺋﺍﺯ-ﺮﻬﻈﻣ, ﺓﺩﻭﺩ
ﻢﻠﻗ: ﻢﻠﻗ
ﺕﺍﻭﺮﻀﺨﻟﺍ: ﻲﺗﺎﺒﻧ
ﺽﺮﻋ: ﺽﺮﻌﻣ, ﺽﺮﻋ, ﺽﺮﻋ, ﺽﺮﻋ, ﺽﺮﻋ, ﺽﺮﻌﺗ
ﻝﺎﻄﻨﺑ: ﻥﻮﻠﻄﻨﺑ, ﻝﺎﻄﻨﺑ
ﺩﺎﺴﻓ: ﺔﺤﻴﻀﻓ, ﺙﻮﻠﺗ
ﺔﻧﺍﺰﺧ: ﺔﻧﺍﺰﺧ, ﺔﻧﺍﺰﺧ, ﺔﻧﺍﺰﺧ, ﺽﺎﺣﺮﻣ
ءﺎﺴﺣ: 
ﺡﺍﺮﺟ-ﺐﻴﺒﻃ: ﺔﻴﺣﺍﺮﺠﻟﺍ-ﺔﻴﻠﻤﻌﻟﺍ, ﻲﺣﺍﺮﺟ, ﺔﻴﻠﻤﻋ
ﻝﺪﺑ: ﻞﻳﺪﺑ, ﻝﺪﺑ, ﺾﻳﻮﻌﺗ, ﻝﺪﺑ, ﻊﻳﺯﻮﺗ, ﻖﺤﻠﻣ
ﻪﺳﻮﺳﺎﺠﻟﺍ: 
ﺭﻮﻬﺘﻣ: ﻲﻟﺎﺒﻣ-ﺮﻴﻏ, ﺐﺗﺮﻣ-ﺮﻴﻏ
ﺔﻤﻴﻤﻧ: ﺔﻌﺋﺎﺷ, ﺔﻌﺋﺎﺷ
ﺰﻣﺭ: 
ﺺﺨﻠﻣ: ﺺﺨﻠﻣ, ﺞﻬﻨﻤﻟﺍ
ﺲﻴﻤﺨﻟﺍ: 
ﺭﻭﺮﻤﻟﺍ-ﺔﻛﺮﺣ: ﻝﻭﺍﺪﺗ, ﺕﻼ﻿ﺻﺍﻮﻤﻟﺍ, ﻞﻘﻨﻟﺍ-ﻞﺋﺎﺳﻭ
ﺔﻳﺭﺎﻤﻌﻣ-ﺔﺳﺪﻨﻫ: 
ﻉﺪﺻ: ﻖﺷ, ﻕﻮﻘﺸﻣ, ﺭﺩﺎﻐﺗ, ﻝﺎﻘﺘﺳﺍ, ﺮﺴﻛ
ﺔﻓﺮﺧﺯ: ﺔﻓﺮﺧﺯ, ﻲﻓﺮﺧﺯ, ﻦﻴﻳﺰﺗ, ﺕﺍﺮﻫﻮﺠﻣ, ﻢﻴﻠﻘﺗ
ﻲﺴﻜﻋ: ﺲﻜﻋ, ﺱﻮﻜﻌﻣ, ﻝﻮﺤﺗ, ﺲﻜﻋ, ﺲﻛﺎﻌﻣ, ﺐﻘﻋ-ﻰﻠﻋ-ﺎﺳﺃﺭ, ﻲﻔﻠﺧ
ﻰﻠﺳ: ﻪﻴﻓﺮﺗ, ﻲﻠﺴﻣ, ﻊﺘﻤﺘﺴﻣ
ﻉﺎﺟﺮﺘﺳﺍ: ﺓﺩﺎﻌﺘﺳﺍ, ﺫﺎﻘﻧﺇ, ﻦﻴﺴﺤﺗ, ءﺎﻴﺣﺇ, ﺓﺩﺎﻌﺘﺳﺍ, ﺓﺩﺎﻌﺘﺳﺍ, ﺓﺩﺎﻋﺇ
ﻉﺭﺎﺸﻟﺍ-ﻒﻴﺻﺭ: ﺢﺒﻛ, ﺐﻌﻠﻤﻟﺍ, ﻥﺍﺮﻄﻗ, ﻪﺑﺎﻌﻟ-ﻝﺎﺳ, ﻲﻄﻐﻳ-،ءﺎﻄﻏ
ﻢﺳﺎﺣ: ﻱﺮﻴﺼﻣ, ﻱﻮﻴﺣ, ﺩﺪﺣ, ﺭﺮﻗ, ﻡﺯﺎﺟ
ﻲﺒﻠﺳ: ﺲﻛﺎﻌﻣ
ﻥﺎﺟﺮﻬﻣ: ﺔﻴﻘﻴﺳﻮﻣ-ﺔﻠﻔﺣ
ﺪﺤﻟﺍ: ﺾﻴﻔﺨﺗ, ﻥﺎﺼﻘﻧ, ﺔﻟﻮﻬﺳ, ﻒﻴﻔﺨﺗ, ﺾﻔﺧ, ﻞﻠﺤﺘﺗ, ﺾﻔﺧ, ﻢﻴﻠﻘﺗ, ﺡﺮﻃ, ﺰﺠﺣ, ﺮﺼﺣ
ﺔﻧﺎﻴﺨﻟﺍ: 
ﺩﺎﻴﺻ: 
ﻥﺎﺒﻌﺛ: ﻒﺣﺍﻭﺯ
ﺔﻳﺭﺎﻄﺑ: 
ﻊﻤﺷ: ﺔﻌﻤﺷ
ﻱﺮﺤﺘﻣ: ﻖﻘﺤﻣ
ﻞﻴﻠﺤﺗ: ﻞﻠﺤﻳ, ﺚﺤﺑ, ﺔﺳﺍﺭﺩ, ﺚﺤﺑ, ﺺﺤﻓ, ﻑﺎﺸﻜﺘﺳﺍ, ﺭﺍﺮﻗ, ﻝﺎﺼﻔﻧﺍ, ﻝﺎﺼﻔﻧﺍ
ﺪﻳﺪﺸﺗ: ﺪﻛﺆﻣ, ﻂﻐﻀﻟﺍ, ﺪﻛﺃ, ﺪﻴﻛﺄﺘﻟﺍ, ﺪﻛﺃ, ﺔﺠﻬﻟ, ﺪﻴﻛﻮﺗ, ﻩﺎﺒﺘﻧﺍ
ﻥﻮﺤﺒﺴﻳ: ﺔﺣﺎﺒﺴﻟﺍ-ﺔﺿﺎﻳﺭ
ﻑﺮﻇ: ﻑﺮﻇ, ﻝﺎﺣ-ﻑﺮﻇ, ﺪﻤﻏ
ﻥﺎﻛ-ﺎﻳﺃ: ﻯﺬﻟﺍ-ﻦﻣ, ﺎﻣ-ﺺﺨﺷ, ﻦﻣ, ﺺﺨﺷ-ﻱﺍ
ﺓﺭﺎﺠﻴﺳ: ﻦﻴﺧﺪﺗ, ﻎﺒﺗ
ﻙﺮﺤﻣ: ﺓﺭﺎﻴﺳ, ﻙﺮﺤﻣ, ﻊﻓﺍﺩ, ﺔﻳﺭﺎﻧ-ﺔﺟﺍﺭﺩ
ﻉﻮﻄﺗ: ﺱﺮﻛ, ﻲﻋﻮﻃ
ﻞﻌﻓ-ﺩﺭ: ﻲﻠﻋﺎﻔﺗ, ﺔﺑﺎﺠﺘﺳﺍ, ﺩﺭ, ﻞﻌﻓ-ﺩﺭ, ﻞﻌﻔﻟﺍ-ﺩﻭﺩﺭ
ﺔﻌﺘﻣﺃ: ﺔﻌﺘﻣﺃ, ﻦﺤﺷ, ﻉﺬﺟ, ﺮﻔﺳ-ﺔﺒﻴﻘﺣ
ﻢﺻﺃ: 
ﺮﻴﺼﻋ: ﺝﺍﺮﺨﺘﺳﺍ
ﻊﺿﺍﻮﺗ: ﺔﻃﺎﺴﺑ, ﻊﺿﺍﻮﺘﻣ
ﺓﺭﺍﺯﻭ: 
ﻲﺴﻨﺟ: ﺲﻨﺟ, ﺔﻴﻧﺎﺴﻨﺟ
ﺓﺮﺋﺍﺪﻟﺍ-ﺮﻄﻗ: 
ﺱﺄﻔﻟﺍ: 
ﺱﺎﻤﻟﺍ: 
ﻞﻳﺪﺒﻟﺍ: ﻲﻓﺎﺿﺇ, ﻞﻳﺪﺒﻟﺍ, ﻝﺪﺑ, ﺭﺎﻴﺧ, ﺐﺋﺎﻨﻟﺍ, ﻞﻳﺪﺑ, ﻉﺭﺯ
ﺕﻮﺻ-ﻯﺪﺻ: 
ﺢﺒﻛ: ﺢﺒﻛ, ﺢﺒﻛ, ﺪﻳﺪﺤﺗ, ﺪﻴﻴﻘﺗ, ﺩﻮﻴﻗ
ﺔﻳﻮﻫ: ﺪﻳﺪﺤﺗ, ﻒﻳﺮﻌﺗ, ﻱﺰﻣﺭ
ﺔﺷﺎﺷ: ﺽﺮﻋ, ﺓﺭﺎﺘﺳ
ﻝﻮﺴﻛ: ﺪﺳﺎﻓ
momentane-ﺐﻧﺎﺟ: 
ﻕﺎﻔﺗﺍ: ﻕﺎﻔﺗﺍ, ﺐﻠﺻ, ﻒﻴﺜﻛ
ﻑﺍﺮﺤﻧﺍ: ﺔﻴﻠﻤﻋ, ﻑﺍﺮﺤﻧﺍ, ﻞﻴﻣ, ﻩﺎﺠﺗﺍ
ﻰﻔﺘﺧﺍ: ﺽﺮﻘﻨﻣ
ﻉﺎﻌﺷ: ﻉﺎﻌﺷ, ﻰﺸﻤﻣ, ﺮﻄﻘﻟﺍ-ﻒﺼﻧ
ﺮﺒﺣ: 
ﻞﺋﺎﻫ: ﺮﻴﺒﻛ, ﺮﻴﺒﻛ, ﻢﺨﺿ, ﻞﺋﺎﻫ, ﻞﺋﺎﻫ, ﺮﻴﺒﻛ, ﻞﺋﺎﻫ-ﻞﻜﺸﺑ
ﻮﺒﻗ: 
ﺯﺭﺎﺑ: ﺯﺭﺎﺑ
ﺞﻫﻭ: ﺞﻫﻮﺗ, ﻖﻟﺄﺗ, ﻖﻟﺄﺗ
ﺥﻮﻴﺸﻟﺍ-ﺲﻠﺠﻣ: ﺏﺍﻮﻨﻟﺍ-ﺲﻠﺠﻣ
ﺶﻌﻧ: 
ﺓﺮﻔﻐﻣ: 
ﻉﻼ﻿ﺘﺑﺍ: ﺔﻔﺷﺭ
ﻞﻟﺩ: ﺐﻘﻌﺗ, ﺽﻮﻋ
ﺢﺟﺭﺄﺘﻟﺍ: 
ﺝﺮﻣ: ﻰﻋﺮﻣ, ﻞﺒﻗ, ﺐﺸﻌﻟﺍ
ﻊﻤﺠﻣ: ﺪﻘﻌﻣ, ﺪﻘﻌﺗ, ﺭﻮﻄﺘﻣ, ﺐﻛﺮﻣ, ﺐﻌﺻ
ﺔﻟﺎﻘﺘﺳﺍ: ﻝﺎﻘﺘﺳﺍ, ﺪﻋﺎﻘﺗ
ﻊﺿﺍﻮﺘﻣ-ﻞﻴﺠﺴﺗ: 
ﺓﺮﻣﺍﺆﻣ: ﺔﻌﻄﻗ
ﻞﻔﻠﻓ: 
ﺔﻴﻓﺮﺣ-ﺔﻤﺟﺮﺗ: 
ﺢﺷﺮﻣ: ﺔﻔﻴﻇﻭ-ﺐﻟﺎﻃ
ﺐﻠﻌﺛ: 
ﺔﻨﺧﺪﻣ: ﺓﺄﻓﺪﻣ, ﺔﻣﻮﻛ
ﺹﺎﺼﺘﺧﻻ﻿ﺍ: ﺔﺌﻴﻫ, ﻢﻜﺣ, ﻢﻜﺣ, ﺹﺎﺼﺘﺧﺍ
ﺔﻋﺍﺭﺯ: ﺔﻋﺍﺭﺯ, ﻲﻋﺍﺭﺯ
ﺔﻗﺩ: ﺔﻗﺩ, ﺔﻔﻋ, ﺔﻗﺪﺑ, ﺢﻴﺤﺻ-ﻞﻜﺸﺑ, ﺔﻴﻗﺍﺪﺼﻣ
ﻖﺑﺎﺳ-ﻰﻓﻮﺘﻣ: 
ﻲﻃﺍﺮﻘﻤﻳﺩ: 
ﻢﻋﺮﺑ: ﺏﺎﺒﻟﺍ-ﺾﺒﻘﻣ, ﻢﻋﺮﺑ
ﺔﻴﻧﺎﻄﺑ: ﻒﻘﺳ, ﻲﻄﻐﻳ-،ءﺎﻄﻏ, ﺓﺩﺎﺠﺳ, ﺔﻴﻄﻐﺗ
ﻞﺑﺍﻭ: ﻞﺘﺤﻣ, ﺎﻴﺣ
ﺮﻳﺰﻨﺧ: ﺓﺮﻳﺰﻨﺧ
ﻞﻜﺸﻟﺍ: ﻞﻜﺸﻟﺍ, ﻞﻜﺷ, ﻦﻴﺗ, ﻪﻴﺟﻭ
ﺝﺎﻋ: 
ﻲﻜﻴﺳﻼ﻿ﻛ: ﻲﻜﻴﺳﻼ﻿ﻛ, ﻱﺪﻴﻠﻘﺗ
ﺐﻗﺍﺮﻣ: ﻑﺮﺸﻤﻟﺍ, ﺮﺋﺍﺯ
ﻞﻴﻓ: 
ﺮﻓﺎﻇﻷ﻿ﺍ: ﺭﺎﻤﺴﻣ
ﺔﻠﺤﻧ: 
ﻦﻓﺩ: ﻦﻓﺩ, ﻦﻴﻤﻀﺗ
ﻞﺜﻤﻤﻟﺍ: ﺔﻠﺜﻤﻣ, ﺩﺆﻣ, ﻰﻋﺪﻣ
ﻕﺮﻋ: 
ﻱﺪﻨﻟﻮﺑ: ﺔﺠﻬﻟ
ﻢﻫﻭ: ﻝﺎﻴﺘﺣﻻ﻿ﺍﻭ-ﺐﺼﻨﻟﺍ
ﻚﺸﻟﺍ: ﺪﻛﺆﻣ-ﺮﻴﻏ, ﺽﻮﻤﻏ
ﻱﻮﻧﺎﺛ: ﻲﻧﻮﻧﺎﻘﻟﺍ-ﻦﺴﻟﺍ-ﺖﺤﺗ, ﻂﺳﻮﺘﻣ, ﻂﺳﻮﺘﻣ, ﻝﺪﺘﻌﻣ, ﺭﺎﻴﺘﻟﺍ, ﻒﺼﺘﻨﻣ
ﺔﻴﻃ: ﻲﻄﻠﻟ-ﺔﻠﺑﺎﻗ
ﻲﻔﻳﺭ: ﻲﻔﻳﺭ, ﻒﻳﺮﻟﺍ, ﻱﻭﺮﻗ
ﻩﻭﺄﺗ: 
ﻪﺑﺎﺸﺗ: ﻞﺛﺎﻤﻣ, ﻪﺑﺎﺸﺗ, ﺮﻴﻛﺬﺗ
ﺲﺒﺘﻗﺍ: ﺝﺍﺮﺨﺘﺳﺍ, ﺱﺎﺒﺘﻗﺍ, ﺔﻣﻼ﻿ﻌﺑ-ﺎﺴﺒﺘﻘﻣ-ﺎﻣﻼ﻿ﻛ ﻢﺘﺧ, ﺽﺍﺮﻗﺇ, ﺽﺍﺮﺘﻗﺍ, ﺽﺮﻗ
ﺲﻴﻛ: ﺮﻈﻨﻟﺍ-ﻑﺮﺻ, ﺔﻟﺎﻗﺇ, ﺔﺒﻴﻘﺣ
ﺝﺎﻋﺯﺇ: ﺝﺎﻋﺯﺇ, ﻞﺧﺪﺗ, ﺔﻗﺎﻋﺇ, ﺔﻘﺋﺎﺿ, ﻞﻠﻣ, ﺞﻋﺰﻳ
ﺓﺮﺑﺇ: ﺔﻨﻘﺣ, ﺔﻨﻘﺤﻣ, ﻢﻗﺮﻣ, ﺱﻮﺑﺩ
ﺪﻫﺎﺷ-ﻭﺫ: ﻢﻜﺤﺘﻟﺍ
ﺝﺎﺟﺩ: ﺔﺟﺎﺟﺩ
ﻖﺴﺘﻣ: ﺮﻤﺘﺴﻣ, ﻖﻓﺍﻮﺘﻣ, ﺔﻧﺎﺳﺮﺨﻟﺍ, ﻲﻨﻤﺿ, ﺐﺳﺎﻨﻣ, ﺏﺍﺮﺤﻣ, ﺔﻠﺻ, ﻚﺳﺎﻤﺘﻣ, ﻲﻠﺴﻠﺴﺗ, ﻥﺯﺍﻮﺘﻣ, ﺖﺑﺎﺛ
ﻞﻴﻣﺮﺑ: ﻮﻟﺩ
ﻱﺩﺎﻴﺘﻋﺍ-ﺐﻧﺎﺟ: 
ﺮﻴﺒﺧ: ﺺﺼﺨﺘﻣ, ﺓﺮﺒﺨﻟﺍ-ﻱﻭﺫ, ﺹﺎﺧ, ﺓﺩﺪﺤﻣ
ﺏﺎﺠﻋﺍ: ﺮﺛﺆﺗ, ﻉﺎﺒﻄﻧﻻ﻿ﺍ, ﺏﺬﺟ
ﻥﻮﺘﻳﺯ: 
ﻞﻘﻧ-ﺓﺭﺎﻴﺳ: ﻡﺎﻤﺻ
ﺔﺒﻘﻋ: ﻊﻄﻗ, ﺩﻮﻴﻗ, ﻖﺋﺎﻋ, ﺰﺟﺎﺣ, ﺔﺴﻜﻧ
ﺓءﺎﻤﻳﺇ: 
ﺔﻨﺿﺎﺤﻟﺍ: ﻉﺭﺯ, ﺦﻧﺎﺒﺳ, ﺞﻳﻭﺮﺗ, ﻞﻴﻬﺴﺗ, ﺔﻳﺬﻐﺗ, ﺓﺎﺑﺎﺤﻣ, ﺓﺎﺑﺎﺤﻣ
ﻒﻳﺮﻌﺗ: ﻖﻴﻠﻌﺗ, ﻒﻳﺮﻌﺗ, ﻒﺻﻮﻟﺍ, ﺮﻳﺮﻘﺗ
ﺩﻼ﻿ﻴﻤﻟﺍ-ﺦﻳﺭﺎﺗ: ﺔﻳﻮﻨﺳ-ﻯﺮﻛﺫ
ﺵﻮﻛﺎﺷ: 
ﻖﺒﻋ: 
ﺭﺍﺮﻜﺘﻟﺍ: ﻞﻴﻘﺛ, ﺩﻮﺼﻘﻤﻟﺍ-ﻥﺎﻜﻤﻟﺍ, ﺭﺮﻛ, ﺭﺍﺮﻜﺗ, ﺔﻓﻭﺮﺑ
ﻪﻓﺎﺗ: ﻪﻓﺎﺗ, ﻢﻬﻣ-ﺮﻴﻏ
ﺔﻠﻛﺭ: ﺏﺮﺿ, ءﻮﺘﻧ, ﻡﺪﻗ-ﺓﺮﻛ, ﻡﻮﻴﺴﻠﻜﻟﺍ, ﻡﺪﻘﻟﺍ-ﺓﺮﻛ, ﺔﺑﺮﺿ
ﺮﻔﺣ: ﺮﻔﺣ, ﺮﻔﺣ, ﺕﺎﻳﺮﻔﺣ
ﺔﻔﻴﻟﻷ﻿ﺍ-ﺕﺎﻧﺍﻮﻴﺤﻟﺍ: 
ﺔﻤﺠﻤﺟ: 
ﺔﻴﻌﻳﺮﺸﺘﻟﺍ-ﺔﻄﻠﺴﻟﺍ: ﺏﺍﻮﻨﻟﺍ-ﺲﻠﺠﻣ, ﻲﻌﻳﺮﺸﺗ, ﻊﻳﺮﺸﺗ
ﺐﻌﻛ: ﺰﻔﻗ
ﺱﻮﺒﻋ: 
ﻉﺍﺮﺘﺧﻹ﻿ﺍ-ﺓءﺍﺮﺑ: 
ﺭﺎﻴﻠﻣ: 
ﺔﻴﺋﺎﻴﻤﻴﻛ-ﺓﺩﺎﻣ: ءﺎﻴﻤﻴﻛ, ﺔﻴﺋﺎﻴﻤﻴﻛ-ﺩﺍﻮﻣ, ﻲﺋﺎﻴﻤﻴﻛ
ﺭﺎﻴﻃ: ﺔﺑﺮﺠﺗ, ﻲﺒﻳﺮﺠﺗ
ﺪﻠﻗ: ﺓﺎﻛﺎﺤﻣ, ﺓﺎﻛﺎﺤﻣ, ﺭﺍﺮﻜﺗ, ﺦﺴﻧ
ﺓﺭﻮﻨﺗ: ﺓﺮﺨﺻ
ﺓﺩﺎﻌﻟﺍ-ﺮﻴﻏ-ﻰﻠﻋ: ﻱﺩﺎﻋ-ﺮﻴﻏ, ﻰﻌﻴﺒﻃ-ﺮﻴﻏ, ﺐﻳﺮﻏ, ﻊﺋﺍﺭ, ﻲﺋﺎﻨﺜﺘﺳﺍ, ﻕﺪﺼﻳ-ﻻ﻿, ﻢﻈﺘﻨﻣ-ﺮﻴﻏ, ﻲﺋﺎﻨﺜﺘﺳﺍ, ﻕﺪﺼﻳ-ﻻ﻿, ﺍﺪﺟ, ﺐﻳﺮﻏ-ﻞﻜﺸﺑ
ﻲﻋﻮﺒﺳﺃ: 
ﻲﻨﻘﺗ: ﺔﻴﻨﻘﺗ, ﺎﻴﺟﻮﻟﻮﻨﻜﺗ, ﺎﻴﻨﻓ, ﺎﻴﺟﻮﻟﻮﻨﻜﺘﻟﺍ
ﺔﻴﺗﺎﺒﻨﻟﺍ-ﺓﺎﻴﺤﻟﺍ: 
ﺏﺍﺮﻏ: ﻉﺩﺎﺨﻣ
ﺲﻤﺸﻟﺍ-ﻕﻭﺮﺷ: 
ﺓﺎﻴﺤﻟﺍ-ﺕﺎﻗﻭﺃ: ﺓﺎﻴﺣ, ءﺎﻘﺑ, ﺓﺎﻴﺤﻟﺍ-ﻂﻤﻧ, ﺔﺸﻴﻌﻤﻟﺍ
ﺔﻤﻫﺎﺴﻤﻟﺍ: ﻡﺎﻬﺳﺇ, ﻉﺮﺒﺗ, ﺔﻛﺍﺮﺷ, ﺞﻳﻭﺮﺗ, ﻞﻴﻬﺴﺗ
ﺪﻴﺻ-ﺓﺭﺎﻨﺻ: ﻂﺑﺭ, ﻂﺑﺭ, ﻂﺑﺍﺮﺗ, ﺱﻮﻗ
ﺮﻤﻧ: 
ﻞﻠﺴﺗ: ﺐﻘﺛ, ﻝﻼ﻿ﺧ, ﺮﺛﺆﻣ
ﻢﻛ: ﻉﺍﺭﺫ
ﻊﻳﺮﺳ-ﻖﻳﺮﻃ: ﻖﻳﺮﻃ
ﺎﻴﺸﻴﻠﻴﻣ: 
ﻕﺪﻨﺧ: ﻕﺪﻨﺧ, ﺢﻣﺭ
ﺔﻫﺍﺰﻧ: 
ﺮﺸﻋ-ﺔﻌﺴﺗ: 
ﻱﻮﻀﻋ: 
ﺕﻮﻫﻻ﻿: 
ﻮﻔﻄﺗ: ﺏﺭﺎﻗ, ﻡﻮﺤﻳ, ﻝﻮﻄﺳﺃ
ﺓﺮﺣﺎﺳ: 
ﺮﺠﺿ: ﻞﻤﻣ, ﻞﻠﻣ
ﻲﺳﺎﻣﻮﻠﺑﺩ: ﻲﺳﺎﻣﻮﻠﺑﺩ
ﻮﻳﺩﻮﺘﺳ: ﻖﺼﻠﻣ, ﻞﻤﻋ-ﺔﺷﺭﻭ, ﺔﺳﺍﺭﺩ
ﺯﻭﺎﺠﺗ: ﻥﺍﻭﺪﻋ, ﺏﺎﺼﺘﻏﺍ, ﺐﻠﻐﺗ, ﺐﻴﻠﺼﻟﺍ
ﺎﻴﻧﺎﺒﻣﺎﺷ: 
ﻢﻬﻟﺃ: ﻊﺠﺷ, ﻡﺎﻬﻟﺇ, ﻊﺠﺸﻣ, ﻖﺸﻨﺘﺳﺍ
ﺔﻳﺍﺭ: ﻢﻠﻋ, ﻖﺼﻠﻤﻟﺍ, ﺓﺮﻛﺬﺗ
ﻕﻼ﻿ﻃ: ﻖﻠﻄﻣ
ﺔﻘﻋﺎﺻ: ﺔﻘﻋﺎﺻ, ﺭﺎﻤﺴﻣ, ءﺍﻮﺘﻟﺇ, ﻲﻏﺮﺑ
ﺪﻳﺭﻭ: ﺐﺼﻌﻟﺍ
ﻝﻮﻬﺠﻤﻠﻟ-ﻲﻨﺒﻣ: ﺭﻮﻬﻤﺟ, ﻕﺎﻌﻣ
ﺓﻮﻏﺭ: ﺔﻋﺎﻘﻓ
ﻰﺼﺣ: 
ﺭﺰﺌﻣ: ﻦﻀﺣ
ﺐﻛﻮﻛ: 
ﻑﻮﻓﺭ: ﻑﺭ, ﺔﻧﺍﺰﺧ
ﺔﺣﻭﺮﻣ: 
ﻲﺋﺍﻮﺘﺳﺍ: 
ﺔﻠﺣﺮﻣ: ﻲﻓﺍﺮﻏﻮﺗﻮﻓ, ﺡﺮﺴﻤﻟﺍ, ﺓﺮﺘﻓ, ءﺎﻨﺑ, ﺓﻮﻄﺧ
ﻲﻃﺎﺒﺘﻋﺍ: ﻱﻮﻔﻋ
ﻖﻄﻧ: ﻖﻄﻨﻟﺍ, ﺔﺠﻬﻟ, ﻡﻼ﻿ﻛ, ﺚﻔﻧ
ﻖﺒﺋﺯ: 
ﻒﺣﺯ: ﻒﺣﺯ, ﻖﻠﺴﺘﻟﺍ, ﻑﻭﺮﺧ
ﺭﺎﺤﺘﻧﺍ: 
ﻲﻓﺎﺤﺻ: ﻲﻓﺎﺤﺻ
ﻡﺮﺣ: ﻥﺎﻣﺮﺣ, ﺐﺤﺳ, ﺪﻌﺒﺘﺳﺍ, ﺡﺮﻃ
ﺮﻫﺎﻣ: ﺮﻫﺎﻣ, ﻝﺎﻌﻓ, ﻰﻠﻋ-ﺭﺩﺎﻗ, ﺏﻮﻫﻮﻣ, ﺓﺮﺒﺨﻟﺍ-ﻱﻭﺫ, ﻞﻫﺄﺗ, ﻲﻛﺫ
ﺔﻓﺮﺷ: ﺔﻓﺮﺷ, ﻕﺍﻭﺭ
ﺔﻛﻮﺷ: 
ﻞﻣﺎﻋ: ﻞﻣﺎﻋ, ﻞﻣﺎﻋ, ﻞﻣﺎﻋ, ﻞﻣﺎﻋ, ﻊﺑﺎﺗ, ﺐﺗﺎﻛ
ﻞﻤﻌﻟﺍ-ﺏﺭ: ﺲﻴﺋﺭ
ﺽﺮﻌﻟﺍ: ﺔﻣﺎﻋ-ﺓﺭﻮﺼﺑ, ﺽﺮﻌﻟﺍ, ﻊﺳﺍﻭ, ﻒﺼﻧ
ﺞﻋﺰﻨﻣ: ﺞﻋﺰﻨﻣ, ﻞﻌﻔﻨﻣ, ﺐﻀﻏ, ﺓﺭﺎﺛﺇ, ﻪﻴﺒﻨﺗ
ﻢﻬﺗﺍ: ﺐﺠﺷ
ﺵﺎﻌﻣ: ﺪﻋﺎﻘﺗ, ﺔﻠﻤﺠﻟﺍ-ءﺎﻨﺑ
ﻞﻌﻔﻟﺍ: ﻞﻤﻋ, ﻞﻌﻓ-ﺩﺭ
ﺩﺮﻗ: 
ﻝﻮﺒﻘﻣ: ﻞﺒﻘﺗ, ﻝﻮﺒﻗ, ﻝﻮﻘﻌﻣ
ﻊﻴﻗﻮﺗ: 
ﻲﺴﻛﺫﻮﺛﺭﺃ: ﻆﻓﺎﺤﻣ
ﺔﻳﺮﺨﺳ: ﺡﺍﺰﻣ, ءﺍﻮﺘﻟﺇ
ﺔﻧﺎﻀﺣ: ﺔﻋﺭﺰﻣ
ﺔﻌﻧﺎﻤﻣ: ﻰﻨﺒﺠﻌﻳ-ﻢﻟ
ﺩﺍﺮﻴﺘﺳﺍ: ﺔﻣﺪﻘﻤﻟﺍ
ﺔﻠﻌﺷ: 
ﺔﻐﻠﻟﺍ-ﺪﻋﺍﻮﻗ: ﻱﻮﺤﻧ
ﺔﻌﻳﺩﻮﻟﺍ: ﻊﻤﺟ
ﻱﺭﺎﻤﻌﺘﺳﺍ: 
ﺖﺨﻳ: ﺓﺭﺎﺒﻌﻟﺍ, ﺏﺭﺎﻗ
ﺎﻴﻘﻄﻨﻣ-ﻂﺑﺍﺮﺘﻣ: ﺔﺠﻴﺘﻧ, ﺔﻘﻠﺤﻟﺍ, ﻢﻬﻣ, ﺮﻴﺒﻛ, ﺓﺩﺎﻴﻗ, ﺯﺭﺎﺑ, ﺍﺮﻴﺜﻛ, ﺮﻴﺒﻛ, ﻱﺮﻫﻮﺟ, ﻯﺰﻐﻣ-ﺕﺍﺫ
ﺔﺒﻗ: 
ﺔﻛﺎﻤﺳ: 
ﺪﻴﻨﻋ: ﻡﺯﺎﺟ
ﺔﻠﻀﻋ: 
ﻢﺠﺣ: ﻢﺠﺣ, ﻢﺠﺣ, ﺔﻌﺳ, ﺱﺎﻴﻘﻣ, ﺔﻴﻤﻛ
ﻙﺮﻓ: 
ﻥﺎﺒﺟ: 
ﺮﻴﺨﺴﺗ: ﺪﺣﻮﺗ, ﺞﻣﺩ, ﺪﻴﺣﻮﺗ, ﻡﺍﺪﺨﺘﺳﺍ, ﻡﺍﺰﺣ
ﺺﻤﺤﻣ-ﺰﺒﺧ: ﺔﻔﻴﻔﺧ-ﺔﺒﺟﻭ
ﺭﺄﻓ: ﺭﺄﻓ
ﻲﻈﻔﻟ-ﻊﻄﻘﻣ: 
ﺔﺘﻴﺑﺮﺗ: ﻖﻔﺻ, ﻕﺮﻃ
ﺭﺍﻮﺣ: ﻞﺻﺍﻮﺘﻟﺍ, ﺔﺛﺩﺎﺤﻣ
ﺪﻳﺎﺤﻣ: ﻰﺼﺧ
ﺩﺎﻬﺘﺟﺍ: ﺔﺳﺎﻤﺣ, ﺲﺒﺣ
ﺾﻗﺎﻨﺗ: ﺾﻗﺎﻨﺘﻣ, ﻝﺍﺪﺟ, ﺾﻣﺎﻏ, ﺮﻴﺤﻣ, ﻝﺪﺠﻠﻟ-ﺓﺮﻴﺜﻣ, ﺽﻮﻤﻏ, ﺔﻗﺭﺎﻔﻤﻟﺍ, ﺽﺭﺎﻌﺗ, ﻦﻳﺎﺒﺘﻟﺍ, ﺽﺍﺮﺘﻋﺍ
ﻖﻘﺤﻳ: ﻙﺭﺩﺃ, ﻰﻟﺇ-ﻝﻮﺻﻭ, ﻞﺻﻭ
ﺰﻋﺎﻣ: 
ﺮﻫﺩﺰﺗ: ﺭﺎﻫﺩﺯﺍ, ﺮﻫﺩﺰﺗ, ﺭﺎﻫﺩﺯﺍ, ﺓﺮﻫﻮﺟ, ﺓﺮﻫﻮﺟ
ﺽﺮﻓ: ﺽﺮﻓ, ﺽﺮﻓ, ﺩﺪﺣ
ﻝﻮﻬﺠﻣ: 
ﻲﻤﺳﺭ-ﻞﻴﺠﺴﺗ: 
ﻞﺠﻋ: ﻞﺠﻋ
ﺐﻴﺘﻛ: ﻞﻴﻟﺩ, ﻲﻬﻴﺟﻮﺘﻟﺍ, ﺔﻳﺭﺎﺠﺗ-ﺔﻣﻼ﻿ﻋ, ﺓﺩﺎﻴﻗ, ﻲﺳﺭﺪﻤﻟﺍ-ﺏﺎﺘﻜﻟﺍ, ﺕﺎﻤﻴﻠﻌﺗ, ﻢﻴﻋﺯ, ﻑﺮﺸﻤﻟﺍ
ﺮﻬﺻ: ﺮﺨﺒﺗ, ﻥﺎﺑﻭﺫ, ﺭﺎﻬﺼﻧﺍ
ﻑﺬﺣ: ﻮﺤﻣ, ﺏﻭﺬﺗ, ءﺎﻐﻟﺇ, ﻉﺰﻧ, ﺪﻌﺒﺘﺳﺍ, ﻰﻐﻟﺃ, ءﺎﻀﻘﻟﺍ, ﺔﻟﺍﺯﺇ
ﺔﻠﻈﻣ: ﺔﻠﻈﻣ
ءﺍﺬﺣ: ءﺍﺬﺣ, ﻉﺬﺟ
ﻥﺪﻌﻣ: ﺩﻮﻴﻟﺍ, ﺬﻐﻣ, ﻥﺪﻌﻣ
ﺔﻧﺪﻫ: ﺭﺎﻨﻟﺍ-ﻕﻼ﻿ﻃﺇ-ﻒﻗﻭ
ﻂﺑ: 
ﻂﻴﻄﺨﺗ: 
ﻥﻮﺑﺎﺻ: 
ﺔﻴﻣﺩ: ﻲﺒﻴﺒﺣ, ﻪﺒﻌﻟ-ﻪﺳﻭﺮﻋ
ﻰﻤﻈﻋ-ﻞﻜﻴﻫ: 
ﻼ﻿ﻴﻓ: ﺔﻴﻨﺟ
ﺔﻃﺎﻴﺧ: ﺓﺯﺮﻏ, ﻁﺎﺧ
ﺢﻟﺎﺼﺗ: ﻂﺳﻮﺗ, ﺪﺣﻮﺗ, ﺪﻴﺣﻮﺗ
ﺔﻳﻼ﻿ﻏ: 
ﺞﺿﺎﻧ: ﻎﻟﺎﺑ
ﺐﻧﺭﺃ: 
ﻞﺻﻮﻣ: ﻢﻠﺳ, ﺐﻗﺍﺮﻤﻟﺍ, ﻖﺋﺎﺳ, ﻢﻴﻋﺯ
ﺩﺎﻤﺘﻋﺍ: ﺪﻤﺘﻌﺗ, ﺩﺎﻤﺘﻋﺍ, ﻊﺑﺎﺗ, ﻦﻣﺪﻣ, ﺏﺍﺬﺠﻧﻻ﻿ﺍ, ﻒﻗﻮﻣ
ﺐﻋﻻ﻿: ﺩﺆﻣ
ﺓﺮﺸﺣ: ﺕﺎﻓﻵ﻿ﺍ
ﻢﻌﻄﻣ: 
ﺔﻣﻮﺑ: 
ﻑﺮﻄﺘﻣ: ﻞﺗﺎﻘﻣ, ﻑﺮﻄﺘﻣ, ﺔﻴﻣﺪﻘﺗ
ﻢﻴﻘﻣ: ﻦﻃﺍﻮﻣ, ﻱﺪﻠﺑ-ﻭﺃ-ﻲﻠﺤﻣ ﻦﻃﺍﻮﻣ, ﻲﻠﺤﻣ, ﻦﻴﻴﻠﺻﻷ﻿ﺍ-ﻥﺎﻜﺴﻟﺍ
ﻦﻴﻨﺗ: ﺔﻴﻗﺭﻭ-ﺓﺮﺋﺎﻃ
ﻲﻌﻤﺳ-ﺮﻫﺎﻇ: 
ﺶﻄﻌﺘﻣ: 
ﺚﻳﺮﺗ: ﻝﻮﻄﻣ
ﺔﻴﺑﺎﺴﺣ-ﺔﻴﻠﻤﻋ: ﺏﺎﺴﺣ, ﺏﺎﺴﺣ, ﺔﺒﺳﻮﺤﻟﺍ, ﻞﻣﺎﻜﺘﻟﺍﻭ-ﻞﺿﺎﻔﺘﻟﺍ-ﺏﺎﺴﺣ, ﺪﻘﺘﻋﺍ, ﺏﺎﺴﺣ, ﺩﺍﺪﻌﺘﻟﺍ
ﻢﻴﻈﻨﺗ: ﺔﺑﺎﻗﺭ, ﻢﻜﺤﺘﻟﺍ, ﺩﻮﻴﻗ, ﺪﻴﻴﻘﺗ, ﺔﻨﻃﻮﺘﺴﻣ
ﺓﺪﻤﻋ: 
ﺔﻴﻠﻗﺃ: 
ﺫﺍﻮﺤﺘﺳﺍ: ﻞﺼﺤﺗ, ﺐﺴﻛ, ﺐﺴﻛ, ﻝﻮﺻﻭ, ﺮﻓﻮﺗ
ﻢﻳﺪﻗ-ﺏﺭﺎﺤﻣ: ﺮﻴﺒﻛ
ﺍﺮﺘﺴﻛﺭﻭﺃ: 
ﺩﺪﻘﻣ-ﺮﻳﺰﻨﺧ-ﻢﺤﻟ: 
ﺉﻭﺎﺴﻣ: ﻥﺍﺪﻘﻓ, ﻥﺎﻣﺮﺣ, ﺲﻛﺎﻌﻣ, ﺐﻴﻋ, ﻖﺋﺎﻋ
ﺵﺎﻤﻗ: ﺵﺎﻤﻗ, ﺲﺑﻼ﻿ﻣ, ﺔﻔﺸﻨﻣ, ﺵﺎﻤﻗ, ﺔﺠﺴﻧﻷ﻿ﺍ
ﻲﻘﻴﺳﻮﻣ: ﻲﻘﻴﺳﻮﻣ-ﻒﻟﺆﻣ, ﻲﻘﻴﺳﻮﻣ
ﺎﻴﻠﻘﻋ: ﻲﺣﻭﺭ, ﻲﻠﻘﻋ, ﺔﻳﻮﻨﻌﻣ-ﺡﻭﺭ, ﺎﻧﺎﻣ, ﻲﺼﺨﺷ
ﻥﺍﺮﺘﻗﺍ: ﻥﻭﺎﻌﺗ, ﻝﺎﺼﺗﻻ﻿ﺍ, ﺐﻛﺮﻣ, ﻥﺍﺮﺘﻗﺍ, ﺪﻋﺎﺴﻣ, ﺞﻣﺩ, ﻚﺳﺎﻤﺘﻣ, ﺐﻨﺟ-ﻰﻟﺇ-ﺎﺒﻨﺟ, ﺔﻳﺭﺍﺮﻤﺘﺳﻻ﻿ﺍ, ﻂﺑﺍﺭ
ﻢﺋﻼ﻿ﻣ-ﺮﻴﻏ: ﻰﻟﺇ-ﺮﻘﺘﻔﺗ, ﻑﺎﻛ-ﺮﻴﻏ, ﺺﻘﻧ, ﺲﺋﺎﺑ, ﻲﻠﻔﺴﻟﺍ, ﻢﺋﻼ﻿ﻣ-ﺮﻴﻏ, ﺢﻴﺴﻓ, ﻪﻟ-ﻒﺳﺆﻳ, ﻖﺋﻻ﻿-ﺮﻴﻏ, ﺐﺳﺎﻨﻣ-ﺮﻴﻏ
ﻪﻳﺭﺎﻤﻌﻤﻟﺍ-ﻪﺳﺪﻨﻬﻟﺍ: 
ﻥﻮﻤﻴﻟ: 
ﻝﺎﻌﺳ: ﻝﺎﻌﺴﻟﺍ
ﺱﺍﺮﻟﺍ-ﻉﺍﺪﺻ: 
ﺮﺟﺄﺘﺴﻣ: ﻂﻄﺨﻣ
ﺔﺑﻮﺼﺧ: ﺥﺎﺴﻨﺘﺳﺍ
ﻰﻔﺸﻳ---ءﺎﻔﺷ: ءﺎﻔﺷ, ﻦﺴﺤﺗ, ﻦﻴﺴﺤﺗ, ﻦﻴﺴﺤﺗ, ﺞﻟﺎﻋ
ﻥﻮﻌﺴﺗ: 
ﻲﺋﺍﻮﺸﻋ: ﻲﺋﺍﻮﺸﻋ-ﻞﻜﺸﺑ, ﺔﻴﺋﺍﻮﺸﻋ, ﻲﺿﺮﻋ
ﺔﻘﻌﻠﻣ: ﻮﻟﺩ
ﺔﻧﻮﻟﺎﺑ: 
ﺮﻴﺷﺎﺒﻃ: ﺺﺟ
ﻲﺟﺎﺘﻨﺘﺳﺍ-ﺮﻫﺎﻇ: 
ﺮﺷﺎﻨﻟﺍ: ﺭﺮﺤﻣ
ﻞﺧ: 
ﺩﺎﻣﺭ: ﻱﺩﺎﻣﺭ, ﻱﺩﺎﻣﺮﻟﺍ-ﻥﻮﻠﻟﺍ
ﻱﻮﺸﺣ: ﺔﻳﺭﻮﺘﺳﺪﻟﺍ-ﻦﻴﻤﻴﻟﺍ-ءﺍﺩﺃ
ءﺎﻴﺣﺇ: ءﺎﻴﺣﺇ
ﺮﺛﺄﺘﻟﺍ-ﻊﻳﺮﺳ: ﺔﺿﺮﻋ, ﺱﺎﺴﺣ, ﻝﻮﻘﻌﻣ, ﻲﻔﻃﺎﻋ, ﺔﺿﺮﻋ
ﻖﻔﻧ: ﻭﺮﺘﻤﻟﺍ
ﺰﻐﻟ: ﻂﻠﺨﻟﺍ, ﺮﻴﺤﻣ
ﺔﻴﻟﺁ: ءﺍﺮﺟﺇ, ﻦﻴﺗﻭﺭ, ﻲﺠﻬﻨﻣ, ﺔﻴﻟﺁ
ﺕﺎﻴﺿﺎﻳﺮﻟﺍ: ﺕﺎﻴﺿﺎﻳﺮﻟﺍ, ﻲﺿﺎﻳﺭ
ﻰﺷﻼ﻿ﺗ: 
ﺪﺒﻛ: 
sublative-ﺔﻟﺎﺣ: 
ﺲﻄﻏ: ﺹﻮﻏ, ﻦﻴﻤﻀﺗ, ﻁﺎﻘﺳﺇ, ﺮﺜﻌﺗ, ﺙﻭﺪﺣ, ﻞﻴﻣ, ﺭﺪﺤﻧﺍ, ﺭﺪﺤﻨﻣ, ﻞﻴﻣ, ﻊﻘﻧ
ﺓﺪﺣﻭ: ﺓﺪﺣﻭ, ﻥﺎﻴﻛ, ﺓﺪﺣﻭ, ﺭﺎﻘﻨﻣ, ﺩﺮﻔﻤﻟﺍ-ﺔﻐﻴﺻ
ﺭﺎﻜﺘﺣﺍ: ﺔﻳﺮﺼﺣ
ﺭﺎﻤﻘﻟﺍ-ﺐﻌﻟ: ﺓﺮﻣﺎﻐﻣ, ﺔﺒﻌﻟ, ﺓﺍﺭﺎﺒﻣ, ﺺﻴﻠﺨﺗ, ﻪﺒﻌﻟ-ﻪﺳﻭﺮﻋ
ﺔﺻﺍﻮﻏ: ءﺎﻤﻟﺍ-ﺖﺤﺗ
ﻝﺍﺰﻟﺯ: ﺞﻨﺸﺗ
ﺮﺒﺘﺨﻣ: ﺮﺒﺘﺨﻣ
ﻦﻴﻠﻓ: ﺮﻄﻓ, ﺮﻄﻓ, ﺔﻌﺒﻗ
ﺕﺍﺬﻟﺍ-ﺔﺒﻗﺍﺮﻣ: 
ﺍﺫﻮﺑ: 
ﺔﻜﺳﺎﻤﺘﻣ: ﺔﻛﺎﻴﺣ, ﺞﺴﻧ, ﻊﻓﺩ, ﻙﻮﺒﺤﻣ, ﺪﻘﻋ, ﺓﺪﻘﻌﻟﺍ, ﺔﻠﻳﺪﺟ
ﺓﺭﺎﻔﺴﻟﺍ: 
ﺪﻌﺑﻷ﻿ﺍ: 
ﻲﺤﻳﺮﺼﺗ-ﺝﺍﺰﻣ: 
ﺰﻴﻔﺤﺘﻟﺍ: ﻊﻴﺠﺸﺗ, ﺰﻓﺎﺣ, ﺔﻔﺻﻭ, ﺰﻴﻔﺤﺘﻟﺍ, ﻊﻓﺍﺩ
ﺔﺗﻻ﻿ﻮﻛﻮﺷ: ﻯﻮﻠﺣ
ﺔﻓﺪﺻ: ﺔﺻﺮﻓ, ﺔﻋﻮﻤﺠﻣ, ﻪﻟ-ﻒﺳﺆﻳ, ﻲﺋﺍﻮﺸﻋ-ﻞﻜﺸﺑ, ﻲﺿﺮﻋ, ﺓﺍﺭﺎﺒﻣ
ﺯﺎﻔﻗ: 
ﻊﻛﺭ: 
ﺎﻴﻓﺍﺮﻐﺟ: 
ﺭﺎﻤﺜﺘﺳﺍ: ﺮﻤﺜﺘﺳﺍ, ﻉﻭﺮﺸﻣ
ﻲﻈﻔﻟ: ﻕﻮﻄﻨﻣ, ﻲﻬﻔﺷ, ﻦﻴﻬﻣ
ﻲﺋﺰﺟ-ﻪﺑﺎﺸﺗ: ﺓﺍﻭﺎﺴﻣ, ﻪﺑﺎﺸﺗ, ﺏﺍﺬﺠﻧﻻ﻿ﺍ, ﺔﺑﺍﺮﻘﻟﺍ, ﺔﺒﺴﻧ
ﻲﻧﺎﻤﻠﻋ: ﻊﺿﻭ
ﺮﻘﺼﻟﺍ-ﺮﺋﺎﻃ: ﺮﺴﻧ
ﺲﻔﻨﻟﺍ-ﻢﻠﻋ: 
ﻂﺑﺭ: ﻂﺑﺭ, ﻂﺑﺭ, ﻂﺑﺭ, ﻪﺑﺎﺼﻋ---ﺓﺩﺎﻤﺿ, ﻝﺎﻘﺘﻋﺍ, ﻖﻓﺮﻳ
ﺓﺩﺮﺧ: ءﺎﻐﻟﺇ, ﺔﻣﺎﻤﻗ, ﺔﻣﺎﻤﻗ, ﺔﻴﻈﺷ
ﺭﻭﺩ: ﺓﺮﻜﺑ, ﻢﺳﺎﻘﺘﻳ, ﻥﻭﺰﺨﻣ, ﻙﺭﺎﺸﻣ
ﺔﻋﺮﺟ: ﺔﻴﻤﻛ
ﻥﻮﻤﻠﺴﻟﺍ-ﻚﻤﺳ: 
ﻎﻧﺩﻮﺑ: 
ﺏﺍﺬﺟ: ﺏﺍﺬﺟ
ﺔﺨﻀﻣ: ﺔﻠﺒﻨﻗ
ﻦﻴﺠﺴﻛﺃ: 
ﺓﺩﺎﻬﺷ: 
ﺔﻴﻟﺍﺪﻴﻣ: 
ﺔﻏﻼ﻿ﺑ: 
ﻂﺸﻛ: ﺵﺪﺧ, ﻂﺸﻛ
ﻑﺍﺬﺠﻣ: ﺔﻓﺮﺠﻣ, ﺔﻔﻨﻋﺰﻟﺍ
ﺏﻮﻜﺴﻠﺗ: ﺮﻬﺠﻣ
ﺓﺩﻼ﻿ﻗ: ﺔﻤﻳﺰﻫ, ﻥﻮﺠﻌﻣ
ﺔﻴﺋﻼ﻿ﻣﻹ﻿ﺍ: ﺮﺤﺳ
ﻲﻜﺴﻳﻭ: 
ﻑﺎﺼﻔﺻ: ﻰﻋﺮﻣ
ﻞﻤﺟ: 
ﻱﻭﺎﻬﻟﺍ: 
ﺝﻭﺮﺧ: ﺮﻳﺪﺼﺗ, ﺬﻔﻨﻣ, ﻍﻭﺰﺑ, ﺞﺗﺎﻨﻟﺍ
ﺔﻴﺗﺍﺫ-ﺓﺮﻴﺳ: 
ﺭﺎﻤﺤﻟﺍ: 
ﺎﻳﺮﻬﺷ: 
ﻞﻫﺎﺠﺗ: ﻝﺎﻤﻫﺇ, ﻞﻄﺗ, ﺮﻈﻨﻟﺍ-ﻑﺮﺻ, ﻞﻬﺟ
ﺔﻠﻄﻋ: ﺭﺩﺎﻏ, ﺔﻠﻄﻋ, ﻡﺎﻤﺠﺘﺳﺍ, ﺔﺣﺍﺭ
ﺮﻘﻧﺍ: ﺓﺮﻣﺯ, ﺔﻌﻗﺮﻓ
ﻱﻮﻀﻴﺑ: 
ﻁﺎﻄﻣ: ﻁﺎﻄﻣ, ﻥﺮﻣ
ﺱﻮﻣﺎﻗ: ﻲﻤﺠﻌﻣ, ﻢﺠﻌﻣ
ﺮﻳﺰﻨﺧ-ﻢﺤﻟ: ﺬﺨﻓ, ﻑﺩﺭ
ﺮﻄﻤﻟﺍ-ﺱﻮﻗ: 
ﻚﻠﻬﺘﺴﺗ: ﻙﻼ﻿ﻬﺘﺳﺍ, ﻡﺍﺪﺨﺘﺳﺍ, ﺮﺸﻧ
ﻕﺎﺼﺑ: ﻞﻴﻣﺯ, ﻥﺎﺴﻟ
ﻥﺍﺰﺧ: ﻥﺍﺰﺧ, ﺔﻳﻭﺎﺣ, ﺔﺒﻳﺮﺿ
ﻞﻴﻣﺯ: ﻲﻧﻭﺎﻌﺗ, ﻞﻴﻣﺯ, ﻞﻴﻣﺯ, ﺪﻋﺎﺴﻣ
ﺔﺷﺍﺮﻓ: 
ﺔﻄﻳﺮﺧ: ﻲﻧﺎﻴﺑ-ﻢﺳﺭ, ﻲﻧﺎﻴﺑ-ﻢﺳﺭ, ﻲﻧﺎﻴﺑ, ﺕﺎﻣﻮﺳﺮﻟﺍ, ﻲﻨﻣﺰﻟﺍ-ﻝﻭﺪﺠﻟﺍ, ﻂﻄﺨﻣ
ﻡﺃﻮﺘﻟﺍ: ﻲﺟﻭﺯ-ﺩﺪﻋ, ﺝﻭﺩﺰﻣ
ﻞﻘﺘﺴﻣ: ﻞﻘﺘﺴﻣ, ﺔﻳﺮﺤﺑ, ﺍﺪﻴﻌﺑ
ﻥﺍﺭﺰﻴﺧ: 
ﺮﺟﺎﺗ: ﺔﺋﺰﺠﺘﻟﺍ-ﺮﺟﺎﺘﻣ, ﻊﺋﺎﺑ, ﺕﺎﻌﻴﺒﻣ-ﺏﻭﺪﻨﻣ, ﺮﺟﺎﺗ
ﻢﻛﺍﺮﺗ: ﻊﻤﺟ, ﺔﻋﻮﻤﺠﻣ, ﺰﻴﻛﺮﺗ
ﺶﺘﻔﻣ: ﺕﺎﺑﺎﺴﺣ-ﻖﻗﺪﻣ, ﺐﻗﺍﺮﻤﻟﺍ
ﺔﻤﻘﻟ: ﺔﻴﻈﺷ, ﺔﺤﻳﺮﺷ, ءﺰﺟ
ﺱﻮﺑﺎﻛ: ﻢﻠﺣ
ﻰﺑﺮﻣ: ﻡﻼ﻿ﻫ
ﻒﺤﺘﻣ: 
ﺔﻳﺪﺠﺑﻷ﻿ﺍ: ﺔﻳﺪﺠﺑﻷ﻿ﺍ-ﻑﻭﺮﺤﻟﺍ-ﺐﺴﺣ ﺐﺗﺮﻣ
ﺮﺜﻌﺒﺗ: ﺮﺸﻧ, ﺭﺎﺸﺘﻧﺍ
ﺓﺭﺎﻏ: ﻝﻼ﻿ﺘﺣﺍ, ﻭﺰﻏ, ءﺍﺪﺘﻋﺍ, ﻲﻣﻮﺠﻫ, ﺔﻳﺍﺪﺑ, ﺓﺪﺋﺎﺴﻟﺍ, ﺩﺎﻌﺑﺇ
ﻒﺸﻛ: ﻦﻠﻋﺃ, ﻒﺸﻛ, ﻒﺸﻛ, ﻒﺸﻜﺗ, ﻚﻓ, ﺮﺸﻧ, ﻒﺸﺘﻛﺍ
ﻦﻔﻌﺗ: ﻝﻼ﻿ﺤﻤﺿﻻ﻿ﺍ, ﺭﻮﻫﺪﺗ
ﻲﻧﺍﻭﺪﻌﻟﺍ: ﺞﻋﺯﺃ, ﺚﺒﻌﺗ, ﻝﻼ﻿ﺘﺣﺍ, ﻥﺍﻭﺪﻋ, ﻲﻣﻮﺠﻫ, ﻡﺯﺎﺟ
ﻙﺎﻜﺘﺣﺍ: 
ﻱﺮﺤﺑ-ﻒﻴﺻﺭ: 
ﺕﻮﺒﻜﻨﻋ: 
ﺲﻃﺎﻄﺒﻟﺍ: 
ﺔﻌﺟﺍﺮﻤﻟﺍ: ﻂﺒﺿ, ﻞﻳﺪﻌﺗ, ﻊﺟﺍﺭ, ﺢﻴﺤﺼﺗ, ﻞﻳﺪﻌﺗ, ﺽﺍﺮﻌﺘﺳﺍ, ﻖﻴﻗﺪﺘﻟﺍ
ﻊﺸﺟ: ﻉﺎﻤﻃ
ﻪﻧﺍﻭﻷ﻿-ﻖﺑﺎﺳ: ﺮﻜﺒﻣ-ﺖﻗﻭ-ﻲﻓ, ءﻮﺘﻧ
ﺏﺮﺿ: ﺏﺮﺿ, ﺮﺛﺎﻜﺗ, ءﻮﺘﻧ
ﻊﻳﺮﺳ-ﻥﺍﺭﻭﺩ: ﺏﻭﺎﻨﺗ, ﻥﺍﺭﻭﺩ, ﻲﻧﻭﺰﻠﺣ, ﻂﻴﺧ, ءﺍﻮﺘﻟﺇ
ﺕﺎﻴﺋﺎﺼﺣﺇ: ﻲﺋﺎﺼﺣﺇ, ﻞﻜﺸﻟﺍ, ﺔﺷﺩﺭﺩ
ﻢﻳﻮﻘﺗ: ﻲﻨﻣﺰﻟﺍ-ﻝﻭﺪﺠﻟﺍ, ﻲﻨﻣﺰﻟﺍ-ﻝﻭﺪﺠﻟﺍ, ﺕﺍﺮﻛﺬﻣ, ﻱﺃﺭ
ﺢﻴﺷﺮﺗ: ﺢﺷﺮﺗ, ﺪﻋﻮﻣ, ﺭﺎﻴﺘﺧﺍ, ﻙﺎﺒﺘﺷﺍ
ﻥﻮﻴﻠﻳﺮﺗ: 
ﺔﻴﻠﻋ: ﺢﻳﺭ
ﺖﺒﺜﻣ-ﺝﺍﺰﻣ: 
ﺕﺎﻘﻴﺒﻄﺘﻟﺍ: 
ﻲﻤﺳﻻ﻿ﺍ: 
ﺎﺿﺮﻟﺍ-ﻡﺪﻋ: 
ﻯﻭﺪﻋ: ﺔﺑﺎﺻﺇ, ﺔﺑﺎﺻﺇ, ﻝﺎﻘﺘﻧﺍ, ﺔﻛﺮﺣ-ﻞﻗﺎﻧ, ﺪﻌﻣ
ﻖﻳﺮﺑﺇ: ءﺎﻧﺇ
ﻪﻴﻔﺘﻛ-ﺰﻫ: ﻞﺸﻧ
ﺪﺋﺍﺭ: ﺪﺋﺍﺭ, ﺔﻴﻌﻴﻠﻄﻟﺍ
ﻝﺎﻔﻏﺇ: ﻲﺿﺍﺮﺘﻓﻻ﻿ﺍ, ﺔﻗﺎﻤﺣ, ﺺﻘﻧ, ﻝﺎﻤﻫﺇ, ﻝﺎﻤﻫﺇ, ﺔﻟﺍﺯﺇ
ﺐﻧﺮﻜﻟﺍ: 
ﻲﺿﺎﻳﺭ: ﺔﻴﺿﺎﻳﺮﻟﺍ-ﺏﺎﻌﻟﻻ﻿ﺍ, ﻲﺿﺎﻳﺭ, ﻲﺿﺎﻳﺭ
ﺮﻜﺴﻟﺍ: ﺮﻜﺴﻟﺍ
idiophone: 
ﺔﻌﻓﺍﺭ: ﺐﻘﻧ
ﺥﻮﻴﺸﻟﺍ-ﺲﻠﺠﻣ-ﻮﻀﻋ: 
ﺔﻴﺣﺰﻗ: 
ﺔﻠﻤﻧ: 
ﻖﺑ: 
ﻞﻣﺎﺣ: ﺔﻴﻣﻮﻣﺃ
ﻞﺟﺎﻋ: ﻝﻮﻄﻫ, ﺐﺳﺍﻭﺭ, ﺔﻋﺮﺳ, ﻞﺟﺎﻋ, ﻉﺭﺎﺴﺗ
ﻞﺣﺎﻜﻟﺍ: 
ﻒﻴﻨﺼﺗ: ﺯﺮﻓ, ﻒﻨﺻ, ﻒﻨﺼﻣ
ﺮﻴﻐﺘﻣ: ﺕﻭﺎﻔﺗ
ﻒﻟ: ﺔﻣﺰﺣ, ءﺰﺟ, ﺔﻣﺰﺣ, ﺔﻣﺯﺭ, ﻒﻟ, ﻑﻼ﻿ﻏ, ﻲﻄﻐﻳ-،ءﺎﻄﻏ, ﺔﻴﻄﻐﺗ
ﺪﻌﺠﻣ: ﺔﻘﻴﻠﺣ, ﻞﺠﻌﺘﺳﺍ, ﻒﻠﻣ, ﺮﻳﺮﻤﺘﻟﺍ, ﻥﻭﺰﻠﺣ
ﺖﻳﺮﺒﻛ: ﺖﻳﺮﺒﻛ, ﺭﻮﺴﻜﻣ
ءﻼ﻿ﻣﺇ: 
ﺯﺮﺑ: ﺮﻬﻇ, ﻲﺟﺭﺎﺧ-ﺮﻬﻈﻣ, ﺄﺸﻨﺗ, ﻍﻭﺰﺑ, ﻝﺎﻘﺘﺳﺍ
ﻉﺪﻔﺿ: 
ﻁﺮﻔﻣ-ﺔﻟﺎﺣ: 
ﺞﻨﻔﺳﺇ: ﺮﻄﻓ, ﺮﻄﻓ
ﺞﻋﺰﻣ: ﺞﻋﺰﻣ, ﺞﻋﺯﺃ, ﺞﻋﺰﻳ, ﺞﻴﺠﺿ, ﺞﻋﺰﻳ, ﻞﻤﻣ, ﺔﻴﺳﺎﺴﺤﻟﺍ-ﺪﻳﺪﺷ, ﻖﻠﻘﻣ
ﺏﺎﺠﻨﺳ: 
ﻦﺤﻃ: ﻒﺼﻧ, ﻒﺼﻧ
irrealis-ﺝﺍﺰﻣ: 
ﻥﺎﻛﺮﺑ: 
ﻞﺧﺍﺪﻟﺍ-ﻲﻓ: ﻲﻠﺧﺍﺩ, ﻞﺧﺍﺩ-ﻲﻓ, ﻦﻤﺿ, ﻰﻨﺒﻣ
ﻝﻼ﻿ﻐﺘﺳﺍ: ﻡﺍﺪﺨﺘﺳﺍ, ﺏﺎﻌﻴﺘﺳﺍ, ﺯﺎﺠﻧﺇ, ﻑﺎﺸﻜﺘﺳﺇ
ﺔﻴﺟﻮﻟﻮﻴﺠﻟﺍ: 
ﺮﻔﺴﻟﺍ-ﺯﺍﻮﺟ: 
ﻕﻼ﻿ﺧﻻ﻿ﺍ-ﻢﻳﺪﻋ: ﺮﻳﺮﺷ, ﺪﺳﺎﻓ
ﺖﻳﻮﻜﺴﺑ: ﻲﻛﻮﻛ
ﻥﻭﺎﻌﺗ: ﻥﻭﺎﻌﺗ, ﺔﻛﺍﺮﺷ, ﺞﻣﺩ, ﺓﺪﻋﺎﺴﻣ
ﺡﻮﻟ: ﺔﺻﺎﺻﺭ, ءﺍﻭﺩ-ﺔﺒﺣ, ﺡﻮﻟ
ءﺎﺧﺮﺘﺳﺍ: ﺩﻮﻛﺭ-ﺓﺮﺘﻓ, ءﺎﺧﺮﺘﺳﺍ, ﻍﺍﺮﻔﻟﺍ-ﺖﻗﻭ, ﺡﺮﺘﺳﺍ, ﺢﻳﺮﻣ, ﻡﺎﻤﺠﺘﺳﺍ
ﺓﺭﺬﻟﺍ: ﻱﺭﺬﻟﺍ, ﻢﻴﺴﺟ, ﻲﺼﺨﺷ
ﺯﺪﻳﻹ﻿ﺍ: ﺓﺪﻋﺎﺴﻣ, ﺔﺣﺍﺭ, ﺪﻋﺎﺴﻣ
ﻡﺮﻫ: 
ﺓﺭﻭﺩ: ﺓﺮﺋﺍﺩ, ﻝﻭﺍﺪﺗ, ﺩﺩﺮﺗ, ﻥﺍﺭﻭﺩ, ﺏﻭﺎﻨﺗ, ﺔﺟﺍﺭﺩ, ﺔﻴﺋﺍﻮﻫ-ﺔﺟﺍﺭﺩ
ﺓﻮﻔﻏ: 
ﻲﻋﺮﺷ-ﺮﻴﻏ: ﻰﻧﻮﻧﺎﻗ-ﺮﻴﻏ
ﻚﺣ: ﺐﻠﺨﻣ, ﻡﺪﻘﻟﺍ-ﻊﺒﺻﺍ
ءﺎﻴﺣ: ﻝﻮﺠﺧ, ﺽﺎﺒﻘﻧﺍ
ﻑﻮﺴﻛ: ﺾﻣﺎﻏ
ﺩﻮﻋ: ﻞﺋﺎﻣ
ﺔﺴﻨﻜﻣ: 
ﺔﺣﻮﻟ: ﻖﺒﻃ, ﺡﻮﻟ, ﺔﺣﻮﻟ, ﺲﻠﺠﻣ, ﺔﻋﻮﻤﺠﻣ, ﺔﻨﺠﻟ
ﻚﻠﻔﻟﺍ-ﻢﻠﻋ: 
ﺔﻫﺎﺘﻣ: 
ﺔﻴﺳﺍﺭﺩ-ﺔﺤﻨﻣ: ﺔﻳﺎﻋﺭ
ﺓﺎﻔﺤﻠﺳ: 
ﺭﺎﺸﺘﺴﻣ: ﺢﺻﺎﻨﻟﺍ, ﺢﺼﻧ
ﻒﻴﻟ: ﻒﻴﻟ, ﺔﻣﺰﺣ
ﺖﻴﻜﻳﺮﻛ: 
ﺔﻣﺎﻤﺣ: 
ﻒﻴﻜﺗ: ﻒﻴﻜﺗ, ﺕﺍﺰﻴﻬﺠﺗ, ﻡﺍﺰﺘﻟﻻ﻿ﺍ, ﻞﻳﺪﻌﺗ, ﻂﺒﺿ
ﺚﻠﺜﻣ: 
ﻕﻭﺪﻨﺻ-ﻦﻴﻣﺃ: 
ﻦﻴﺟﻭﺭﺪﻴﻫ: 
ﺶﻫ: ﺱﺎﺴﺣ, ﺶﻫ
ﺔﻌﺑﺎﻃ: 
ﻖﻨﺧ: 
ﻦﻣﺰﻣ: ﻡﻭﺎﻘﻣ
ﺐﻠﻐﺗ: ءﺎﻘﻟ, ﻒﻴﻜﺗ, ﺔﻬﺟﺍﻮﻣ, ﺽﻮﻋ, ﺐﻠﻐﺗ, ﺔﺠﻟﺎﻌﻣ, ﻲﻠﺑﺎﻘﺘﻟﺍ, ﺾﺒﻘﻣ
ﺔﻠﻀﻌﻣ: 
ﺔﺳﺪﻨﻫ: ﺔﻴﻨﻘﺗ, ﺎﻴﻨﻓ
ﺮﻳﻮﺼﺗ-ﺔﻟﺍ: ﺔﻓﺮﻏ
ﺭﺍﺬﺘﻋﺍ: ﺭﺍﺬﺘﻋﺍ, ﺍﺭﺬﻋ-ﻚﺤﻴﻤﺘﺳﺍ
ﻖﻌﻟ: 
ﺔﺼﻗﺍﺭ: 
ﺓﺮﺠﻫ: ﺓﺮﺠﻬﻟﺍ, ﺓﺮﺠﻫ
ﺲﻨﺗ: 
ﻱﺮﻘﻔﻟﺍ-ﺩﻮﻤﻌﻟﺍ: 
ﻰﻠﻘﺗ: 
ﻝﻮﻧ: ﻖﻠﻐﻣ, ﻕﻼ﻿ﻏﺇ
ﺔﻨﻌﻃ: ﺔﻏﺪﻟ, ﺐﻘﺛ, ﻉﺍﺰﺘﻧﺍ, ﺔﻟﻭﺎﺤﻣ, ﻝﻭﺎﺣ
ﻱﺮﺴﻟﺍ-ﺰﻣﺮﻟﺍ: ﺓﺭﺎﺷﺇ, ﺔﻠﻳﺪﺟ, ﺭﺎﻌﺷ
ﺓﺮﻛ-ﻒﺼﻧ: ﺩﺎﺣ, ﺢﻴﻤﻠﺗ
ﺔﻴﺠﻴﺗﺍﺮﺘﺳﺇ: ﻲﺠﻴﺗﺍﺮﺘﺳﺇ
ﺰﺗﺭﺍﻮﻛ: 
ﺺﻘﻣ: ﺐﺤﺳ, ﺐﺤﺳ
ﺔﻳﺭﻭﺩ: 
ﺪﻴﻠﺠﻟﺍ-ﺮﻬﻧ: 
ﻖﻳﺮﻄﻟﺍ-ﻒﺼﺘﻨﻣ-ﻲﻓ: ﻒﺼﻧ, ﺎﻴﺋﺰﺟ, ﻒﺼﻧ, ﻂﺳﻭ, ﻒﺼﺘﻨﻣ
ﺓﺮﻛﺬﻣ: ﺓﺪﻫﺎﻌﻣ, ﺪﻘﻋ, ﺔﻴﻗﺎﻔﺗﺍ, ﻕﺎﻔﺗﺍ, ﺓﺮﻛﺬﻣ
ﻁﻭﺮﺨﻣ: ﺐﺑﺪﻣ
ﺮﻇﺎﻨﺗ: 
ﺔﻌﻨﺼﻤﻟﺍ-ﺔﻛﺮﺸﻟﺍ: ﺮﻤﺜﻣ, ﺞﺘﻨﻣ, ﻲﻟﻻ﻿ﺪﺘﺳﺍ
ﻪﻴﻠﻋ-ﻰﻋﺪﻤﻟﺍ: ﻡﺎﺤﻣ
ﺪﺠﺴﻣ: 
ﺞﻧﺮﻄﺷ: 
ﻡﻮﺳﺭ: ﺔﻤﻬﺗ, ﻡﻮﺳﺭ, ﺔﻴﺤﺿ, ﻞﻜﺸﻟﺍ, ﺪﻴﻘﻌﺗ
ﺯﺮﻜﻟﺍ: 
ﺭﺎﺸﺘﻧﻻ﻿ﺍ-ﻊﺳﺍﻭ: ﻕﺎﻄﻨﻟﺍ-ﺔﻌﺳﺍﻭ, ﻊﺳﺍﻭ-ﻮﺤﻧ-ﻰﻠﻋ, ﺭﺎﺸﺘﻧﺍ, ﻊﺳﺍﻭ, ﻊﺳﺍﻭ
ﺮﺜﻌﺗ: ﺮﺜﻌﺗ
ﺔﻨﺣﺎﺷ: ﺔﻨﺣﺎﺷ, ﻦﺤﺷ, ﻦﺣﺎﺷ
ﻝﺩﺮﺧ: 
ﺔﺋﺎﻤﻟﺍ-ﻰﻓ: ﻪﻳﻮﺌﻣ-ﻪﺒﺴﻧ, ﺖﻨﺳ
ﻲﻨﻠﻋ-ﺩﺍﺰﻣ: ﺮﻌﺴﻟﺍ-ﺾﻴﻔﺨﺗ
ﻝﺎﺑﺮﻏ: 
ﺮﻘﺘﺴﻣ-ﺮﻴﻏ: ﺮﻘﺘﺴﻣ-ﺮﻴﻏ, ﺭﺍﺮﻘﺘﺳﻻ﻿ﺍ-ﻡﺪﻋ, ﺪﻛﺆﻣ-ﺮﻴﻏ, ﺮﻘﺘﺴﻣ-ﺮﻴﻏ
ﺲﻴﻃﺎﻨﻐﻣ: 
ﺺﻣ: ﺏﺎﻌﻴﺘﺳﺍ, ﻊﻘﻧ
ﻡﻼ﻿ﺳﻹ﻿ﺍ: 
ﻊﺑﺎﺻﻷ﻿ﺍ-ﺱﻭﺅﺭ-ﻰﻠﻋ: ﻡﺪﻘﻟﺍ-ﻊﺒﺻﺍ, ﺩﺍﺪﻌﺘﺳﺍ, ﺐﻏﺍﺭ
ءﺎﺸﻏ: 
ﺔﻗﻼ﻿ﺣ: 
ﺭﺎﺘﻴﻏ: 
ﻊﻣﻻ﻿: ﻕﺮﺸﻣ, .ﺎﺣﺎﺒﺻ, ﻱﺮﻘﺒﻋ
ﺭﺍﺩﺭﺪﻟﺍ-ﺐﺸﺧ: 
ﻖﻠﺣ: ﻊﻓﺭ, ﻡﻮﺤﻳ, ﻖﻠﺣ, ﺔﻠﺣﺭ
ﺮﻴﻤﺿ-ﺔﻣﻼ﻿ﻋ: 
ﻲﺳﺎﺳﺃ: ﺔﺻﺎﺼﻗ, ﺱﻮﻗ, ﻲﺳﺎﺳﺃ, ﻲﺳﺎﺳﺃ, ﺔﻴﺳﺎﺳﻷ﻿ﺍ, ﻲﺴﻴﺋﺭ, ﺪﺋﺍﺭ, ﻰﺼﻗﺃ, ﻲﺋﺍﺪﺘﺑﺍ
ﻞﺑﺎﺗ: ﺫﺬﻠﺗ
ﺔﻟﺎﻔﻛ: ﻁﺎﺑﺭ, ﺪﻴﻛﻮﺗ, ﺪﻬﻌﺗ, ﻥﺎﻤﺿ
ﻞﻗﺎﻨﻟﺍ: ﺕﻼ﻿ﻗﺎﻧ, ﻰﻋﺪﻣ, ﻝﺎﻤﺣ
ﺯﺍﺰﺘﻫﺍ: ﻯﺪﺻ
ﺶﻔﻧ: ﺏﺬﺟ, ﺞﻋﺰﻳ, ﺐﻀﻏ, ﻦﺘﻓ
ﺙﺍﺮﺤﻣ: ﻞﺣ, ﺔﻓﺮﺠﻣ, ﻒﻄﺧ
ﻲﺟﻮﻟﻮﻴﺴﻓ: ﻱﺪﺴﺟ
ﺏﺍﺭﺰﻣ: ﻑﺍﺰﻨﺘﺳﺍ
ﺐﻧﺬﻤﻟﺍ: ﺐﻧﺬﻤﻟﺍ
ﻰﻄﺳﻮﻟﺍ-ﻥﻭﺮﻘﻟﺍ-ﻦﻣ: ﻒﺼﺘﻨﻣ
ﺭﻮﻔﺼﻋ: 
ﺾﻳﻮﻌﺗ: ﺄﻓﺎﻛ, ﺾﻳﻮﻌﺗ, ﺽﻮﻋ, ﺺﻠﺧ, ﺏﺃ-ﻚﻴﻣ, ﺏﺃ-ﻚﻴﻣ
ﻚﻴﺘﺳﻼ﻿ﺒﻟﺍ: 
ﺔﻴﺷﺎﺣ: 
ﺭﺍﺪﻣ: ﻞﺼﻔﻟﺍ, ﻰﺳﺭﺪﻣ-ﻞﺼﻓ, ﺭﺎﺴﻣ
ﺪﺼﺘﻘﻣ: ﻊﺿﺍﻮﺘﻣ
ﻒﻟﻮﺟ: 
ﺮﻔﺻ: ءﻲﺷ-ﻻ﻿
ﺔﻗﺎﻗﺭ: ﺔﻌﻄﻗ, ﺔﻴﻈﺷ, ﺔﺤﻳﺮﺷ, ﺔﻌﻄﻗ
ﻢﻠﻇ: ﻊﻤﻗ, ﻊﻤﻗ, ﺾﻔﺧ, ﻰﻠﻋ-ﻰﻐﻄﺗ
ﺏءﺎﺜﺗ: ﺮﺨﺒﺗ
ﺓﺍﻭﺎﺴﻤﻟﺍ-ﻡﺪﻋ: 
ﺪﻠﺨﻟﺍ: ﻢﺴﻤﺳ, ﻦﻴﻃ
ﺭﺎﺨﻔﻟﺍ-ﺔﻋﺎﻨﺻ: 
ﻝﺰﻨﻣ-ﻪﺑﺭ: 
ﺭﺍﺩﻭﺎﺠﻟﺍ-ﺏﻮﺒﺣ: 
ﻰﺼﻋ: ﻙﺎﻬﺘﻧﺍ
ﺢﻣﺎﺴﺘﻣ: ﺢﻣﺎﺴﺗ
ﻦﻴﻨﺟ: ﺔﻠﺠﻌﻟﺍ-ﺭﺎﻃﺇ, ﺔﻠﺠﻌﻟﺍ-ﺭﺎﻃﺇ, ﻦﻴﻨﺟ, ﻦﻴﻨﺟ, ﺓﺍﻮﻧ
ﻢﺠﻨﻣ-ﻞﻣﺎﻋ: ﻲﻧﻮﻧﺎﻘﻟﺍ-ﻦﺴﻟﺍ-ﺖﺤﺗ
ﺪﻴﺸﻧ: ﺭﺪﻘﻧ, ﻖﻴﻔﺼﺗ, ﻖﻔﺻ
ﺓﺮﻴﻤﺧ: ﺓﺮﻴﻤﺧ, ﺔﻨﻴﺠﻋ
ﺓﺯﺎﺘﻤﻤﻟﺍ: ﺓﻭﻼ﻿ﻋ, ﺓﺰﺋﺎﺟ, ﺓﺰﺋﺎﺟ
ﻕﻮﻗﺮﺑ: 
ﺱﻼ﻿ﻓﺇ: ﻞﺸﻓ
ﻱﺭ: 
ﻉﺎﻨﻌﻧ: ﻯﻮﻠﺣ
ﻲﻟﺎﻤﺳﺃﺭ: ﺔﻴﻟﺎﻤﺳﺃﺭ
ﺔﻧﻭﺮﻣ: ﺔﻧﻭﺮﻣ
ﺵﺮﻘﻟﺍ-ﻚﻤﺳ: 
ﺪﻴﻨﺠﺗ: ﺔﻋﺪﺨﻟﺍ, ﺉﺪﺘﺒﻣ
ﻦﻳﺰﺨﺗ: ﻰﻠﻋ-ﻅﺎﻔﺤﻟﺍ, ﻆﻔﺣ, ﻦﻳﺰﺨﺗ, ﺮﻴﻓﻮﺗ
ﺔﻴﻌﻗﺍﻮﻟﺍ: 
ﻞﻴﺒﺠﻧﺯ: 
ﻑﺎﻌﺳﺍ-ﻩﺭﺎﻴﺳ: 
ﻪﺑﺎﺸﻣ: ﺐﺳﺎﻨﺘﻣ, ﻞﺛﺎﻤﻣ
ﺐﻴﺟ-ﺔﻈﻔﺤﻣ: ﺔﻈﻔﺤﻣ
ﺮﺸﻛ: ﺮﺸﻛ, ﺔﻣﺎﺴﺘﺑﺍ, ﺺﻠﻤﺗ
ﻢﻟﺎﻋ: ﻲﻤﻠﻋ, ﻢﻟﺎﻋ, ﺚﺣﺎﺒﻟﺍ, ﻖﻘﺤﻣ
ﺔﻴﻤﻀﻬﻟﺍ-ﺓﺎﻨﻘﻟﺍ: ءﺎﻌﻣﺃ, ءﺎﻌﻣﺃ
ﺵﺄﺟ-ﺔﻃﺎﺑﺭ: 
ﻮﻳﺩﺍﺭ: ﻡﻮﻳﺩﺍﺮﻟﺍ
ﻉﻮﺿﻮﻤﻟﺍ-ﻊﻣ-ﻪﻟ ﺔﻗﻼ﻿ﻋ ﻻ﻿ ،ﺔﻠﺻ ﺕﺍﺫ ﺮﻴﻏ: ﺾﻗﺎﻨﺘﻣ, ﺐﺳﺎﻨﻣ-ﺮﻴﻏ, ﻖﺋﻻ﻿-ﺮﻴﻏ, ﻢﻬﻣ-ﺮﻴﻏ
ﺎﻴﻟﻮﺻﺎﻓ: ﻕﺪﻨﺒﻟﺍ, ﻼ﻿ﻳﺯﺎﺑ, ﻲﻧﺍﺩﻮﺴﻟﺍ-ﻝﻮﻔﻟﺍ, ﺏﻮﺒﺣ
ﻲﻤﺳﺭ-ﺮﻴﻏ: 
ﺓﺪﻴﻔﺣ: ﺪﻴﻔﺣ, ﺪﻴﻔﺣ, ﺖﺧﻷ﻿ﺍ-ﻭﺃ-ﺥﻷ﻿ﺍ ﺔﻨﺑﺃ, ﻞﻴﻠﺴﻟﺍ
ﻑﻼ﻿ﺧ: ﺽﺍﺮﺘﻋﺍ, ﺔﺸﻗﺎﻨﻣ, ﻑﻼ﻿ﺧ, ﺽﺭﺎﻌﺗ
ﻢﺤﻟ-ﺔﺤﻳﺮﺷ: ﻊﻄﻘﻳ
ﻦﻴﺟﻭﺮﺘﻧ: 
ﺔﻗﻼ﻿ﺤﻟﺍ-ﺱﻮﻣ: 
ﺔﻀﻗﺎﻨﺘﻤﻟﺍ: ﻦﻳﺎﺒﺗ, ﻲﻠﺑﺎﻘﺘﻟﺍ, ﺾﻗﺎﻨﺘﻣ, ﺽﺭﺎﻌﻣ, ﺲﻜﻋ
ﺔﻳﺎﻋﺩ: ﻦﻠﻋﺃ, ﺔﻳﺎﻋﺩ, ﻥﻼ﻿ﻋﺇ, ﻥﻼ﻿ﻋﺇ, ﻦﻠﻋﺃ
ﺔﻳﺭﺎﻧ-ﺏﺎﻌﻟﺃ: 
ﺔﻌﻗﺮﻓ: ﺔﻌﻗﺮﻓ, ﺔﻌﻗﺮﻓ
ﻪﺴﺑﻼ﻿ﻣ-ﻊﻠﺧ: 
ﻢﻠﺛ: 
ﺮﻀﻣ: ﺭﺮﺿ, ﺮﻴﻄﺧ, ﺲﻛﺎﻌﻣ
ﺔﻳﺩﻮﻬﻳ: 
ﺔﻠﻤﻜﺗ: ﻲﻠﻴﻤﻜﺗ, ﺰﻴﻬﺠﺗ, ﺔﻓﺎﺿﺇ
ﺔﺳﺪﻋ: ﺱﺪﻋ, ﻱﻭﺪﻳ-ﺡﺎﺒﺼﻣ
pegative-ﺔﻟﺎﺣ: 
ﻥﺎﻃﺮﺳ: 
ﻦﻫﺭ: ﻦﻫﺭ, ﻱﺪﻨﺟ, ﺪﻬﻌﺗ
ﺮﺿﺎﺤﻣ: 
ﺏﺮﺴﺗ: ﺏﺮﺴﺗ, ﻥﺍﺪﻘﻓ, ﻁﺎﻘﺳﺇ
ﻞﻫﺄﺘﻟﺍ: ﻞﻫﺆﻣ, ﺓﺭﺍﺪﺟ, ﻖﺤﺘﺳﺍ, ﻞﻫﺄﺗ, ﻰﻤﻠﻌﻟﺍ-ﻞﻫﺆﻤﻟﺍ
ﺔﻓﺎﺜﻛ: ﻢﺣﺩﺰﻣ, ﺔﻓﺎﺜﻛ
ﺚﺤﻟﺍ: 
ﻎﻀﻣ: 
ﻡﻼ﻿ﻜﻟﺍ-ﺮﻴﺜﻛ: ﺢﻳﺮﺻ
ﺮﺤﺒﻟﺍ-ﻥﺎﻃﺮﺳ: 
ﺮﻌﺴﻟﺍ-ﺾﻴﻔﺨﺗ: ءﺎﻔﻋﺇ, ﺮﻌﺴﻟﺍ-ﺾﻴﻔﺨﺗ, ﻝﺯﺎﻨﺗ
ﻩﺮﺟﺍ-ﺓﺭﺎﻴﺳ: 
ﻲﻣﺮﻬﻟﺍ-ﻞﺴﻠﺴﺘﻟﺍ: ﺓﺩﺎﻴﻗ, ﻡﺎﻈﻧ
ﻢﺸﻳ: 
ﻚﺑﺎﺸﺗ: 
ﺔﻴﻠﺤﺳ: 
ﻝﻼ﻿ﺷ: 
ﻝﺎﻣﻼ﻿ﻟ-ﺐﻴﺨﻣ: ﻥﺰﺤﻣ, ﻞﻣﻻ﻿ﺍ-ﺔﺒﻴﺧ, ﺐﻴﺨﻳ, ﻞﻣﻻ﻿ﺍ-ﺐﺋﺎﺧ, ﺮﻳﺮﺷ
ﺾﻘﻨﻟﺍ-ﻖﺣ: ﺾﻓﺭ, ﺮﺛﺃ, ﺾﻓﺭ, ﺮﻈﻨﻟﺍ-ﻑﺮﺻ, ﺭﺎﻜﻨﺘﺳﺍ, ﻥﺎﻫﺭ, ﺮﺟ
ﺔﺳﺎﺋﺭ: ﻲﺳﺎﺋﺭ
ﺮﺘﺸﻣ: ﻥﻮﺑﺯ
ﻥﻮﻟﺎﻏ: 
ﺽﻮﻌﺑ: 
ﻑﺍﺮﺤﻧﻻ﻿ﺍ: ﻑﺍﺮﺤﻧﺍ, ﻪﻳﻮﺸﺗ, ﺽﻮﻋ
ﻉﺭﺎﺼﺗ: ﺲﻓﺎﻨﺗ
ءﺎﺴﻔﻴﺴﻓ: 
ﺲﺑﺎﻗ: ﻞﺻﻮﻤﻟﺍ, ﺔﻤﻴﺴﻗ
ﺾﺑﺭ: ﻢﺜﺟﺇ
ﺔﻟﺎﻘﺑ: 
ﻲﻋﻮﻴﺷ: 
ﺶﻫﺪﺗ: ﺊﺟﺎﻔﻣ, ﺎﻘﺣ-ﺔﻌﺋﺍﺭ, ﻞﻫﺬﻣ, ﻞﻴﻠﻀﺗ, ﻂﻠﺨﻟﺍ, ﻖﻌﺻ, ﻚﺑﺭﺃ
ﺔﻴﺋﺎﻀﻘﻟﺍ-ﺔﻘﺣﻼ﻿ﻤﻟﺍ-ﺔﻟﺎﺣ: 
ﺔﺒﻛﻮﻛ: ﺓﺮﺠﻤﻟﺍ
ﺭﻮﺗﺎﺘﻛﺩ: 
ﻙﺎﻤﻬﻧﺍ: ﻒﻴﻇﻮﺗ, ﻖﻠﻗ, ﻖﻠﻗ, ﺔﻳﺎﻨﻋ-،ﻥﺄﺷ-،ﻡﺎﻤﺘﻫﺍ
ﺔﻴﻋﺎﻨﺼﻟﺍ-ﺭﺎﻤﻗﻷ﻿ﺍ: 
ﻝﺎﻌﻨﻟﺍ: ﻝﺪﻨﺻ
ﻦﻛﺎﺳ-ﻑﺮﺣ: 
ﻲﺒﻳﺮﻘﺗ: ﺐﻳﺮﻘﺗ, ﺎﺒﻳﺮﻘﺗ, ﺐﻳﺮﻘﺘﻟﺎﺑ
ﻞﻤﻌﻟﺍ-ﻦﻋ-ﻦﻴﻠﻃﺎﻋ: ﻒﻴﻇﻮﺗ
ﺪﻳﺆﻣ: ﺪﻋﺎﺴﻣ, ﺪﻋﺎﺴﻣ, ﻞﻤﺤﺗ, ﺱﻮﻗ
ﺲﺗﻮﻟ: 
ﺲﺨﻟﺍ: ﺔﻄﻠﺳ, ﺦﻧﺎﺒﺳ
ﺪﻳﺭﻮﻠﻛ: 
ﺎﻳﺮﻴﺘﻜﺑ: ﺮﻄﻓ, ﺎﻳﺮﻴﺘﻜﺑ
ﺝﺰﻟ: ﺝﺰﻟ
ﻥﻮﻜﻣ: 
ﺓﺍﻮﻧ: 
ﻖﻠﺘﺧﺍ: ﺮﻫﺎﻈﺗ, ﺓﺎﻛﺎﺤﻣ
ﺖﻳﺎﺑ: 
ﺯﺍﺮﻓﺇ: ﺯﺮﻔﺗ
ﺔﺣﺍﺮﺻ: ﺮﺜﻛﺍ-ﺢﺿﻭﺍ, ﺔﺣﺍﺮﺻ-ﻞﻜﺑ, ﻭﺪﺒﻳ-ﺎﻣ-ﻰﻠﻋ, ﻅﻮﺤﻠﻣ-ﻞﻜﺸﺑ, ﺎﻌﻄﻗ
ﻦﻣﺍﺰﺗ: ﺓﺍﺭﺎﺒﻣ, ﺐﺳﺎﻨﻣ, ﺐﺳﺎﻨﻣ, ﻕﺎﻔﺗﺍ, ﺔﻘﺑﺎﻄﻣ
ﻪﻴﻟﺎﺒﻟﺍ-ﺺﻗﺭ: ﺔﻔﻨﻋﺰﻟﺍ
ﻝﻮﺑ: ﺦﺷ
ﻡﻮﺛ: 
ﻰﻀﻘﻧﺍ: ﻲﺿﺎﻤﻟﺍ, ﺮﺑﺎﻋ
ﺩﺎﺼﺘﻗﻻ﻿ﺍ-ﻢﻠﻋ: ﺩﺎﺼﺘﻗﺍ, ﻱﺩﺎﺼﺘﻗﺍ-ﺩﻮﻛﺭ, ﺮﻴﻓﻮﺗ
ﺔﻄﺳﻮﺘﻤﻟﺍ-ﺔﻘﺒﻄﻟﺍ: 
ﻖﻴﺷﺭ: ﺔﻋﺮﺴﺑ, ﻊﻳﺮﺳ, ﻊﻳﺮﺳ, ﻪﺟﻮﻣ
ﻂﻘﻠﻣ: ﺔﻓﺮﺠﻣ, ﺔﺻﺎﺼﻗ
ﺲﺑﻼ﻿ﻣ-ﻞﻴﺴﻏ: ﻞﺴﻏ
ﺔﻟﻭﺍﺮﻔﻟﺍ: 
ﻱﺮﻀﺤﻟﺍ: ﻲﻧﺪﻣ
ﻞﺠﺨﻳ: ﻂﻴﺒﺜﺗ, ﻖﺋﺎﻋ, ﻚﺑﺮﻣ, ﻚﺑﺭﺃ, ﻂﻠﺨﻟﺍ
ﺮﺘﻓﺩ: 
ﻡﻮﺒﻟﺃ: 
ﻝﻮﺒﺴﻴﺒﻟﺍ: 
ﻢﺷ: 
ﻪﻴﻓﻮﺑ: 
ﻞﻋﺎﻔﻟﺍ-ﻢﺳﺇ: ﻙﺭﺎﺸﻣ, ﻙﺭﺎﺸﻣ
ﺝﺍﺮﻛ: 
ﺺﻴﺨﺸﺘﻟﺍ: ﻲﺼﻴﺨﺸﺗ, ﺺﻴﺨﺸﺗ, ﻲﻛﺍﺭﺩﻹ﻿ﺍ, ﻰﻠﻋ-ﻑﺮﻌﺗﺍ
ﺯﺎﻜﻋ: 
ﺯﺍﺰﺘﺑﺍ: ﺯﺍﺰﺘﺑﺍ, ﻒﺘﻧ, ﺪﻴﻘﺗ
ﻞﻴﺠﺴﺘﻟﺍ: ﻞﺠﺳ, ﻞﺠﺳ, ﻞﻴﺠﺴﺗ, ﻞﺠﺳ
ﻥﺎﺑﻭﺬﻠﻟ-ﻞﺑﺎﻗ: ﺏﻭﺬﺗ
ﺭﻮﻔﺳﻮﻔﻟﺍ: 
ﻱﻮﻴﻨﺑ: ءﺎﻨﺑ, ﺐﻴﺗﺮﺗ, ﻦﻳﻮﻜﺘﻟﺍ
ﻎﻤﺻ: 
ﺔﺣﻭﺮﻃﺃ: ﺔﺣﻭﺮﻃﺃ
ﻦﻴﻴﻓﺮﺤﻟﺍ: ﻲﻜﻴﻧﺎﻜﻴﻣ
ﺯﻮﻣ: 
ﺔﻤﻠﺴﻣ: ﺔﻳﺮﻈﻧ, ﺢﻳﺮﺻ, ﺢﺿﺍﻭ, ﺢﺿﺍﻭ, ﺢﻳﺮﺻ, ﺃﺪﺒﻣ
ﻊﻠﺿ: ﺕﺍﺪﻌﻣ
ﻞﻜﻴﻨﻟﺍ: ءﻲﺷ-ﻻ﻿
ﺐﺼﻌﺘﻣ: ﺎﻋﺍﺩﻭ, ﺓﺮﻴﻄﻓ, ﻥﻮﻜﻴﻠﻴﺴﻟﺍ
ﺔﻠﻓﺎﺣ: ﺢﻤﺳ
ﺐﻴﻗﺮﻟﺍ: ﺔﺑﺎﻗﺭ
ﺥﻭﺭﺎﺻ: ﺥﻭﺭﺎﺻ
ﻖﺠﺳ: ﻖﻧﺎﻘﻧ
ﺐﻋﻼ﻿ﺗ: ﻞﻤﻌﻟﺍ, ﺔﺠﻟﺎﻌﻣ, ﻞﻴﻐﺸﺗ, ﺔﻋﺪﺨﻟﺍ, ﻉﺍﺪﺧ, ﺾﺒﻘﻣ
ﺓﺭﻭﺪﻨﺑ: 
ﺯﺰﻌﺗ: ﺞﻣﺩ, ﻒﻴﺜﻜﺗ, ﺪﻴﻛﺄﺗ
ءﺎﺑﺮﻬﻛ-ﺲﺑﺎﻗ: ﺏﺎﺤﺴﻧﺍ, ﺬﻔﻨﻣ, ﻞﺻﻮﻤﻟﺍ, ﺶﻋ
ﻡﻮﻴﺳﺎﺗﻮﺑ: 
ﺩﺍﺩﺮﺘﺳﺍ: ﺐﻠﺟ, ﺓﺩﺎﻌﺘﺳﺍ, ﺓﺩﺎﻌﺘﺳﺍ, ﺓﺩﺎﻌﺘﺳﺍ
ﺔﻴﺿﺍﺮﺘﻓﺍ: ﻝﺎﻳﺭ, ﻲﻠﻌﻓ, ﻲﻘﻴﻘﺣ
ﺮﺒﺠﻟﺍ-ﻢﻠﻋ: 
ﻥﺎﻨﺳﻻ﻿ﺍ-ﺔﺒﻴﺒﻃ: ﻦﺳ
ﻱﺮﺼﺑ: ﻱﺮﺼﺑ
ﺡﺰﺣﺰﺗ: ﻝﺯﺎﻨﺗ, ﺢﻨﻤﻣ, ﺓﻮﻄﺧ, ﻙﺮﺤﺘﻣ, ﺮﻴﺠﻬﺗ
ءﺎﻴﺣﻻ﻿ﺍ-ﺓﺩﺎﻣ: 
ﺔﻟﺎﻄﺑ: 
ﺔﻗﺮﻳ: 
ﺩﺮﻔﻨﻣ: ﻞﺼﻓ, ﻲﺋﺎﻨﺜﺘﺳﺍ, ﻞﺼﻔﻨﻣ, ﺔﺑﺮﺗ, ﻩﺪﺣﻭ
ﺢﻔﺼﺘﻤﻟﺍ: 
ﺪﻌﺑ-ﻦﻋ-ﻲﺿﺎﻤﻟﺍ ﺮﺗﻮﺗ: 
ﻲﺨﻳﺭﺎﺗ-ﺮﺗﻮﺗ: 
ﻱﻭﻮﻧ: ﺓﺍﻮﻧ, ﻱﺭﺬﻟﺍ
ﻒﻴﻃ: 
ﻡﻮﻳﺩﻮﺻ: 
ﺎﻳﺮﻴﺘﺴﻫ: 
ﻢﻴﻗ: ﺮﻳﺪﻣ
ﺔﻨﻴﻫﺭ: ﻦﻫﺭ, ﺪﻬﻌﺗ
ﺕﺎﺒﻧ-ﻉﺮﻗ: ﻦﻴﻄﻘﻴﻟﺍ, ﻉﺎﺨﻧ
ﺪﻌﺠﺗ: ﻞﻠﺧ
ﺔﻴﻓﺎﻔﺷ: ﻑﺎﻔﺷ, ﺢﻳﺮﺻ, ﻂﻴﺴﺑ
ﺭﺎﻤﺴﻣ: ﺪﺗﻭ, ءﺍﺬﺤﻟﺍ-ﻂﺑﺭ, ﺢﻴﻤﻠﺗ, ﺭﺎﻤﺴﻣ
ﺔﻴﻠﻀﻓﺃ: ﻩﺎﺒﺘﻧﺍ
ﺓﺎﺸﻣ: ﻲﺸﻤﻟﺍ
ﺩﺎﺤﻟﻹ﻿ﺍ: 
ﻪﺷﺎﺷ: ﺭﺎﺴﻣ, ﻑﺍﺮﺷﻹ﻿ﺍ, ﺐﻗﺍﺭ, ﺐﻘﻌﺗ
ﺔﻴﺑﺎﺨﺘﻧﺇ-ﺓﺮﺋﺍﺩ: ﺐﺧﺎﻧ, ﻦﻴﺒﺧﺎﻨﻟﺍ-ﺭﻮﻬﻤﺟ
ﻂﺒﻀﻨﻣ-ﺮﻴﻏ: 
ﺭﺎﺒﺴﻣ: ﺺﺤﻓ, ﺭﺎﺴﻔﺘﺳﺍ, ﻖﻴﻘﺤﺗ, ﻖﻴﻘﺤﺘﻟﺍ, ﺭﺎﺴﻔﺘﺳﺍ, ﻑﺎﺸﻜﺘﺳﺍ, ﺔﺑﺮﺠﺘﻟﺍ
ﻦﻴﺗﻼ﻿ﺑ: 
ﻲﺋﺎﻨﺛ-ﺩﺪﻋ: 
ﺔﺋﺭ: 
ﻖﺋﺎﻓ: ﻲﺋﺎﻨﺜﺘﺳﺍ, ﻞﺋﺎﻫ-ﻞﻜﺸﺑ, ﻕﺪﺼﻳ-ﻻ﻿
ﺔﺑﺮﻋ: ﻞﻘﻧ, ﺔﺑﺮﻋ, ﺔﺑﺮﻋ
ﺎﻴﻠﺤﻣ: ﻲﻠﺤﻣ
ﺽﺮﺣ: ﺭﺎﺛﺃ, ﺞﻋﺰﻳ
ﻦﻴﻟﻭﺯﺎﻐﻟﺍ: ﻦﻳﺰﻨﺑ
ﻰﻠﻜﻟﺍ: 
ﺐﻬﻧ: ﻩﺍﺮﻛﻹ﻿ﺎﺑ-ﺔﻗﺮﺳ, ﺐﻬﻧ, ﺔﺴﻳﺮﻓ, ﺩﺎﺴﻓﺇ, ﺐﻠﺳ, ﺐﺤﺳ
ﺮﻳﺪﻘﺗ: ﺮﻳﺪﻘﺗ, ﺮﻳﺪﻘﺗ, ﻢﻴﻴﻘﺗ, ﺔﺟﺭﺩ
ﺦﻴﻧﺭﺯ: 
ﻥﻭﺰﻠﺣ: ﻥﻭﺰﻠﺣ
ﺏﺪﻨﺟ: 
ﺔﻟﺩﺎﻌﻣ: ﺔﻟﺩﺎﻌﻣ, ﺓﺍﻭﺎﺴﻣ
ﻲﻛﺍﺮﺘﺷﻻ﻿ﺍ: ﺔﺑﺍﺮﻘﻟﺍ
ﺮﺘﻠﻓ: 
ﻲﺴﺣ-ﺮﻫﺎﻇ-ﺝﺍﺰﻣ: 
ﻊﺳﻭ: ﻊﺳﻭ, ﻊﺳﺍﻭ, ﺔﻓﺎﺿﺇ, ﻊﻓﺭ, ﻦﻴﺴﺤﺗ, ﺪﻳﺪﻤﺗ, ﺔﻣﺎﻋ-ﺓﺭﻮﺼﺑ, ﺭﺍﺮﻗ, ﺪﻳﺪﻤﺗ, ﻊﻴﺳﻮﺗ
ﺚﻌﺒﻨﻳ: ﻕﻼ﻿ﻃﺇ, ﻲﻣﺭ, ﺮﻓﺯ, ﺭﺎﻨﻟﺍ-ﻖﻠﻃﺃ, ﺢﻤﺳ
ﺩﻮﻘﻣ: ﺭﺎﺠﻳﻹ﻿ﺍ-ﺪﻘﻋ, ﻡﺍﺰﺣ
ﻲﻔﺳﻮﻴﻟﺍ: 
ﺲﺋﺎﺳ: 
ﻱﻮﺋﺮﻟﺍ-ﺏﺎﻬﺘﻟﻻ﻿ﺍ: 
ﻦﻣﺎﻀﺗ: ﺪﺣﻮﺗ, ﻊﻤﺠﺗ, ﺏﺍﺬﺠﻧﻻ﻿ﺍ, ﺓﺪﺣﻭ, ﻪﺑﺎﺸﺗ
ﻞﺼﻔﻣ: ﻞﺼﻔﻣ, ﺔﻃﻮﺸﻧﺃ
ﻲﻟﻮﻃ: ﻱﺩﻮﻤﻋ
ﺡﺎﺑﺭﺍ-ﺕﺎﻌﻳﺯﻮﺗ: ﻊﻳﺯﻮﺗ
ﺞﻟﺰﺗ: ﺞﻟﺰﺗ
ﺱﻷ﻿ﺍ: ﺱﺮﻬﻓ, ﻲﺳﻷ﻿ﺍ
ﺰﺠﻋ: ﻖﺋﺎﻋ, ﺰﺠﻋ, ﻞﻠﺧ, ﻡﺎﺗ-ﺮﻴﻏ, ﻕﺎﻌﻣ, ﺐﻴﻋ, ﺐﻴﻋ
ﺱﻮﻫ: ﺔﻘﻳﺎﻀﻣ
ﺺﻴﺼﺨﺗ: ﻊﻳﺯﻮﺗ, ﺺﻴﺼﺨﺗ, ﻢﻳﺪﻘﺗ, ﺎﺗﻮﻛ, ﺔﻤﻬﻣ
ﻲﻓﺍﺮﻏﻮﺗﻮﻔﻟﺍ-ﺭﻮﺼﻤﻟﺍ: ﻲﻓﺍﺮﻏﻮﺗﻮﻓ
ﺎﺘﻟﺩ: ﻙﺭﺎﺷ
ﻲﻤﻗﺭ: ﻞﻜﺸﻟﺍ, ﻱﺩﺪﻋ, ﻱﺩﺪﻋ
ﺔﺒﻠﻜﻟﺍ: 
ﻦﻔﺟ: 
ﻱﺮﻄﻗ: 
ﻲﻋﻮﻟﺍ-ﻥﻭﺩ: 
ﻦﻴﻌﻟﺍ-ﺐﺟﺎﺣ: 
ﺲﻄﻋ: 
ﺡﺮﻣ: ﺡﺮﻣ, ﺡﺮﻣ, ﺪﻴﻌﺳ, ﻚﺤﻀﻣ, ﻲﻠﺴﻣ, ﻞﺴﻣ, ﻊﺘﻤﺘﺴﻣ, ﺔﺑﺎﻋﺪﻟﺍ-ﺡﻭﺭ, ﻒﻴﺨﺳ
ﺔﻴﺳﻭﺪﻨﻬﻟﺍ: 
ﺊﺟﻻ﻿: ﺮﺟﺎﻬﻤﻟﺍ
ﻙﻮﻜﻣ: ﺔﻴﺋﺎﻀﻓ-ﺔﻨﻴﻔﺳ, ﻞﻘﻧ, ﺕﻼ﻿ﺻﺍﻮﻤﻟﺍ, ﻞﻘﻨﻟﺍ-ﻞﺋﺎﺳﻭ
ﻦﻴﺗﻭﺮﺑ: ﺔﻀﻴﺒﻟﺍ-ﺽﺎﻴﺑ
ﺔﻳﺎﻔﻧ: ﺔﻣﻮﻛ, ﺔﻣﻮﻛ, ﺩﺎﻌﺑﺇ, ﺔﻣﺎﻤﻗ, ﺔﻣﺎﻤﻗ
ﻞﻘﺻ: 
ءﻲﻗ: 
ﻦﻴﺟ: ﺎﻴﺛﺍﺭﻭ, ﻲﺛﺍﺭﻭ
ءﻯﺪﺘﺒﻤﻟﺍ: 
ﻉﺎﻤﺘﺟﻹ﻿ﺍ-ﻢﻠﻋ: 
ﻉﺮﻗ: ﻦﻴﻄﻘﻴﻟﺍ, ﻖﺤﺳ
ﺩﺎﻴﺼﻟﺍ: 
ﻲﻤﻴﻠﻗﺇ: ﺔﻌﻃﺎﻘﻣ, ﺔﻘﻄﻨﻣ, ﺔﻘﻄﻨﻣ, ﺡﺎﻨﺟ, ﻥﺍﺪﻴﻣ, ﻉﺎﻄﻗ, ﻲﻄﻴﺤﻣ
ﺔﻛﺮﺣ-ﺍﺪﻌﺻ: 
ءﺍﺭﻮﻟﺍ-ﻰﻟﺍ-ﻊﻠﻄﺘﻣ: ﻲﺿﺎﻤﻟﺍ, ﻥﺎﻄﺒﺘﺳﺍ
ﺭﺎﺼﻋﺇ: 
ﺲﻜﻋ: ﺲﻜﻋ, ﺲﻜﻋ, ﻝﺩﺎﺒﺘﻣ, ﺱﻮﻜﻌﻣ
ﻥﻮﻳﺰﻔﻠﺘﻟﺍ: ﻥﻮﻳﺰﻔﻠﺗ, ﻢﻠﻴﻓ
ﺐﻌﻜﻣ: 
ﺔﻴﺟﺎﺘﻧﺇ: ءﺍﺩﺃ, ﺞﺗﺎﻨﻟﺍ
ﺭﺰﺟ: 
ﻲﺌﻳﺰﺟ: ءﻱﺰﺟ, ﺓﺰﻴﻛﺮﻟﺍ
ﻞﺘﻜﺗ: ﺓﺮﻣﺯ, ﺔﻋﻮﻤﺠﻣ, ﺔﻠﺘﻛ
ﺐﺳﺎﺤﻣ: ﺕﺎﺑﺎﺴﺣ-ﻖﻗﺪﻣ
ﺭﺎﻴﺧ: ﺭﺎﻴﺧ, ﻖﻠﺣ
ﺓﺪﺑﺮﻌﻟﺍ-ﺱﻮﻘﻃ: 
ﺐﻳﺬﻣ: ﺏﻭﺬﺗ
ﺕﺎﻔﺳﻮﻓ: 
ﻱﺪﻴﻬﻤﺗ-ﺏﺎﺘﻛ: ﻢﻌﻃ, ﻑﺭﺎﻌﺘﻟﺍ, ﺔﻣﺪﻘﻤﻟﺍ
ﻱﻮﻠﻗ: 
ﺔﻴﻧﺪﺑ-ﺔﺿﺎﻳﺭ: ﻪﻴﻧﺪﺒﻟﺍ-ﻪﻗﺎﻴﻠﻟﺍ
ﺔﻠﺻﺎﻓ: ﺔﺑﻮﺒﻴﻏ, ﺏﺰﺣ
ﺔﻛﺮﺣ-ﺭﺍﺪﺤﻧﺍ: 
ﺽﺎﻬﺟﺇ: ﺽﺎﻬﺟﻹ﻿ﺍ, ﺾﻔﺨﻨﻣ, ﻞﺸﻓ
ﺏﺍﺮﺟ: ﺓﺮﺸﻗ, ﺪﻤﻏ, ﺮﺸﻗ
ﺢﻧﺎﻤﻟﺍ: 
ﺰﻴﻨﻐﻨﻤﻟﺍ: 
ﻲﺴﻔﻨﻟﺍ-ﺐﻴﺒﻄﻟﺍ: 
ﺭﻮﻠﻜﻟﺍ: 
ﺢﻴﺗﺎﻔﻤﻟﺍ-ﺔﺣﻮﻟ: 
ﺓﻮﻔﺻ-ﺔﺒﺨﻧ: 
ﺱﺍﻮﻗﺃ: 
ﻲﺒﺟﺮﻟﺍ: 
ﺔﺣﺮﻗ: ﺔﺣﺮﻗ, ﺡﺮﺟ, ﺔﻣﺪﺻ, ﻲﻠﻐﻳ---ﻖﻠﺴﻳ
ﻦﺜﻨﻣ: 
ﺏﺎﻋ: 
ﺔﻴﻤﻛ: ﺔﻴﻤﻛ, ﺔﻴﻤﻛ, ﺎﺗﻮﻛ, ﺔﺒﺴﻧ
ﺓﺮﺘﺳ: ﻒﻄﻌﻣ
ﻱﺭﻮﻄﺗ: ﺔﻳﻮﻤﻨﺘﻟﺍ, ﺭﻮﻄﺗ
ﻦﻳﻭﺪﺗ: ﻪﺘﻓﻻ﻿, ﺰﻣﺭ, ﺔﻈﺣﻼ﻿ﻣ
ﺩﺍﺪﺗﺭﺍ: ﺭﺎﻫﺩﺯﺍ, ﺰﻔﻗ
ﺢﻳﺮﺸﺗ: ﺺﻴﺼﺨﺗ, ﻢﺴﻗ
ﺄﺒﺨﻣ: 
ﻲﻄﺧ: ﻂﻴﺴﺑ
ﻥﻮﻤﻴﺘﻧﻷ﻿ﺍ: 
superessive-ﺔﻟﺎﺣ: 
ﻡﺭﻭ: ﻡﺭﻭ, ﻢﺠﺣ, ءﻮﺘﻧ
ﺔﻳﺮﻌﺘﻟﺍ: 
ﺎﻔﻟﺃ: 
ﻦﻄﺒﻟﺍ-ﺓﺮﺳ: ﻦﻄﺑ, ﺩﻮﻤﻋ
ﻦﻴﺼﺣ: ﺲﻔﻨﺗ, ﻡﻭﺎﻘﻣ
ﺍﺰﻧﻮﻠﻔﻧﺇ: ﺍﺰﻧﻮﻠﻔﻧﺃ, ﺐﺋﺍﺫ, ﻰﻤﺣ, ﺮﻴﺛﺄﺗ
ﺔﻌﺠﻟﺍ-ﻊﻨﺼﻣ: 
ﻂﻴﺴﺒﺗ: 
ﺮﺼﺘﺧﺍ: ﺪﺣ, ﺰﺠﺣ, ﺮﺼﺣ
ﻪﻔﻴﻔﺧ-ﻪﻣﺪﺻ: ﺔﻠﺘﻛ, ءﻮﺘﻧ, ﻦﺳ
ﺮﺳﺃ: ﺮﺳﺃ, ﻦﺘﻓ
ﺮﺒﺠﺗ: ﺪﻴﻘﺗ, ﺽﺮﻓ, ﺽﺮﻓ, ﻖﻴﺒﻄﺗ
ﺏﺭﻮﺟ: 
ﻢﻠﻴﻓ: ﻢﻠﻴﻓ, ﺎﻤﻨﻴﺳ, ﻂﻳﺮﺷ, ﻂﻳﺮﺷ, ﻂﻳﺮﺷ
ﻥﻮﻛ: ﻥﻮﻜﻟﺍ
ﺙﻮﻟ: ﺙﻮﻠﺗ, ﺔﺑﺎﺻﺇ
ﻲﻌﻴﻄﻗ: 
ﺐﻴﻀﻗ: ﺲﻨﺟ
ﺕﺎﺑﺎﻐﻟﺍ: 
ﻡﻮﻴﻨﻣﻮﻟﻷ﻿ﺍ: ﻡﻮﻴﻨﻣﻮﻟﻷ﻿ﺍ
ﺔﺑﺬﺑﺫ: ﺐﻠﻘﺗ
ﻚﻠﻔﻟﺍ-ﺝﺍﺮﺑﺍ: 
ﺩﺮﻃ: ﺔﺛﺎﻔﻧ-ﺓﺮﺋﺎﻃ, ﺩﺮﻃ, ﺩﺮﻃ, ﺩﺮﻃ, ﺯﺮﻔﺗ, ﺮﻴﺠﻬﺗ, ﺡﺮﻃ
ﻦﻴﻤﻀﺗ: ﻞﻴﺠﺴﺗ, ﺞﻣﺩ, ﻦﻴﻤﻀﺗ, ﻲﻄﻐﻳ-،ءﺎﻄﻏ, ﻦﻤﻀﺘﺗ, ﺔﻴﻄﻐﺗ, ﻂﻳﺭﻮﺗ, ﻦﻤﻀﺘﺗ, ﺔﻛﺭﺎﺸﻣ
ﺪﻴﻔﺘﺴﻤﻟﺍ: ﻞﻏﺎﺷ, ﻞﻤﻌﺘﺴﻤﻟﺍ
ﻦﻴﻔﻟﺩ: 
ﻞﺗﺎﻘﻟﺍ: 
ﺕﺎﻳﺪﺜﻟﺍ-ﻦﻣ-ﻥﺍﻮﻴﺣ ﻲﻳﺪﺜﻟﺍ: 
ﺮﺷﺆﻣ: ﻊﺿﻭ, ﺱﺮﻬﻓ, ﺮﻴﻳﺎﻌﻤﻟﺍ, ﺔﺑﺎﺒﺴﻟﺍ, ﺱﺎﻴﻘﻣ
ﺪﻴﺴﻛﺃ-ﻲﻧﺎﺛ: 
ﻥﻮﻟﻮﻘﻟﺍ: 
ﺔﻴﻃﺍﺮﻗﻭﺮﻴﺑ: ﻲﻨﻴﺗﻭﺭ
ﻩﻮﺷ: ﻞﻴﻠﻀﺗ, ﻢﺣﺍﺰﺗ, ﻪﻳﻮﺸﺗ
ﺔﺟﻼ﻿ﺛ: ﺔﺟﻼ﻿ﺛ
ﻱﺮﺛﺃ: ﺭﺎﺛﻵ﻿ﺍ-ﻢﻠﻋ, ﺭﺎﺛﻵ﻿ﺍ-ﻢﻠﻋ, ﺭﻮﻔﺣﻷ﻿ﺍ
ﻝﻮﺒﻘﻣ-ﺮﻴﻏ: ﺾﻓﺍﺭ
ﺔﻔﺻﺍﻮﻣ: ﺭﺎﻴﻌﻣ, ﺪﻴﺣﻮﺗ
ﺓﺮﺸﻧ: ﺓﺮﺸﻧ, ﺔﻗﺪﺻ, ﺔﻗﺭﻭ
ﻥﺎﺴﻧﻻ﻿ﺍ-ﻢﻠﻋ: 
ﻕﺍﺬﻤﻟﺍ-ﺐﻴﻃ: ﺬﻳﺬﻟ
ﺪﻌﺘﻣ: ﺭﺬﻋ, ﻝﺎﻘﺘﻧﺍ
ﺶﻤﻜﻧﺍ: ﻒﺣﺯ
ﺲﻤﺸﻟﺍ-ﺩﺎﺒﻋ: 
ﺔﻠﻤﻗ: ﺔﻣﻼ﻿ﻋ, ءﺰﺟ
ﻥﻮﻳﺃ: 
ﺔﺣﺎﻴﺳ: ﻲﺣﺎﻴﺳ, ﺮﻔﺳ
ﻡﺩﻮﻣ: 
ﻊﻳﺮﺴﺗ: ﺞﻳﻭﺮﺗ, ﻞﻴﻬﺴﺗ, ﻪﻴﺒﻨﺗ
ﺾﺣﺩ: ﻚﺑﺭﺃ, ﻞﻴﻜﺸﺗ
ﺙﺎﻌﺒﻧﺍ: ﺭﺬﻗ, ﺔﻴﻀﻘﻟﺍ
ﻒﻄﺧ: ﻒﻄﺧ, ﻞﻴﺻﻮﺘﻟﺍ, ﻉﺰﺘﻧﺍ
ﻞﺧﺍﺪﺗ: ﻞﻋﺎﻔﺗ, ﻞﻋﺎﻔﺘﻣ
ﺮﻌﺸﻟﺍ-ﻒﻴﻔﺼﺗ: 
ﻲﺒﻌﺸﻟﺍ-ﺙﺍﺮﺘﻟﺍ: ﺢﻤﻗ
ﻱﺮﻌﺷ: 
ﺔﻴﻣﻮﻗ: ﺔﻴﺴﻨﺟ
ﻥﺎﻓﺩﺭ: ءﻮﺘﻧ-ﻭﺍ-ﻙﺭﻭ, ﻑﺩﺭ
ﺭﺰﻋ: ﻉﻮﺿﻮﻣ, ﻉﻮﺿﻮﻣ, ﻊﻓﺍﺩ, ﺱﺎﺳﺃ
ﻰﻣﺎﺴﺗ: 
ﻁﺎﺒﺣﺇ: ﺔﺴﻜﻧ, ﺱﺄﻳ, ﻞﻣﻻ﻿ﺍ-ﺔﺒﻴﺧ, ﺮﺋﺎﺣ, ءﺎﻐﻟﺇ
ﺖﻟﺎﺑﻮﻜﻟﺍ: 
ﺔﺗﺎﺒﻧ-ﻥﺎﻓﻮﺷ: 
ﺔﻛﺮﺣ-ﺮﻬﻨﻟﺍ: 
ﺝﺮﺷ: 
ﻱﺮﻘﺑ: 
ﻒﻘﻧ: ﻢﺟﺮﺗ, ﻢﺟﺮﺗ
ﺓﺮﻓﻭ: ﺓﺮﻓﻭ, ﻲﻘﺒﺘﻤﻟﺍ, ﺾﺋﺎﻓ, ﺮﻈﻨﻟﺍ-ﻑﺮﺻ, ﺔﻟﺎﻗﺇ, ءﺎﻔﻋﺇ
ﻮﻳﺪﻴﻓ: 
ﺔﻌﻃﺎﻘﻣ: ﺔﻌﻃﺎﻘﻣ, ﺫﻮﺒﻨﻣ, ﻝﺎﻤﻫﺇ
ﺮﻴﺼﻗ-ﺭﺎﺒﺘﺧﺍ: ﺔﻟﻭﺎﺤﻣ, ﺭﺎﺒﺘﺧﺍ, ﻉﻼ﻿ﻄﺘﺳﺍ
ﻲﻛﻮﻬﻟﺍ: 
ﺕﺎﺑﺎﺼﻌﻟﺍ-ﺏﺮﺣ: 
ﻡﻮﻴﺴﻴﻨﻐﻤﻟﺍ: 
ﺭﺍﺩﺍﺭ: 
ﻱﺰﻧﺎﺒﻤﺸﻟﺍ: 
ﺔﻴﻗﻮﺛﻮﻤﻟﺍ: ﺔﻴﻗﺍﺪﺼﻣ
ﻞﻴﻄﺘﺴﻣ: 
ﺮﺤﺒﻟﺍ-ﺐﺸﻋ: 
ﻢﻤﻋ: ﻢﻴﻤﻌﺗ
ﻝﻮﺠﺘﻟﺍ-ﺮﻈﺣ: 
ﺲﻨﺠﻟﺍ-ﻲﻠﺜﻣ: 
ﻮﻳﺭﺎﻨﻴﺳ: ﻲﺼﻨﻟﺍ, ﻪﻴﻌﻴﺒﻄﻟﺍ-ﺮﻇﺎﻨﻤﻟﺍ
ﺔﻐﻴﺻ: ءﺎﻨﺑ, ءﺎﻨﺑ, ﻲﻟﻻ﻿ﺪﺘﺳﺍ, ﺔﻏﺎﻴﺻ, ﻖﻠﺧ, ﻞﻴﻜﺸﺗ, ﺔﻏﺎﻴﺻ
ﺺﻤﻘﺗ: 
ﻞﻌﺷﺃ: 
ﻡﻮﻴﻧﺍﺭﻮﻴﻟﺍ: 
ﻚﺳﺎﻤﻟﺍ: ﺕﻼ﻿ﺒﻘﺘﺴﻣ
ﻖﻴﺴﻨﺗ: ﻖﻴﺴﻨﺗ
ﺐﺋﺍﺮﻀﻟﺍ-ﻊﻓﺍﺩ: 
ﺔﻠﻣﺎﻜﺘﻤﻟﺍ: ﻞﻣﺎﻜﺘﻟﺍ
ﻯﺃﺭ: ﻱﺃﺭ, ﻱﺃﺭ, ﻖﻴﻠﻌﺗ
ﺎﻣﺎﻏ: 
ﻱﺭﺎﻔﺴﻟﺍ-ﺕﻼ﻿ﺣﺭ: ﺏﻮﻛﺭ, ﺔﻠﺣﺭ, ﺔﻠﺣﺭ, ﺔﻠﺣﺭ
ﺔﻛﺮﺣ-ﺮﻔﻳﺮﻧﻭﻭﺩ: 
ﺔﺟﺭﺩ: ﺔﺟﺭﺩ, ﻞﻣﺎﻋ
ﻲﺴﻴﺋﺭ-ﻥﺍﻮﻨﻋ: ﻥﺍﻮﻨﻋ, ﻉﻮﺿﻮﻣ
ﻞﻠﺤﻤﻟﺍ: ﻞﻠﺤﻳ
ﺕﺎﻣ: 
ﻱﺭﺎﺠﺗ-ﻊﻤﺠﻣ: ﺖﻛﺭﺎﻣ-ﺮﺑﻮﺳ
ﻱﺰﻠﻓ-ﺮﺼﻨﻋ-ﺕﻮﻣﺰﺒﻟﺍ: 
ﺔﻳﺪﻳﺮﺑ-ﺔﻗﺎﻄﺑ: ﺔﻴﺤﺗ
ءﺎﻘﺘﻟﺍ: ﺐﻳﺮﻘﺗ, ﺏﺭﺎﻘﺗ
ﺩﺮﻄﺘﺳﺍ: ﻊﺟﺍﺮﺗ, ﺭﺩﺎﻐﺗ
ﻢﻫﺎﺴﻤﻟﺍ: ﻚﻳﺮﺷ
ﺏﻭﺮﻜﻴﻣ: 
ﺔﻴﻠﺳﺎﻨﺘﻟﺍ-ءﺎﻀﻋﻷ﻿ﺍ: 
ﺔﻴﻠﻜﺷ: ﻲﺛﺍﺭﻭ, ﺎﻴﺟﻮﻟﻮﻓﺭﻮﻤﻟﺍ-ﻞﻜﺸﺘﻟﺍ-ﻢﻠﻋ
ﺎﺘﻴﺑ: 
ﺰﻨﻴﺟ: 
ﺕﺎﻧﺎﻴﺒﻟﺍ-ﺓﺪﻋﺎﻗ: 
ﺔﺒﺳﺎﺣ-ﺔﻟﺁ: ﺔﺒﺳﻮﺤﻟﺍ
ﺔﻴﻨﻴﺳ-ﺔﻌﺷﺃ: 
ﻞﻴﻠﺤﺗ: 
ﻲﺌﻴﺑ: ﻪﻴﻌﻴﺒﻄﻟﺍ-ﺮﻇﺎﻨﻤﻟﺍ, ﻂﻴﺤﻣ, ﺔﺌﻴﺑ, ﻕﺎﻴﺴﻟﺍ, ﻲﺌﻴﺑ, ﻲﺣ, ﻲﺣ, ﻑﺎﻔﻛ
ﺎﻤﻐﻴﺳ: 
ﻝﺎﺼﻔﻧﺍ: ﻝﺰﻋ, ﻞﺼﻔﻟﺍ, ﻝﺎﺼﻔﻧﺍ, ﻝﺎﺼﻔﻧﺍ
ﻝﺎﻤﻋﺃ-ﻝﻭﺪﺟ: ﺞﻣﺎﻧﺮﺑ, ﺞﻣﺎﻧﺮﺑ, ﻲﺳﺍﺭﺩ-ﺞﻬﻨﻣ
ﺓﺮﻴﺷﺄﺗ: 
ﺔﻴﺘﺤﺗ-ﺔﻴﻨﺑ: 
ﺔﻋﺍﺮﻳ: 
ﻒﺷﺎﻛ: 
ﻒﻴﻜﺘﻟﺍ: 
ﻲﺋﺎﻴﺣﺃ: 
ﻖﺼﻟ: ﻖﺼﻟ, ﻞﻳﺪﻌﺗ, ﻖﻓﺮﻳ, ﻂﺑﺭ
ﻡﻭﺮﺒﻟﺍ: 
ﻡﻮﻳﺩﻼ﻿ﺒﻟﺍ: 
ﻕﺍﻮﻓ: 
ﻥﻮﻠﻟﺍ-ﺢﺗﺎﻓ: ﺖﻫﺎﺑ
ﻥﺍﻮﻴﺣ-ﺔﻘﻳﺪﺣ: 
ﺓﺩﺎﻴﻋ: 
ﻡﻮﻬﻔﻣ: ﻂﻳﺭﻮﺗ, ﻰﻨﻌﻣ, ﻅﺎﻔﻟﻷ﻿ﺍ-ﺕﻻ﻿ﻻ﻿ﺩ, ﻡﻮﻬﻔﻣ, ﻡﻮﻬﻔﻣ, ﺱﺎﺴﺣﺇ, ﻕﺎﻴﺴﻟﺍ
ﺎﻏﻮﻴﻟﺍ: ﻉﻮﻤﺠﻣ
ﺐﺘﻜﻟﺍ-ﻊﻴﺒﻟ-ﺔﺒﺘﻜﻣ: ﺐﺘﻜﻟﺍ-ﺔﻧﺍﺰﺧ
ﺝﻼ﻿ﻋ: ﺝﻼ﻿ﻋ, ﺞﻟﺎﻋ, ءﺎﻔﺷ, ﺝﻼ﻿ﻋ, ﺞﻟﺎﻌﻤﻟﺍ
ﻲﻣﻮﻗ: ﻲﻗﺮﻋ
ﻪﺳﺃﺭ-ﻊﻄﻗ: 
ﻢﻌﻧ: ﻼ﻿ﻌﻓ-ﻢﻌﻧ
ﺔﻴﻟﺎﻜﺷﺇ: ﺔﻴﻀﻘﻟﺍ, ﺔﻠﻜﺸﻣ, ﺪﻴﻘﻌﺗ
ﺯﺎﺠﻟﺍ-ﻰﻘﻴﺳﻮﻣ: 
ﻦﺘﺴﻐﻨﺘﻟﺍ: 
ﻲﺑﺎﻫﺭﺇ: ﻞﺗﺎﻘﻣ, ﺐﻋﺭ
ﻪﺑﺎﻌﻟ-ﻝﺎﺳ: ﻪﺑﺎﻌﻟ-ﻝﺎﺳ
ﻲﺋﺍﺬﻐﻟﺍ-ﻞﻴﺜﻤﺘﻟﺍ: 
ﺔﻘﻠﻄﻤﻟﺍ-ﺔﺟﻭﺰﻟﺍ-ﺔﻘﻔﻧ: 
ﻉﻮﺒﺳﻷ﻿ﺍ-ﺔﻳﺎﻬﻧ: 
ﻥﺍﻮﺤﻗﺃ: 
ﺡﺎﻘﻟ: ﻖﻴﻠﻌﺗ, ﺔﻴﻄﻐﺗ
ﺔﻳﺭﺎﻧ-ﺔﺟﺍﺭﺩ: ﺔﻳﺭﺎﻧ-ﺔﺟﺍﺭﺩ
ﺓﺬﻳﻮﻌﺗ: 
ﺔﻨﺴﻟﺍ-ﻒﺼﻧ: ﺮﻴﺒﻌﺗ
ﻦﻳﻭﺮﻴﻬﻟﺍ: 
ﺪﻠﺠﻣ: 
ﺩﻮﺛﺎﻜﻟﺍ-ﺔﻌﺷﺃ: 
ﺔﻴﺟﻮﻟﻮﻳﺪﻳﺃ: ﺪﻘﺘﻌﻳ
ﺕﺍﺭﺎﻴﺳ-ﻒﻗﻮﻣ: 
ﺎﺘﻴﺛ: 
ﻞﻣﺃ-ﺔﺒﻴﺧ: ﻞﻣﻻ﻿ﺍ-ﺔﺒﻴﺧ
ﻡﻮﻴﻨﻴﻠﻴﺴﻟﺍ-ﺮﺼﻨﻋ: 
ﺕﺎﺟﺍﺭﺪﻟﺍ-ﺏﻮﻛﺭ: ﻝﻭﺍﺪﺗ, ﺔﻃﻮﺸﻧﺃ, ﻱﺭﻭﺩ, ﺔﺟﺍﺭﺩ, ﺔﻴﺋﺍﻮﻫ-ﺔﺟﺍﺭﺩ
ﺓﺮﺸﻗ: ﺡﺎﺒﻧ, ﺓﺮﺸﻗ, ﺮﺸﻗ
ﺓﺍﻭﺎﺴﻣ: ﺓﺍﻭﺎﺴﻣ
ﺭﺎﻴﺗ-ﺔﻣءﻼ﻿ﻣ-ﺔﻣﻼ﻿ﻋ: 
ﺭﺎﻄﻣ: 
ﺮﺘﺑ: ﻊﻄﻗ
ﻪﻠﺴﻟﺍ-ﻩﺮﻛ: 
ﻝﺎﺟﺩ: 
ﺭﻮﺻﺮﺻ: 
ﻡﻭﺮﻜﻟﺍ: 
ﺮﺘﻟ: ﺮﺘﻟ
ﻚﻟﺫ-ﻦﻣ-ﻢﻏﺮﻟﺍ ﻰﻠﻋ: ﻚﻟﺫ-ﻊﻣﻭ, ﻥﻵ﻿ﺍ-ﻰﺘﺣ, ﻦﻜﻟ, ﻝﺎﺣ-ﻱﺃ-ﻰﻠﻋ
ﻥﻮﻣﺮﻫ: 
ﺔﺒﻴﻌﻣ: ﺺﻘﻧ, ﺺﻘﻧ, ﻡﺎﺗ-ﺮﻴﻏ, ﺊﻄﺨﻣ, ﺔﺌﻃﺎﺧ, ﻰﻟﺇ-ﺮﻘﺘﻔﺗ
ﻡﺮﺧ: ﺐﻘﺛ
ﺔﻴﺣﺍﻭﺭﻷ﻿ﺍ: 
ﻊﻠﻀﻤﻟﺍ: ﺔﻳﻭﺍﺯ
ﺔﻳﻮﺴﻧ: 
ﺪﺣﻭ: ﺭﺪﺤﻧﺍ, ﻞﺼﺘﻣ
ﻭﺭﻮﻴﻟﺍ: 
ﻎﻨﺴﻨﻴﺠﻟﺍ: 
ﺔﻴﻣﺯﺭﺍﻮﺧ: 
ﺭﺰﻴﻠﻟﺍ: 
ﺔﻴﻟﺪﻴﺻ: 
ﺮﺘﻤﻴﻠﻠﻣ: ﺮﺘﻤﻴﻠﻠﻣ
ﻲﻨﺛ: ﻲﻨﺤﻨﻳ, ﻦﺤﻨﻣ, ﻥﺮﻣ, ﻢﺋﻼ﻿ﻣ, ﻞﺑﺎﻛ
ﺩﻮﻧﻷ﻿ﺍ: 
ﻂﻴﺴﺑ-ﻕﺭﺎﻓ: ﻞﻇ
ﻰﺋﺰﺟ-ﻡﺍﻭﺩ: 
ﺔﻴﺳﺎﺴﺣ: 
ﺮﻫﺎﻈﺘﻣ: 
ﻡﻮﻴﻠﻴﻬﻟﺍ: 
ﺔﻐﻠﻟﺍ-ﻲﺋﺎﻨﺛ: 
ﺭﺎﺼﺘﺧﺍ: ﺓﺬﺒﻧ, ﺰﺟﻮﻣ, ﺵﺎﻤﻜﻧﺍ
initialism: 
ﻞﻌﻔﻟﺍ-ﺔﻐﻴﺻ: 
ﺎﻣﺯﻼ﻿ﺑ: 
ﻡﻮﺳﻮﻣﻭﺮﻛ: 
ﻲﺒﻴﺗﺮﺗ: ﻊﻃﺎﻘﺗ, ﻒﺻ, ﻢﻈﺘﻨﻣ, ﻲﻠﺴﻠﺴﺗ
ﺮﺘﻣﻮﻠﻴﻛ: ﺮﺘﻣﻮﻠﻴﻛ
ﺲﻛﺎﻔﻟﺍ: 
ﺔﺛﺍﺭﻮﻟﺍ-ﻢﻠﻋ: ﻲﺛﺍﺭﻭ, ﺎﻴﺛﺍﺭﻭ
ﺶﻤﻧ: 
ﻲﻏﺍﺮﺑ-ﻚﻔﻣ: ﻂﺑﺮﻟﺍ-ﺡﺎﺘﻔﻣ
ﻲﻠﻛﻭﺮﺑ: 
preterite: 
ﻦﻴﻣﺎﺘﻴﻓ: 
ﻡﻮﻴﻣﺩﺎﻜﻟﺍ: 
ﺮﺠﻔﻣ: 
ﻲﻄﻴﻄﺨﺗ: 
ﻡﻮﻴﻧﺎﺘﻴﺘﻟﺍ: 
ﺮﺧﺎﻔﺗ: ﺮﺧﺎﻔﺗ
ﺍﺪﻣﺍ: 
ﺔﻘﻳﺪﺻ: ﻚﻳﺮﺷ, ﻞﻴﻠﺧ, ﺐﻴﺒﺣ, ﺓﺎﺘﻓ
ﻊﺟﺎﺿ: 
ﺔﻴﻠﻣﺮﻟﺍ-ﺔﻋﺎﺴﻟﺍ: 
ﻲﻔﻃﺎﻌﻟﺍ-ﺺﻤﻘﺘﻟﺍ: ﻒﻃﺎﻌﺗ, ﺔﻘﻔﺷ, ﻢﻬﻓ
ﻥﻭﺭﻮﺒﻟﺍ: 
ﺮﺘﺑﻮﻜﻴﻠﻫ: 
ﺢﺋﺎﻔﺻ-ﻭﺫ-ﻊﻣﻻ﻿ ﻥﺪﻌﻣ: ﻡﻮﻳﺪﻧﺎﻜﺳ, ﻱﺰﻠﻓ-ﺮﺼﻨﻋ-ﻡﻮﻧﺎﺜﻨﻠﻟﺍ
ﺔﻳﺎﻬﻨﻟﺍ-ﻂﺧ: ﺮﻴﺒﻌﺗ
ﺓﺍﺫﺎﺤﻣ: 
ﺮﺘﻤﻴﺘﻨﺳ: 
ﻡﻮﻨﻳﺪﺒﻴﻟﻮﻤﻟﺍ: 
ﻡﻮﻴﺜﻴﻠﻟﺍ: 
ﺓﺩﺪﻌﺘﻤﻟﺍ-ﻂﺋﺎﺳﻮﻟﺍ: 
ﺚﻳﺪﺤﺗ: ﺚﻳﺪﺤﺗ, ﺶﻌﺘﻨﻣ
ﺔﻳﺭﺍﺮﺣ-ﺓﺮﻌﺳ: 
ﻲﻟﺁ-ﻥﺎﺴﻧﺇ: 
ﻰﻟﺰﻨﻤﻟﺍ-ﺐﺟﺍﻮﻟﺍ: 
ﺕﺎﻴﺿﺎﻳﺮﻟﺍ-ﻲﻓ-ﻢﺛﺭﺎﻏﻮﻠﻟﺍ: 
ﻲﺒﻨﻟﺍ-ﺱﺮﻓ: 
ﺐﻴﻛﺮﺗ: ﻞﺒﺟ, ﺖﻴﺒﺜﺘﻟﺍ, ﺐﻴﻛﺮﺗ
ﺔﻴﻨﻴﻣﻷ﻿ﺍ: 
ﺔﻳﺰﻣﺮﻟﺍ-ﺓﺭﻮﺼﻟﺍ: ﺔﺣﺍﺭ
aorist: ﺩﺪﺤﻣ-ﺮﻴﻏ
ﺔﺌﻴﺒﻟﺍ-ﻢﻠﻋ: ﻲﺌﻴﺑ
ﻚﻨﺤﻤﻟﺍ: ﺩﺎﺴﻓﺇ
ﻱﺪﻨﻫ-ﺐﻨﻗ: 
ﺮﻴﻐﺼﻟﺍ: ﻖﻴﻗﺭ, ﺮﻴﻐﺻ, ﺮﻴﻐﺻ, ﺮﻴﻐﺼﺘﻟﺍ-ﺔﻐﻴﺻ, ﻥﻮﻓﻭﺮﻜﻴﻣ
ﻡﺍﺮﻏﻮﻠﻴﻛ: 
ﻞﻛﻷ﻿ﺍ-ﻲﻓ-ﺩﺍﺯ: 
ﺆﺒﻨﺘﻠﻟ-ﻞﺑﺎﻗ: ﺆﺒﻨﺗ, ﺆﺒﻨﺗ, ﺕﺎﻌﻗﻮﺗ
ﺍﺰﺘﻴﺒﻟﺍ: 
ﺲﺴﺠﺗ: 
ﺔﻐﻠﻟﺍ-ﻢﻠﻋ: ﻱﻮﻐﻟ
ﺮﻌﺷ-ﺔﻗﻼ﻿ﺣ: 
ﻡﻮﻳﺪﻳﺮﻳﻻ﻿ﺍ: 
ﺔﻳﺮﺼﻨﻋ: ﻲﻗﺮﻋ
ﻞﺜﻣﻷ﻿ﺍ: ﻰﻠﻋﺃ, ﻞﺜﻣﻷ﻿ﺍ
ﻊﻴﻨﺼﺗ: ﻊﻴﻨﺼﺘﻟﺍ, ﺔﻴﻋﺎﻨﺼﻟﺍ, ﻊﻴﻨﺼﺗ
ﻰﺴﻴﺋﺮﻟﺍ-ﺰﻛﺮﻤﻟﺍ: ﻲﺴﻴﺋﺮﻟﺍ-ﺮﻘﻤﻟﺍ, ﺪﻌﻘﻣ
ﻱﺰﻠﻓ-ﺮﺼﻨﻋ-ﻡﻮﻳﺮﻴﺴﻟﺍ: 
ﻢﺠﺴﻨﻣ: ﺩﻭﺩﻭ, ﺐﺳﺎﻨﻣ, ﻢﺋﻼ﻿ﻣ, ﻖﻓﺍﻮﺘﻣ, ﻞﺛﺎﻤﻣ
partitive-ﺔﻟﺎﺣ: 
ﺖﻴﺳﺎﻛ: ﻂﻳﺮﺷ
ﺓﺩﺍﺭﻹ﻿ﺍ-ﺓﻮﻗ: ﺓﺩﺍﺭﺇ, ﻑﻮﺳ
ﺩﺎﻌﺑﻷ﻿ﺍ: ﻢﺠﺣ, ﻞﻜﺷ, ﺪﻌﺑ, ﻲﻧﺎﻜﻣ
ﺔﻤﻠﻌﻣ: 
ﻦﻣﺍﺰﺗ: ﺔﻨﻣﺍﺰﻣ
ﻢﻴﻈﻌﺗ: ﻰﺼﻗﺃ, ﻦﻴﺴﺤﺗ, ﺔﻐﻟﺎﺒﻣ
ﺓﻭﺪﻧ: ﻞﻤﻋ-ﺔﺷﺭﻭ
ﻮﻜﺴﻳﺩ: ﻖﺒﻃ
ﻥﻮﻴﻧ: 
ﻱﺰﻠﻓ-ﺮﺼﻨﻋ-ﻡﻮﻴﻣﺯﻭﻷ﻿ﺍ: 
ﺱﺎﻄﻐﻟﺍ-ﺪﻴﻋ: 
ﻞﺤﺘﻧﺍ: ﺔﻗﺮﺳ
ﺔﻳﺮﺛﺃ-ﺔﻌﻄﻗ: 
ﻞﻋﺎﻔﻣ: 
ﻞﺑﺍﻮﺗ: 
ﻡﻮﻴﻧﻮﺗﻮﻠﺒﻟﺍ: 
ﻱﺰﻠﻓ-ﺮﺼﻨﻋ-ﻡﻮﻳﺮﺘﻳﻻ﻿ﺍ: 
ﺩﺎﻳﺩﺯﻼ﻿ﻟ-ﻞﺑﺎﻗ: 
ﻡﺪﺨﺘﺴﻤﻟﺍ-ﻢﺳﺍ: 
ﺎﻴﻠﻋ-ﺕﺎﺳﺍﺭﺩ: 
ﻦﻤﻳﻷ﻿ﺍ-ﺡﺎﻨﺠﻟﺍ: 
ﻥﻮﺟﺭﻷ﻿ﺍ: 
ﺏﺎﻫﺭ: ﻉﺰﻓ, ﺐﻋﺭ, ﺩﺩﺮﺗ, ﻑﺮﻗ
ﺕﺎﻗﺍﺪﺻ-ﻖﻠﺧ: ﻞﺻﺍﻮﺘﻟﺍ, ﻞﻋﺎﻔﺗ
ﺔﻤﻟﻮﻌﻟﺍ: 
ﻲﺟﻮﻤﻟﺍ-ﻝﻮﻄﻟﺍ: 
ﺰﻴﻣﺮﺗ: ﺰﻣﺭ
ﺮﻳﻭﺪﺗ-ﺓﺩﺎﻋﺇ: ﻞﻤﻌﺘﺴﻣ
ءﺪﺑ-ﺓﺩﺎﻋﺇ: ﻞﻴﻐﺸﺘﻟﺍ-ﺓﺩﺎﻋﺍ
ﻲﺳﻭﺮﻴﻔﻟﺍ-ﺪﺒﻜﻟﺍ-ﺏﺎﻬﺘﻟﺍ: 
ﺮﻳﺪﺘﺴﻣ-ءﻮﺘﻧ: ﺔﻠﺘﻛ
ﻲﺋﺎﻴﻤﻴﻜﻟﺍ-ﺝﻼ﻿ﻌﻟﺍ: ﻦﻳﺪﺘﻣ
ﻮﻟﻭﺩﻮﻣ: ﺐﻟﺎﻗ, ﺓﺪﺣﻭ
ﻥﻮﺗﻭﺮﺑ: 
ﻥﺮﻤﻟﺍ-ﺹﺮﻘﻟﺍ: 
ﻡﺍﺮﻐﻴﻠﻣ: 
ﻞﺴﻜﺑ: 
ﻱﺰﻠﻓ-ﺮﺼﻨﻋ-ﻡﻮﻟﺎﺘﻨﺘﻟﺍ: 
ﺏﺍﺬﻤﻟﺍ: ﺭﺮﻗ
ﺔﻴﻋﺎﻤﺟ-ﺓﺩﺎﺑﺇ: 
ﺱﺮﺘﻔﻤﻟﺍ: ﻒﻴﻨﻋ
ﺭﺩﺎﻧ-ﻱﺰﻠﻓ-ﺮﺼﻨﻋ ﻡﻮﻴﻟﺎﻐﻟﺍ: 
ﻡﻮﻴﻧﻮﻛﺭﺰﻟﺍ: 
determiner: ﺩﺪﺣ, ﺩﺪﺣ, ﻖﻘﺤﻣ
ﺔﻴﻄﺨﻟﺍ-ﺮﻴﻏ: 
ﺔﻳﺮﺸﺤﻟﺍ-ﺕﺍﺪﻴﺒﻤﻟﺍ: 
ﻡﻮﻴﻠﻳﺮﺒﻟﺍ: 
ﺔﻴﺒﺼﻌﻟﺍ-ﺎﻳﻼ﻿ﺨﻟﺍ: 
ﻱﺩﺎﻨﺳﺇ: ﻡﺯﺎﺟ
ﺔﻴﺘﺤﺗ-ﻞﻳﻭﺍﺮﺳ: ﺔﻴﻠﺧﺍﺩ-ﺏﺎﻴﺛ
ﺏﻭﺮﻀﻣ: ﺔﻴﻠﻛ
ﻥﻭﺮﺗﻮﻴﻨﻟﺍ: 
ﻡﻮﻴﺑﻮﻴﻨﻟﺍ: 
ﻡﻮﻴﻧﺎﻣﺮﺠﻟﺍ: 
ﺰﻠﻓﻻ﻿: ﺔﻳﺰﻠﻓﻼ﻿ﻟﺍ
ﻊﺿ-ﻰﻠﻋ: 
prolative-ﺔﻟﺎﺣ: 
ﻲﺟﻮﻟﻮﻴﺒﻟﺍ-ﻉﻮﻨﺘﻟﺍ: 
ﻢﻜﺤﺘﻟﺍ-ﺎﺼﻋ: 
ﻱﻮﻴﺣ-ﺩﺎﻀﻣ: 
ﻁﺎﺸﻨﻟﺍ-ﻲﻋﺎﻌﺷﺇ-ﺮﺼﻨﻋ ﻡﻮﻴﻨﻴﺘﻛﻷ﻿ﺍ: 
ءﺎﻀﻓ-ﺪﺋﺍﺭ: ءﺎﻀﻔﻟﺍ
ﺽﺭﻷ﻿ﺍ-ﺝﺭﺎﺧ: ﻲﺋﺎﻀﻓ-ﻦﺋﺎﻛ
ﺭﺍﻮﻃﻷ﻿ﺍ-ﺐﻳﺮﻏ: ﻲﺒﻏ, ﻥﻮﻨﺠﻣ, ﻞﻗﺎﻋ-ﺮﻴﻏ, ﻥﻮﻨﺠﻣ, ﻰﻌﻴﺒﻃ-ﺮﻴﻏ
ﻥﻮﺛﺍﺭﺎﻣ: 
ﻱﺰﻠﻓ-ﺮﺼﻨﻋ-ﻡﻮﻴﺑﺮﺘﻳﻻ﻿ﺍ: 
ﺪﺣﻮﺘﻟﺍ-ﺽﺮﻣ: 
ﻦﻳﺄﺗ: 
ﻥﻭﺩﺍﺭ: 
ﻰﻠﻓﺪﻟﺍ: 
ﺔﺌﺑﻭﻷ﻿ﺍ-ﻢﻠﻋ: 
ﺔﺧﻮﺨﻴﺸﻟﺍ: ﻦﺴﻟﺍ-ﺭﺎﺒﻛ
ﻢﻴﻴﺨﺗ: ﻢﻴﺨﻣ
ﻂﻄﺨﻣ: ﻂﻳﺮﺷ, ﻂﻄﺨﻣ, ﻂﻄﺨﻣ
ﻱﺰﻠﻓ-ﺮﺼﻨﻋ-ﻡﻮﻳﺪﻧﻹ﻿ﺍ: 
veridical: ﻕﺩﺎﺻ, ﻲﻘﻧ, ﺔﻜﺒﺷ
ﻲﻧﻭﺮﺘﻜﻟﺍ-ﻊﻗﻮﻣ: ﻲﻧﻭﺮﺘﻜﻟﺍ-ﻊﻗﻮﻣ, ﻊﻗﻮﻣ, ﻲﺼﺨﺸﻟﺍ-ﻒﻠﻤﻟﺍ
ﻢﻳﺮﻜﻟﺍ-ﻥﺁﺮﻘﻟﺍ: 
ﻕﺎﺒﻃﺃ: 
ﺭﺬﺠﻟﺍ-ﻒﻟﻷ﻿ﺍ: 
ﻡﻮﻴﺴﻧﺭﻮﻠﻟﺍ: 
ﺔﻴﻧﺪﻤﻟﺍ-ﻕﻮﻘﺤﻟﺍ: 
ﻝﻮﻤﺤﻣ-ﻥﻮﻔﻴﻠﺗ: ﻱﻮﻠﺨﻟﺍ-ﻒﺗﺎﻬﻟﺍ, ﻱﻮﻠﺨﻟﺍ-ﻒﺗﺎﻬﻟﺍ
ﻝﻮﻠﺸﻣ: 
ﻱﺰﻠﻓ-ﺮﺼﻨﻋ-ﻡﻮﻴﻨﻴﺘﻜﺗﻭﺮﺒﻟﺍ: 
ﻉﺎﻌﺷﺇ: ﺞﻫﻮﺗ
ﺪﻤﺘﻌﺗ-ﻰﻠﻋ: 
ﻡﻮﻳﺭﻮﺜﻟﺍ-ﺓﺭﺫ: ﻱﺰﻠﻓ-ﺮﺼﻨﻋ-ﻡﻮﻴﻠﺜﻟﺍ ﺓﺭﺫ, ﻱﺰﻠﻓ-ﺮﺼﻨﻋ-ﻡﻮﻴﺑﺮﺘﻟﺍ ﺓﺭﺫ, ﻡﻮﻳﺩﻭﺮﻟﺍ-ﺓﺭﺫ, ﻱﺰﻠﻓ-ﺮﺼﻨﻋ-ﻡﻮﻳﺪﻴﺑﻭﺮﻟﺍ ﺓﺭﺫ, ﻡﻮﻳﺩﺎﻧﺎﻔﻟﺍ-ﺓﺭﺫ, ﺭﻮﻠﻔﻟﺍ-ﺓﺭﺫ, ﻲﻋﺎﻌﺷﺇ-ﻱﺰﻠﻓ-ﺮﺼﻨﻋ ﻡﻮﻴﻧﻮﻟﻮﺑ ﺓﺭﺫ, ﻱﺰﻠﻓ-ﺮﺼﻨﻋ-ﻡﻮﻴﻠﺜﻟﺍ ﺓﺭﺫ, ﻱﺰﻠﻓ-ﺮﺼﻨﻋ-ﻡﻮﻴﺘﻧﻭﺮﺘﺳﻹ﻿ﺍ ﺓﺭﺫ, ﻱﺰﻠﻓ-ﺮﺼﻨﻋ-ﻡﻮﻴﻨﻴﺛﻭﺮﻟﺍ ﺓﺭﺫ
ﻕﺭﺯﺃ-ﺰﻨﻴﺟ: 
ﻝﺰﻨﻣ-ﻊﻨﺼﻣ: 
ﻱﺩﺮﻓ-ﻞﻜﺸﺑ: ﺎﻴﺼﺨﺷ, ﻲﺼﺨﺷ, ﺔﻴﺼﺨﺸﻟﺍ, ﺓﺪﺣ-ﻰﻠﻋ
ﺭﺎﻴﺘﻟﺍ-ﻖﻓﺪﺗ: 
ﺔﻄﻘﻧ-ﻲﺛﻼ﻿ﺜﻟﺍ: 
ﻢﺴﺠﻟﺍ-ﻱﺮﺸﺒﻟﺍ: 
ءﺎﻳﺰﻴﻓ: ﻱﺪﺴﺟ, ﺎﻴﻧﺪﺑ
ﺔﺋﺰﺠﺘﻟﺍ-ﺮﺠﺘﻣ: 
ﻡﻮﻳﺰﻴﺳ: 
ﻞﻳﻮﻃ-ﺬﻨﻣ: 
ﻝﻭﺪﺟ: 
ﺔﻠﺘﻜﻟﺍ-ﻦﻣ-ﺓﺪﺣﻭ: 
ﻊﻤﺟ: 
--ﺔﻴﺋﺎﻨﺛ-ﺔﻤﻴﻗ: 
ﻥﺎﺴﻧﻻ﻿ﺍ-ﻱﺮﺠﻳ: 
ﺔﻄﺳﺍﻮﺑ-ﻲﻨﻌﻳ-ﻦﻣ: 
depan-dari: 
ﻡﻮﻴﻤﻳﺩﻮﻴﺳﺍﺮﺒﻟﺍ: 
ﻯﻮﻘﻣ-ﻕﺭﻭ: ﺔﻗﺎﻄﺑ
ﺩﻭﺪﺤﻣ-ﻞﻌﻔﻟﺍ: 
ﺔﺑﺮﺠﺘﻟﺍ-ﺩﺪﻋ: 
ﺪﻳﺆﻤﻟﺍ-ﺔﻠﻤﺟ: ﺪﻳﺆﻤﻟﺍ-ﺓﺭﺎﺒﻌﻟﺍ
ﺪﻗﺎﻨﻟﺍ: ﺝﺮﺣ, ﺓﺮﻴﻄﺧ
ﻒﻴﻠﻐﺘﻟﺍﻭ-ﺔﺌﺒﻌﺘﻟﺍ: ﻑﻼ﻿ﻏ, ﺔﻣﺰﺣ
ﺕﺎﺒﺜﻟﺍ-ﻡﺪﻋ: ﺮﻘﺘﺴﻣ-ﺮﻴﻏ
ﻲﻓ-ﻢﻈﻌﻣ: 
ﻒﺻﺍﻭ: ﻒﺻﻮﻟﺍ
ﻡﻮﻴﻤﻳﺩﻮﻴﻨﻟﺍ: 
ﺔﻗﺍﺪﺻ: ﺩﻭﺩﻭ, ﻒﻴﻠﺣ
ﺃﺮﻗﺍ-ﻂﻘﻓ: 
ﺲﺳﺆﻳ: 
ﺭﻮﺛﺄﻣ-ﺝﺍﺰﻣ: 
ﺕﻮﺻ: 
ﺔﻴﻧﻼ﻿ﻘﻋ: ﻲﻋﻭ, ﻖﻄﻨﻣ
ﺔﻴﺗﻮﺼﻟﺍ: 
ﻡﺎﻌﻄﻟﺍ-ﺔﻓﺮﻏ: 
ﺔﺸﻴﻌﻤﻟﺍ-ﺔﻓﺮﻏ: 
ﻱﺰﻛﺮﻣ-ﺔﻟﺎﺣ: 
hodiernal-ﻞﺒﻗ: 
ﺾﻳﺮﻤﻟﺍ-ﺔﻟﺎﺣ: 
ﻑﺮﺤﻨﻣ-ﺔﻟﺎﺣ: 
ﻲﻔﻳﺭ-ﺔﻘﻄﻨﻣ: 
RECURSE: 
ﻂﺳﻭ-ﺕﻮﺻ: 
ﻡﻮﻳﺮﻨﺘﻳﺎﻣ: 
ﻞﻗﺎﻨﻟﺍ-ﻲﻧﻭﺮﺘﻜﻟﻹ﻿ﺍ: 
ﻡﺰﻠﻣ-ﺮﻴﻏ: ﺔﻘﺸﻟﺍ
ﻥﻭﺰﺨﻣ-ﻕﻮﺳ: 
ﻑﺮﻌﺘﻟﺍ: ﻒﻳﺮﻌﺗ, ﺪﻳﺪﺤﺗ
ﻑﺪﻫ-ﻞﻐﺸﻣ: 
ﺓﺪﺣﺍﻭ-ﺔﻴﻧﺎﺛ: 
lative-ﺔﻟﺎﺣ: 
ﺔﺼﺣ: ءﺰﺟ
ﺮﻴﻏ-ﻥﺎﺴﻧﻻ﻿ﺍ: 
ﺔﺸﻴﻌﻤﻟﺍ-ءﻲﺷ: 
ﺍﺪﺟ-ﻞﻴﻠﻘﻟﺍ: 
ﺡﺮﺴﻤﻟﺍ-ﻢﻠﻴﻓ: ﺎﻤﻨﻴﺳ
ﻡﻮﻴﺳﺎﻫ: 
attenuative: 
multal-ﺩﺪﻋ: 
ﻲﺒﻴﻠﺣ-ﻖﻳﺮﻃ: 
ﻱﺰﻠﻓ-ﺮﺼﻨﻋ-ﻡﻮﻴﻧﻮﺘﺒﻨﻟﺍ: 
ﻥﻮﻄﻌﻳ: 
ﺮﺒﻋ-ﻱﺩﺪﻋ: 
ﺎﻬﻟﻮﺣ-ﻉﺍﺪﺧ: 
ﻡﻮﻴﺴﻳﺮﻴﻣﻻ﻿ﺍ: 
ﺡﺎﺒﺻ-ﺪﺠﻣ: 
ءﺎﻔﻃﻻ﻿ﺍ-ﻝﺎﺟﺭ: 
ﻡﻮﻴﻠﻴﻛﺮﺒﻟﺍ: 
ﺓﺮﺠﻤﻟﺍ-ﺲﻨﺟ: 
ﻡﻮﻴﻠﺑﻮﻧ: 
ﺎﻋﺍﺩﻭ-ﺎﻋﺍﺩﻭ: ﺎﻋﺍﺩﻭ, ﺔﻣﻼ﻿ﺴﻟﺍ-ﻊﻣ, ﻰﺘﺣ
ﺔﻳﺫﻮﺒﻟﺍ: 
ﻡﻮﻴﻣﺮﻓ: 
ﻱﻭﺎﻤﺳ-ﻕﺭﺯﺍ: ﻲﻧﺍﻮﺟﺭﺃ
ﺎﻳﻮﺼﻟﺍ-ﻝﻮﻓ: 
ﻉﺯﻮﻣ: 
ﺏﺍﺮﻀﻟﺍ-ﺪﺴﻔﻣ: 
ﺞﻟﺎﻌﻣ: 
abessive-ﺔﻟﺎﺣ: 
adessive-ﺔﻟﺎﺣ: 
ﻰﻟﺇ-ﺔﻟﺎﺣ: ﻲﻓ-ﺔﻟﺎﺣ, ﻲﺋﺍﻮﺸﻋ-ﻞﻜﺸﺑ
agentive-ﺔﻟﺎﺣ: 
ﻡﻮﻳﺩﺭﻮﻓﺭﺫﺭ: 
ﺩﺎﻀﻤﻟﺍ-ﻢﺴﺠﻟﺍ: 
ﻞﺜﻣ-ﺍﺮﻴﺜﻛ-ﻞﺜﻣ: 
ﻞﻴﻛﻭ-ﻞﻐﺸﻣ: 
ﻞﺜﻤﻤﻟﺍ-ﺭﻭﺩ: 
ﻡﻮﻳﺪﻴﺜﻳﺇ: 
ﻙﺮﺘﺸﻣ-ﺚﻴﻧﺄﺗ-ﻭﺃ ﺮﻴﻛﺬﺗ ﺲﻨﺟ: 
accompanier: 
ﻢﻃﺮﻘﻟﺍ: 
ﻡﻮﻴﺴﻧﺍﺮﻔﻟﺍ: 
ﻱﺰﻠﻓ-ﺮﺼﻨﻋ-ﻡﻮﻴﺑﺭﻷ﻿ﺍ: 
ﻝﻮﻬﺠﻤﻠﻟ-ﻲﻨﺒﻣ-ﺕﻮﺻ: 
ﻦﻴﺗﺎﺘﺳﺃ: 
ﻎﻀﻣ-ﻎﻤﺻ: 
ﺔﻤﺠﻧ-ﺲﻨﺟ: 
ﻪﻳﻮﻨﺗ-ﻞﻜﺷ: 
ﻱﺰﻠﻓ-ﺮﺼﻨﻋ-ﻡﻮﻳﺭﻮﻜﻟﺍ: 
ﻂﻳﺮﺸﻟﺍ-ﻲﻟﺰﻬﻟﺍ: 
ﻥﺍﻮﻟﻻ﻿ﺍ-ﻰﻤﻋ: 
euler's---ﺩﺪﻌﻟﺍ: 
ﺓﺮﻈﻧ-ﻲﻓ: 
ﺮﻤﻣ: ﺮﻤﻣ
ﺔﻛﺮﻌﻤﻟﺍ-ﺔﺣﺎﺳ: 
ﻖﺋﺎﺳ: ﻖﺋﺎﺳ
ﻲﺋﺎﺑﺮﻬﻛ-ﺱﺎﻣ: 
ﻲﻈﻔﻟ-ﻢﺳﺇ: 
ءﺎﻜﺑ-ﺝﺭﺎﺧ: 
ﺔﻴﺋﺎﺼﺣﺇ: ﻲﺋﺎﺼﺣﺇ
ﻱﺩﺎﺑﺯ: 
ﻥﻮﻨﻳﺯ: 
ﺎﻴﺴﻴﻃﺎﻨﻐﻣ-ﻡﻮﻧ: 
ﺬﺧﺃ-ﺍﺪﻴﻌﺑ: 
ﻞﻳﺬﻟﺍ-ﻁﺮﺷ: 
ﺓﺮﺷﺎﺒﻣ-ﻉﻮﺿﻮﻣ: ﺮﺷﺎﺒﻣ-ﺮﻴﻏ-ﻉﻮﺿﻮﻣ
ﺔﻟﺎﻘﺑ-ﺮﺠﺘﻣ: 
ﻒﻟﺄﺘﺗ-ﻦﻣ: 
ergative-ﺔﻟﺎﺣ: 
ﺔﻐﻠﻟﺍ-ﻲﻓ: 
ﻝﻭﻷ﻿ﺍ-ﺭﺪﺼﻤﻟﺍ-ﻦﻣ ﻰﻘﺘﺴﻣ ﺮﺷﺎﺒﻣ: ﺓﺮﺷﺎﺒﻣ
ﻲﻓﺮﻇ-ﺔﻟﺎﺣ: 
ﺔﺣﺎﺒﺴﻟﺍ-ﻡﺎﻤﺣ: ﺔﺣﺎﺒﺴﻟﺍ-ﺽﻮﺣ, ﺽﻮﺣ
ﻑﺮﻈﻟﺍ-ﺔﻟﺎﺣ: 
ﺔﻴﺣﺎﻴﺳ-ﺔﻟﻮﺠﺑ: ﺔﻠﺣﺭ, ﺺﺤﻓ, ﻝﻭﺍﺪﺗ
ﻥﻮﻳﺰﻔﻠﺗ-ﺔﻋﻮﻤﺠﻣ: 
ﻲﺋﺎﻬﻧ-ﻢﻴﺴﺟ: 
evitative-ﺔﻟﺎﺣ: 
ﻞﻴﻫﺄﺘﻟﺍ-ﺓﺩﺎﻋﺇ: 
ﻊﺟﺍﺮﺗ: ﺓﺩﻮﻋ, ﺏﺎﺤﺴﻧﺍ, ﻊﺟﺍﺮﺗ, ﺔﺴﻜﻧ
ﻊﻨﻣ-ﻦﻣ-ﻖﻘﺸﻟﺍ: 
ﻆﻘﻴﺘﺳﺍ-ﻕﻮﻓ: 
ﺔﻃﺮﺷ-ﻂﺑﺎﺿ: 
ﻲﻓ-ﻢﺴﻗﺃ: 
ﻊﻳﺬﻣ: ﺔﻠﺑﺎﻘﻣ
ﻱﺰﻠﻓ-ﺮﺼﻨﻋ-ﻡﻮﻴﻨﻳﺮﻟﺍ: 
ﻱﻮﺠﻟﺍ-ءﺎﺒﻬﻟﺍ: 
ﻲﻜﻠﻤﺗ-ﺔﻟﺎﺣ: ﻲﻜﻠﻤﺗ-ﺔﻟﺎﺣ
ﺔﻴﻤﺳﻻ﻿ﺍ-ﻰﻟﺇ-ﻞﻘﻧ: ﻢﺳﺇ
ﻚﻠﺘﻣﺍ-ﺔﻟﺎﺣ: 
ﺶﺣﺎﻓ-ﻦﻤﺛ: 
ﺪﻋﺎﺴﻣ-ﻞﻌﻔﻟﺍ: 
ﻲﺋﺍﺪﺘﺑﺍ-ﻉﻮﺿﻮﻣ: 
ﺕﺎﺳﻭﺮﻴﻔﻟﺍ-ﻦﻣ-ﺮﺗﻮﻴﺒﻤﻜﻟﺍ: 
ﻝﺎﻤﻋﺃ-ﻞﺟﺭ: ﻞﻤﻋ-ﺺﺨﺷ, ﺮﺟﺎﺗ
ﺍ-ﺱﺎﻨﻟﺍ: ﺱﺎﻨﻟﺍ, ﻡﻮﻗ
antessive-ﺔﻟﺎﺣ: 
ﻝﻭﻷ﻿ﺍ-ﺮﻳﺯﻮﻟﺍ: 
ﻡﻮﻴﺘﻴﺗﻮﻠﻟﺎﺑ: 
ﻯﺰﻠﻓ-ﺮﺼﻨﻋ-ﻡﻮﻴﺑﻭﺭﻭﻷ﻿ﺍ: 
emote: 
ﺔﻴﺒﻌﺸﻟﺍ-ﻰﻘﻴﺳﻮﻤﻟﺍ: 
ﺮﻋﺎﺷ: 
ﺪﻳﺮﺒﻟﺍ-ﺐﺘﻜﻣ: ﺪﻌﺑ, ﺪﻳﺮﺑ
ﺽﺮﺘﻔﻳ: ﺽﺍﺮﺘﻓﺍ, ﺽﺮﺘﻓﺍ, ﻞﻤﺘﺤﻣ, ﻭﺪﺒﻳ-ﺎﻣ-ﻰﻠﻋ, ﺢﺟﺭﻷ﻿ﺍ-ﻰﻠﻋ
ﻲﺣ-ﺚﻴﻧﺄﺗ-ﻭﺃ ﺮﻴﻛﺬﺗ ﺲﻨﺟ: 
subessive-ﺔﻟﺎﺣ: 
ﺩﻮﻗﻮﻟﺍ-ﺔﺳﺍﻭﺩ: 
ﺔﻴﺒﻄﻗ: ﻲﺒﻄﻗ
ﺔﺒﻛﺮﻣ-ﺲﻨﺟ: 
ﻥﺪﻌﻣ-ﺚﻴﻧﺄﺗ-ﻭﺃ ﺮﻴﻛﺬﺗ ﺲﻨﺟ: 
ﺔﻘﺣﻻ﻿-ﻦﻴﺑ-ﻞﻌﻔﻟﺍ: 
ﻑﻮﻐﺷ: ﺔﻔﻃﺎﻋ, ﻲﻔﻃﺎﻋ, ﻲﺴﺣ
ﻱﺰﻠﻓ-ﺮﺼﻨﻋ-ﻡﻮﻳﺮﻤﺴﻟﺍ: 
ﺮﺴﻴﻣ: ﻂﻴﺳﻭ
ﺓﺪﺣﻭ-ﺔﻴﻤﻫﻭ: 
ءﻮﻀﻟﺍ-ﻦﻣ-ﺔﻋﺮﺴﻟﺍ: 
ﺔﻳﻮﺠﻟﺍ-ﺕﺍﻮﻘﻟﺍ: 
ﻥﺎﻨﺤﺑ-ﺔﺣﺮﻓ: 
ﺔﺟﺮﺣ-ﺔﻄﻘﻧ: 
ﻞﻣﺎﻛ-ﺖﻗﻭ: 
ﻱﺰﻠﻓ-ﺮﺼﻨﻋ-ﻡﻮﻴﻨﻔﻬﻟﺍ: 
ﺖﺒﻛ: ﺢﺒﻛ, ﺢﺒﻛ, ﻊﻨﻣ, ﺮﻈﺣ
ﺮﻴﻴﻐﺗ-ﻦﻣ-ﺙﺪﺣ: 
ﻡﻮﻴﻤﻟﻮﻫ: 
ﻒﻠﺘﺨﻣ-ﺙﺪﺣ: 
ﻥﻮﻜﻟﺍ-ﺲﻨﺟ: 
ﻥﺎﻜﻣ-ﺲﻨﺟ: 
ﺔﻴﺿﺍﺮﺘﻓﺍ-ﺔﻟﺁ: 
ﺚﺤﺑ-ﺲﻨﺟ: 
ﻲﻨﻓ-ﺲﻨﺟ: 
crastinal-ﺮﺗﻮﺗ: 
ﺺﺨﻠﻣ-ﺚﻴﻧﺄﺗ-ﻭﺃ ﺮﻴﻛﺬﺗ ﺲﻨﺟ: 
exocentric-ﺔﻟﺎﺣ: 
ﺪﻌﺘﻣ-ﻞﻌﻔﻟﺍ: 
ﻢﻴﻓﺮﻣ: 
ﻲﻨﻃﻮﻟﺍ-ﺐﺼﻌﺘﻟﺍ-ﻲﻓ ﻲﻟﺎﻐﻤﻟﺍ ﻲﻨﻴﻓﻮﺸﻟﺍ: 
ﻲﺿﺎﻤﻟﺍ-ﻦﺴﺤﺘﻣ: 
ﻲﻨﻬﻣ: ﺺﺼﺨﺗ, ﻲﻨﻬﻣ, ﻝﻼ﻿ﺘﺣﺍ, ﺔﻓﺮﺣ, ﻑﺮﺘﺤﻣ
ﺮﺷﺎﺒﻣ-ﺮﻴﻏ-ﺏﺎﻄﺧ: 
ﺎﻴﻧﺎﺛ-ﺔﻐﻟ: 
ﻰﻟﺇ-ﻥﻮﻜﻳ: 
ﺓﺮﺒﻘﻣ-ﺔﺑﻮﻧ: 
ﻲﻋﺎﻤﺟ-ﻢﺳﺇ: 
absolutive-ﺔﻟﺎﺣ: 
ﺾﻳﺮﻤﻟﺍ-ﻞﻐﺸﻣ: 
ﺕﺍﺬﻟﺍ-ﺲﻔﻨﻟﺎﺑ-ﺔﻘﺜﻟﺍ: 
ﺯﺍﺮﺒﻟﺍ: ﺯﺍﺮﺑ, ﺏﻮﺒﻧﺃ, ﺥﺎﺳﻭﻻ﻿ﺍ
ﻲﺳﺎﻜﻌﻧﺍ-ﺕﻮﺻ: 
ﻝﻮﻬﺠﻤﻠﻟ-ﻰﻨﺒﻣ-ﻞﻌﻔﻟﺍ: 
ﻡﻮﻴﺟﺭﻮﺒﻴﺴﻟﺍ: 
ءﺎﻀﻴﺒﻟﺍ-ﺔﺣﺎﺴﻤﻟﺍ: 
ﻲﻠﻜﺷ-ﺔﻟﺎﺣ: 
ﺩﺎﻤﺟ-ﺚﻴﻧﺄﺗ-ﻭﺃ ﺮﻴﻛﺬﺗ ﺲﻨﺟ: 
ﺐﺒﺴﻣ: 
propositive-ﺝﺍﺰﻣ: 
ﻲﺋﺎﺑﺮﻬﻛ-ﺭﺎﻴﺗ: 
ﻲﻄﺑﺍﺮﺗ-ﺔﻟﺎﺣ: 
ﻞﻴﻀﻔﺘﻟﺍ-ﺔﻐﻴﺻ-ﺔﻟﺎﺣ: 
ﺍﺪﺟ-ﺍﺮﻴﺜﻛ: 
ﻲﺒﻛﻮﻛ-ﺲﻨﺟ: 
ﻙﺮﺤﺘﻣ-ﺔﻛﺮﺤﺘﻣ-ﻡﻮﺳﺭ: 
ﻝﺩﺎﺒﺘﻣ-ﺕﻮﺻ: 
ﻊﻳﺮﺸﺗ: ﻊﻳﺮﺸﺗ, ﻲﻌﻳﺮﺸﺗ, ﺐﺗﺭ, ﻢﻈﻨﺗ
ﻲﻓ-ﻞﻗﻷ﻿ﺍ: 
ﺓﺪﺣ-ﺔﻳﻮﺤﻨﻟﺍ: 
ﻡﺪﺨﺘﺴﻣ: 
ﺓﺍﻮﻨﻟﺍ-benefactive: 
ﻰﻣﺮﻣ-ﺱﺭﺎﺣ: 
:-Except-for: 
ﻢﺳﺎﻗ: 
ﺍﺫﺍ-ﺮﺧﺁ: 
ﻑﺍﺮﺤﻧﺎﺑ: ﺎﺒﻧﺎﺟ
ﺾﻌﺒﻟﺍ-ﻢﻬﻀﻌﺑ: ﺪﺣﺍﻭ-ﺮﺧﺁ-،, ﻝﺩﺎﺒﺘﻣ
ﻝﺍﻮﺘﻣ-ﺪﻨﺑ: 
ﺝﺭﺎﺧ-ءﺍﺪﺗﺭﺍ: 
ﺓﺮﻴﺼﻘﻟﺍ-ﻞﻳﻭﺍﺮﺴﻟﺍ: 
ﻱﺰﻠﻓ-ﺮﺼﻨﻋ-ﻡﻮﻳﺯﻭﺮﺒﺳﺪﻟﺍ: 
ﺍﺬﻜﻫ-ﻞﺒﻘﺘﺴﻣ-ﺮﺗﻮﺗ: 
ﻲﺳ-ﺕﺍﺪﺣﻮﻟﺍ: 
ﻱﺯﺎﻏ-ﺮﺼﻨﻋ-ﻥﻮﺘﺑﺮﻜﻟﺍ: 
ﻡﻮﻴﻔﻴﻟﺪﻨﻤﻟﺍ: 
ﺔﻴﻘﻴﺒﻄﺗ-ﺕﻮﺻ: 
antipassive-ﺕﻮﺻ: 
continuative-ﺐﻧﺎﺟ: 
ﺽﺮﻤﻟﺍ-ﻉﺎﻌﺷﻹ﻿ﺍ: 
necessitative-ﺝﺍﺰﻣ: 
ﺪﻴﺣﻭ-ﻞﻤﻋ-ﻞﻌﻔﻟﺍ: 
ﺭﺎﻄﻘﻟﺍ-ﺔﺑﺮﻋ: 
ﻞﻴﻀﻔﺘﻟﺍ-ﺔﻐﻴﺻ-ﺔﻴﻤﻠﻌﻟﺍ ﺔﺟﺭﺪﻟﺍ: 
ﻱﺩﻮﺟﻭ-ﺪﻨﺑ: 
ﻡﻮﻴﻧﺭﻮﻔﻴﻟﺎﻛ: 
ﺮﺿﺎﺣ-ﻞﻋﺎﻔﻟﺍ-ﻢﺳﺇ: 
ءﻲﻀﻣ-ﺔﻓﺎﺜﻛ: 
singulative-ﺩﺪﻋ: 
ﻩﻮﺟﻭ-ﻦﻴﺑ-ﺔﻳﻮﺤﻨﻟﺍ: 
ﻝﻮﻬﺠﻤﻠﻟ-ﻲﻨﺒﻣ-ﻞﻋﺎﻔﻟﺍ ﻢﺳﺇ: 
ﻁﺮﻔﻣ-ﺓﺪﻣ: 
ﻞﺋﺎﺴﻟﺍ---ﺔﺟﺮﺤﻟﺍ ﻕﻮﻓ: 
ﺔﻴﻤﻛ-ﻦﻣ-ﺓﺩﺎﻣ: 
postpositional-ﺔﻟﺎﺣ: 
ﻱﺭﺎﻴﺘﺧﺍ-ﺔﻴﻤﻜﻟﺍ-ﺩﺪﺤﻣ: 
ﻱﺰﻠﻓ-ﺮﺼﻨﻋ-ﻡﻮﻴﻨﻴﻟﻭﺩﺎﻐﻟﺍ: 
epenthetic-ﻢﻴﻓﺮﻣ: 
ﺾﻓﺍﺭ-ﺔﻴﻤﻜﻟﺍ-ﺩﺪﺤﻣ: 
ﻡﻮﻴﻨﻳﺎﺘﺸﻨﻳﺁ: 
ﻊﻨﻄﺼﻣ-ﺔﻐﻟ: 
ﻡﺎﺿ-ﻢﻴﺴﺟ: 
ﺪﻌﺑ-ﻦﻋ-ﻞﺒﻘﺘﺴﻣ ﺮﺗﻮﺗ: 
ﻱﺭﺮﻜﺗ-ﺐﻧﺎﺟ: 
ﻲﻌﻳﺯﻮﺗ-ﺮﻴﻤﺿ: 
ﺔﻴﻤﺳﺭ-ﺔﺒﻄﺧ-ﺔﻴﻗﺎﻔﺗﻻ﻿ﺍ: 
ﻊﻠﺻﺃ: ﺭﺎﻋ
ﺔﻴﺣﺎﺿ: ﺔﻳﺮﻗ, ﻒﻳﺮﻟﺍ
ﻲﻤﻟﺎﻋ-ﺔﻴﻤﻜﻟﺍ-ﺩﺪﺤﻣ: 
ﺏﻮﺳﺎﺤﻟﺍ-ﺔﺠﻣﺮﺑ: 
ﻥﻮﻳﺰﻔﻠﺗ-ﺞﻣﺎﻧﺮﺑ: 
ﻢﻗﺭ-ﺔﻄﻘﻧ-ﺔﻤﺋﺎﻌﻟﺍ: 
ﻱﺩﻮﺟﻭ-ﺔﻴﻤﻜﻟﺍ-ﺩﺪﺤﻣ: 
ﻝﺍ-ﻡﻮﻳ-ﺪﻌﺑ ﺪﻏ ﻡﻮﻳ: 
ﻞﻳﺪﺒﻟﺍ-ﺔﻴﻤﻜﻟﺍ-ﺩﺪﺤﻣ: 
ﺞﺋﺎﻫ: ﺞﺋﺎﻫ
ﻲﺿﺎﻤﻟﺍ-ﻝﻮﻬﺠﻤﻠﻟ-ﻲﻨﺒﻣ ﻞﻋﺎﻔﻟﺍ ﻢﺳﺇ: 
ﻝﺍ-ﻡﻮﻳ-ﻞﺒﻗ ﻖﺑﺎﺴﻟﺍ ﻡﻮﻴﻟﺍ: 
ﻲﻓﺮﻇ-ﻲﻫﺎﺠﺗﺍ-ﺔﻟﺎﺣ: 
ﺮﻳﺎﻐﻤﻟﺍ-ﻲﻃﺮﺷ: 
