ﺭﺪﺼﻤﻟﺍ-ﺔﻐﻴﺻ: hnit
ﺪﻋﺍﻮﻗ-ﻊﻓﺭ-ﺔﻟﺎﺣ: hnak
ﺐﺼﻨﻟﺍ-ﺔﻟﺎﺣ-ﺔﻟﺎﺣ: hkak
ﻉﻮﺿﻮﻣ-ﺔﻟﺎﺣ: htak
ﻡﻷ﻿ﺍ: hmat
ﺏﺃ: hpap
ﻲﻣﺃ: hmam
ﻼ﻿ﻫﺃ: hnat
ﻒﻠﺳ: htat
ﺪﺟ: hyat
ﻊﺋﺎﺟ: hcac
ﻑﺎﻀﻣ-ﺔﻟﺎﺣ: hnik
ﺔﻔﺻ: hcit
ﻭ: hwan
ﺎﻧﺃ: hmic
ﺖﻧﺃ: hnan
ﺎﻨﻟ: hnam
ﻮﻫ: hyic
ﺩﻮﺼﻘﻤﻟﺍ-ﻥﺎﻜﻤﻟﺍ-ﺔﻟﺎﺣ: htas
ﺐﺼﻨﻟﺍ-ﻝﺎﺣ-ﻲﻓ ﺔﻌﻗﺍﻭ ﺔﻤﻠﻛ ﺔﻟﺎﺣ: htik
ﻲﻠﺧﺍﺩ-ﻡﻼ﻿ﻜﻟﺍ-ﻕﺎﻴﺳ: htis
ﺺﺨﺷ-ﻡﻼ﻿ﻜﻟﺍ-ﻕﺎﻴﺳ: hpak
ﻊﺑﺎﺗ-ﺪﻨﺑ: htan
ﻦﺴﺤﺘﻣ-ﺐﻧﺎﺟ: htap
ﻲﺿﺎﻤﻟﺍ-ﺮﺗﻮﺗ: hkat
ﺮﻛﺬﻣ-ﺚﻴﻧﺄﺗ-ﻭﺃ ﺮﻴﻛﺬﺗ ﺲﻨﺟ: hsan
comitative-ﺔﻟﺎﺣ: hmik
ﺮﺿﺎﺣ-ﺮﺗﻮﺗ: hyan
benefactive-ﺔﻟﺎﺣ: hpik
essive-ﺔﻟﺎﺣ: swik
ﺲﻴﻟ: hnic
ﺎﻬﻧﺍ: hsis
ﺢﻄﺳ-ﻡﻼ﻿ﻜﻟﺍ-ﻕﺎﻴﺳ: hsak
adpositional-ﺔﻟﺎﺣ: hpan
ﻊﻗﻮﻣ-ﺔﻟﺎﺣ: hwak
ءﺎﻀﻔﻟﺍ-ﻡﻼ﻿ﻜﻟﺍ-ﻕﺎﻴﺳ: hnos
ﻖﻳﺮﻃ-ﺔﻟﺎﺣ: hrak
ﻝﺎﻌﻓ-ﺭﻭﺩ-ﺔﻟﺎﺣ: hsik
ﻲﺘﻟﺍ: hkan
ﻲﻣﺎﻬﻔﺘﺳﺍ-ﺝﺍﺰﻣ: hnim
ﻭ-ﻭﺃ: htam
ﻭﺃ-ﻱﺮﺼﺣ: hkit
ﺭﺪﺼﻣ-ﺔﻟﺎﺣ: hsok
ﺮﺠﻟﺍ-ﺔﻟﺎﺣ: hlak
ﻲﻧﺎﻫﺮﺑ: hdit
ﻦﻜﻟ: hlan
ﻊﻴﻤﺟ: hsut
ﺚﻧﺆﻤﻟﺍ-ﺚﻴﻧﺄﺗ-ﻭﺃ ﺮﻴﻛﺬﺗ ﺲﻨﺟ: hnin
ﻢﻬﻧﺃ: hwin
ﻊﻤﺠﻟﺍ-ﺔﻐﻴﺻ-ﺩﺪﻋ: hlun
ﺪﺣﺍﻭ: hyik
ﻞﺒﻘﺘﺴﻣ-ﺮﺗﻮﺗ: hwet
ﻲﻋﺎﻤﺘﺟﺍ-ﻡﻼ﻿ﻜﻟﺍ-ﻕﺎﻴﺳ: hson
ﻰﺘﻣ: hkap
imperfective-ﺐﻧﺎﺟ: hmap
ﻙﺎﻨﻫ: hkac
ﻲﻃﺮﺷ-ﺝﺍﺰﻣ: hcan
ﺮﺜﻛﺃ: hdoc
ﺝﺭﺎﺧ: htac
ﺐﻳﺮﻗ-ﺔﻟﺎﺣ: hrik
illative-ﺔﻟﺎﺣ: hlik
ﻞﻌﻓ: hkas
ﺕﺎﻬﻴﺟﻮﺗ-ﺝﺍﺰﻣ: hden
deontic-ﺝﺍﺰﻣ: hdim
ﻝﺍﺆﺳ-ﺔﻤﻠﻛ: hwac
ﻂﺑﺍﺮﻟﺍ-ﻞﻌﻔﻟﺍ: hkok
ﺺﺨﺷ: hpon
ﺮﻛﺫ: hman
ﻉﺎﻄﺘﺳﺍ: kwat
ﺮﺧﻵ﻿ﺍ: hcon
ﺩﺪﻋ: hnoc
ﺍﺪﺟ: tcac
ﺓﺮﻣ: htim
ﺓﺮﻣ-ﻡﻼ﻿ﻜﻟﺍ-ﻕﺎﻴﺳ: htos
ﻞﺋﺍﺯ-ﺔﻟﺎﺣ: hmak
ﻝﻮﺣ: hkam
ﻲﻓﺮﻌﻤﻟﺍ-ﺝﺍﺰﻣ: hsim
ﻂﻘﻓ: htun
ﻞﻴﻠﻘﻟﺍ: hcak
ﻢﺛ: pcan
hortative-ﺝﺍﺰﻣ: hton
ءﺍﺭﻮﻟﺍ-ﻰﻟﺍ-ﻊﻠﻄﺘﻣ ﺐﻧﺎﺟ: hrip
ﺔﻌﺋﺍﺭ: hcat
volitive-ﺝﺍﺰﻣ: hlim
ﻞﺒﻗ: hsec
ﺐﺠﻳ: pcic
ﻥﺎﻨﺛﺍ: htut
ﺪﻫﺎﺷ: tcan
ﻢﻠﻋ: hsat
ﻞﻔﺳﺃ: hcin
ﺪﻌﺑ: hcas
ﻝﻭﻷ﻿ﺍ: hpas
ﻚﻠﺘﻤﻳ: hpun
ﻞﻳﻮﺤﺘﻠﻟ-ﻞﺑﺎﻗ-ﺓﺯﺎﻴﺣ: hlic
ﺍﺪﺑﺃ: hnac
ﻞﻳﻮﻤﺘﻟﺍ-ﻭ-ﺓﺭﺩﺎﺼﻤﻠﻟ ﻞﺑﺎﻗ ﺮﻴﻏ ﺓﺯﺎﻴﺣ: hkic
ﻢﻳﺪﻗ: hwat
ﻝﻭﺍﺪﺗ-ﺝﺍﺰﻣ: hcim
ﻡﻮﻳ: htin
ﻦﻳﺃ: hnap
ﻝﺎﻌﺗ: hlat
ﻖﻳﺮﻃ: hyas
ﻞﻤﻋ: hkaf
ﻙﺮﺤﺘﻣ-ﻑﺮﺣ: hwaf
ﺐﻫﺫﺍ: hkun
perlative-ﺔﻟﺎﺣ: pwik
ﺔﻴﻣﺪﻘﺗ-ﺐﻧﺎﺟ: hpip
ﻞﻳﻮﻃ: hlac
ﻞﻗ: hsac
ﻒﻴﻛ: hkin
ﻰﺘﺣ: hpit
ﻒﻠﺨﻟﺍ-ﻰﻟﺍ: hwap
ﺎﻨﻫ: hcic
ﻲﻓ-ﺮﻜﻓ: hcik
ﻪﺴﻔﻧ: hsam
ﺮﺧﺁ: kcac
ﺍﺪﻴﻌﺑ: twan
ﺖﺤﺗ-ﻡﻼ﻿ﻜﻟﺍ-ﻕﺎﻴﺳ: hnas
ﺬﺧﺃ: htit
ﺕﺪﺟﻭ: hfan
ﺪﻳ: cyat
ﺏﺎﺷ: hyac
ﻥﺃ-ﻢﻏﺭ: hyap
ﺢﻨﻣ: hkik
ﻪﻠﻟﺍ: hmac
delative-ﺔﻟﺎﺣ: lwak
ﻰﺷ-ﻻ﻿: hmin
ﺢﻴﺤﺼﻟﺍ: hyit
ﺓﺮﻣ-ﺕﺍﺫ: hyam
semelfactive-ﺐﻧﺎﺟ: fwip
ءﺰﺟ: hpat
ﺭﺎﺸﻨﻣ: htic
ﺖﻴﺑ: hfas
ﻢﻟﺎﻌﻟﺍ: tcat
ﺱﺃﺭ: hcaf
ﺔﺛﻼ﻿ﺛ: tyin
ﺩﺪﺠﻟﺍ: hnon
ﺰﻛﺮﺗ: hcok
ﺐﺤﻟﺍ: hpac
ﺎﻤﺋﺍﺩ: hsit
ﻞﻴﻟ: hwit
ﻞﻛ: hmit
ﻚﻠﻣ: hyak
ﻦﻴﺑ-ﺎﻣ: hsin
ﺐﻠﻗ: cyin
paucal-ﺩﺪﻋ: plom
ﺐﺒﺴﺑ: hyok
ﻲﺒﺒﺳ-ﺔﻟﺎﺣ: ksak
ءﻲﺷ: hkis
ﺔﻋﻮﻤﺠﻣ: swat
ﻢﺳﺍ: hnem
ﻖﺋﻻ﻿-ﻢﺳﺇ: hran
hortative: hrat
ﺪﻠﺑ: hlit
ﺖﺒﻠﻃ: hput
ﻲﺋﺮﻣ-ﺮﻫﺎﻇ: crit
ﻞﻀﻓﺃ: pcac
ﺐﻧﺎﺟ: psac
ﺱﺭﺩ: hkus
ﻰﺜﻧﺃ: hfin
ﻲﻔﻜﻳ: kyat
ﺍﺬﻜﻫ: hpuc
ﻞﻣﺎﻛ: hcun
ﺔﻓﺮﻏ: hfac
ﺎﺒﻳﺮﻗ: hlap
ﻦﻜﻤﻳ-ﻻ﻿: nyat
ءﺎﻣ: hwik
desiderative-ﺝﺍﺰﻣ: hdin
ﺭﻮﻧ: lyak
ﻻ﻿ﻭ: hnun
ﺔﻤﻠﻛ: slat
ﺏﺎﺑ: tyan
ﻡﺍﺪﺨﺘﺳﺍ: hpus
ﺡﺎﺒﺻ: hsap
terminative-ﺔﻟﺎﺣ: twik
ﺔﻄﻠﺳ: hkuk
ﻢﻬﺴﻔﻧﺃ: hmis
ﻲﻟﺎﺤﻟﺍ: hyin
ﺕﻮﺻ: hwas
ﺾﻴﺑﺃ: hpis
ﻝﺎﻣ: tlan
ﻰﻟﺎﺘﻟﺍ: kyak
ﺮﻴﻘﻓ: hyis
ﺕﻮﻤﻟﺍ: hmut
ﻞﻜﺷ: hfam
inessive-ﺔﻟﺎﺣ: nwik
ﺐﻠﻘﻟﺍ-ﺐﻴﻃ: tyac
ﺎﺒﻟﺎﻏ: tsan
ﺔﻨﺳ: nwan
ﻖﻳﺪﺻ: myat
ﻡﺎﻈﻨﻟﺍ: hyut
ﺐﺟﺍﻭ-ﺝﺍﺰﻣ: hpim
ﺔﻟﻮﺠﻟﺍ: hcut
ﻦﻣﺅﺃ: hban
ﺔﻣﺎﻋ: hpin
ﺔﻟﺎﺣ-ﻡﻼ﻿ﻜﻟﺍ-ﻕﺎﻴﺳ: hsas
ﻦﺑﺍ: psat
ﺔﺋﺎﻣ: hmas
ﻝﺎﻔﻃﻷ﻿ﺍ: hcis
ﺍﺬﻜﻫﻭ: tyak
ﻞﻣﺃ: hcap
ﻕﻮﻓ: hyip
ﺰﻳﺰﻌﻟﺍ: pyin
ﺃﺮﻗﺍ: pyac
ﺔﻨﻳﺪﻤﻟﺍ: hsic
ﻞﻌﻔﻟﺎﺑ-،ﺎﻘﺑﺎﺳ: hpic
ﺔﻘﻴﻘﺣ: hfat
factive-ﺮﻫﺎﻇ: hfit
ﻊﻤﺳ: hsun
ﻞﻗﻷ﻿ﺍ: hmim
ﺎﻤﺑﺭ: pyat
ﺢﺘﻓ: kcat
ﻢﺴﺠﻟﺍ: tcic
ءﺍﻮﻫ: cwac
ﺔﻌﻴﺒﻃ: nyit
ﺓﺪﻋﺎﺴﻣ: mlat
ﺔﻟﺎﺳﺭ: lyat
ﺔﻌﺑﺭﺃ: ksat
ﻲﻨﻤﺘﻟﺍ-ﻰﻠﻋ-ﻝﺍﺩ ﺝﺍﺰﻣ: hpam
ﻖﻳﺮﺣ: hfak
ﺍﺬﻟ: hyif
ﺔﻋﺎﺳ: hcam
ﺮﺣ: tyit
ﺏﺮﺣ: syat
ءﺍﻮﺳ: hsaf
ﺐﺒﺳ: kyan
ﺪﺤﺘﻣ: hnut
ﺔﻤﻟﺎﻜﻣ: hkuc
ﺍ-ﺍﺫﺎﻤﻟ: hwam
ﻊﺋﺎﺿ: hkut
ﻒﻟﺃ: tsas
ﺔﻠﺋﺎﻋ: hfic
ﺡﻭﺭ: twam
ﻝﺍﺆﺳ: swac
ﺔﻳﺎﻋﺭ: kcan
REALIS-ﺝﺍﺰﻣ: hlin
ﻲﻨﻌﺗ: mwit
ﻞﻤﺘﺤﻣ-ﺝﺍﺰﻣ: hten
ﻩﺎﺠﺗ: cyan
allative-ﺔﻟﺎﺣ: lwik
ﻲﺴﻧﺇ-ﺚﻴﻧﺄﺗ-ﻭﺃ ﺮﻴﻛﺬﺗ ﺲﻨﺟ: hrin
ﺮﻴﺼﻗ: kyut
ﺭﺩﺎﻗ: hyuk
ﻲﺣ: hkip
ﻉﻮﺿﻮﻤﻟﺍ: hsek
ﻪﺴﻔﻧ-ﻉﻮﺿﻮﻣ-ﺔﻣﻼ﻿ﻋ: hcek
ﻒﻠﺘﺨﻣ-ﻉﻮﺿﻮﻣ: hfek
ﺔﺑﺎﺟﺇ: tsat
ﺮﺤﺑ: mwat
ﻑﻮﺧ: hcoc
ﻢﻬﻔﺗ: pcat
ﻕﺎﺷ: kyin
ﻁﻭﺮﺷ: tyut
ﻚﺷ: hdac
dubitative-ﺝﺍﺰﻣ: twin
ﺐﻠﻄﺗ: psan
ﺔﺤﻠﺳﺃ: tcas
ﺩﻮﺳﺃ: clis
ﺮﻀﺣﺍ: tyat
ﻞﻴﻤﺟ: ksis
ﻦﻛﺍﺩ: tcak
ﺪﻘﻋ: psak
ﺓﺮﺸﻋ: htaf
ﻦﻴﺒﺗ: pyan
ﺔﺼﻗ: hkif
ﻙﺮﺘﺸﻣ: kwan
ﺏﺎﺘﻛ: hkup
ﻲﻧﻭﺮﺘﻜﻟﺇ: lyin
ﻢﻠﻜﺘﺗ: plak
ﺔﻣﻼ﻿ﻋ: myac
ﻡﺎﻤﺘﻫﺍ: nyis
ﺐﺘﻛﺍ: kcit
ﺮﻳﺮﺳ: pwat
ﻱﺭﻭﺮﺿ: syis
ﺓﺮﻜﻓ: hwis
ﻦﻓ: klat
vialis-ﺔﻟﺎﺣ: hlas
ﺥﺃ: pyak
ﺎﻧﺎﻴﺣﺃ: ksas
ﻂﺧ: lyan
ﻝﻭﺪﺟ: tlas
ﺮﻬﻧ: nwit
ﻦﻴﻋ: kyac
ﺕﺎﻣﻮﻠﻌﻣ: fyin
ﺓﺄﺠﻓ: tfan
ﺐﻳﺮﻏ: hgan
ﻖﻴﻤﻋ: ksan
ﺮﻴﻴﻐﺗ: hrit
ﺭﻮﻌﺷ: nwac
ﻊﻤﺘﺠﻳ: mlit
ﺽﺮﻏ: htuc
ﺪﻴﻌﺳ: hcuc
ﺍﺪﺑ: syit
ﻡﺩ: cyac
ﻊﻔﺗﺭﺍ: kwas
ﺏﻮﻨﺟ: swan
ﺩﺮﺑ: tlat
ﻡﺎﻣﻷ﻿ﺍ-ﻰﻟﺇ: myik
ﻊﺿﻮﻣ: psis
ﺮﺧﺄﺘﻣ: tyam
ﻒﻗﻮﻣ: syan
ﺽﺮﺘﻓﺍ: nlas
ﺔﻨﺑﺍ: pyit
ﻲﺑ-ﺹﺎﺨﻟﺍ: myan
ﻊﻄﻗ: hkim
ﺦﺴﻧ: hfap
ﺝﻭﺰﻟﺍ: hgat
ﺔﺘﺳ: hlis
ﺮﻛﺬﺗ: twat
ﺮﻴﺛﺄﺗ: hyaf
ﻊﻘﺗ: htuk
ﺍﺪﻋ-ﺎﻣ: hsip
ﺮﻌﺷ: hpaf
ﺯﺎﻴﺘﺟﺍ: pyas
ﺮﺸﻨﻟﺍ-ﻖﺣ: pcit
ﺶﻴﺟ: cyit
ﺾﻛﺭﺍ: kcak
ﻥﺎﺼﺣ: kcas
ﻞﺒﻘﺘﺴﻣ: hwic
ﺏﺮﻏ: pcak
ﻊﻓﺩ: plit
ﺮﻤﺣﺃ: hyun
ﺐﻫﺫ: tcun
ﺔﺒﻏﺭ: hdan
ﺐﻌﻟ: plin
ﻲﺴﻴﺋﺭ: mwas
ﺐﺘﻜﻣ: hfus
ﺔﻣﻮﻜﺣ: syak
ﺔﺴﻴﻨﻛ: kyas
ﻝﻮﻄﻟﺍ: hlen
ﺔﻛﺮﺷ: ksin
ﺔﻗﺭﻭ: kyis
ﻝﺎﻤﺘﺣﺍ: hbin
ﺔﺻﺎﺧ: cyas
ﻞﻤﺤﺘﻳ: pcas
ﺓﺬﻓﺎﻧ: cyak
ﺔﻴﻗﺎﻔﺗﻻ﻿ﺍ: hgac
ﻝﺎﻤﺟ: syac
ﺐﺟﺍﻭ: tfac
ﻝﺎﺳﺭﺇ: fyan
ﺕﺎﻓﺎﺴﻤﻟﺍ: htif
ﺖﻤﺼﻟﺍ: slan
ﻡﺪﻗ: fyat
ﻱﺮﺑ: kyik
ﺕﻮﻤﻳ: myam
ﻆﻔﺣ: pfan
ﺮﻀﺧﺃ: kcin
ﺔﻠﻜﺸﻣ: mlan
ﺔﻣﺎﺴﺘﺑﺍ: myak
ﺊﻃﺎﺧ: clat
ﻒﻠﺘﺨﻣ: pcin
ﻡﻮﻧ: slit
quotative-ﺔﻟﺎﺣ: kwik
ﺔﻳﺍﺪﺒﻟﺍ: cwan
ءﺍﺮﺟﺇ: kfan
ﺓﺭﺎﻳﺯ: fwat
ﻊﺒﺗﺇ: nlan
ﻝﻭﺎﺣ: tcis
ﺭﻮﻀﺣ: psit
ﻮﻠﺣ: tlit
ﻲﻨﻏ: tcin
ﻭﺪﻌﻟﺍ: tcam
ﺔﻨﻴﻔﺳ: hcip
ﺔﻟﺎﺣ: kyit
ﺎﻬﻨﻤﺿ-ﻦﻣ: hkum
ﻞﻣﺎﺷ-ﺺﺨﺷ: hlon
ﺮﺳ: kwit
precative-ﺝﺍﺰﻣ: pwim
ﺏﺬﻬﻣ-ﻞﻴﺠﺴﺗ: hbit
ﺮﺷ: pwac
ﻡﺪﻘﺘﻳ-،ﺮﻴﺴﻳ-،ﺱﺭﺎﻣ: myas
ﻥﺎﻛ-ﺎﻳﺍ: kwac
ءﺎﻘﺒﻟﺍ: hlam
ﻦﻣ-ﻻ﻿ﺪﺑ: plat
ﻕﺭﺯﺃ: plan
ﻦﻜﻤﻣ-ﺮﻴﻏ: psap
ﺔﺳﺭﺪﻤﻟﺍ: hsuk
ﺔﺒﺳﺎﻨﻣ: ksac
ﺝﻭﺰﺘﻣ: nwat
ﻡﺎﻌﻃ: hcuk
ﻥﻭﺮﺸﻋ: tsis
ﺉﺩﺎﻫ: tcit
ﺔﻟﻮﻬﺴﺑ: hnis
ﻞﻤﺘﺤﻣ-ﺐﻧﺎﺟ: hrap
ﺔﻐﻟ: lyac
ﺮﻴﺒﻌﺘﻟﺍ: syas
ﻉﻮﺒﺳﺃ: hsus
ﺔﻋﺎﻗ: hcum
ﺮﻄﺧ: kcic
ﺔﻴﻜﻠﻤﻟﺍ: myit
ﺪﻴﻟﺍﻮﻣ-ﻦﻣ: nyan
ﺔﻤﻜﺤﻣ: kcut
ﻡﻮﻤﻌﻟﺍ-ﻰﻠﻋ: tyap
ﺭﻮﺛﺄﻣ-ﺐﻧﺎﺟ: hmip
ﺔﻤﻴﻗ: tyas
ﻂﻴﺴﺑ: syap
ﺓﺮﺠﺷ: pyic
ﺏﺭﺎﺣ: pyap
ﺭﺍﺪﺠﻟﺍ: twit
ﺔﻨﺠﻟﺍ: cwak
inchoative-ﺐﻧﺎﺟ: htip
jussive-ﺝﺍﺰﻣ: hjin
ﺔﻤﻐﻧ: twun
ﺭﺎﺒﺘﻋﺍ: klan
ﻊﻗﻮﺘﻣ: pcik
ﺮﻬﺷ: hmaf
ﺓﺮﺒﺧ: nyap
ﺎﻣﺎﻤﺗ: nyac
ﺝﺯﺎﻃ: tsac
ﻕﻭﺩ: hnuk
ﻰﻄﻐﻣ: kwak
ﺪﻴﻘﻣ: hyim
ﻕﺮﺸﻟﺍ: tyuk
ﺮﺠﺣ: pwan
ﺾﻌﺑ: kfat
ﻩﺎﺠﺗﺍ: tlac
ﻲﺳﺮﻛ: kwis
ﻢﻋﺪﻟﺍ: syut
ﺦﻳﺭﺎﺘﻟﺍ: tyic
ﺔﻳﺮﻗ: klac
ﻝﺎﺠﻣ-،ﻞﻘﺣ: clit
ﻥﺫﺇ: nwin
ﻞﻫﺎﺴﺘﻣ-ﺝﺍﺰﻣ: hmom
ﺡﺎﺠﻧ: slak
ﻖﺋﻻ﻿: hric
ﻞﺗ: clin
ﻰﻘﻴﺳﻮﻣ: ksik
ﻲﺻﺎﻘﻟﺍ-ﻲﻧﺎﻫﺮﺑ: hdat
ﻝﺍﻭﺰﻟﺍ-ﺪﻌﺑ: htup
ءﺎﻜﺑ: hyuc
ﻑﺮﺷ: hnaf
ﺔﻌﺒﺳ: swit
ﺹﺎﺧ: pfat
ﺭﺎﺒﺧﺃ: nwas
ﺪﻬﺸﻣ: slac
ﺔﻘﻳﺪﺣ: cyam
ﻕﺎﺒﺳ: htus
ﻲﻌﻳﺯﻮﺗ-ﺔﻟﺎﺣ: twak
ﻢﻠﻌﺗ: clan
ﻲﺳﺎﻴﺳ: syik
ﺔﺑﺬﻛ: kcun
ﺏﻮﺒﺼﻤﻟﺍ: tsak
ﻞﻛﺃ: kcam
ﺔﻴﺿﺭﺃ: hlaf
ءﻮﺳ: pwin
ﻲﻠﺻﺃ: mlin
ﻒﻴﺼﻟﺍ: kyam
ﻦﻳﺩ: tlam
ﺓﺭﻮﺻ: ksit
ﺏﺮﻫ: plap
ﻒﻟﺆﻣ: hlut
ﻰﻨﺑ: pyun
ﻢﻤﺼﻣ: htem
ﻢﻟﺃ: hdon
ﻊﻴﺑﺭ: psin
ﻥﺮﻗ: syic
ﻢﻋﺎﻧ: mwan
ﻦﻛﺭ: kyun
ﺝﺎﺘﻧﺇ: psas
ﻚﺤﺿ: cyaf
ﻰﺴﻨﻧ: flat
ﺎﺑﻭﺭﻭﺃ: hyup
ﺔﻴﻧﺎﻤﺛ: lwat
ﻥﺎﺘﺴﻓ: lwac
ﺐﻴﻫﺭ: cyap
ﺲﻔﻨﺗ: syaf
ﻢﻴﻜﺣ: hbas
ﻲﻜﻠﻤﺗ-ﺔﻣﻼ﻿ﻋ: srak
ﺓﺮﻛﺍﺫ: myin
ﺚﻳﺪﺣ: fwan
ﺔﻌﻘﺑ: tcap
ﻊﻔﺗﺮﺗ: hyus
ﺔﺣﺍﺮﺘﺳﺍ: pyik
ﻥﻮﺴﻤﺧ: hfis
ﺓﺮﻳﺰﺟ: tlap
ﺲﻤﻟ: hsuc
ﺪﻋﻭ: pcam
commissive-ﺝﺍﺰﻣ: mwin
ﺔﻴﻤﻠﻌﻟﺍ-ﺔﺟﺭﺪﻟﺍ: tfat
ﺔﻄﺧ: plac
ﻙﻮﻠﺳ: nyak
ﺓﺄﺟﺎﻔﻣ: cran
ﺔﻘﻴﻗﺩ: hmun
ﺭﺎﻨﻟﺍ-ﻕﻼ﻿ﻃﺍ: hwut
ﺃﻮﺳﺃ: pcap
ﺝﺎﺟﺯ: klak
ﻞﺜﻣ: tlin
ﻦﻣﺁ: hsif
ﺭﻮﺘﻛﺩ: tsit
ﻝﺎﻤﻛﻷ﻿ﺍ-ﺐﻧﺎﺟ: hmep
ﺭﺮﻜﺘﻣ: tyun
ﺮﻜﺴﻋ: slin
ﺊﻓﺍﺩ: nyam
ﺏﺮﺷ: pfin
ﺔﻠﺌﺳﺃ: pcaf
ﺐﻀﻏ: nran
ﺓﺮﺷﺎﺒﻣ: tyik
ﺔﻌﺒﻗ: hcup
ﺐﻠﻜﻟﺍ: kwap
ﻡﺩﺎﺧ: hnuc
ءﺎﻳﺮﺒﻛ: hram
ﺪﺸﺣ: tcuc
ﺭﺎﻄﻗ: nyin
ﻲﻗﻼ﻿ﺧﺃ: myut
ﺔﻄﺒﺗﺮﻤﻟﺍ: kyim
ﻞﺧﺩﺃ: fyak
ﻢﻜﺣ: nyas
ﻒﻴﺳ: cwat
ﻡﻮﺠﻫ: kfak
ﺔﺤﺼﻟﺍ: clac
ﺓﺮﻘﻓ: pyaf
ﻲﻋﺎﻤﺘﺟﺍ: hsum
ﺩﺭ: tfit
ﻒﺳﺁ: hpec
ﺔﻋﺎﺠﺷ: krac
ﺔﻤﻌﻧ: hnen
ﻲﻤﺳﺭ: hfaf
ﺔﻣﺪﻘﻤﻟﺍ: tsik
ﺐﻠﻃ: pwit
ﺔﺤﻤﻟ: klas
ﺔﻛﺮﺣ: hyon
ﻊﻗﻮﺗ: cwit
ﻞﺑﺎﻘﻣ: psam
ﺮﺸﻋ-ﻲﻨﺛﺍ: tyaf
ﺏﻮﻄﺨﻣ: nyut
ﺬﻴﺒﻧ: hwun
ﻢﻌﻃ: swut
ﺪﻳﺪﺣ: fyac
ﺮﺸﻧ: syin
ﺓﺭﺎﺠﺗ: myap
ﺓﺰﻴﻣ: twac
ﺏﺎﻴﺛ-،ﺲﺑﻼ﻿ﻣ: kfip
ﻲﺿﺎﻘﻟﺍ: fwak
ﻕﺮﻓ: tfaf
ﻖﻠﻗ: kcis
ﻥﺎﻄﺒﻗ: kwin
ﻦﻣ-ءﺎﻬﺘﻧﻻ﻿ﺍ-ﻢﺗ: nlat
ﻒﻗﻭ-ﺐﻧﺎﺟ: hsep
ﻲﻟﻮﻀﻓ: kyic
ﻲﺒﻨﺟﺃ: kwic
ﻒﻴﺜﻜﺗ: hnif
ﺔﻴﻤﻫﺃ: myun
ﺍﺮﻴﺧﺃ: hfim
ﺓﺭﻮﺗﺎﻓ: fwin
ﺖﺒﺛ: hpuk
ﻥﻭﺩ-ﻝﻮﺤﻳ: flan
ﻖﻨﻌﻟﺍ: cyun
ﻲﻧﻮﻧﺎﻗ: hfik
ﻑﺎﺟ: swak
ﺔﻣﺪﺧ: syam
ﺮﺴﺨﺗ: pcut
ﻞﻴﻟﺩ: pyut
ﺮﻫﺎﻇ-ﺔﻟﺎﺣ: hdak
ﻡﺪﻘﺗ: pyis
ءﺎﻨﺑ: klit
ﻦﻋ-ﺚﺤﺒﻟﺍ: syuc
ﻦﻳﺰﺣ: hrac
ﺔﺌﻴﻄﺧ: psip
ﻥﻮﺛﻼ﻿ﺛ: tfis
ﻕﺩﺎﺻ: tsin
ﻕﻼ﻿ﻏﺇ: kyap
ﻚﻨﺑ: pcun
ﺮﻴﺼﻣ: cyik
ﺔﺑﺎﻏ: hfun
ﺲﻴﻘﻳ---ﺱﺎﻴﻗ: mlac
ﻚﻟﺫ-ﻑﻼ﻿ﺧ: htoc
ﻯﺮﺠﻣ: lyam
ﺰﺒﺧ: hpup
ﻲﻓﺎﺿﺇ: tfak
ﺮﺘﺧﺃ: twas
ﻥﺍﻮﻴﺣ: nwam
zoic-ﺚﻴﻧﺄﺗ-ﻭﺃ ﺮﻴﻛﺬﺗ ﺲﻨﺟ: hzin
eventive-ﺝﺍﺰﻣ: hwim
ﻪﺴﻔﻧ-ﺙﺪﺣ-ﺔﻣﻼ﻿ﻋ: hcom
ﻒﻋﺎﻀﻤﻟﺍ-ﺔﻟﺎﺣ: tlak
ﻚﻴﻤﺳ: hmus
ﻕﻮﻠﺨﻣ: hyum
ﺮﻄﻣ: myic
ﺢﻄﺳ: pfas
ﺱﺪﻘﻣ: swis
ﻮﻴﻟﻮﻳ: clim
ﺮﻳﺮﻘﺗ: hfut
ﻞﺣﺎﺳ: pwas
ﻒﻠﻣ: hfif
ﻒﺘﻛ: cwut
ﺶﻫﺪﻨﻣ: kran
ﻲﻜﻠﻣ: klik
ﺔﻴﻨﻏﺃ: hkuf
ﺔﺣﺍﺭ: kfaf
ﺪﺣﺍﻭ-ﻱﺃ: nyic
ﺐﺸﻋ: kcap
ﻝﺩﺎﻌﺗ: cwik
ﺡﺎﺘﺘﻓﺍ: cyic
ﻮﻴﻧﻮﻳ: cwun
ﻚﻤﺳ: mlic
ﻝﺎﻤﻟﺍ-ﺱﺃﺭ: klin
ﻱﺪﺛ: cyut
ﺞﻠﺛ: hcif
ﻢﻴﻠﻌﺘﻟﺍ: tlik
ﺩﺎﺣ: tcaf
ﺔﻘﻔﺷ: hdam
ﻑﻭﺮﺼﻣ: fyas
ﻚﺑ-ﺔﺻﺎﺧ: hmuc
ﻥﻮﻴﻠﻣ: mlun
ﺐﻌﺘﻣ: tcik
ﻞﺘﻗ: ksam
ﻞﻇ: cwap
ﻥﺯﻮﻟﺍ: plas
ﺔﻠﺘﻛ: mlas
ﺄﺸﻧﺃ: tlip
ﻉﺎﺠﺷ: pyam
ﻒﻴﺤﻧ: plic
ﺽﺍﺭ: srat
ﺭﺎﻴﺘﺧﻻ﻿ﺍ: kcik
ﺔﻠﻴﻀﻓ: hdet
ﻲﻨﻃﻮﻟﺍ: nyaf
ﻲﻬﻟﺇ: swin
ﻱﺩﺍﻮﻟﺍ: clak
ﻦﻤﺨﻳ: kwam
ﺔﺑﺭﺎﻀﻤﻟﺍ-ﺝﺍﺰﻣ: hken
ﺮﻔﺻﺃ: clas
ﺎﻳﺎﻘﺑ: mwac
ﻰﻨﺤﻧﺍ: nlac
ﻕﻭﺪﻨﺻ: pwak
ﻢﺳﻮﻤﻟﺍ: tsim
ﻡﻮﻠﻌﻟﺍ: slas
ﻒﻳﻮﺠﺗ: kcuc
ﻡﻻ﻿ﺍ-ﻮﺧﺍ: hmuk
ﺔﻤﺋﺎﻗ: lyit
ﺲﻄﺴﻏﺃ: ksut
ﻲﺒﻌﺷ: hlup
ﻑﻭﺮﻌﻣ-ﺮﻴﻏ: fyit
ﻑﻮﻟﺄﻣ: flak
ﻑﻮﻟﺄﻣ-ﻞﻴﺠﺴﺗ: krit
ﺉﺭﺎﻗ: tsut
ﺔﺑﺭﺎﻘﻣ: pcuc
ﻦﻴﺗﺮﻣ: tsap
ﺮﻜﻔﻣ: tfik
ﺎﻘﺣ: tsam
ﻦﻫﺎﻛ: pcis
ﺢﻳﺮﺟ: fran
ﻥﺰﺣ: hpom
ﺮﺼﻗ: kfas
ﺏﺮﻀﻳ: clap
؟-ﻪﻳﺇ: hnec
ﻞﻘﻌﻟﺍ-ﻞﺘﺨﻣ: myuk
ﺔﻓﺎﺣ: pfac
ﺔﻌﺴﺗ: nwun
ﺭﺎﺠﻔﻧﺍ: psut
ﻰﻧﺎﻋ: tfas
ﺞﻴﺠﺿ: hcus
ﺏﺩﺃ: lyic
ﺔﺤﻴﺼﻨﻟﺍ: swas
ﺔﻏﺭﺎﻓ: kcuk
ﺔﺒﺗﺮﻣ: psik
ﻡﺎﺤﺘﻗﺍ: tcut
ﺐﻴﺟ: kyip
ﻝﺎﻴﺧ: nlin
ﻰﻠﻋ-ﻢﻜﺣ-ﻭﺍ ﺔﻠﻤﺟ: cwas
ﻲﻧﺎﺜﻟﺍ-ﻦﻳﺮﺸﺗ: nwap
ﺮﺒﻤﺴﻳﺩ: tsip
ﺏﺎﻴﻏ: psic
ﺍﺮﻜﺷ: ryak
ﻥﺍﻮﻨﻌﻟﺍ: tyis
ﺮﺋﺎﻃ: pyuc
ﻚﻟﺎﻣ: mlik
ﻒﻄﻌﻣ: kwut
ﺩﺍﺪﻋﺇ: tyip
ﺕﺎﻗﻼ﻿ﻋ: lwan
ﻥﺎﺧﺩ: htum
ﻲﻧﺎﺜﻟﺍ-ﻥﻮﻧﺎﻛ: nwak
ﺔﻟﺁ: clic
ﻯﻮﺘﺤﻣ: nyik
ﻥﺎﻨﺳﺃ: tlis
ﺭﺎﻋ: hcet
ﺞﻴﻠﺧ: kcaf
ﻍﺎﻣﺩ: pyuk
ﺔﻘﻠﺣ: klic
ﺓﺭﺎﺒﻌﻟﺍ-ﺔﻣﻼ﻿ﻋ: frak
ﻊﺑﺮﻣ: ksap
ﺔﻬﻛﺎﻓ: fyut
ﻱﺎﺷ: tsic
ﺡﺮﺷ: slam
ﺎﺒﺣﺮﻣ: cwam
ﺮﻌﺸﻟﺍ: pwis
ءﺍﺮﺷ: klam
ﻦﻣﺆﻣ: hdic
ﺓﺭﺎﺛﺇ: hcen
ﻥﻮﻌﺑﺭﺃ: klis
ﻞﻳﺮﺑﺃ: pyip
ﻰﺟﺮﻳ: kfit
ﺮﺑﻮﺘﻛﺍ-ﺮﻬﺷ: kfap
ﺓﺭﺍﺮﻣ: kyuc
ﺪﺒﻋ: tlaf
ﺽﺎﻔﻀﻓ: hluk
ﺺﻧ: tsus
ﻥﺎﻤﺘﺋﺍ: cyip
ﺮﺸﻋ-ﺔﺴﻤﺧ: pfit
ﺔﻴﺳﺎﻗ: kcim
ﻢﻀﻧﺍ: cluc
ﺔﻴﻠﻤﻋ: hpif
ﺔﻤﻳﺮﺟ: kyaf
ﺭﺎﺒﻏ: tsuc
ﻲﻠﻤﻋ: plik
ﻥﻮﻠﻟﺍ: nlak
ﻡﺪﻫ: nyuc
ﺓﺩﺎﻳﺯ: lyas
ﻒﻧﺃ: hnus
ﻑﺮﺘﻋﺍ: tyim
ﻖﺑﺎﺴﻟﺍ-ﻡﻮﻴﻟﺍ: kfac
hesternal-ﺮﺗﻮﺗ: tlen
ﻞﺸﻓ: slap
ﻞﻤﻛﺃ: tcim
ءﺍﺪﺗﺭﺍ: pwam
ﺪﻨﻴﻠﺑ: nlit
ﺔﻨﻳﺯﺩ: tsun
ﺮﻴﻄﻳ: fyap
ﺡﺪﻣ: cwin
ﺲﻴﻠﺑﺇ: cwaf
ﺎﻴﺠﻳﺭﺪﺗ: twic
ﺔﻴﺤﻀﺗ: kyif
ﺔﺳﺭﺎﻤﻣ: cyis
ﺮﻴﻤﺿ: tfin
ﺔﻳﺮﻈﻧ: tlic
ﺮﻳﺯﻭ: myis
ﺔﻴﻫﺍﺮﻛ: hnet
ﺓﺮﻴﺤﺑ: cwic
ﺰﻛﺮﻣ: syun
ﺖﻓﺎﺧ: pfic
ﻲﻧﻼ﻿ﻘﻋ-ﺚﻴﻧﺄﺗ-ﻭﺃ ﺮﻴﻛﺬﺗ ﺲﻨﺟ: hron
ﺭﺬﺣ: fwac
ﻊﺘﻤﺘﺳﺍ: nlam
ﺓﺩﺎﺒﻋ: pwap
ﻊﺋﺎﻀﺑ: twap
ﺓﺮﺸﺑ: twaf
ﺖﻴﺒﻟﺍ-ﺢﻄﺳ: tlut
ﺝﺎﺗ: gyan
ﺔﻌﻠﻗ: klap
ﺵﺮﻋ: tcus
ﻖﻓﺮﻤﻟﺍ: nlaf
ﻞﻴﻣ: mlim
ﻰﺼﻗﺃ: krim
ﻦﺠﺴﻟﺍ: fyis
ﺏﻮﻛ: kcip
ﻮﻀﻋ: mlam
ﻲﻧﺪﻣ: syim
ﻥﺎﻜﻣ-ﻞﻛ-ﻰﻓ: tsaf
ﺢﺿﺍﻭ: tfic
ﻥﺎﺟﻭﺯ: pwaf
ﺕﻮﺼﻟﺍ: clam
ﻑﺮﻋ: ksaf
ﺓءﺎﻨﺤﻧﺍ: ksun
ﺔﻟﺪﺑ: slut
ﻢﺤﻟ: mwak
ﺐﻴﻠﺣ: hluc
ﻲﺗﺎﺒﻧ-ﺚﻴﻧﺄﺗ-ﻭﺃ ﺮﻴﻛﺬﺗ ﺲﻨﺟ: hwen
ﺔﻳﺅﺭ: slic
ﺭﺩﺎﻧ: nlap
ﻪﻟﺎﺨﻟﺍ-ﻪﻨﺑﺍ: ksic
ﺮﺴﺟ: pwut
ﻲﻤﺤﻳ: pfak
ﺢﻠﻣ: swam
ﺉﺮﺑ: hwus
ﺔﻜﻠﻣ: kwim
ﺪﻋ: kcus
ﻉﻼ﻿ﻄﺘﺳﻻ﻿ﺍ-ﺐﺣ: hras
ﺺﻗﺭ: tyus
ﻕﺪﻨﻔﻟﺍ: clut
ﺔﺌﺒﻌﺗ: flin
ﻦﻴﺠﺳ: psun
ﺮﺠﺘﻣ: hjan
ﺝﺭﺩ: sric
ﻉﺮﻀﺗ: hmen
ﻞﻣﺭ: sran
ﻒﻴﻨﻋ: hgit
ﺮﺒﻤﺘﺒﺳ: hsem
ﺓﺭﺩﺎﻐﻣ: prac
ﺏﺍﺮﺧ: crin
ﺓﺭﺎﻬﻣ: krin
ﺔﻴﺷﺎﻣ: hwec
ﺕﺍﺪﻌﻣ: hwip
ﺦﺒﻄﻣ: hkon
ﻊﻴﺒﻳ: hbak
ﺔﻋﺮﺳ: hsot
ﺔﺻﻼ﻿ﺨﻟﺍ: clon
ﺏﻮﺳﺎﺤﻟﺍ: hkot
ﻱﺪﺑﺃ: hsen
ﺩﻭﺪﺤﻣ: mrit
ﺔﺒﺘﻜﻣ: hbek
ﺓﺪﻋﺎﻗ: hbac
ﻙﺎﺒﺗﺭﺍ: hrun
ﺪﻴﺠﻤﻟﺍ: cris
ﺎﻀﻳﺃ: hjic
ﻒﺋﺎﺧ: hbic
ﺲﻴﻌﺗ: prin
ﺔﻟﺎﻘﻣ: hrek
ﺦﺒﻃ: kfin
ﺔﻗﺮﻓ: hbat
ءﺍﺮﺤﺻ: hget
ﺔﻠﺒﻗ: hbun
ﺓﺮﻛ: hbot
ﺎﺼﻋ: hpot
ﻝﺍﺪﺟ: hrut
ﺪﺻﺭ: nrak
ﺔﻛﺮﺒﻟﺍ-ﺢﻨﻣ-ﺝﺍﺰﻣ: hbim
ﺶﻫﺪﻣ: hrim
ﺐﻧﺬﻣ: hdis
ﺔﻴﻗﺪﻨﺑ: hgin
ﺔﻃﺮﺷ: plis
ءﺎﻔﺧﺇ: hzan
ﺔﻠﻤﺣ: srin
ﻞﻫﺎﺟ: nrin
ﺔﻤﻳﺮﻛ: drac
ﺔﺑﺎﺤﺳ: blan
ﺕﺎﻔﻠﺨﻤﻟﺍ: htek
ﺮﻳﺍﺮﺒﻓ: frif
ﺽﺮﻣ: hren
ءﺎﻀﻗ: bwan
ﺭﺪﺼﻣ: sron
ﺓﺭﺩﺎﺒﻣ-ﺔﻟﺎﺣ: hnok
ﺔﻤﻋ: hbam
ﺮﻴﺧﺄﺗ: dlic
ﺮﻴﺧﺄﺗ-ﺐﺟﺍﻭ: hlip
ﺕﺮﻛﺫ-ﺮﻫﺎﻇ: prat
ﻞﻴﻠﻟﺍ-ﻒﺼﺘﻨﻣ: dyit
ﻞﻄﺑ: nrac
ﺔﻔﺴﻠﻓ: hfof
ﺪﻴﻟﺍ-ﻊﺒﺻﺍ: hjit
ﺢﻳﺮﻣ: hzat
ﺎﻣ-ﻥﺎﻜﻣ: hmoc
ﺔﻓﺎﺤﺻ: bran
ﻦﻴﻠﻣﺎﻌﻟﺍ: hraf
ﺓﺎﻓﺎﻜﻣ-ﻭﺍ-ﺓﺰﺋﺎﺟ: rwan
ﻰﻠﻋ-ﻡﻮﻠﻟﺍ-ءﺎﻘﻟﺇ: dlac
ﺱﺆﺑ: krat
ﺱﺃﺮﻟﺍ-ﺔﻬﺒﺟ: htec
ﻱﺩﻼ﻿ﻴﻣ: glan
ﻙﻼ﻿ﻣ: htet
ﺩﺮﻔﻤﻟﺍ-ﺔﻐﻴﺻ-ﺩﺪﻋ: hgam
ﺮﺠﻓ: hbon
ﻱﺭﺎﺠﺗ: krak
ﺮﻔﻏ: pran
ﻑﻭﺮﺧ: hcec
ﺮﺒﺻ: hpen
ﺔﻋﺭﺰﻣ: crac
ﻲﻌﺟﺮﻣ: hrec
ﺓﺭﺫ-ﺏﻮﺒﺣ: mran
ﺡﺎﺘﻔﻣ: kcif
ﺔﻴﺒﻠﻏﺃ: hmot
ﻒﻌﺿ: hdut
ﻮﺠﻟﺍ: traf
ﺪﻬﻨﺗ: tcoc
ﻱﺮﺸﺒﻟﺍ-ﺲﻨﺠﻟﺍ: mlis
ﺔﺿﺭﺎﻌﻣ: pric
ﺔﻧﺍﻮﻄﺳﺃ: hdik
ﺍﺪﻴﺣﻭ: hket
ﻥﺎﻨﻓ: nrat
ﺱﺭﺎﻓ: cwis
ﺮﺤﺳ: tran
ﺭﺍﺮﻗ: drin
ﻆﻓﺎﺤﻣ: gran
ﻉﺮﻓ: rwac
ﺐﻴﺗﺮﺗ: hsoc
ﺱﺎﻤﺣ: tsum
ﻲﺜﺣ-ﺝﺍﺰﻣ: hdum
ﻊﻤﺘﺠﻣ: hmum
ﻂﻔﻧ: hyen
ﺏﻮﺒﻧﺃ: hbap
ﺔﻋﺎﺒﻃ: trat
ﺎﻳ: dyoc
ﺭﺍﻮﺤﻟﺍ-ﻡﻼ﻿ﻜﻟﺍ-ﻕﺎﻴﺳ: hros
ﻲﺋﺍﺪﻧ-ﺔﻟﺎﺣ: hwok
ﺓﺮﻤﻗ: ksen
ﺭﺍﺬﻧﺇ: plam
ﻲﺒﺼﻋ: hnes
ﻢﺋﺍﺩ: hset
ﻦﻴﻜﺳ: ksuk
ﺮﻳﺮﺣ: slik
ءﺍﺭﺩﺯﺍ: grin
ﻢﻴﺤﺠﻟﺍ: nrik
ﻞﺼﻔﻨﻣ: plen
ﺩﺎﺟ-ﻞﻜﺸﺑ: mrat
ﻂﻠﺘﺨﻣ: mrik
ﻲﺒﺸﺧ: mrak
ﻞﻀﻔﺗ: hpet
ﺮﻳﺬﺤﺗ: trin
ﺏﺎﺘﻋ-ﺝﺍﺰﻣ: htom
ﺔﻌﻓﺩ: hmos
ﺡﻮﻤﻃ: mrac
ﺾﻓﺭ: hnek
ﺭﻮﺘﺳﺩ: swic
ﻚﺻ: srit
ﺮﻤﺘﺴﻣ-ﺐﻧﺎﺟ: hnip
ﺭﺰﺟ-ﻭ-ﺪﻣ: hgas
ﺔﻴﻠﻛ: klen
ﻞﻳﺫ: hkek
ﻞﻴﺟ: nric
ﻂﻗ: blat
ﺓﺮﺷﺎﺒﻣ-ﺮﻫﺎﻇ: hret
ﺔﻟﻮﻫﺄﻣ-ﺮﻴﻏ: trac
ﺓﺮﺸﻋ-ﻯﺪﺣﺍ: hyec
ﺱﺪﺣ: nlik
ﺓﺰﻴﻤﻣ-ﺔﻔﺻ: trit
ﺔﻠﻴﺒﻗ: hgik
ﻖﻠﻗ-ﺝﺍﺰﻣ: pcim
ﻯﻭﺄﻣ: crat
ﺏﺬﻬﻣ-ﺮﻴﻏ: hruc
ﺐﻛﺮﻳ: hris
ﺓﺰﻫ: hmon
ﺔﻋﺎﻨﺻ: hdot
ﺔﻨﻬﻣ: hres
ﺝﺍﺮﺳ: hdap
ﺓﻮﻬﻗ: kfif
ﻉﺎﻃﺃ: htot
ﻲﻟﺎﻤﺷ: nrit
ﺽﺮﻤﻣ: nris
ﻥﺎﻤﺿ: hjat
ﺔﻠﺴﻠﺳ: ryin
ﺲﻳﺭﺪﺗ: cric
ﺔﻳﺬﺣﺃ: hgut
ﻝﺰﻨﻣ-ﺔﻘﻳﺪﺣ: mram
ﺾﻣﺎﻏ: hmec
ﺮﺧﺍ-ﻥﺎﻜﻣ: hlet
ﺔﻘﺷ: pret
ﻁﺎﺸﻧ: twot
ﺖﺒﺴﻟﺍ-ﻡﻮﻳ: cram
ﻕﺍﺮﺷﺇ: hduc
ﺔﻠﻣﺭﺃ: hwuc
ﺮﺼﻨﻌﻟﺍ: hlem
ﺱﺎﻜﻌﻧﺍ: hfen
ﻢﻴﻈﻨﺘﻟﺍ: hgis
ﺔﻤﺠﻧ: tram
ﺙﺩﺎﺣ: hgon
ﻒﻴﺿ: hgip
ﺭﺎﺑ: brap
ﺔﺟﺎﺟﺯ: hbet
ﻙﺭﺎﺑ: blak
ﺔﺠﺿ: crak
ﻲﻠﺧﺍﺩ: trik
ﻞﺣ: krik
ﺹﻼ﻿ﺨﺘﺳﺍ: prit
ﻑﻮﺟﺃ: hcot
ﺔﻳﻻ﻿ﻭ: hpos
ﺓﺭﺎﻀﺣ: srac
ﻖﻠﻋ: hgak
ﺔﻣﺪﺻ: crok
ءﺎﻨﺜﺘﺳﺍ: swap
ﺔﻟﻼ﻿ﺳ: tren
ﺭﺎﻴﻌﻣ: ryan
ﺓﺩﺎﻴﻘﻟﺍ: dran
ﻦﻣ-ﺺﻠﺨﺗ: hruk
ﻢﺴﻗﺃ: kses
ﺰﻨﻛ: zran
ﺓﺭﺬﺑ: hbis
ﺝﺮﺑ: tras
ﻞﻀﻔﻤﻟﺍ: fwit
ﺎﺜﻳﺪﺣ: hcem
ﺓﺮﻴﺧﻷ﻿ﺍ-ﻲﺿﺎﻤﻟﺍ-ﺮﺗﻮﺗ: hrot
ﻆﻘﻴﺘﺴﻣ: srik
ﺙﺎﺛﺃ: mrin
ﻞﺒﺣ: hkos
ﺓﺮﻣﺎﻐﻣ: hdas
ﺔﻴﻜﻠﻣ: ryit
ﺪﻴﻋ: dyat
ﻒﺻﻭ: dras
ﻥﻮﺘﺳ: hses
ﺱﺎﻴﻘﻣ: hkem
ﻢﻳﺮﻜﺗ-ﻞﻔﺣ: srec
ﺪﻴﺼﻟﺍ: clik
ﺲﻤﻫ: psus
ﺮﻴﺒﻛ-ﺪﺣ-ﻰﻟﺇ: ryat
ﺔﻴﺤﻴﺴﻤﻟﺍ-ﺔﻧﺎﻳﺪﻟﺍ: ksim
ﻡﺎﺤﻣ: hwif
ﻞﻴﺻﺎﻔﺘﻟﺍ: drit
ﺓﺮﻴﻣﺃ: hrus
ﺢﺑﺬﻣ: dlat
ﺔﻜﺒﺷ: hwes
ﻲﺠﺴﻔﻨﺑ: brin
ﻊﻤﺟ: hkoc
ﺏﺎﺨﺘﻧﺍ: hben
ﺭﻮﺼﺗ: kren
ﻥﺍﺮﻜﺳ: crik
ﺐﺼﻳ: brac
ﻊﻓﺭ: hlif
ﺪﺴﺠﻟﺍ-ﺔﻐﻠﺑ-ﺮﻴﺒﻌﺗ: hjis
ﺓﺭﺍﺩﺇ: rwin
ﻝﺩﺎﺒﺗ: tcen
ﺓﺪﻴﻛﺃ-ﺔﻟﺎﻘﻣ: hdek
ﺭﻮﻃﺍﺮﺒﻣﺇ: mras
ﺪﻌﺑ-ﻦﻋ: hroc
ﺢﻴﺒﻗ: clup
ﺓﺭﺎﺿ-ﺮﻴﻏ: cras
ﺔﻔﻟ: hrof
ﺔﺻﻮﺑ: nlic
ﺓﺪﻳﺮﺟ: grat
ﺔﻴﺤﻟ: dric
ﻕﺰﻤﺗ: srim
ﺔﺌﻴﻫ-ﻭﺃ-ﺔﻟﻮﻤﻋ: kson
ﺎﻤﻨﻴﺑ: grak
ﺮﺒﻌﻣ: kcoc
ﻝﻼ﻿ﻘﺘﺳﺍ: htes
ﺔﺤﺋﺍﺭ: hwon
ﺓﺮﺸﻋ-ﺔﻴﻧﺎﻤﺛ: hdec
ﻲﺨﻳﺭﺎﺗ: tris
ﻲﻟﺎﻤﺟﺇ: krut
ﺭﺬﺟ: hrok
ﻦﻴﻃ: hbik
ﺱﻭﺮﻋ: dlan
ﺏﺎﺠﺣ: pras
ﺡﺮﺴﻣ: tret
ﺔﻧﺭﺎﻘﻣ: kras
ﺲﻓﺎﻨﻣ: rwis
ﺪﻴﺻﺮﻟﺍ: slen
ﺏﺭﺪﻣ: kron
ﺔﻫﺎﻜﻓ: hnum
ﺔﻳﺍﻭﺭ: rwas
ﻡﺎﻘﺘﻧﺍ: hbaf
ﺭﻮﻴﻏ: ryut
ﺔﻠﺠﻋ: hlok
ﻕﺮﺣﺃ: glat
ﺵﻼ﻿ﻓ: flac
ﻖﻠﺧ: hkec
ﻉﺍﺮﺻ: hnot
ﺔﻨﻌﻟ: hlos
ﻦﻋﺍ-ﺝﺍﺰﻣ: pram
ﺰﺟﺎﻋ: hces
ﻲﺑﺎﺠﻳﺇ: hzit
ﻱﺩﺎﻨﻟﺍ: klup
ﻥﺎﻀﻴﻓ: nras
ﺏﻮﺒﺣ: gwan
ﺓﻻ﻿ﺎﺒﻣ-ﻻ﻿: hdun
ﻲﻠﻘﻌﻟﺍ-ءﺮﻤﻟﺍ-ﻖﻓﺃ: crim
ﻪﺑ-ﻢﻠﺴﻣ-ﺝﺍﺰﻣ: hsom
ﺭﺪﺤﻟﺍ: htop
ﻡﺎﺠﺴﻧﻻ﻿ﺍ: mron
ﺪﻋﺮﻟﺍ-ﺕﻮﺻ: hgot
ﺔﻟﻮﻔﻄﻟﺍ-ﺔﻠﺣﺮﻣ: htok
ﺔﺒﻛﺭ: hgun
ﺕﺎﻴﺠﻣﺮﺒﻟﺍ: pwen
ﺡﺮﺟ: kram
ﻝﺎﺼﻳﺇ: ryis
ﻦﻴﻜﻤﺗ: nlim
protasis: hpoc
ﻕﻻ﻿ﺰﻧﺍ: slok
ﺓﺭﻮﺛ: hrif
ﻉﺭﺍﺰﻣ: hjim
ﺔﻴﻏﺎﻣﺪﻟﺍ-ﺔﺘﻜﺴﻟﺍ: trak
ﺔﺼﻨﻣ: hpof
ﻝﻮﺳﺭ: hmes
ﺯﺎﻴﺘﻣﺍ: hpek
ﻢﻈﻨﻣ: hyot
ﻢﻠﻋ-ﺐﻟﺎﻃ: clen
ﻒﻬﻛ: hgec
ﺪﻴﻠﻘﺘﻟﺍ: rwat
ﺓﺎﺳﺄﻣ: tses
ﻊﻳﺩﻮﺗ: hjap
ﺪﻘﻧ: ryik
ﻦﻄﻗ: krap
ﻰﻔﺸﺘﺴﻣ: slot
ﺭﺎﺠﻳﺇ: kris
ﺯﺎﻏ: hges
ﻪﻨﻣ-ﺮﻔﻣ-ﻻ﻿: pwic
ﺖﻴﻤﻣ: hgim
ﺮﺠﺸﻟﺍ-ﺔﻗﺭﻭ: glit
ﺭﻮﺸﻨﻣ: plun
ﻲﺋﺍﺪﻋ: tsup
ﺔﻤﺟﺮﺗ: dwan
ﺓﺯﺎﻨﺟ: jran
ﻖﻴﻗﺩ: mrun
ﺔﻠﺳﺍﺮﻣ: ryon
ﻲﺴﻧﺎﻣﻭﺭ: hrom
ﺥﻮﻛ: clun
ﺡﺮﺘﻗﺍ: psot
ﺪﻴﻠﻘﺘﻟﺎﺑ-ﻢﺴﺘﻣ: hmet
ﺭﻻ﻿ﻭﺩ: dlon
ﺭﺎﻬﻨﻟﺍ-ءﻮﺿ: hjac
ﺮﺸﻋ-ﺱﺩﺎﺴﻟﺍ: hsos
ﺔﻴﻌﻤﺟ: hzac
ﺓﺮﻤﻌﺘﺴﻣ: klon
ﺡﺎﻨﺟ: gyin
ﺪﺳﺃ: hles
ﺔﻓﺎﻘﺛ: klut
ﺩﻮﻤﻋ: hkom
ﺮﻜﻣ: glak
ﺎﻣﺍﺭﺩ: dram
ﺔﺘﻜﻧ: hjuc
ﺏﺎﺒﺿ: hdus
ءﺍﻭﺪﻟﺍ: dwas
ﺓﺮﺸﻋ-ﺔﻌﺑﺭﺃ: hkes
ﺾﻣﺎﺣ: sram
ﻱﺃ: hyet
ﻞﺧﺩ: hmok
ﻒﻘﺳﺃ: hbip
ﻲﻟﺎﻘﺗﺮﺒﻟﺍ: tron
ﻡﺎﻤﺣ: byan
ﻲﺋﺍﺪﺑ: rwit
ﺔﻠﺳ: ksek
ﻦﻴﻣﺃ: sris
ﺶﻗ: prak
ﺭﻮﺒﺻ-ﺮﻴﻏ: pfif
ﺹﻼ﻿ﺧ: slon
hodiernal-ﺮﺗﻮﺗ: dlin
ﻡﺰﺘﻋﺍ: zrin
ﺭﺎﺨﺑ: tcip
ﻢﺳ: hwoc
ﺔﺒﻫﻮﻣ: tlon
ﺥﺎﻨﻣ: lwim
ﻝﺎﻌﻓ: fric
ﺰﻴﻤﺗ: tcif
ﻞﺴﻏ: dwac
ﻑﺍﺮﺘﻋﺍ: kfis
ﻍﺭﺎﻓ-ﻡﻼ﻿ﻛ: hjas
ﻢﺤﻓ: kyon
ﻒﻴﻔﺧ-ﻞﻳﻮﻃ-ﻕﺭﻭﺯ ﻮﻨﻜﻟﺍ: kwon
ﺖﻗﺆﻣ: tric
delimitative-ﺐﻧﺎﺟ: hdip
ﻢﻈﻋ: hcos
ﻦﻴﻨﺛﻹ﻿ﺍ: nwic
ءﺎﺛﻼ﻿ﺜﻟﺍ: glac
ءﺎﻌﺑﺭﻷ﻿ﺍ: bwac
ﻲﻟﺍﺭﺪﻔﻟﺍ: frin
ﻪﻴﻓ-ﺏﻮﻏﺮﻣ: hzic
ﻞﺜﻤﻣ: ryic
ﻥﺎﺘﻛ: lwin
ﺔﻋﻮﻟﺎﺑ: swuk
ﺖﺧ-ﻷ﻿ﺍ-ﻭﺃ ﺥﻷ﻿ﺍ ﻦﺑﺇ: bwin
ﻡﺍﺩ: kric
ﺭﺎﺼﺣ: cren
ﺓﺪﻌﻣ: hpem
ﺱﺎﺤﻧ: pcon
ﺔﻤﻗ: hzik
ﺲﻣﺎﺨﻟﺍ: pfik
ﺺﻴﺧﺭ: brat
ﺔﻳﺮﺼﺣ-ﺺﺨﺷ: kwen
ﺰﺠﺣ: zrat
ﺝﺎﻴﺳ: hzas
ﻝﺎﺜﻤﺗ: tfam
ﺔﻴﻌﻓﺪﻤﻟﺍ-ﺡﻼ﻿ﺳ: tlep
ﻖﻧﺎﻌﺗ: mrap
ﻂﻴﺤﻤﻟﺍ: sren
ﺔﻗﺪﺑ: srot
ﻝﺍﺰﻐﻟﺍ: hluf
ﺓﺮﻴﺠﺷ: hbuc
ﺔﻳﺪﻳﺪﺤﻟﺍ-ﺔﻜﺴﻟﺍ: hrep
ﻎﻳﺮﻔﺗ: hduk
ﺚﻳﺭﻭ: mris
ﻁﻮﻠﺑ: blun
ﺾﻴﻐﺑ: pren
ﻉﺍﺮﺘﺧﺍ: hgic
ﻮﻧﺎﻴﺑ: pyon
ﻉﺎﻨﻗﺍ: swen
ﻰﺋﺮﻣ-ﺮﻴﻏ: gric
ﺭﻮﻬﺸﻣ: ryun
ﺓﻮﺴﻗ: kluk
ءﺍﺮﻏﺇ: hyoc
ﻚﻴﻠﻴﺗ-ﺐﻧﺎﺟ: hlep
ﻱﺩﺎﺼﺘﻗﺍ: kfik
ﻲﻟﻭﺩ: troc
ﻞﺧﺪﺗ: tcek
ﻑﻮﺴﻠﻴﻓ: flif
ﻖﻴﻧﻷ﻿ﺍ: gyit
ﺮﻴﺧ: kyen
ﻚﻤﺴﻟﺍ-ﺪﻴﺻ: mlak
ﺔﻗﺮﺳ: truc
ﺔﻔﺷ: hloc
ﺪﻋﺎﻘﺗ: ryac
ﺩﺍﺪﺘﻣﺍ: sras
ﺽﺮﻋ-ﺔﻟﺎﺻ: glen
ﻯﺯﺍﻮﻣ: zlan
atelic-ﺐﻧﺎﺟ: htep
ﺓﺭﺎﻗ: trap
ﻲﻤﻳﺮﺤﺗ-ﺝﺍﺰﻣ: nrim
ﻝﺩﺎﻌﺘﻟﺍ: dwat
ﺔﻧﺍﺰﻧﺯ: slep
ﺔﻀﻴﺑ: dyan
ﻊﻨﻄﺼﻣ: jrat
ﻥﻮﻀﻏ-ﻲﻓ: nwis
ﺔﻣﺯﺃ: ksot
ﺏﺬﻬﻣ: sloc
ءﺍﺪﻏ: lyon
ﺮﺑﻮﻨﺻ: pwon
ﻊﻓﺩﺇ: hcef
ﻒﻟﺎﺤﺗ: lyen
ﺮﺼﺨﻟﺍ: hkop
ﺓﺰﺠﻌﻣ: hmek
ﺭﺎﺤﺑ: slis
ءﺎﻘﻧ: prut
ﺔﻳﺭﻮﻬﻤﺟ: hguk
ﻒﺗﺎﻫ: tfen
ﻁﻮﺳ: krip
ﺺﻴﻤﻗ: cyim
ﻢﻳﺪﻘﺗ: ryas
ﺔﻜﻳﺭﺃ: hsof
ﺢﺴﻣ: hsup
ﻕﺭﺎﺴﻟﺍ: ksif
ﻆﻔﺘﺣﺍ: nrec
ﺓﺎﻨﻗ: kcen
ﺔﻴﺼﺨﺷ: klim
ﺡﻼ﻿ﺻﺇ: kfam
ﺩﺪﻬﻣ: hzim
ﻒﻛ: plim
ﺙﺪﺤﺘﻤﻟﺍ: hzak
ﺔﺒﺘﻋ: dwic
ﺚﺣ: pris
ﺔﺑﺮﺣ: bzak
ﻖﻴﻧﺃ: syec
ﺔﺴﻠﺟ: cwen
ﺐﻳﺬﻌﺗ: crot
ﺐﻃﺭ: tcum
ﻞﺒﺟ-ﺔﻤﻗ: grit
ﺮﻓﺎﺴﻣ: hyek
ﺔﻨﺤﻄﻣ: mwik
ﺔﻄﻳﺮﺧ-ﻢﺳﺭ: jrac
ﻕﻮﻃ: klok
ﻞﺤﻣ-ﻞﺤﻳ: klif
ﺪﻤﻌﺘﺑ: drat
ﺓﺮﻴﺑ: hbif
ﻞﻤﺨﻣ: hwem
ﺔﻴﺑﺫﺎﺠﻟﺍ: gwit
ﺔﺒﻄﺧ: hpum
ﺓءﺎﺳﺇ: glas
ﻊﻴﻄﻗ: hgen
ﺮﺸﻋ-ﺔﺛﻼ﻿ﺛ: tres
ﺮﻳﺮﺒﺗ: jyit
ﺔﻌﻤﺠﻟﺍ: crum
ﺓﺎﺷﺮﻓ: broc
ﻞﻴﻤﺤﺗ: dlas
ﻢﻳﺮﻛ: krem
ﻑﺮﺟ: klaf
ﻦﻴﻔﻠﺤﻤﻟﺍ-ﺔﺌﻴﻫ: jrin
ﺦﺴﻣ: ksos
ﺪﻤﺠﻣ: hgoc
ﺺﻴﺻﺃ: pfot
ﺵﺮﻗ: psen
ﺮﺻﺃ: srut
ﺔﺣﺎﻔﺗ: hpep
ﺶﻗﺎﻨﺗ: drak
ﺔﻴﻔﻠﺧ: prun
ﺦﺴﻨﻳ: trim
ﻱﺭﻭﺩ: prik
ﺔﻴﻠﺴﺗ: nren
ﺱﻭﺮﻴﻓ: bris
ﻲﻟﻮﻔﻃ: blit
ﺲﻜﻌﺗ: flit
ﻝﻮﺤﺗ: kcet
ﺔﻀﻳﺮﻌﻟﺍ-ﻁﻮﻄﺨﻟﺍ: kluc
ﺍﺮﺑﻭﻷ﻿ﺍ-ﺭﺍﺩ: hpop
ﺔﻘﻓﺍﻮﻣ: nron
ﺍﺮﺳ-ﻰﺸﻓﺃ: rwak
ﺔﺒﻗﺎﻌﻣ: hzen
ﻉﻮﻛ: kcon
ﻖﻠﻌﺘﻟﺍ: tcet
ﺢﻠﺼﻳ: hrop
ﻩﻮﺒﺸﻣ: cyec
ﻥﻮﻌﺒﺳ: swet
ﺱﺪﻘﻤﻟﺍ-ﺏﺎﺘﻜﻟﺍ: srip
ﺓﺮﻔﺣ: grac
ﺏﺍﺮﻄﺿﺍ: dlak
ﻲﺋﺎﻨﺛ: byin
ﺮﻳﺩ: bjan
ﻢﻬﺳ: tcec
ﻞﻴﻤﺗ: trec
ﺢﺿﻭ: frat
ءﺎﻓﻭ: hlot
ﺔﻴﻧﺪﻌﻣ-ﺔﻠﻤﻋ: syip
ﺶﻌﺗﺮﺗ: tcem
ﻰﻔﻨﻣ: gwin
ﻰﻜﻴﻧﺎﻜﻴﻣ: myim
ﺦﻓ: crap
ﺔﻜﻌﻛ: kyek
ﻱﺪﻴﺳ: cyes
ﺩﺩﺮﺗ: sret
ﺮﺸﻋ-ﻪﻌﺒﺳ: syet
ﻞﺴﻋ: myon
ﺪﺗﻭ: dzat
ﺓﻮﻄﺧ: hjam
ﺔﻨﺒﻟ: brit
ﻥﻮﻧﺎﻤﺛ: hpes
ﻆﺤﻟﺍ-ءﻮﺴﻟ: pcen
ﺭﻭﺎﺸﺗ: kcot
ﺓﺭﻮﻄﺳﺃ: lwen
ﺩﺎﺼﺣ: hfos
ﺔﻴﻔﻴﻇﻭ-ﺔﻴﻗﺮﺗ: pfon
ﺪﻗﻮﻣ: hsop
ﺩﺮﻤﺘﻣ: bric
ﺯﺍﺮﻄﻟﺍ-ﻢﻳﺪﻗ: hnom
ﻢﺨﻀﺗ: cron
ﻊﻘﻨﺘﺴﻣ: swot
ﺔﺼﻠﺻ: hdes
ﺪﻫﺍﺯ: pces
ﺮﻳﺪﻣ: mren
ﺔﻗﻮﺟ: cros
ﻲﻧﻼ﻿ﻘﻋ: tson
ﺔﺠﻟﺎﻌﻣ: pson
ﺐﺋﺬﻟﺍ: blaf
ﺓﺩﺎﺠﺳ: hgap
ﺔﻤﻳﺪﻘﻟﺍ-ﺭﻮﺼﻌﻟﺍ: hjak
ﺐﺼﺧ: frut
ﺓﺭﺎﻔﺻ: slif
ﻦﺒﺟ: twis
ﺔﻀﻋ: byat
ﻮﻋﺪﻳ: jwan
ﺔﻴﺋﺍﺭﺪﺗﺎﻛ: kyet
ءﺎﻨﻴﻣ: brak
ﻝﻮﺠﺗ: djan
ﻞﻴﺻﺎﺤﻤﻟﺍ: tsos
ﺔﻳﺮﺤﺒﻟﺍ-ﺕﺍﻮﻘﻟﺍ: nlen
ﻉﺎﻨﻗ: mrok
ﻢﻠﻗ: pses
ﺕﺍﻭﺮﻀﺨﻟﺍ: sroc
ﺽﺮﻋ: hzet
ﻝﺎﻄﻨﺑ: tlun
ﺩﺎﺴﻓ: hrup
ﺔﻧﺍﺰﺧ: nram
ءﺎﺴﺣ: srup
ﺡﺍﺮﺟ-ﺐﻴﺒﻃ: syon
ﻝﺪﺑ: tcot
ﻪﺳﻮﺳﺎﺠﻟﺍ: gyas
ﺭﻮﻬﺘﻣ: hlec
ﺔﻤﻴﻤﻧ: gyic
ﺰﻣﺭ: hzon
ﺺﺨﻠﻣ: srok
ﺲﻴﻤﺨﻟﺍ: cwim
ﺭﻭﺮﻤﻟﺍ-ﺔﻛﺮﺣ: ryaf
ﺔﻳﺭﺎﻤﻌﻣ-ﺔﺳﺪﻨﻫ: ryek
ﻉﺪﺻ: rwaf
ﺔﻓﺮﺧﺯ: rwon
ﻲﺴﻜﻋ: lwas
ﻰﻠﺳ: mwun
ﻉﺎﺟﺮﺘﺳﺍ: ksus
ﻉﺭﺎﺸﻟﺍ-ﻒﻴﺻﺭ: plut
ﻢﺳﺎﺣ: dyin
ﻲﺒﻠﺳ: nraf
ﻥﺎﺟﺮﻬﻣ: hfec
ﺪﺤﻟﺍ: hrum
ﺔﻧﺎﻴﺨﻟﺍ: zyan
ﺩﺎﻴﺻ: djin
ﻥﺎﺒﻌﺛ: syen
ﺔﻳﺭﺎﻄﺑ: bret
ﻊﻤﺷ: flam
ﻱﺮﺤﺘﻣ: dlit
ﻞﻴﻠﺤﺗ: nlis
ﺪﻳﺪﺸﺗ: hzot
ﻥﻮﺤﺒﺴﻳ: twen
ﻑﺮﻇ: lwaf
ﻥﺎﻛ-ﺎﻳﺃ: hgek
ﺓﺭﺎﺠﻴﺳ: jrit
ﻙﺮﺤﻣ: mrot
ﻉﻮﻄﺗ: hwot
ﻞﻌﻓ-ﺩﺭ: ryif
ﺔﻌﺘﻣﺃ: blam
ﻢﺻﺃ: hboc
ﺮﻴﺼﻋ: hjus
ﻊﺿﺍﻮﺗ: jlit
ﺓﺭﺍﺯﻭ: mret
ﻲﺴﻨﺟ: hjon
ﺓﺮﺋﺍﺪﻟﺍ-ﺮﻄﻗ: dyam
ﺱﺄﻔﻟﺍ: blac
ﺱﺎﻤﻟﺍ: dlam
ﻞﻳﺪﺒﻟﺍ: hlek
ﺕﻮﺻ-ﻯﺪﺻ: hgus
ﺢﺒﻛ: swon
ﺔﻳﻮﻫ: hdaf
ﺔﺷﺎﺷ: krun
ﻝﻮﺴﻛ: lwis
momentane-ﺐﻧﺎﺟ: hmop
ﻕﺎﻔﺗﺍ: kfot
ﻑﺍﺮﺤﻧﺍ: hdif
ﻰﻔﺘﺧﺍ: hgaf
ﻉﺎﻌﺷ: ryen
ﺮﺒﺣ: mwic
ﻞﺋﺎﻫ: mraf
ﻮﺒﻗ: dyac
ﺯﺭﺎﺑ: nrun
ﺞﻫﻭ: klek
ﺥﻮﻴﺸﻟﺍ-ﺲﻠﺠﻣ: slet
ﺶﻌﻧ: tfap
ﺓﺮﻔﻐﻣ: frac
ﻉﻼ﻿ﺘﺑﺍ: nlun
ﻞﻟﺩ: nlot
ﺢﺟﺭﺄﺘﻟﺍ: swun
ﺝﺮﻣ: gram
ﻊﻤﺠﻣ: klos
ﺔﻟﺎﻘﺘﺳﺍ: hzis
ﻊﺿﺍﻮﺘﻣ-ﻞﻴﺠﺴﺗ: nret
ﺓﺮﻣﺍﺆﻣ: swim
ﻞﻔﻠﻓ: prip
ﺔﻴﻓﺮﺣ-ﺔﻤﺟﺮﺗ: pron
ﺢﺷﺮﻣ: hzam
ﺐﻠﻌﺛ: flik
ﺔﻨﺧﺪﻣ: tcon
ﺹﺎﺼﺘﺧﻻ﻿ﺍ: drik
ﺔﻋﺍﺭﺯ: rwic
ﺔﻗﺩ: tcuk
ﻖﺑﺎﺳ-ﻰﻓﻮﺘﻣ: brim
ﻲﻃﺍﺮﻘﻤﻳﺩ: mrek
ﻢﻋﺮﺑ: hbos
ﺔﻴﻧﺎﻄﺑ: bwat
ﻞﺑﺍﻭ: hgep
ﺮﻳﺰﻨﺧ: srus
ﻞﻜﺸﻟﺍ: krek
ﺝﺎﻋ: craf
ﻲﻜﻴﺳﻼ﻿ﻛ: ksok
ﺐﻗﺍﺮﻣ: nwet
ﻞﻴﻓ: lwit
ﺮﻓﺎﻇﻷ﻿ﺍ: nwus
ﺔﻠﺤﻧ: hmif
ﻦﻓﺩ: dzan
ﻞﺜﻤﻤﻟﺍ: bzat
ﻕﺮﻋ: zwan
ﻱﺪﻨﻟﻮﺑ: ploc
ﻢﻫﻭ: hlus
ﻚﺸﻟﺍ: pcet
ﻱﻮﻧﺎﺛ: syif
ﺔﻴﻃ: tsot
ﻲﻔﻳﺭ: grun
ﻩﻭﺄﺗ: nyen
ﻪﺑﺎﺸﺗ: slec
ﺲﺒﺘﻗﺍ: hzun
ﺲﻴﻛ: cyek
ﺝﺎﻋﺯﺇ: fren
ﺓﺮﺑﺇ: hjun
ﺪﻫﺎﺷ-ﻭﺫ: nroc
ﺝﺎﺟﺩ: truk
ﻖﺴﺘﻣ: kwot
ﻞﻴﻣﺮﺑ: bras
ﻱﺩﺎﻴﺘﻋﺍ-ﺐﻧﺎﺟ: hcep
ﺮﻴﺒﺧ: ksec
ﺏﺎﺠﻋﺍ: blin
ﻥﻮﺘﻳﺯ: zlin
ﻞﻘﻧ-ﺓﺭﺎﻴﺳ: myen
ﺔﺒﻘﻋ: bwak
ﺓءﺎﻤﻳﺇ: kcec
ﺔﻨﺿﺎﺤﻟﺍ: plaf
ﻒﻳﺮﻌﺗ: fyic
ﺩﻼ﻿ﻴﻤﻟﺍ-ﺦﻳﺭﺎﺗ: gjin
ﺵﻮﻛﺎﺷ: hcof
ﻖﺒﻋ: hfon
ﺭﺍﺮﻜﺘﻟﺍ: trun
ﻪﻓﺎﺗ: twut
ﺔﻠﻛﺭ: hjik
ﺮﻔﺣ: kwaf
ﺔﻔﻴﻟﻷ﻿ﺍ-ﺕﺎﻧﺍﻮﻴﺤﻟﺍ: plot
ﺔﻤﺠﻤﺟ: hcop
ﺔﻴﻌﻳﺮﺸﺘﻟﺍ-ﺔﻄﻠﺴﻟﺍ: dlik
ﺐﻌﻛ: cruk
ﺱﻮﺒﻋ: crun
ﻉﺍﺮﺘﺧﻹ﻿ﺍ-ﺓءﺍﺮﺑ: plet
ﺭﺎﻴﻠﻣ: blim
ﺔﻴﺋﺎﻴﻤﻴﻛ-ﺓﺩﺎﻣ: fyik
ﺭﺎﻴﻃ: pyot
ﺪﻠﻗ: mlot
ﺓﺭﻮﻨﺗ: kwet
ﺓﺩﺎﻌﻟﺍ-ﺮﻴﻏ-ﻰﻠﻋ: srap
ﻲﻋﻮﺒﺳﺃ: jwik
ﻲﻨﻘﺗ: tfip
ﺔﻴﺗﺎﺒﻨﻟﺍ-ﺓﺎﻴﺤﻟﺍ: tset
ﺏﺍﺮﻏ: kraf
ﺲﻤﺸﻟﺍ-ﻕﻭﺮﺷ: sruc
ﺓﺎﻴﺤﻟﺍ-ﺕﺎﻗﻭﺃ: glin
ﺔﻤﻫﺎﺴﻤﻟﺍ: hyom
ﺪﻴﺻ-ﺓﺭﺎﻨﺻ: hdok
ﺮﻤﻧ: blic
ﻞﻠﺴﺗ: crut
ﻢﻛ: slun
ﻊﻳﺮﺳ-ﻖﻳﺮﻃ: jras
ﺎﻴﺸﻴﻠﻴﻣ: mlip
ﻕﺪﻨﺧ: kroc
ﺔﻫﺍﺰﻧ: kret
ﺮﺸﻋ-ﺔﻌﺴﺗ: dzin
ﻱﻮﻀﻋ: rwik
ﺕﻮﻫﻻ﻿: flic
ﻮﻔﻄﺗ: flut
ﺓﺮﺣﺎﺳ: byac
ﺮﺠﺿ: hwuk
ﻲﺳﺎﻣﻮﻠﺑﺩ: dyik
ﻮﻳﺩﻮﺘﺳ: twos
ﺯﻭﺎﺠﺗ: kcok
ﺎﻴﻧﺎﺒﻣﺎﺷ: cyen
ﻢﻬﻟﺃ: crif
ﺔﻳﺍﺭ: hbes
ﻕﻼ﻿ﻃ: lwon
ﺔﻘﻋﺎﺻ: hbut
ﺪﻳﺭﻭ: jyan
ﻝﻮﻬﺠﻤﻠﻟ-ﻲﻨﺒﻣ: psif
ﺓﻮﻏﺭ: hgum
ﻰﺼﺣ: grik
ﺭﺰﺌﻣ: tyen
ﺐﻛﻮﻛ: gren
ﻑﻮﻓﺭ: claf
ﺔﺣﻭﺮﻣ: flon
ﻲﺋﺍﻮﺘﺳﺍ: hjip
ﺔﻠﺣﺮﻣ: fwas
ﻲﻃﺎﺒﺘﻋﺍ: rwen
ﻖﻄﻧ: kfun
ﻖﺒﺋﺯ: krok
ﻒﺣﺯ: hrem
ﺭﺎﺤﺘﻧﺍ: tcos
ﻲﻓﺎﺤﺻ: prot
ﻡﺮﺣ: hpok
ﺮﻫﺎﻣ: klun
ﺔﻓﺮﺷ: blik
ﺔﻛﻮﺷ: fras
ﻞﻣﺎﻋ: mlek
ﻞﻤﻌﻟﺍ-ﺏﺭ: myot
ﺽﺮﻌﻟﺍ: jrak
ﺞﻋﺰﻨﻣ: djit
ﻢﻬﺗﺍ: klot
ﺵﺎﻌﻣ: pyen
ﻞﻌﻔﻟﺍ: kres
ﺩﺮﻗ: mwon
ﻝﻮﺒﻘﻣ: hwek
ﻊﻴﻗﻮﺗ: tlim
ﻲﺴﻛﺫﻮﺛﺭﺃ: rwos
ﺔﻳﺮﺨﺳ: fron
ﺔﻧﺎﻀﺣ: nrap
ﺔﻌﻧﺎﻤﻣ: jlan
ﺩﺍﺮﻴﺘﺳﺍ: tyot
ﺔﻠﻌﺷ: croc
ﺔﻐﻠﻟﺍ-ﺪﻋﺍﻮﻗ: gjak
ﺔﻌﻳﺩﻮﻟﺍ: gyat
ﻱﺭﺎﻤﻌﺘﺳﺍ: plon
ﺖﺨﻳ: jyat
ﺎﻴﻘﻄﻨﻣ-ﻂﺑﺍﺮﺘﻣ: kwec
ﺔﺒﻗ: kwun
ﺔﻛﺎﻤﺳ: hfot
ﺪﻴﻨﻋ: cyon
ﺔﻠﻀﻋ: hmup
ﻢﺠﺣ: ryam
ﻙﺮﻓ: ryos
ﻥﺎﺒﺟ: rwam
ﺮﻴﺨﺴﺗ: gwac
ﺺﻤﺤﻣ-ﺰﺒﺧ: tros
ﺭﺄﻓ: myus
ﻲﻈﻔﻟ-ﻊﻄﻘﻣ: slim
ﺔﺘﻴﺑﺮﺗ: prap
ﺭﺍﻮﺣ: dlaf
ﺪﻳﺎﺤﻣ: nrot
ﺩﺎﻬﺘﺟﺍ: dwin
ﺾﻗﺎﻨﺗ: trot
ﻖﻘﺤﻳ: kfic
ﺰﻋﺎﻣ: byak
ﺮﻫﺩﺰﺗ: hfet
ﺽﺮﻓ: mlon
ﻝﻮﻬﺠﻣ: nwim
ﻲﻤﺳﺭ-ﻞﻴﺠﺴﺗ: frit
ﻞﺠﻋ: hbof
ﺐﻴﺘﻛ: mwut
ﺮﻬﺻ: hjec
ﻑﺬﺣ: flas
ﺔﻠﻈﻣ: gras
ءﺍﺬﺣ: bzut
ﻥﺪﻌﻣ: mrim
ﺔﻧﺪﻫ: crus
ﻂﺑ: hbok
ﻂﻴﻄﺨﺗ: pfam
ﻥﻮﺑﺎﺻ: hsuf
ﺔﻴﻣﺩ: gwak
ﻰﻤﻈﻋ-ﻞﻜﻴﻫ: klet
ﻼ﻿ﻴﻓ: blis
ﺔﻃﺎﻴﺧ: jlin
ﺢﻟﺎﺼﺗ: dyak
ﺔﻳﻼ﻿ﻏ: kset
ﺞﺿﺎﻧ: mruc
ﺐﻧﺭﺃ: kruc
ﻞﺻﻮﻣ: nwot
ﺩﺎﻤﺘﻋﺍ: djat
ﺐﻋﻻ﻿: jlic
ﺓﺮﺸﺣ: pset
ﻢﻌﻄﻣ: cret
ﺔﻣﻮﺑ: lwun
ﻑﺮﻄﺘﻣ: djik
ﻢﻴﻘﻣ: zwin
ﻦﻴﻨﺗ: dron
ﻲﻌﻤﺳ-ﺮﻫﺎﻇ: drot
ﺶﻄﻌﺘﻣ: kyos
ﺚﻳﺮﺗ: dren
ﺔﻴﺑﺎﺴﺣ-ﺔﻴﻠﻤﻋ: glun
ﻢﻴﻈﻨﺗ: ryim
ﺓﺪﻤﻋ: mlap
ﺔﻴﻠﻗﺃ: mric
ﺫﺍﻮﺤﺘﺳﺍ: dwon
ﻢﻳﺪﻗ-ﺏﺭﺎﺤﻣ: bren
ﺍﺮﺘﺴﻛﺭﻭﺃ: ryes
ﺩﺪﻘﻣ-ﺮﻳﺰﻨﺧ-ﻢﺤﻟ: bjin
ﺉﻭﺎﺴﻣ: zwat
ﺵﺎﻤﻗ: frap
ﻲﻘﻴﺳﻮﻣ: gzik
ﺎﻴﻠﻘﻋ: hnep
ﻥﺍﺮﺘﻗﺍ: nyon
ﻢﺋﻼ﻿ﻣ-ﺮﻴﻏ: nrip
ﻪﻳﺭﺎﻤﻌﻤﻟﺍ-ﻪﺳﺪﻨﻬﻟﺍ: tsek
ﻥﻮﻤﻴﻟ: nyim
ﻝﺎﻌﺳ: kcos
ﺱﺍﺮﻟﺍ-ﻉﺍﺪﺻ: crek
ﺮﺟﺄﺘﺴﻣ: ryet
ﺔﺑﻮﺼﺧ: srun
ﻰﻔﺸﻳ---ءﺎﻔﺷ: hfoc
ﻥﻮﻌﺴﺗ: nwon
ﻲﺋﺍﻮﺸﻋ: hbec
ﺔﻘﻌﻠﻣ: kcek
ﺔﻧﻮﻟﺎﺑ: blon
ﺮﻴﺷﺎﺒﻃ: hfip
ﻲﺟﺎﺘﻨﺘﺳﺍ-ﺮﻫﺎﻇ: nlet
ﺮﺷﺎﻨﻟﺍ: pcot
ﻞﺧ: sruk
ﺩﺎﻣﺭ: fyec
ﻱﻮﺸﺣ: slek
ءﺎﻴﺣﺇ: nrut
ﺮﺛﺄﺘﻟﺍ-ﻊﻳﺮﺳ: kfim
ﻖﻔﻧ: tfun
ﺰﻐﻟ: hpef
ﺔﻴﻟﺁ: mwim
ﺕﺎﻴﺿﺎﻳﺮﻟﺍ: gzit
ﻰﺷﻼ﻿ﺗ: frun
ﺪﺒﻛ: jwin
sublative-ﺔﻟﺎﺣ: bwik
ﺲﻄﻏ: dris
ﺓﺪﺣﻭ: twim
ﺭﺎﻜﺘﺣﺍ: hnop
ﺭﺎﻤﻘﻟﺍ-ﺐﻌﻟ: hgup
ﺔﺻﺍﻮﻏ: bzin
ﻝﺍﺰﻟﺯ: hbem
ﺮﺒﺘﺨﻣ: brot
ﻦﻴﻠﻓ: kruk
ﺕﺍﺬﻟﺍ-ﺔﺒﻗﺍﺮﻣ: syot
ﺍﺫﻮﺑ: hbus
ﺔﻜﺳﺎﻤﺘﻣ: bjat
ﺓﺭﺎﻔﺴﻟﺍ: blas
ﺪﻌﺑﻷ﻿ﺍ: sres
ﻲﺤﻳﺮﺼﺗ-ﺝﺍﺰﻣ: drim
ﺰﻴﻔﺤﺘﻟﺍ: tyuc
ﺔﺗﻻ﻿ﻮﻛﻮﺷ: clot
ﺔﻓﺪﺻ: tyon
ﺯﺎﻔﻗ: gwat
ﻊﻛﺭ: hjek
ﺎﻴﻓﺍﺮﻐﺟ: hjif
ﺭﺎﻤﺜﺘﺳﺍ: nwes
ﻲﻈﻔﻟ: mrec
ﻲﺋﺰﺟ-ﻪﺑﺎﺸﺗ: nlip
ﻲﻧﺎﻤﻠﻋ: srek
ﺮﻘﺼﻟﺍ-ﺮﺋﺎﻃ: blap
ﺲﻔﻨﻟﺍ-ﻢﻠﻋ: nloc
ﻂﺑﺭ: gjan
ﺓﺩﺮﺧ: krep
ﺭﻭﺩ: cyum
ﺔﻋﺮﺟ: hdos
ﻥﻮﻤﻠﺴﻟﺍ-ﻚﻤﺳ: slom
ﻎﻧﺩﻮﺑ: pwun
ﺏﺍﺬﺟ: gyik
ﺔﺨﻀﻣ: pcom
ﻦﻴﺠﺴﻛﺃ: ksip
ﺓﺩﺎﻬﺷ: tfot
ﺔﻴﻟﺍﺪﻴﻣ: hmem
ﺔﻏﻼ﻿ﺑ: trok
ﻂﺸﻛ: rwap
ﻑﺍﺬﺠﻣ: dyas
ﺏﻮﻜﺴﻠﺗ: trip
ﺓﺩﻼ﻿ﻗ: clek
ﺔﻴﺋﻼ﻿ﻣﻹ﻿ﺍ: prif
ﻲﻜﺴﻳﻭ: hwos
ﻑﺎﺼﻔﺻ: hwof
ﻞﻤﺟ: hlum
ﻱﻭﺎﻬﻟﺍ: myet
ﺝﻭﺮﺧ: crec
ﺔﻴﺗﺍﺫ-ﺓﺮﻴﺳ: brif
ﺭﺎﻤﺤﻟﺍ: gzac
ﺎﻳﺮﻬﺷ: mwis
ﻞﻫﺎﺠﺗ: nruk
ﺔﻠﻄﻋ: byit
ﺮﻘﻧﺍ: lyik
ﻱﻮﻀﻴﺑ: twon
ﻁﺎﻄﻣ: lyet
ﺱﻮﻣﺎﻗ: kfon
ﺮﻳﺰﻨﺧ-ﻢﺤﻟ: gzam
ﺮﻄﻤﻟﺍ-ﺱﻮﻗ: rwun
ﻚﻠﻬﺘﺴﺗ: kcum
ﻕﺎﺼﺑ: tcup
ﻥﺍﺰﺧ: trek
ﻞﻴﻣﺯ: clok
ﺔﺷﺍﺮﻓ: trif
ﺔﻄﻳﺮﺧ: graf
ﻡﺃﻮﺘﻟﺍ: jwat
ﻞﻘﺘﺴﻣ: trem
ﻥﺍﺭﺰﻴﺧ: hbum
ﺮﺟﺎﺗ: jlat
ﻢﻛﺍﺮﺗ: kles
ﺶﺘﻔﻣ: nyet
ﺔﻤﻘﻟ: hyos
ﺱﻮﺑﺎﻛ: hbom
ﻰﺑﺮﻣ: gjam
ﻒﺤﺘﻣ: mrem
ﺔﻳﺪﺠﺑﻷ﻿ﺍ: lwam
ﺮﺜﻌﺒﺗ: zras
ﺓﺭﺎﻏ: crip
ﻒﺸﻛ: clus
ﻦﻔﻌﺗ: fraf
ﻲﻧﺍﻭﺪﻌﻟﺍ: gris
ﻙﺎﻜﺘﺣﺍ: mroc
ﻱﺮﺤﺑ-ﻒﻴﺻﺭ: gyac
ﺕﻮﺒﻜﻨﻋ: brik
ﺲﻃﺎﻄﺒﻟﺍ: trut
ﺔﻌﺟﺍﺮﻤﻟﺍ: cwon
ﻊﺸﺟ: jlac
ﻪﻧﺍﻭﻷ﻿-ﻖﺑﺎﺳ: ryot
ﺏﺮﺿ: gzan
ﻊﻳﺮﺳ-ﻥﺍﺭﻭﺩ: pcip
ﺕﺎﻴﺋﺎﺼﺣﺇ: tsok
ﻢﻳﻮﻘﺗ: klem
ﺢﻴﺷﺮﺗ: nwen
ﻥﻮﻴﻠﻳﺮﺗ: tlos
ﺔﻴﻠﻋ: tlok
ﺖﺒﺜﻣ-ﺝﺍﺰﻣ: rwim
ﺕﺎﻘﻴﺒﻄﺘﻟﺍ: pfen
ﻲﻤﺳﻻ﻿ﺍ: nlon
ﺎﺿﺮﻟﺍ-ﻡﺪﻋ: sraf
ﻯﻭﺪﻋ: hfok
ﻖﻳﺮﺑﺇ: krot
ﻪﻴﻔﺘﻛ-ﺰﻫ: cyok
ﺪﺋﺍﺭ: gzin
ﻝﺎﻔﻏﺇ: nlif
ﺐﻧﺮﻜﻟﺍ: glic
ﻲﺿﺎﻳﺭ: tlet
ﺮﻜﺴﻟﺍ: mrut
idiophone: hdof
ﺔﻌﻓﺍﺭ: lwek
ﺥﻮﻴﺸﻟﺍ-ﺲﻠﺠﻣ-ﻮﻀﻋ: syem
ﺔﻴﺣﺰﻗ: nrif
ﺔﻠﻤﻧ: mwam
ﻖﺑ: hbop
ﻞﻣﺎﺣ: grim
ﻞﺟﺎﻋ: hjet
ﻞﺣﺎﻜﻟﺍ: tcok
ﻒﻴﻨﺼﺗ: glik
ﺮﻴﻐﺘﻣ: prim
ﻒﻟ: ryap
ﺪﻌﺠﻣ: krec
ﺖﻳﺮﺒﻛ: hsef
ءﻼ﻿ﻣﺇ: dwik
ﺯﺮﺑ: brun
ﻉﺪﻔﺿ: fram
ﻁﺮﻔﻣ-ﺔﻟﺎﺣ: twek
ﺞﻨﻔﺳﺇ: hjen
ﺞﻋﺰﻣ: djon
ﺏﺎﺠﻨﺳ: slip
ﻦﺤﻃ: zyin
irrealis-ﺝﺍﺰﻣ: flim
ﻥﺎﻛﺮﺑ: glam
ﻞﺧﺍﺪﻟﺍ-ﻲﻓ: gron
ﻝﻼ﻿ﻐﺘﺳﺍ: kloc
ﺔﻴﺟﻮﻟﻮﻴﺠﻟﺍ: jlik
ﺮﻔﺴﻟﺍ-ﺯﺍﻮﺟ: psop
ﻕﻼ﻿ﺧﻻ﻿ﺍ-ﻢﻳﺪﻋ: mlet
ﺖﻳﻮﻜﺴﺑ: hbuk
ﻥﻭﺎﻌﺗ: kros
ﺡﻮﻟ: tlot
ءﺎﺧﺮﺘﺳﺍ: kces
ﺓﺭﺬﻟﺍ: trom
ﺯﺪﻳﻹ﻿ﺍ: hzip
ﻡﺮﻫ: psim
ﺓﺭﻭﺩ: swok
ﺓﻮﻔﻏ: hnup
ﻲﻋﺮﺷ-ﺮﻴﻏ: hjaf
ﻚﺣ: pfap
ءﺎﻴﺣ: crom
ﻑﻮﺴﻛ: klip
ﺩﻮﻋ: lwap
ﺔﺴﻨﻜﻣ: srum
ﺔﺣﻮﻟ: mwen
ﻚﻠﻔﻟﺍ-ﻢﻠﻋ: tcom
ﺔﻫﺎﺘﻣ: blen
ﺔﻴﺳﺍﺭﺩ-ﺔﺤﻨﻣ: bwit
ﺓﺎﻔﺤﻠﺳ: kfuc
ﺭﺎﺸﺘﺴﻣ: dwak
ﻒﻴﻟ: fwic
ﺖﻴﻜﻳﺮﻛ: jrik
ﺔﻣﺎﻤﺣ: ksom
ﻒﻴﻜﺗ: dyon
ﺚﻠﺜﻣ: tfon
ﻕﻭﺪﻨﺻ-ﻦﻴﻣﺃ: tsen
ﻦﻴﺟﻭﺭﺪﻴﻫ: jron
ﺶﻫ: hfuk
ﺔﻌﺑﺎﻃ: pyet
ﻖﻨﺧ: tcof
ﻦﻣﺰﻣ: gzon
ﺐﻠﻐﺗ: slaf
ﺔﻠﻀﻌﻣ: dlim
ﺔﺳﺪﻨﻫ: jyin
ﺮﻳﻮﺼﺗ-ﺔﻟﺍ: hkef
ﺭﺍﺬﺘﻋﺍ: pluc
ﻖﻌﻟ: lwet
ﺔﺼﻗﺍﺭ: dret
ﺓﺮﺠﻫ: mres
ﺲﻨﺗ: tces
ﻱﺮﻘﻔﻟﺍ-ﺩﻮﻤﻌﻟﺍ: clip
ﻰﻠﻘﺗ: zrac
ﻝﻮﻧ: tfuc
ﺔﻨﻌﻃ: twuc
ﻱﺮﺴﻟﺍ-ﺰﻣﺮﻟﺍ: psaf
ﺓﺮﻛ-ﻒﺼﻧ: praf
ﺔﻴﺠﻴﺗﺍﺮﺘﺳﺇ: zrit
ﺰﺗﺭﺍﻮﻛ: krus
ﺺﻘﻣ: jris
ﺔﻳﺭﻭﺩ: proc
ﺪﻴﻠﺠﻟﺍ-ﺮﻬﻧ: lwic
ﻖﻳﺮﻄﻟﺍ-ﻒﺼﺘﻨﻣ-ﻲﻓ: dwam
ﺓﺮﻛﺬﻣ: mwap
ﻁﻭﺮﺨﻣ: kwuc
ﺮﻇﺎﻨﺗ: hzut
ﺔﻌﻨﺼﻤﻟﺍ-ﺔﻛﺮﺸﻟﺍ: zrak
ﻪﻴﻠﻋ-ﻰﻋﺪﻤﻟﺍ: fwik
ﺪﺠﺴﻣ: djis
ﺞﻧﺮﻄﺷ: cres
ﻡﻮﺳﺭ: htof
ﺯﺮﻜﻟﺍ: tref
ﺭﺎﺸﺘﻧﻻ﻿ﺍ-ﻊﺳﺍﻭ: kfen
ﺮﺜﻌﺗ: tfok
ﺔﻨﺣﺎﺷ: ryok
ﻝﺩﺮﺧ: mros
ﺔﺋﺎﻤﻟﺍ-ﻰﻓ: pfet
ﻲﻨﻠﻋ-ﺩﺍﺰﻣ: jlam
ﻝﺎﺑﺮﻏ: srif
ﺮﻘﺘﺴﻣ-ﺮﻴﻏ: swoc
ﺲﻴﻃﺎﻨﻐﻣ: gjat
ﺺﻣ: syus
ﻡﻼ﻿ﺳﻹ﻿ﺍ: slum
ﻊﺑﺎﺻﻷ﻿ﺍ-ﺱﻭﺅﺭ-ﻰﻠﻋ: twip
ءﺎﺸﻏ: mlen
ﺔﻗﻼ﻿ﺣ: clet
ﺭﺎﺘﻴﻏ: gjit
ﻊﻣﻻ﻿: bzan
ﺭﺍﺩﺭﺪﻟﺍ-ﺐﺸﺧ: hyem
ﻖﻠﺣ: kcom
ﺮﻴﻤﺿ-ﺔﻣﻼ﻿ﻋ: ryec
ﻲﺳﺎﺳﺃ: pcus
ﻞﺑﺎﺗ: zlat
ﺔﻟﺎﻔﻛ: jlas
ﻞﻗﺎﻨﻟﺍ: zyac
ﺯﺍﺰﺘﻫﺍ: bron
ﺶﻔﻧ: trus
ﺙﺍﺮﺤﻣ: hlom
ﻲﺟﻮﻟﻮﻴﺴﻓ: zlik
ﺏﺍﺭﺰﻣ: hgok
ﺐﻧﺬﻤﻟﺍ: cyet
ﻰﻄﺳﻮﻟﺍ-ﻥﻭﺮﻘﻟﺍ-ﻦﻣ: dyic
ﺭﻮﻔﺼﻋ: grec
ﺾﻳﻮﻌﺗ: twet
ﻚﻴﺘﺳﻼ﻿ﺒﻟﺍ: psuk
ﺔﻴﺷﺎﺣ: cyot
ﺭﺍﺪﻣ: rwot
ﺪﺼﺘﻘﻣ: twum
ﻒﻟﻮﺟ: hgof
ﺮﻔﺻ: zrun
ﺔﻗﺎﻗﺭ: tcep
ﻢﻠﻇ: prok
ﺏءﺎﺜﺗ: gjac
ﺓﺍﻭﺎﺴﻤﻟﺍ-ﻡﺪﻋ: gwas
ﺪﻠﺨﻟﺍ: tloc
ﺭﺎﺨﻔﻟﺍ-ﺔﻋﺎﻨﺻ: frik
ﻝﺰﻨﻣ-ﻪﺑﺭ: hgif
ﺭﺍﺩﻭﺎﺠﻟﺍ-ﺏﻮﺒﺣ: rwem
ﻰﺼﻋ: hyes
ﺢﻣﺎﺴﺘﻣ: glon
ﻦﻴﻨﺟ: brec
ﻢﺠﻨﻣ-ﻞﻣﺎﻋ: jren
ﺪﻴﺸﻧ: zlac
ﺓﺮﻴﻤﺧ: lyim
ﺓﺯﺎﺘﻤﻤﻟﺍ: pfim
ﻕﻮﻗﺮﺑ: plem
ﺱﻼ﻿ﻓﺇ: byas
ﻱﺭ: rwif
ﻉﺎﻨﻌﻧ: nyun
ﻲﻟﺎﻤﺳﺃﺭ: glis
ﺔﻧﻭﺮﻣ: hlef
ﺵﺮﻘﻟﺍ-ﻚﻤﺳ: gyak
ﺪﻴﻨﺠﺗ: drut
ﻦﻳﺰﺨﺗ: zren
ﺔﻴﻌﻗﺍﻮﻟﺍ: cles
ﻞﻴﺒﺠﻧﺯ: djic
ﻑﺎﻌﺳﺍ-ﻩﺭﺎﻴﺳ: blus
ﻪﺑﺎﺸﻣ: kwip
ﺐﻴﺟ-ﺔﻈﻔﺤﻣ: bjap
ﺮﺸﻛ: glim
ﻢﻟﺎﻋ: gyis
ﺔﻴﻤﻀﻬﻟﺍ-ﺓﺎﻨﻘﻟﺍ: grot
ﺵﺄﺟ-ﺔﻃﺎﺑﺭ: hwum
ﻮﻳﺩﺍﺭ: href
ﻉﻮﺿﻮﻤﻟﺍ-ﻊﻣ-ﻪﻟ ﺔﻗﻼ﻿ﻋ ﻻ﻿ ،ﺔﻠﺻ ﺕﺍﺫ ﺮﻴﻏ: zlit
ﺎﻴﻟﻮﺻﺎﻓ: bwam
ﻲﻤﺳﺭ-ﺮﻴﻏ: frim
ﺓﺪﻴﻔﺣ: gyut
ﻑﻼ﻿ﺧ: dloc
ﻢﺤﻟ-ﺔﺤﻳﺮﺷ: tfek
ﻦﻴﺟﻭﺮﺘﻧ: zron
ﺔﻗﻼ﻿ﺤﻟﺍ-ﺱﻮﻣ: hjut
ﺔﻀﻗﺎﻨﺘﻤﻟﺍ: krom
ﺔﻳﺎﻋﺩ: pcoc
ﺔﻳﺭﺎﻧ-ﺏﺎﻌﻟﺃ: fris
ﺔﻌﻗﺮﻓ: pcop
ﻪﺴﺑﻼ﻿ﻣ-ﻊﻠﺧ: crop
ﻢﻠﺛ: cruc
ﺮﻀﻣ: hzaf
ﺔﻳﺩﻮﻬﻳ: hjum
ﺔﻠﻤﻜﺗ: pluk
ﺔﺳﺪﻋ: lyes
pegative-ﺔﻟﺎﺣ: pwek
ﻥﺎﻃﺮﺳ: kfes
ﻦﻫﺭ: pyek
ﺮﺿﺎﺤﻣ: zyat
ﺏﺮﺴﺗ: hzuk
ﻞﻫﺄﺘﻟﺍ: krif
ﺔﻓﺎﺜﻛ: djot
ﺚﺤﻟﺍ: dyis
ﻎﻀﻣ: htuf
ﻡﻼ﻿ﻜﻟﺍ-ﺮﻴﺜﻛ: bzit
ﺮﺤﺒﻟﺍ-ﻥﺎﻃﺮﺳ: hgos
ﺮﻌﺴﻟﺍ-ﺾﻴﻔﺨﺗ: dyut
ﻩﺮﺟﺍ-ﺓﺭﺎﻴﺳ: tsuk
ﻲﻣﺮﻬﻟﺍ-ﻞﺴﻠﺴﺘﻟﺍ: crem
ﻢﺸﻳ: gyec
ﻚﺑﺎﺸﺗ: glaf
ﺔﻴﻠﺤﺳ: lyis
ﻝﻼ﻿ﺷ: crof
ﻝﺎﻣﻼ﻿ﻟ-ﺐﻴﺨﻣ: djak
ﺾﻘﻨﻟﺍ-ﻖﺣ: frot
ﺔﺳﺎﺋﺭ: ryip
ﺮﺘﺸﻣ: mrif
ﻥﻮﻟﺎﻏ: jlen
ﺽﻮﻌﺑ: mruk
ﻑﺍﺮﺤﻧﻻ﻿ﺍ: dwen
ﻉﺭﺎﺼﺗ: lyut
ءﺎﺴﻔﻴﺴﻓ: myok
ﺲﺑﺎﻗ: plok
ﺾﺑﺭ: pcuk
ﺔﻟﺎﻘﺑ: ksoc
ﻲﻋﻮﻴﺷ: myos
ﺶﻫﺪﺗ: mwek
ﺔﻴﺋﺎﻀﻘﻟﺍ-ﺔﻘﺣﻼ﻿ﻤﻟﺍ-ﺔﻟﺎﺣ: rwuk
ﺔﺒﻛﻮﻛ: nlos
ﺭﻮﺗﺎﺘﻛﺩ: dwit
ﻙﺎﻤﻬﻧﺍ: tyet
ﺔﻴﻋﺎﻨﺼﻟﺍ-ﺭﺎﻤﻗﻷ﻿ﺍ: tlec
ﻝﺎﻌﻨﻟﺍ: hlop
ﻦﻛﺎﺳ-ﻑﺮﺣ: fyon
ﻲﺒﻳﺮﻘﺗ: tsif
ﻞﻤﻌﻟﺍ-ﻦﻋ-ﻦﻴﻠﻃﺎﻋ: byet
ﺪﻳﺆﻣ: sros
ﺲﺗﻮﻟ: lwot
ﺲﺨﻟﺍ: sles
ﺪﻳﺭﻮﻠﻛ: lwok
ﺎﻳﺮﻴﺘﻜﺑ: bwic
ﺝﺰﻟ: pcek
ﻥﻮﻜﻣ: bwon
ﺓﺍﻮﻧ: klec
ﻖﻠﺘﺧﺍ: bjak
ﺖﻳﺎﺑ: bzet
ﺯﺍﺮﻓﺇ: sruf
ﺔﺣﺍﺮﺻ: pres
ﻦﻣﺍﺰﺗ: mloc
ﻪﻴﻟﺎﺒﻟﺍ-ﺺﻗﺭ: blet
ﻝﻮﺑ: mrus
ﻡﻮﺛ: lyun
ﻰﻀﻘﻧﺍ: hguc
ﺩﺎﺼﺘﻗﻻ﻿ﺍ-ﻢﻠﻋ: kcem
ﺔﻄﺳﻮﺘﻤﻟﺍ-ﺔﻘﺒﻄﻟﺍ: hdom
ﻖﻴﺷﺭ: gjic
ﻂﻘﻠﻣ: htef
ﺲﺑﻼ﻿ﻣ-ﻞﻴﺴﻏ: lyoc
ﺔﻟﻭﺍﺮﻔﻟﺍ: srem
ﻱﺮﻀﺤﻟﺍ: pcos
ﻞﺠﺨﻳ: mlaf
ﺮﺘﻓﺩ: tfut
ﻡﻮﺒﻟﺃ: zlam
ﻝﻮﺒﺴﻴﺒﻟﺍ: hbep
ﻢﺷ: sluc
ﻪﻴﻓﻮﺑ: hbuf
ﻞﻋﺎﻔﻟﺍ-ﻢﺳﺇ: rwip
ﺝﺍﺮﻛ: grek
ﺺﻴﺨﺸﺘﻟﺍ: djas
ﺯﺎﻜﻋ: ksuc
ﺯﺍﺰﺘﺑﺍ: srom
ﻞﻴﺠﺴﺘﻟﺍ: psuc
ﻥﺎﺑﻭﺬﻠﻟ-ﻞﺑﺎﻗ: jlun
ﺭﻮﻔﺳﻮﻔﻟﺍ: psof
ﻱﻮﻴﻨﺑ: rwut
ﻎﻤﺻ: glum
ﺔﺣﻭﺮﻃﺃ: twes
ﻦﻴﻴﻓﺮﺤﻟﺍ: clif
ﺯﻮﻣ: bwas
ﺔﻤﻠﺴﻣ: kyom
ﻊﻠﺿ: psos
ﻞﻜﻴﻨﻟﺍ: nyek
ﺐﺼﻌﺘﻣ: pyim
ﺔﻠﻓﺎﺣ: bwos
ﺐﻴﻗﺮﻟﺍ: swes
ﺥﻭﺭﺎﺻ: mlus
ﻖﺠﺳ: slos
ﺐﻋﻼ﻿ﺗ: nlut
ﺓﺭﻭﺪﻨﺑ: tfet
ﺯﺰﻌﺗ: kfut
ءﺎﺑﺮﻬﻛ-ﺲﺑﺎﻗ: syok
ﻡﻮﻴﺳﺎﺗﻮﺑ: tsom
ﺩﺍﺩﺮﺘﺳﺍ: prup
ﺔﻴﺿﺍﺮﺘﻓﺍ: zwit
ﺮﺒﺠﻟﺍ-ﻢﻠﻋ: gjas
ﻥﺎﻨﺳﻻ﻿ﺍ-ﺔﺒﻴﺒﻃ: dzit
ﻱﺮﺼﺑ: pcok
ﺡﺰﺣﺰﺗ: bzen
ءﺎﻴﺣﻻ﻿ﺍ-ﺓﺩﺎﻣ: bwim
ﺔﻟﺎﻄﺑ: byim
ﺔﻗﺮﻳ: krum
ﺩﺮﻔﻨﻣ: slof
ﺢﻔﺼﺘﻤﻟﺍ: bjac
ﺪﻌﺑ-ﻦﻋ-ﻲﺿﺎﻤﻟﺍ ﺮﺗﻮﺗ: nyot
ﻲﺨﻳﺭﺎﺗ-ﺮﺗﻮﺗ: crep
ﻱﻭﻮﻧ: nluk
ﻒﻴﻃ: pyem
ﻡﻮﻳﺩﻮﺻ: syom
ﺎﻳﺮﻴﺘﺴﻫ: syes
ﻢﻴﻗ: tyos
ﺔﻨﻴﻫﺭ: byik
ﺕﺎﺒﻧ-ﻉﺮﻗ: gluk
ﺪﻌﺠﺗ: kwuk
ﺔﻴﻓﺎﻔﺷ: tfif
ﺭﺎﻤﺴﻣ: swip
ﺔﻴﻠﻀﻓﺃ: pcif
ﺓﺎﺸﻣ: dyen
ﺩﺎﺤﻟﻹ﻿ﺍ: tsem
ﻪﺷﺎﺷ: mwot
ﺔﻴﺑﺎﺨﺘﻧﺇ-ﺓﺮﺋﺍﺩ: nlec
ﻂﺒﻀﻨﻣ-ﺮﻴﻏ: hkof
ﺭﺎﺒﺴﻣ: grok
ﻦﻴﺗﻼ﻿ﺑ: plip
ﻲﺋﺎﻨﺛ-ﺩﺪﻋ: dlun
ﺔﺋﺭ: pcep
ﻖﺋﺎﻓ: syup
ﺔﺑﺮﻋ: trop
ﺎﻴﻠﺤﻣ: lyot
ﺽﺮﺣ: gzat
ﻦﻴﻟﻭﺯﺎﻐﻟﺍ: plif
ﻰﻠﻜﻟﺍ: grif
ﺐﻬﻧ: bzac
ﺮﻳﺪﻘﺗ: dlen
ﺦﻴﻧﺭﺯ: syek
ﻥﻭﺰﻠﺣ: nrok
ﺏﺪﻨﺟ: tsec
ﺔﻟﺩﺎﻌﻣ: fwen
ﻲﻛﺍﺮﺘﺷﻻ﻿ﺍ: swos
ﺮﺘﻠﻓ: flot
ﻲﺴﺣ-ﺮﻫﺎﻇ-ﺝﺍﺰﻣ: hxin
ﻊﺳﻭ: kyot
ﺚﻌﺒﻨﻳ: mwet
ﺩﻮﻘﻣ: pwet
ﻲﻔﺳﻮﻴﻟﺍ: drun
ﺲﺋﺎﺳ: hjok
ﻱﻮﺋﺮﻟﺍ-ﺏﺎﻬﺘﻟﻻ﻿ﺍ: hnof
ﻦﻣﺎﻀﺗ: gret
ﻞﺼﻔﻣ: cyif
ﻲﻟﻮﻃ: nruc
ﺡﺎﺑﺭﺍ-ﺕﺎﻌﻳﺯﻮﺗ: dwun
ﺞﻟﺰﺗ: hkep
ﺱﻷ﻿ﺍ: slop
ﺰﺠﻋ: dlif
ﺱﻮﻫ: bwen
ﺺﻴﺼﺨﺗ: pfun
ﻲﻓﺍﺮﻏﻮﺗﻮﻔﻟﺍ-ﺭﻮﺼﻤﻟﺍ: trof
ﺎﺘﻟﺩ: dlet
ﻲﻤﻗﺭ: djim
ﺔﺒﻠﻜﻟﺍ: brut
ﻦﻔﺟ: hyop
ﻱﺮﻄﻗ: dyun
ﻲﻋﻮﻟﺍ-ﻥﻭﺩ: byon
ﻦﻴﻌﻟﺍ-ﺐﺟﺎﺣ: bruc
ﺲﻄﻋ: pcec
ﺡﺮﻣ: dlis
ﺔﻴﺳﻭﺪﻨﻬﻟﺍ: nwum
ﺊﺟﻻ﻿: nyif
ﻙﻮﻜﻣ: cwot
ﻦﻴﺗﻭﺮﺑ: pwot
ﺔﻳﺎﻔﻧ: hdop
ﻞﻘﺻ: flen
ءﻲﻗ: hwom
ﻦﻴﺟ: gyen
ءﻯﺪﺘﺒﻤﻟﺍ: hdem
ﻉﺎﻤﺘﺟﻹ﻿ﺍ-ﻢﻠﻋ: syoc
ﻉﺮﻗ: kwoc
ﺩﺎﻴﺼﻟﺍ: hfuc
ﻲﻤﻴﻠﻗﺇ: jyen
ﺔﻛﺮﺣ-ﺍﺪﻌﺻ: hvok
ءﺍﺭﻮﻟﺍ-ﻰﻟﺍ-ﻊﻠﻄﺘﻣ: hxik
ﺭﺎﺼﻋﺇ: gyon
ﺲﻜﻋ: nwos
ﻥﻮﻳﺰﻔﻠﺘﻟﺍ: twif
ﺐﻌﻜﻣ: kfet
ﺔﻴﺟﺎﺘﻧﺇ: pwuk
ﺭﺰﺟ: krop
ﻲﺌﻳﺰﺟ: mwuk
ﻞﺘﻜﺗ: glet
ﺐﺳﺎﺤﻣ: ksum
ﺭﺎﻴﺧ: kyok
ﺓﺪﺑﺮﻌﻟﺍ-ﺱﻮﻘﻃ: drok
ﺐﻳﺬﻣ: jlet
ﺕﺎﻔﺳﻮﻓ: psef
ﻱﺪﻴﻬﻤﺗ-ﺏﺎﺘﻛ: gwik
ﻱﻮﻠﻗ: flis
ﺔﻴﻧﺪﺑ-ﺔﺿﺎﻳﺭ: jyas
ﺔﻠﺻﺎﻓ: kwom
ﺔﻛﺮﺣ-ﺭﺍﺪﺤﻧﺍ: hvat
ﺽﺎﻬﺟﺇ: jwac
ﺏﺍﺮﺟ: tcop
ﺢﻧﺎﻤﻟﺍ: dzon
ﺰﻴﻨﻐﻨﻤﻟﺍ: hzem
ﻲﺴﻔﻨﻟﺍ-ﺐﻴﺒﻄﻟﺍ: syos
ﺭﻮﻠﻜﻟﺍ: clos
ﺢﻴﺗﺎﻔﻤﻟﺍ-ﺔﺣﻮﻟ: kyoc
ﺓﻮﻔﺻ-ﺔﺒﺨﻧ: zyit
ﺱﺍﻮﻗﺃ: pfaf
ﻲﺒﺟﺮﻟﺍ: rwoc
ﺔﺣﺮﻗ: jlon
ﻦﺜﻨﻣ: hxit
ﺏﺎﻋ: nres
ﺔﻴﻤﻛ: fwam
ﺓﺮﺘﺳ: swek
ﻱﺭﻮﻄﺗ: fwis
ﻦﻳﻭﺪﺗ: nyoc
ﺩﺍﺪﺗﺭﺍ: tcuf
ﺢﻳﺮﺸﺗ: drec
ﺄﺒﺨﻣ: kcep
ﻲﻄﺧ: lyec
ﻥﻮﻤﻴﺘﻧﻷ﻿ﺍ: trum
superessive-ﺔﻟﺎﺣ: psek
ﻡﺭﻭ: twom
ﺔﻳﺮﻌﺘﻟﺍ: cyos
ﺎﻔﻟﺃ: flaf
ﻦﻄﺒﻟﺍ-ﺓﺮﺳ: nwip
ﻦﻴﺼﺣ: myip
ﺍﺰﻧﻮﻠﻔﻧﺇ: flun
ﺔﻌﺠﻟﺍ-ﻊﻨﺼﻣ: bjit
ﻂﻴﺴﺒﺗ: slef
ﺮﺼﺘﺧﺍ: bram
ﻪﻔﻴﻔﺧ-ﻪﻣﺪﺻ: djen
ﺮﺳﺃ: dwim
ﺮﺒﺠﺗ: brok
ﺏﺭﻮﺟ: bzas
ﻢﻠﻴﻓ: fyim
ﻥﻮﻛ: klom
ﺙﻮﻟ: hpuf
ﻲﻌﻴﻄﻗ: gjen
ﺐﻴﻀﻗ: zyis
ﺕﺎﺑﺎﻐﻟﺍ: lyif
ﻡﻮﻴﻨﻣﻮﻟﻷ﻿ﺍ: lwum
ﺔﺑﺬﺑﺫ: zlon
ﻚﻠﻔﻟﺍ-ﺝﺍﺮﺑﺍ: ksop
ﺩﺮﻃ: dlek
ﻦﻴﻤﻀﺗ: nluc
ﺪﻴﻔﺘﺴﻤﻟﺍ: byic
ﻦﻴﻔﻟﺩ: dlip
ﻞﺗﺎﻘﻟﺍ: cyus
ﺕﺎﻳﺪﺜﻟﺍ-ﻦﻣ-ﻥﺍﻮﻴﺣ ﻲﻳﺪﺜﻟﺍ: myaf
ﺮﺷﺆﻣ: swif
ﺪﻴﺴﻛﺃ-ﻲﻧﺎﺛ: dwis
ﻥﻮﻟﻮﻘﻟﺍ: zlen
ﺔﻴﻃﺍﺮﻗﻭﺮﻴﺑ: brus
ﻩﻮﺷ: jric
ﺔﺟﻼ﻿ﺛ: frip
ﻱﺮﺛﺃ: cluk
ﻝﻮﺒﻘﻣ-ﺮﻴﻏ: kwok
ﺔﻔﺻﺍﻮﻣ: pfis
ﺓﺮﺸﻧ: pfut
ﻥﺎﺴﻧﻻ﻿ﺍ-ﻢﻠﻋ: nlom
ﻕﺍﺬﻤﻟﺍ-ﺐﻴﻃ: kyec
ﺪﻌﺘﻣ: txit
ﺶﻤﻜﻧﺍ: kwus
ﺲﻤﺸﻟﺍ-ﺩﺎﺒﻋ: hzuc
ﺔﻠﻤﻗ: glus
ﻥﻮﻳﺃ: lyos
ﺔﺣﺎﻴﺳ: tyum
ﻡﺩﻮﻣ: myom
ﻊﻳﺮﺴﺗ: jrun
ﺾﺣﺩ: tsoc
ﺙﺎﻌﺒﻧﺍ: hmef
ﻒﻄﺧ: drap
ﻞﺧﺍﺪﺗ: hwep
ﺮﻌﺸﻟﺍ-ﻒﻴﻔﺼﺗ: pfes
ﻲﺒﻌﺸﻟﺍ-ﺙﺍﺮﺘﻟﺍ: floc
ﻱﺮﻌﺷ: plek
ﺔﻴﻣﻮﻗ: nlum
ﻥﺎﻓﺩﺭ: nros
ﺭﺰﻋ: hmuf
ﻰﻣﺎﺴﺗ: slem
ﻁﺎﺒﺣﺇ: xras
ﺖﻟﺎﺑﻮﻜﻟﺍ: kwos
ﺔﺗﺎﺒﻧ-ﻥﺎﻓﻮﺷ: gwam
ﺔﻛﺮﺣ-ﺮﻬﻨﻟﺍ: trup
ﺝﺮﺷ: gyam
ﻱﺮﻘﺑ: bwun
ﻒﻘﻧ: flip
ﺓﺮﻓﻭ: dzun
ﻮﻳﺪﻴﻓ: hwop
ﺔﻌﻃﺎﻘﻣ: bjik
ﺮﻴﺼﻗ-ﺭﺎﺒﺘﺧﺍ: cwif
ﻲﻛﻮﻬﻟﺍ: cwok
ﺕﺎﺑﺎﺼﻌﻟﺍ-ﺏﺮﺣ: grip
ﻡﻮﻴﺴﻴﻨﻐﻤﻟﺍ: hgem
ﺭﺍﺩﺍﺭ: drek
ﻱﺰﻧﺎﺒﻤﺸﻟﺍ: hzif
ﺔﻴﻗﻮﺛﻮﻤﻟﺍ: kwif
ﻞﻴﻄﺘﺴﻣ: tyec
ﺮﺤﺒﻟﺍ-ﺐﺸﻋ: klep
ﻢﻤﻋ: jlak
ﻝﻮﺠﺘﻟﺍ-ﺮﻈﺣ: kfec
ﺲﻨﺠﻟﺍ-ﻲﻠﺜﻣ: mlok
ﻮﻳﺭﺎﻨﻴﺳ: srop
ﺔﻐﻴﺻ: flus
ﺺﻤﻘﺗ: nrom
ﻞﻌﺷﺃ: zlak
ﻡﻮﻴﻧﺍﺭﻮﻴﻟﺍ: ryum
ﻚﺳﺎﻤﻟﺍ: kwes
ﻖﻴﺴﻨﺗ: kyop
ﺐﺋﺍﺮﻀﻟﺍ-ﻊﻓﺍﺩ: nwaf
ﺔﻠﻣﺎﻜﺘﻤﻟﺍ: trep
ﻯﺃﺭ: hzap
ﺎﻣﺎﻏ: hxam
ﻱﺭﺎﻔﺴﻟﺍ-ﺕﻼ﻿ﺣﺭ: fwim
ﺔﻛﺮﺣ-ﺮﻔﻳﺮﻧﻭﻭﺩ: ht6n
ﺔﺟﺭﺩ: kfus
ﻲﺴﻴﺋﺭ-ﻥﺍﻮﻨﻋ: zlic
ﻞﻠﺤﻤﻟﺍ: nles
ﺕﺎﻣ: hzes
ﻱﺭﺎﺠﺗ-ﻊﻤﺠﻣ: hmof
ﻱﺰﻠﻓ-ﺮﺼﻨﻋ-ﺕﻮﻣﺰﺒﻟﺍ: bzim
ﺔﻳﺪﻳﺮﺑ-ﺔﻗﺎﻄﺑ: psok
ءﺎﻘﺘﻟﺍ: bros
ﺩﺮﻄﺘﺳﺍ: djet
ﻢﻫﺎﺴﻤﻟﺍ: ksem
ﺏﻭﺮﻜﻴﻣ: mrip
ﺔﻴﻠﺳﺎﻨﺘﻟﺍ-ءﺎﻀﻋﻷ﻿ﺍ: jwit
ﺔﻴﻠﻜﺷ: mluk
ﺎﺘﻴﺑ: byot
ﺰﻨﻴﺟ: gjis
ﺕﺎﻧﺎﻴﺒﻟﺍ-ﺓﺪﻋﺎﻗ: tles
ﺔﺒﺳﺎﺣ-ﺔﻟﺁ: klus
ﺔﻴﻨﻴﺳ-ﺔﻌﺷﺃ: ksef
ﻞﻴﻠﺤﺗ: zram
ﻲﺌﻴﺑ: zyen
ﺎﻤﻐﻴﺳ: zyim
ﻝﺎﺼﻔﻧﺍ: hxon
ﻝﺎﻤﻋﺃ-ﻝﻭﺪﺟ: gres
ﺓﺮﻴﺷﺄﺗ: bzis
ﺔﻴﺘﺤﺗ-ﺔﻴﻨﺑ: nyuk
ﺔﻋﺍﺮﻳ: gyun
ﻒﺷﺎﻛ: tyek
ﻒﻴﻜﺘﻟﺍ: dyip
ﻲﺋﺎﻴﺣﺃ: byis
ﻖﺼﻟ: pyec
ﻡﻭﺮﺒﻟﺍ: brom
ﻡﻮﻳﺩﻼ﻿ﺒﻟﺍ: plum
ﻕﺍﻮﻓ: kfok
ﻥﻮﻠﻟﺍ-ﺢﺗﺎﻓ: psec
ﻥﺍﻮﻴﺣ-ﺔﻘﻳﺪﺣ: zwac
ﺓﺩﺎﻴﻋ: lyok
ﻡﻮﻬﻔﻣ: nwoc
ﺎﻏﻮﻴﻟﺍ: hjoc
ﺐﺘﻜﻟﺍ-ﻊﻴﺒﻟ-ﺔﺒﺘﻜﻣ: byun
ﺝﻼ﻿ﻋ: grap
ﻲﻣﻮﻗ: zlis
ﻪﺳﺃﺭ-ﻊﻄﻗ: zlet
ﻢﻌﻧ: swec
ﺔﻴﻟﺎﻜﺷﺇ: byam
ﺯﺎﺠﻟﺍ-ﻰﻘﻴﺳﻮﻣ: dzas
ﻦﺘﺴﻐﻨﺘﻟﺍ: tsof
ﻲﺑﺎﻫﺭﺇ: gwis
ﻪﺑﺎﻌﻟ-ﻝﺎﺳ: droc
ﻲﺋﺍﺬﻐﻟﺍ-ﻞﻴﺜﻤﺘﻟﺍ: tlem
ﺔﻘﻠﻄﻤﻟﺍ-ﺔﺟﻭﺰﻟﺍ-ﺔﻘﻔﻧ: lyaf
ﻉﻮﺒﺳﻷ﻿ﺍ-ﺔﻳﺎﻬﻧ: hfom
ﻥﺍﻮﺤﻗﺃ: gzim
ﺡﺎﻘﻟ: byap
ﺔﻳﺭﺎﻧ-ﺔﺟﺍﺭﺩ: tyok
ﺓﺬﻳﻮﻌﺗ: dyot
ﺔﻨﺴﻟﺍ-ﻒﺼﻧ: myes
ﻦﻳﻭﺮﻴﻬﻟﺍ: gwon
ﺪﻠﺠﻣ: flap
ﺩﻮﺛﺎﻜﻟﺍ-ﺔﻌﺷﺃ: kfoc
ﺔﻴﺟﻮﻟﻮﻳﺪﻳﺃ: dlec
ﺕﺍﺭﺎﻴﺳ-ﻒﻗﻮﻣ: prek
ﺎﺘﻴﺛ: fret
ﻞﻣﺃ-ﺔﺒﻴﺧ: hxis
ﻡﻮﻴﻨﻴﻠﻴﺴﻟﺍ-ﺮﺼﻨﻋ: clem
ﺕﺎﺟﺍﺭﺪﻟﺍ-ﺏﻮﻛﺭ: blek
ﺓﺮﺸﻗ: pros
ﺓﺍﻭﺎﺴﻣ: swaf
ﺭﺎﻴﺗ-ﺔﻣءﻼ﻿ﻣ-ﺔﻣﻼ﻿ﻋ: hxak
ﺭﺎﻄﻣ: cwoc
ﺮﺘﺑ: gyet
ﻪﻠﺴﻟﺍ-ﻩﺮﻛ: bwet
ﻝﺎﺟﺩ: mwip
ﺭﻮﺻﺮﺻ: tlek
ﻡﻭﺮﻜﻟﺍ: hgom
ﺮﺘﻟ: hl6t
ﻚﻟﺫ-ﻦﻣ-ﻢﻏﺮﻟﺍ ﻰﻠﻋ: nwec
ﻥﻮﻣﺮﻫ: cwom
ﺔﺒﻴﻌﻣ: tluc
ﻡﺮﺧ: prec
ﺔﻴﺣﺍﻭﺭﻷ﻿ﺍ: nyom
ﻊﻠﻀﻤﻟﺍ: cloc
ﺔﻳﻮﺴﻧ: hfes
ﺪﺣﻭ: kcop
ﻭﺭﻮﻴﻟﺍ: dros
ﻎﻨﺴﻨﻴﺠﻟﺍ: hjes
ﺔﻴﻣﺯﺭﺍﻮﺧ: hlof
ﺭﺰﻴﻠﻟﺍ: lwes
ﺔﻴﻟﺪﻴﺻ: dlot
ﺮﺘﻤﻴﻠﻠﻣ: mlem
ﻲﻨﺛ: flek
ﺩﻮﻧﻷ﻿ﺍ: nlok
ﻂﻴﺴﺑ-ﻕﺭﺎﻓ: hzus
ﻰﺋﺰﺟ-ﻡﺍﻭﺩ: prem
ﺔﻴﺳﺎﺴﺣ: nyec
ﺮﻫﺎﻈﺘﻣ: drom
ﻡﻮﻴﻠﻴﻬﻟﺍ: clum
ﺔﻐﻠﻟﺍ-ﻲﺋﺎﻨﺛ: dzic
ﺭﺎﺼﺘﺧﺍ: hqim
initialism: nl6m
ﻞﻌﻔﻟﺍ-ﺔﻐﻴﺻ: gros
ﺎﻣﺯﻼ﻿ﺑ: psem
ﻡﻮﺳﻮﻣﻭﺮﻛ: rwom
ﻲﺒﻴﺗﺮﺗ: rwok
ﺮﺘﻣﻮﻠﻴﻛ: klum
ﺲﻛﺎﻔﻟﺍ: tfes
ﺔﺛﺍﺭﻮﻟﺍ-ﻢﻠﻋ: nwek
ﺶﻤﻧ: frek
ﻲﻏﺍﺮﺑ-ﻚﻔﻣ: dres
ﻲﻠﻛﻭﺮﺑ: blok
preterite: xrit
ﻦﻴﻣﺎﺘﻴﻓ: tyem
ﻡﻮﻴﻣﺩﺎﻜﻟﺍ: kyem
ﺮﺠﻔﻣ: bwoc
ﻲﻄﻴﻄﺨﺗ: gjik
ﻡﻮﻴﻧﺎﺘﻴﺘﻟﺍ: dyim
ﺮﺧﺎﻔﺗ: clec
ﺍﺪﻣﺍ: lwem
ﺔﻘﻳﺪﺻ: pcem
ﻊﺟﺎﺿ: kyuk
ﺔﻴﻠﻣﺮﻟﺍ-ﺔﻋﺎﺴﻟﺍ: tlus
ﻲﻔﻃﺎﻌﻟﺍ-ﺺﻤﻘﺘﻟﺍ: mlif
ﻥﻭﺭﻮﺒﻟﺍ: bres
ﺮﺘﺑﻮﻜﻴﻠﻫ: cwet
ﺢﺋﺎﻔﺻ-ﻭﺫ-ﻊﻣﻻ﻿ ﻥﺪﻌﻣ: tlum
ﺔﻳﺎﻬﻨﻟﺍ-ﻂﺧ: jyic
ﺓﺍﺫﺎﺤﻣ: gwic
ﺮﺘﻤﻴﺘﻨﺳ: hfem
ﻡﻮﻨﻳﺪﺒﻴﻟﻮﻤﻟﺍ: mlom
ﻡﻮﻴﺜﻴﻠﻟﺍ: tfim
ﺓﺩﺪﻌﺘﻤﻟﺍ-ﻂﺋﺎﺳﻮﻟﺍ: myum
ﺚﻳﺪﺤﺗ: dyet
ﺔﻳﺭﺍﺮﺣ-ﺓﺮﻌﺳ: clom
ﻲﻟﺁ-ﻥﺎﺴﻧﺇ: ryoc
ﻰﻟﺰﻨﻤﻟﺍ-ﺐﺟﺍﻮﻟﺍ: groc
ﺕﺎﻴﺿﺎﻳﺮﻟﺍ-ﻲﻓ-ﻢﺛﺭﺎﻏﻮﻠﻟﺍ: grom
ﻲﺒﻨﻟﺍ-ﺱﺮﻓ: gzas
ﺐﻴﻛﺮﺗ: nwut
ﺔﻴﻨﻴﻣﻷ﻿ﺍ: myoc
ﺔﻳﺰﻣﺮﻟﺍ-ﺓﺭﻮﺼﻟﺍ: glif
aorist: pyos
ﺔﺌﻴﺒﻟﺍ-ﻢﻠﻋ: plec
ﻚﻨﺤﻤﻟﺍ: flok
ﻱﺪﻨﻫ-ﺐﻨﻗ: bjam
ﺮﻴﻐﺼﻟﺍ: mrom
ﻡﺍﺮﻏﻮﻠﻴﻛ: lwom
ﻞﻛﻷ﻿ﺍ-ﻲﻓ-ﺩﺍﺯ: jrot
ﺆﺒﻨﺘﻠﻟ-ﻞﺑﺎﻗ: dzik
ﺍﺰﺘﻴﺒﻟﺍ: zyas
ﺲﺴﺠﺗ: zris
ﺔﻐﻠﻟﺍ-ﻢﻠﻋ: bwis
ﺮﻌﺷ-ﺔﻗﻼ﻿ﺣ: braf
ﻡﻮﻳﺪﻳﺮﻳﻻ﻿ﺍ: ryom
ﺔﻳﺮﺼﻨﻋ: gwim
ﻞﺜﻣﻷ﻿ﺍ: gyim
ﻊﻴﻨﺼﺗ: drif
ﻰﺴﻴﺋﺮﻟﺍ-ﺰﻛﺮﻤﻟﺍ: krup
ﻱﺰﻠﻓ-ﺮﺼﻨﻋ-ﻡﻮﻳﺮﻴﺴﻟﺍ: zrim
ﻢﺠﺴﻨﻣ: nrum
partitive-ﺔﻟﺎﺣ: pxik
ﺖﻴﺳﺎﻛ: ksep
ﺓﺩﺍﺭﻹ﻿ﺍ-ﺓﻮﻗ: blot
ﺩﺎﻌﺑﻷ﻿ﺍ: dzen
ﺔﻤﻠﻌﻣ: rwet
ﻦﻣﺍﺰﺗ: nrop
ﻢﻴﻈﻌﺗ: dzim
ﺓﻭﺪﻧ: mwec
ﻮﻜﺴﻳﺩ: dyok
ﻥﻮﻴﻧ: nyok
ﻱﺰﻠﻓ-ﺮﺼﻨﻋ-ﻡﻮﻴﻣﺯﻭﻷ﻿ﺍ: hzom
ﺱﺎﻄﻐﻟﺍ-ﺪﻴﻋ: hp6n
ﻞﺤﺘﻧﺍ: lyap
ﺔﻳﺮﺛﺃ-ﺔﻌﻄﻗ: rwek
ﻞﻋﺎﻔﻣ: fyet
ﻞﺑﺍﻮﺗ: ryop
ﻡﻮﻴﻧﻮﺗﻮﻠﺒﻟﺍ: pwum
ﻱﺰﻠﻓ-ﺮﺼﻨﻋ-ﻡﻮﻳﺮﺘﻳﻻ﻿ﺍ: tyom
ﺩﺎﻳﺩﺯﻼ﻿ﻟ-ﻞﺑﺎﻗ: hxat
ﻡﺪﺨﺘﺴﻤﻟﺍ-ﻢﺳﺍ: mrum
ﺎﻴﻠﻋ-ﺕﺎﺳﺍﺭﺩ: zrot
ﻦﻤﻳﻷ﻿ﺍ-ﺡﺎﻨﺠﻟﺍ: dwaf
ﻥﻮﺟﺭﻷ﻿ﺍ: jros
ﺏﺎﻫﺭ: hxot
ﺕﺎﻗﺍﺪﺻ-ﻖﻠﺧ: sluk
ﺔﻤﻟﻮﻌﻟﺍ: bluc
ﻲﺟﻮﻤﻟﺍ-ﻝﻮﻄﻟﺍ: hnef
ﺰﻴﻣﺮﺗ: kfom
ﺮﻳﻭﺪﺗ-ﺓﺩﺎﻋﺇ: psoc
ءﺪﺑ-ﺓﺩﺎﻋﺇ: nrek
ﻲﺳﻭﺮﻴﻔﻟﺍ-ﺪﺒﻜﻟﺍ-ﺏﺎﻬﺘﻟﺍ: pyes
ﺮﻳﺪﺘﺴﻣ-ءﻮﺘﻧ: fros
ﻲﺋﺎﻴﻤﻴﻜﻟﺍ-ﺝﻼ﻿ﻌﻟﺍ: myep
ﻮﻟﻭﺩﻮﻣ: mwok
ﻥﻮﺗﻭﺮﺑ: zwot
ﻥﺮﻤﻟﺍ-ﺹﺮﻘﻟﺍ: dwet
ﻡﺍﺮﻐﻴﻠﻣ: mlum
ﻞﺴﻜﺑ: psep
ﻱﺰﻠﻓ-ﺮﺼﻨﻋ-ﻡﻮﻟﺎﺘﻨﺘﻟﺍ: twem
ﺏﺍﺬﻤﻟﺍ: hjot
ﺔﻴﻋﺎﻤﺟ-ﺓﺩﺎﺑﺇ: nyos
ﺱﺮﺘﻔﻤﻟﺍ: rwes
ﺭﺩﺎﻧ-ﻱﺰﻠﻓ-ﺮﺼﻨﻋ ﻡﻮﻴﻟﺎﻐﻟﺍ: glem
ﻡﻮﻴﻧﻮﻛﺭﺰﻟﺍ: hzum
determiner: txin
ﺔﻴﻄﺨﻟﺍ-ﺮﻴﻏ: nlem
ﺔﻳﺮﺸﺤﻟﺍ-ﺕﺍﺪﻴﺒﻤﻟﺍ: pyif
ﻡﻮﻴﻠﻳﺮﺒﻟﺍ: brem
ﺔﻴﺒﺼﻌﻟﺍ-ﺎﻳﻼ﻿ﺨﻟﺍ: nrus
ﻱﺩﺎﻨﺳﺇ: pxit
ﺔﻴﺘﺤﺗ-ﻞﻳﻭﺍﺮﺳ: tlif
ﺏﻭﺮﻀﻣ: kref
ﻥﻭﺮﺗﻮﻴﻨﻟﺍ: zrut
ﻡﻮﻴﺑﻮﻴﻨﻟﺍ: nwom
ﻡﻮﻴﻧﺎﻣﺮﺠﻟﺍ: hjem
ﺰﻠﻓﻻ﻿: tlop
ﻊﺿ-ﻰﻠﻋ: dlap
prolative-ﺔﻟﺎﺣ: hl6k
ﻲﺟﻮﻟﻮﻴﺒﻟﺍ-ﻉﻮﻨﺘﻟﺍ: jwic
ﻢﻜﺤﺘﻟﺍ-ﺎﺼﻋ: jyok
ﻱﻮﻴﺣ-ﺩﺎﻀﻣ: twok
ﻁﺎﺸﻨﻟﺍ-ﻲﻋﺎﻌﺷﺇ-ﺮﺼﻨﻋ ﻡﻮﻴﻨﻴﺘﻛﻷ﻿ﺍ: gjim
ءﺎﻀﻓ-ﺪﺋﺍﺭ: srof
ﺽﺭﻷ﻿ﺍ-ﺝﺭﺎﺧ: tyes
ﺭﺍﻮﻃﻷ﻿ﺍ-ﺐﻳﺮﻏ: hwup
ﻥﻮﺛﺍﺭﺎﻣ: mrof
ﻱﺰﻠﻓ-ﺮﺼﻨﻋ-ﻡﻮﻴﺑﺮﺘﻳﻻ﻿ﺍ: zwim
ﺪﺣﻮﺘﻟﺍ-ﺽﺮﻣ: tyif
ﻦﻳﺄﺗ: nlof
ﻥﻭﺩﺍﺭ: cwos
ﻰﻠﻓﺪﻟﺍ: nrem
ﺔﺌﺑﻭﻷ﻿ﺍ-ﻢﻠﻋ: pwip
ﺔﺧﻮﺨﻴﺸﻟﺍ: lyuc
ﻢﻴﻴﺨﺗ: kyep
ﻂﻄﺨﻣ: drip
ﻱﺰﻠﻓ-ﺮﺼﻨﻋ-ﻡﻮﻳﺪﻧﻹ﻿ﺍ: nyum
veridical: hvik
ﻲﻧﻭﺮﺘﻜﻟﺍ-ﻊﻗﻮﻣ: bwes
ﻢﻳﺮﻜﻟﺍ-ﻥﺁﺮﻘﻟﺍ: kwek
ﻕﺎﺒﻃﺃ: fwet
ﺭﺬﺠﻟﺍ-ﻒﻟﻷ﻿ﺍ: tfec
ﻡﻮﻴﺴﻧﺭﻮﻠﻟﺍ: lyem
ﺔﻴﻧﺪﻤﻟﺍ-ﻕﻮﻘﺤﻟﺍ: glip
ﻝﻮﻤﺤﻣ-ﻥﻮﻔﻴﻠﺗ: mlof
ﻝﻮﻠﺸﻣ: twoc
ﻱﺰﻠﻓ-ﺮﺼﻨﻋ-ﻡﻮﻴﻨﻴﺘﻜﺗﻭﺮﺒﻟﺍ: prum
ﻉﺎﻌﺷﺇ: hd6n
ﺪﻤﺘﻌﺗ-ﻰﻠﻋ: pxin
ﻡﻮﻳﺭﻮﺜﻟﺍ-ﺓﺭﺫ: hxim
ﻕﺭﺯﺃ-ﺰﻨﻴﺟ: bjun
ﻝﺰﻨﻣ-ﻊﻨﺼﻣ: hxas
ﻱﺩﺮﻓ-ﻞﻜﺸﺑ: dvit
ﺭﺎﻴﺘﻟﺍ-ﻖﻓﺪﺗ: lwuk
ﺔﻄﻘﻧ-ﻲﺛﻼ﻿ﺜﻟﺍ: ht6t
ﻢﺴﺠﻟﺍ-ﻱﺮﺸﺒﻟﺍ: hn6n
ءﺎﻳﺰﻴﻓ: bzik
ﺔﺋﺰﺠﺘﻟﺍ-ﺮﺠﺘﻣ: hxan
ﻡﻮﻳﺰﻴﺳ: hs6m
ﻞﻳﻮﻃ-ﺬﻨﻣ: hqan
ﻝﻭﺪﺟ: hxet
ﺔﻠﺘﻜﻟﺍ-ﻦﻣ-ﺓﺪﺣﻭ: hn6m
ﻊﻤﺟ: ml6n
--ﺔﻴﺋﺎﻨﺛ-ﺔﻤﻴﻗ: vrim
ﻥﺎﺴﻧﻻ﻿ﺍ-ﻱﺮﺠﻳ: nyus
ﺔﻄﺳﺍﻮﺑ-ﻲﻨﻌﻳ-ﻦﻣ: hvan
depan-dari: pxat
ﻡﻮﻴﻤﻳﺩﻮﻴﺳﺍﺮﺒﻟﺍ: pyom
ﻯﻮﻘﻣ-ﻕﺭﻭ: kxat
ﺩﻭﺪﺤﻣ-ﻞﻌﻔﻟﺍ: hqik
ﺔﺑﺮﺠﺘﻟﺍ-ﺩﺪﻋ: hr6n
ﺪﻳﺆﻤﻟﺍ-ﺔﻠﻤﺟ: hr6t
ﺪﻗﺎﻨﻟﺍ: hk6k
ﻒﻴﻠﻐﺘﻟﺍﻭ-ﺔﺌﺒﻌﺘﻟﺍ: pxas
ﺕﺎﺒﺜﻟﺍ-ﻡﺪﻋ: pxan
ﻲﻓ-ﻢﻈﻌﻣ: txas
ﻒﺻﺍﻭ: drop
ﻡﻮﻴﻤﻳﺩﻮﻴﻨﻟﺍ: nyem
ﺔﻗﺍﺪﺻ: hvit
ﺃﺮﻗﺍ-ﻂﻘﻓ: xyak
ﺲﺳﺆﻳ: xwan
ﺭﻮﺛﺄﻣ-ﺝﺍﺰﻣ: kxin
ﺕﻮﺻ: hxom
ﺔﻴﻧﻼ﻿ﻘﻋ: xlit
ﺔﻴﺗﻮﺼﻟﺍ: xlin
ﻡﺎﻌﻄﻟﺍ-ﺔﻓﺮﻏ: hxac
ﺔﺸﻴﻌﻤﻟﺍ-ﺔﻓﺮﻏ: hxic
ﻱﺰﻛﺮﻣ-ﺔﻟﺎﺣ: zrik
hodiernal-ﻞﺒﻗ: hx6n
ﺾﻳﺮﻤﻟﺍ-ﺔﻟﺎﺣ: hqak
ﻑﺮﺤﻨﻣ-ﺔﻟﺎﺣ: bwok
ﻲﻔﻳﺭ-ﺔﻘﻄﻨﻣ: hqat
RECURSE: hr6s
ﻂﺳﻭ-ﺕﻮﺻ: dyos
ﻡﻮﻳﺮﻨﺘﻳﺎﻣ: hm6m
ﻞﻗﺎﻨﻟﺍ-ﻲﻧﻭﺮﺘﻜﻟﻹ﻿ﺍ: hvak
ﻡﺰﻠﻣ-ﺮﻴﻏ: kxit
ﻥﻭﺰﺨﻣ-ﻕﻮﺳ: xrak
ﻑﺮﻌﺘﻟﺍ: hxap
ﻑﺪﻫ-ﻞﻐﺸﻣ: krof
ﺓﺪﺣﺍﻭ-ﺔﻴﻧﺎﺛ: hxen
lative-ﺔﻟﺎﺣ: dvak
ﺔﺼﺣ: hr6c
ﺮﻴﻏ-ﻥﺎﺴﻧﻻ﻿ﺍ: hg6n
ﺔﺸﻴﻌﻤﻟﺍ-ءﻲﺷ: hvic
ﺍﺪﺟ-ﻞﻴﻠﻘﻟﺍ: hxut
ﺡﺮﺴﻤﻟﺍ-ﻢﻠﻴﻓ: hvin
ﻡﻮﻴﺳﺎﻫ: xyim
attenuative: ty6t
multal-ﺩﺪﻋ: ml6m
ﻲﺒﻴﻠﺣ-ﻖﻳﺮﻃ: txam
ﻱﺰﻠﻓ-ﺮﺼﻨﻋ-ﻡﻮﻴﻧﻮﺘﺒﻨﻟﺍ: nwem
ﻥﻮﻄﻌﻳ: txik
ﺮﺒﻋ-ﻱﺩﺪﻋ: ts6s
ﺎﻬﻟﻮﺣ-ﻉﺍﺪﺧ: hqun
ﻡﻮﻴﺴﻳﺮﻴﻣﻻ﻿ﺍ: myem
ﺡﺎﺒﺻ-ﺪﺠﻣ: txan
ءﺎﻔﻃﻻ﻿ﺍ-ﻝﺎﺟﺭ: xran
ﻡﻮﻴﻠﻴﻛﺮﺒﻟﺍ: blem
ﺓﺮﺠﻤﻟﺍ-ﺲﻨﺟ: kxan
ﻡﻮﻴﻠﺑﻮﻧ: blum
ﺎﻋﺍﺩﻭ-ﺎﻋﺍﺩﻭ: hvac
ﺔﻳﺫﻮﺒﻟﺍ: hfum
ﻡﻮﻴﻣﺮﻓ: frem
ﻱﻭﺎﻤﺳ-ﻕﺭﺯﺍ: xyan
ﺎﻳﻮﺼﻟﺍ-ﻝﻮﻓ: syof
ﻉﺯﻮﻣ: qrit
ﺏﺍﺮﻀﻟﺍ-ﺪﺴﻔﻣ: txak
ﺞﻟﺎﻌﻣ: ples
abessive-ﺔﻟﺎﺣ: bvak
adessive-ﺔﻟﺎﺣ: dvik
ﻰﻟﺇ-ﺔﻟﺎﺣ: kxak
agentive-ﺔﻟﺎﺣ: dvek
ﻡﻮﻳﺩﺭﻮﻓﺭﺫﺭ: hr6m
ﺩﺎﻀﻤﻟﺍ-ﻢﺴﺠﻟﺍ: txip
ﻞﺜﻣ-ﺍﺮﻴﺜﻛ-ﻞﺜﻣ: hjos
ﻞﻴﻛﻭ-ﻞﻐﺸﻣ: hg6t
ﻞﺜﻤﻤﻟﺍ-ﺭﻭﺩ: xram
ﻡﻮﻳﺪﻴﺜﻳﺇ: txim
ﻙﺮﺘﺸﻣ-ﺚﻴﻧﺄﺗ-ﻭﺃ ﺮﻴﻛﺬﺗ ﺲﻨﺟ: hk6n
accompanier: kl6n
ﻢﻃﺮﻘﻟﺍ: kxam
ﻡﻮﻴﺴﻧﺍﺮﻔﻟﺍ: fyam
ﻱﺰﻠﻓ-ﺮﺼﻨﻋ-ﻡﻮﻴﺑﺭﻷ﻿ﺍ: ry6m
ﻝﻮﻬﺠﻤﻠﻟ-ﻲﻨﺒﻣ-ﺕﻮﺻ: xyis
ﻦﻴﺗﺎﺘﺳﺃ: hqit
ﻎﻀﻣ-ﻎﻤﺻ: hqam
ﺔﻤﺠﻧ-ﺲﻨﺟ: hqin
ﻪﻳﻮﻨﺗ-ﻞﻜﺷ: ht6m
ﻱﺰﻠﻓ-ﺮﺼﻨﻋ-ﻡﻮﻳﺭﻮﻜﻟﺍ: jrim
ﻂﻳﺮﺸﻟﺍ-ﻲﻟﺰﻬﻟﺍ: kxis
ﻥﺍﻮﻟﻻ﻿ﺍ-ﻰﻤﻋ: hqon
euler's---ﺩﺪﻌﻟﺍ: hl6m
ﺓﺮﻈﻧ-ﻲﻓ: kxas
ﺮﻤﻣ: pwok
ﺔﻛﺮﻌﻤﻟﺍ-ﺔﺣﺎﺳ: txat
ﻖﺋﺎﺳ: vrit
ﻲﺋﺎﺑﺮﻬﻛ-ﺱﺎﻣ: txok
ﻲﻈﻔﻟ-ﻢﺳﺇ: hvis
ءﺎﻜﺑ-ﺝﺭﺎﺧ: hk6t
ﺔﻴﺋﺎﺼﺣﺇ: xyit
ﻱﺩﺎﺑﺯ: txot
ﻥﻮﻨﻳﺯ: hs6n
ﺎﻴﺴﻴﻃﺎﻨﻐﻣ-ﻡﻮﻧ: hxif
ﺬﺧﺃ-ﺍﺪﻴﻌﺑ: hxaf
ﻞﻳﺬﻟﺍ-ﻁﺮﺷ: hxok
ﺓﺮﺷﺎﺒﻣ-ﻉﻮﺿﻮﻣ: dwot
ﺔﻟﺎﻘﺑ-ﺮﺠﺘﻣ: kxun
ﻒﻟﺄﺘﺗ-ﻦﻣ: hm6t
ergative-ﺔﻟﺎﺣ: gvik
ﺔﻐﻠﻟﺍ-ﻲﻓ: txic
ﻝﻭﻷ﻿ﺍ-ﺭﺪﺼﻤﻟﺍ-ﻦﻣ ﻰﻘﺘﺴﻣ ﺮﺷﺎﺒﻣ: pxam
ﻲﻓﺮﻇ-ﺔﻟﺎﺣ: hqok
ﺔﺣﺎﺒﺴﻟﺍ-ﻡﺎﻤﺣ: slup
ﻑﺮﻈﻟﺍ-ﺔﻟﺎﺣ: vlak
ﺔﻴﺣﺎﻴﺳ-ﺔﻟﻮﺠﺑ: hqas
ﻥﻮﻳﺰﻔﻠﺗ-ﺔﻋﻮﻤﺠﻣ: ht6s
ﻲﺋﺎﻬﻧ-ﻢﻴﺴﺟ: xlik
evitative-ﺔﻟﺎﺣ: hvek
ﻞﻴﻫﺄﺘﻟﺍ-ﺓﺩﺎﻋﺇ: xlat
ﻊﺟﺍﺮﺗ: xris
ﻊﻨﻣ-ﻦﻣ-ﻖﻘﺸﻟﺍ: kxot
ﻆﻘﻴﺘﺳﺍ-ﻕﻮﻓ: hxup
ﺔﻃﺮﺷ-ﻂﺑﺎﺿ: ps6s
ﻲﻓ-ﻢﺴﻗﺃ: vran
ﻊﻳﺬﻣ: qrat
ﻱﺰﻠﻓ-ﺮﺼﻨﻋ-ﻡﻮﻴﻨﻳﺮﻟﺍ: ryem
ﻱﻮﺠﻟﺍ-ءﺎﺒﻬﻟﺍ: xres
ﻲﻜﻠﻤﺗ-ﺔﻟﺎﺣ: kxik
ﺔﻴﻤﺳﻻ﻿ﺍ-ﻰﻟﺇ-ﻞﻘﻧ: mlec
ﻚﻠﺘﻣﺍ-ﺔﻟﺎﺣ: dzak
ﺶﺣﺎﻓ-ﻦﻤﺛ: pxak
ﺪﻋﺎﺴﻣ-ﻞﻌﻔﻟﺍ: xyik
ﻲﺋﺍﺪﺘﺑﺍ-ﻉﻮﺿﻮﻣ: mlut
ﺕﺎﺳﻭﺮﻴﻔﻟﺍ-ﻦﻣ-ﺮﺗﻮﻴﺒﻤﻜﻟﺍ: prus
ﻝﺎﻤﻋﺃ-ﻞﺟﺭ: hqis
ﺍ-ﺱﺎﻨﻟﺍ: hqen
antessive-ﺔﻟﺎﺣ: ts6k
ﻝﻭﻷ﻿ﺍ-ﺮﻳﺯﻮﻟﺍ: pxis
ﻡﻮﻴﺘﻴﺗﻮﻠﻟﺎﺑ: lyum
ﻯﺰﻠﻓ-ﺮﺼﻨﻋ-ﻡﻮﻴﺑﻭﺭﻭﻷ﻿ﺍ: rwum
emote: xrot
ﺔﻴﺒﻌﺸﻟﺍ-ﻰﻘﻴﺳﻮﻤﻟﺍ: zyik
ﺮﻋﺎﺷ: vwit
ﺪﻳﺮﺒﻟﺍ-ﺐﺘﻜﻣ: pxot
ﺽﺮﺘﻔﻳ: hvas
ﻲﺣ-ﺚﻴﻧﺄﺗ-ﻭﺃ ﺮﻴﻛﺬﺗ ﺲﻨﺟ: hven
subessive-ﺔﻟﺎﺣ: bvik
ﺩﻮﻗﻮﻟﺍ-ﺔﺳﺍﻭﺩ: glep
ﺔﻴﺒﻄﻗ: pr6t
ﺔﺒﻛﺮﻣ-ﺲﻨﺟ: vlin
ﻥﺪﻌﻣ-ﺚﻴﻧﺄﺗ-ﻭﺃ ﺮﻴﻛﺬﺗ ﺲﻨﺟ: xrin
ﺔﻘﺣﻻ﻿-ﻦﻴﺑ-ﻞﻌﻔﻟﺍ: hvif
ﻑﻮﻐﺷ: pc6n
ﻱﺰﻠﻓ-ﺮﺼﻨﻋ-ﻡﻮﻳﺮﻤﺴﻟﺍ: sr6m
ﺮﺴﻴﻣ: hs6t
ﺓﺪﺣﻭ-ﺔﻴﻤﻫﻭ: xyin
ءﻮﻀﻟﺍ-ﻦﻣ-ﺔﻋﺮﺴﻟﺍ: kxac
ﺔﻳﻮﺠﻟﺍ-ﺕﺍﻮﻘﻟﺍ: hxes
ﻥﺎﻨﺤﺑ-ﺔﺣﺮﻓ: pfec
ﺔﺟﺮﺣ-ﺔﻄﻘﻧ: qyit
ﻞﻣﺎﻛ-ﺖﻗﻭ: hxem
ﻱﺰﻠﻓ-ﺮﺼﻨﻋ-ﻡﻮﻴﻨﻔﻬﻟﺍ: xyam
ﺖﺒﻛ: hn6s
ﺮﻴﻴﻐﺗ-ﻦﻣ-ﺙﺪﺣ: qrin
ﻡﻮﻴﻤﻟﻮﻫ: xlim
ﻒﻠﺘﺨﻣ-ﺙﺪﺣ: hf6t
ﻥﻮﻜﻟﺍ-ﺲﻨﺟ: hvip
ﻥﺎﻜﻣ-ﺲﻨﺟ: kxen
ﺔﻴﺿﺍﺮﺘﻓﺍ-ﺔﻟﺁ: hvim
ﺚﺤﺑ-ﺲﻨﺟ: txen
ﻲﻨﻓ-ﺲﻨﺟ: ts6n
crastinal-ﺮﺗﻮﺗ: sl6t
ﺺﺨﻠﻣ-ﺚﻴﻧﺄﺗ-ﻭﺃ ﺮﻴﻛﺬﺗ ﺲﻨﺟ: srep
exocentric-ﺔﻟﺎﺣ: zrek
ﺪﻌﺘﻣ-ﻞﻌﻔﻟﺍ: txif
ﻢﻴﻓﺮﻣ: tfom
ﻲﻨﻃﻮﻟﺍ-ﺐﺼﻌﺘﻟﺍ-ﻲﻓ ﻲﻟﺎﻐﻤﻟﺍ ﻲﻨﻴﻓﻮﺸﻟﺍ: dvis
ﻲﺿﺎﻤﻟﺍ-ﻦﺴﺤﺘﻣ: xrat
ﻲﻨﻬﻣ: hy6n
ﺮﺷﺎﺒﻣ-ﺮﻴﻏ-ﺏﺎﻄﺧ: tyoc
ﺎﻴﻧﺎﺛ-ﺔﻐﻟ: draf
ﻰﻟﺇ-ﻥﻮﻜﻳ: txis
ﺓﺮﺒﻘﻣ-ﺔﺑﻮﻧ: vrak
ﻲﻋﺎﻤﺟ-ﻢﺳﺇ: hxos
absolutive-ﺔﻟﺎﺣ: bvuk
ﺾﻳﺮﻤﻟﺍ-ﻞﻐﺸﻣ: tr6t
ﺕﺍﺬﻟﺍ-ﺲﻔﻨﻟﺎﺑ-ﺔﻘﺜﻟﺍ: hs6s
ﺯﺍﺮﺒﻟﺍ: hzos
ﻲﺳﺎﻜﻌﻧﺍ-ﺕﻮﺻ: hf6s
ﻝﻮﻬﺠﻤﻠﻟ-ﻰﻨﺒﻣ-ﻞﻌﻔﻟﺍ: hxek
ﻡﻮﻴﺟﺭﻮﺒﻴﺴﻟﺍ: br6m
ءﺎﻀﻴﺒﻟﺍ-ﺔﺣﺎﺴﻤﻟﺍ: hxep
ﻲﻠﻜﺷ-ﺔﻟﺎﺣ: dlok
ﺩﺎﻤﺟ-ﺚﻴﻧﺄﺗ-ﻭﺃ ﺮﻴﻛﺬﺗ ﺲﻨﺟ: hj6n
ﺐﺒﺴﻣ: qran
propositive-ﺝﺍﺰﻣ: psom
ﻲﺋﺎﺑﺮﻬﻛ-ﺭﺎﻴﺗ: tr6n
ﻲﻄﺑﺍﺮﺗ-ﺔﻟﺎﺣ: nwok
ﻞﻴﻀﻔﺘﻟﺍ-ﺔﻐﻴﺻ-ﺔﻟﺎﺣ: tluk
ﺍﺪﺟ-ﺍﺮﻴﺜﻛ: xyut
ﻲﺒﻛﻮﻛ-ﺲﻨﺟ: pxen
ﻙﺮﺤﺘﻣ-ﺔﻛﺮﺤﺘﻣ-ﻡﻮﺳﺭ: nwuk
ﻝﺩﺎﺒﺘﻣ-ﺕﻮﺻ: vrik
ﻊﻳﺮﺸﺗ: hqaf
ﻲﻓ-ﻞﻗﻷ﻿ﺍ: vlas
ﺓﺪﺣ-ﺔﻳﻮﺤﻨﻟﺍ: qrak
ﻡﺪﺨﺘﺴﻣ: pxut
ﺓﺍﻮﻨﻟﺍ-benefactive: kfef
ﻰﻣﺮﻣ-ﺱﺭﺎﺣ: hgop
:-Except-for: kcef
ﻢﺳﺎﻗ: dvan
ﺍﺫﺍ-ﺮﺧﺁ: lyek
ﻑﺍﺮﺤﻧﺎﺑ: hx6s
ﺾﻌﺒﻟﺍ-ﻢﻬﻀﻌﺑ: dles
ﻝﺍﻮﺘﻣ-ﺪﻨﺑ: lyuk
ﺝﺭﺎﺧ-ءﺍﺪﺗﺭﺍ: hxun
ﺓﺮﻴﺼﻘﻟﺍ-ﻞﻳﻭﺍﺮﺴﻟﺍ: ht6k
ﻱﺰﻠﻓ-ﺮﺼﻨﻋ-ﻡﻮﻳﺯﻭﺮﺒﺳﺪﻟﺍ: prom
ﺍﺬﻜﻫ-ﻞﺒﻘﺘﺴﻣ-ﺮﺗﻮﺗ: rwec
ﻲﺳ-ﺕﺍﺪﺣﻮﻟﺍ: vyin
ﻱﺯﺎﻏ-ﺮﺼﻨﻋ-ﻥﻮﺘﺑﺮﻜﻟﺍ: kxon
ﻡﻮﻴﻔﻴﻟﺪﻨﻤﻟﺍ: dlem
ﺔﻴﻘﻴﺒﻄﺗ-ﺕﻮﺻ: hp6s
antipassive-ﺕﻮﺻ: tsef
continuative-ﺐﻧﺎﺟ: ht6p
ﺽﺮﻤﻟﺍ-ﻉﺎﻌﺷﻹ﻿ﺍ: hr6k
necessitative-ﺝﺍﺰﻣ: hn6t
ﺪﻴﺣﻭ-ﻞﻤﻋ-ﻞﻌﻔﻟﺍ: hqek
ﺭﺎﻄﻘﻟﺍ-ﺔﺑﺮﻋ: xlak
ﻞﻴﻀﻔﺘﻟﺍ-ﺔﻐﻴﺻ-ﺔﻴﻤﻠﻌﻟﺍ ﺔﺟﺭﺪﻟﺍ: tlup
ﻱﺩﻮﺟﻭ-ﺪﻨﺑ: hs6k
ﻡﻮﻴﻧﺭﻮﻔﻴﻟﺎﻛ: kf6n
ﺮﺿﺎﺣ-ﻞﻋﺎﻔﻟﺍ-ﻢﺳﺇ: vrat
ءﻲﻀﻣ-ﺔﻓﺎﺜﻛ: hc6t
singulative-ﺩﺪﻋ: slus
ﻩﻮﺟﻭ-ﻦﻴﺑ-ﺔﻳﻮﺤﻨﻟﺍ: hy6t
ﻝﻮﻬﺠﻤﻠﻟ-ﻲﻨﺒﻣ-ﻞﻋﺎﻔﻟﺍ ﻢﺳﺇ: vris
ﻁﺮﻔﻣ-ﺓﺪﻣ: kxic
ﻞﺋﺎﺴﻟﺍ---ﺔﺟﺮﺤﻟﺍ ﻕﻮﻓ: sr6t
ﺔﻴﻤﻛ-ﻦﻣ-ﺓﺩﺎﻣ: ks6t
postpositional-ﺔﻟﺎﺣ: pxok
ﻱﺭﺎﻴﺘﺧﺍ-ﺔﻴﻤﻜﻟﺍ-ﺩﺪﺤﻣ: lwif
ﻱﺰﻠﻓ-ﺮﺼﻨﻋ-ﻡﻮﻴﻨﻴﻟﻭﺩﺎﻐﻟﺍ: dl6n
epenthetic-ﻢﻴﻓﺮﻣ: hp6m
ﺾﻓﺍﺭ-ﺔﻴﻤﻜﻟﺍ-ﺩﺪﺤﻣ: nwif
ﻡﻮﻴﻨﻳﺎﺘﺸﻨﻳﺁ: ny6n
ﻊﻨﻄﺼﻣ-ﺔﻐﻟ: txac
ﻡﺎﺿ-ﻢﻴﺴﺟ: qrik
ﺪﻌﺑ-ﻦﻋ-ﻞﺒﻘﺘﺴﻣ ﺮﺗﻮﺗ: twec
ﻱﺭﺮﻜﺗ-ﺐﻧﺎﺟ: hfep
ﻲﻌﻳﺯﻮﺗ-ﺮﻴﻤﺿ: bvin
ﺔﻴﻤﺳﺭ-ﺔﺒﻄﺧ-ﺔﻴﻗﺎﻔﺗﻻ﻿ﺍ: hk6m
ﻊﻠﺻﺃ: blos
ﺔﻴﺣﺎﺿ: syum
ﻲﻤﻟﺎﻋ-ﺔﻴﻤﻜﻟﺍ-ﺩﺪﺤﻣ: vlit
ﺏﻮﺳﺎﺤﻟﺍ-ﺔﺠﻣﺮﺑ: mr6m
ﻥﻮﻳﺰﻔﻠﺗ-ﺞﻣﺎﻧﺮﺑ: tr6m
ﻢﻗﺭ-ﺔﻄﻘﻧ-ﺔﻤﺋﺎﻌﻟﺍ: hvun
ﻱﺩﻮﺟﻭ-ﺔﻴﻤﻜﻟﺍ-ﺩﺪﺤﻣ: tl6t
ﻝﺍ-ﻡﻮﻳ-ﺪﻌﺑ ﺪﻏ ﻡﻮﻳ: dwek
ﻞﻳﺪﺒﻟﺍ-ﺔﻴﻤﻜﻟﺍ-ﺩﺪﺤﻣ: lw6t
ﺞﺋﺎﻫ: hdup
ﻲﺿﺎﻤﻟﺍ-ﻝﻮﻬﺠﻤﻠﻟ-ﻲﻨﺒﻣ ﻞﻋﺎﻔﻟﺍ ﻢﺳﺇ: hp6t
ﻝﺍ-ﻡﻮﻳ-ﻞﺒﻗ ﻖﺑﺎﺴﻟﺍ ﻡﻮﻴﻟﺍ: txet
ﻲﻓﺮﻇ-ﻲﻫﺎﺠﺗﺍ-ﺔﻟﺎﺣ: tc6k
ﺮﻳﺎﻐﻤﻟﺍ-ﻲﻃﺮﺷ: ht6c
