bye: Hwyl-fawr, Helo, pi, ffarwel
y: 
o: rhwng, am, ei
i: dod, rhaid-i
yn: 
:-first-person: 
ff: mi
:-third-person: 
bod: mae'n, sy'n
ei: ei, hun
ef: mae'n
gyda: 
ar-gyfer: am, tuag-at
fel: sy'n, enghraifft, sut
:-second-person: 
fod: 
hi: ei
ar: galwad, am
ar: ceffyl
gan: pasio, ac, am
cael: arth
neu: nac
o: 
hwn: mae'n
ef: ei
hi: maent, mae'n
fy: mwynglawdd, mi
eu: ei, maent
felly: a-thrwy-hynny, yn-fuan
yn: 
nhw: maent, chi
rydym: ni, mi
pwy: pwy-bynnag, sy'n
byddai: meddwl, dod-â
bydd: grym-ewyllys
dim: Ni
os: p'un-a, a-ddarperir
i-fyny: uchod, yn-codi, allan, waeth
i-mewn-i: un
unrhyw: sef, sy'n, i-gyd, pob-un
eich: eich-un-chi
beth: nac, sy'n, beth
dangosol-hwyliau: gyfarwyddeb-hwyliau
dyn: person, gŵr, gwrywaidd
na: mwy, am, sut
ein: gwanwyn, ni
rhai: braidd
ar: ar-ôl, uchod, allan
gall: gallu
bellach: bresennol
hoffi: sut, caru, cynnal
gall: gallu, gallai, blwch
Dylai: rhaid-i
gwnaeth: gwneud, ffaith
fath: a-thrwy-hynny
a: un
rhain: maent, mae'n
dros: uchod, mwy
llawer: iawn, cyfaint
mr: syr, meistr
dda: hardd, mawr, math
y-rhan-fwyaf o: mwy, i-raddau-helaeth, mwyafrif, iawn
rhaid: rhaid-i
y-rhai: maent, ei
ei-hun: hun, un-fath, eu-hunain
bywyd: byw, oes, llafariad, canol
heb: 
gwneud: gwneud, creu
yn-dda: gyfforddus, hawl
disgwrs-marciwr: 
drwy: pasio, treiddio
gallai: pŵer, efallai, gallai
hefyd: iawn, hyd-yn-oed
eto: yna,, yn-ôl, unwaith
llawer: mwyafrif
pob: pob-un, sy'n
pobl: person, cymuned, a-pobl
meddwl: ideoleg, syniad, meddwl
dan: i-lawr
dal: mwy
lle: fan-a'r-lle, sefyllfa, lle
tra: tra, amser, dros-dro
dim-ond: yn-unig, syml
hefyd: hyd-yn-oed, yn-yr-un modd, mwy
eto: ond, nac, serch-hynny, mwy
erbyn: tuag-at, cyn
cael: cwrdd, cymryd, deillio
erioed: tragwyddol, byth, bob-amser
off: cau, i-ffwrdd, allan, a-gwmpesir
wyneb: wyneb, cant, person
arall: diwethaf, eraill
Gadawodd: i-ffwrdd
newydd: neo, nofel, ffres, naw, ifanc
mrs: 
rhoi: set, diwethaf, rhoi
dweud: dweud
meddwl: deallusol, meddwl
ychydig: cwpl, ychydig
pwy: sy'n, pwy-bynnag
yn-hyn: i-ffwrdd, bell, iawn
gelwir: meddwl
cyfan: llawn, i-gyd
ddau: dau
dod-o-hyd i: dod-o-hyd, chwilio
edrych: gweld, gwiriwch, Cipolwg
gadewch: bws, allyrru, rhoi, galluogi
arglwydd: meistr, syr, Brenin
cartref: tŷ
rhywbeth: dim-byd, braidd
hyn-o-bryd: amser
tad: dad
ymhlith: rhwng
menywod: benywaidd
mam: mom
diwedd: gorffenedig, diwethaf, yn-hwyr
bach: ychydig, micro
ti: chi
eisiau: rhaid-i
fodd-bynnag: ond, serch-hynny, er
yn-eithaf: yn-gyfan-gwbl, braidd, iawn, digon
y-mae-ei: sy'n
gorau: gwell
fy-hun: mi, eu-hunain
nes: hyd-yn-oed, cyn, Hwyl-fawr
ers: yna,, yn-gyntaf, achos
a-ddefnyddir: oed, ailgylchu
yn-hytrach: yn-lle-hynny, braidd, mwy
llai: byr, i-lawr, lleiaf
o-fewn: mewnol, dwfn, dan-do
gyda'n-gilydd: set
mawr: mawr, enfawr
mater: beth, pwnc, cwestiwn
penodol: benderfynir, hawl
hi-ei-hun: eu-hunain
hanner: hanner-ffordd, falu, ochr
yn-wir: wirioneddol, ffaith, hawl
unrhyw-beth: Beth-bynnag, braidd, dim-byd
cadw: cynnal, set, cadw
gwraig: benywaidd
fodd: ffordd
ger: pasio, bron
wladwriaeth: cyflwr, fynd-i-mewn, gwlad, llywodraeth
ei-ben-ei hun: unig, solo, un
achos: syrthio, enghraifft, siwt, digwyddiad, achos
ti: chi
uchel: uchod, llawr
merch: merch, benywaidd, gariad
yn-siwr: sicrhau, hawl, wirioneddol
yn-wir: wirioneddol, ffaith
ei-hun: eu-hunain, hun, p'un-a
hyd: cysylltiedig, hir, hyd
tir: gwlad
dychwelyd: atchweliad, yn-ôl, ad-daliad
gadael: ymadawiad, ystod-y-gwyliau, wedi'u-gadael, i-ffwrdd, caniatâd
naill-ai: hyd-yn-oed
gyfraith: hawl, cyfreithiol, rheol
lleyg: set, seciwlar, helpu
pwynt: fan-a'r-lle, gweithredu, yn-unig, paragraff
plentyn: plant
dymuno: gobeithio, dymuniad
siarad: dweud, sgwrs
yn-ystod: amser, tra
nifer: dwsin, cwpl, mwy
busnes: fasnach, siop, cwmni, gwaith, masnachol, symudiad
modd: ffordd, ymagwedd
ail: eraill
cyffredinol: cyffredin, Yn-gyffredinol,, cyhoeddus
y-tu-ôl: yn-ôl
yn-dod-yn: dod
marw: yn-marw, marwolaeth
ddaear: gwlad
bachgen: mab
teimlo: teimlad, clywed
ysbryd: enaid
gwirionedd: ffaith
ddaear: llawr, gwlad, fan-a'r-lle
'n-sylweddol: wirioneddol, iawn, ffaith
gorffwys: eraill, cysur, ymddeol, gweddillion, ystod-y-gwyliau
gwahanol: amrywiol, gwahaniaeth, eraill
bosibl: efallai
dynol: person, dynoliaeth
tref: dinas
canlynol: nesaf, dilyn, ar-ôl
angen: angenrheidiol, rhaid-i
achos: rheswm, cymell, achos
gyda'r-nos: nos, prynhawn
pump: pumed, blwyddyn
cryf: pŵer, gallu, treisgar
lady: benywaidd
o-gwmpas: cyfagos, bron, am, llygad
dro: ochr, set, gorchymyn
synnwyr: golygu, teimlad, connotation
cau: cau, bron
cymeriad: nodweddiadol, personoliaeth, marc, natur
didoli: dosbarthiad, math
golwg: gweledigaeth, ymlaen, olygfa, gweld, Cipolwg
parti: gwledd, coma, gwlad
dirwy: mawr, tenau
barod: paratoi, eisoes, flaenau-eich-traed, gorffenedig
cyfrif: rheswm, bil, cyfrifiad, cyfrif
ysgrifenedig: ysgrifennu
oed: oed, ganrif
arall: eraill, diwethaf, mewn-mannau-eraill, mwy
grym: pŵer, gorfodi, gosod
ar-draws: uchod, gyferbyn
yn-gynnar: cynamserol, dechrau, cyntefig, yn-fuan
haul: 
yn-ddiweddarach: dyfodol, yna,, ar-ôl, nesaf
popeth: i-gyd
gorffennol: mynd-heibio, ôl-weithredol, diwethaf, ar-ôl
act: bil, ferf, gweithredu, gwaith, symudiad
ymhellach: ymlaen, mwy, ychwanegol
tu-hwnt: mwy, allan
nid: nac, sy'n
golygfa: Mynegwyd-barn-gan, Cipolwg, gweld, gweledigaeth, olygfa, calendr
sain: llais
dim: dim-byd, nicel
glir: agored, yn-amlwg, trawiadol, golau
ffordd: priffyrdd, ffordd
go-iawn: rhithwir, ffaith, brenhinol
bron: bron, am
gwybodaeth: gwybodaeth
tuag-at: tuag-at
drwg: waeth, drwg, gwael
byw: byw, canol, oes
heddwch: ystafell
isel: byr, rhad, camesgoriad
gogledd: ateb, gogleddol, canol-nos
naturiol: natur
'n-bert: hardd, iawn, digon
deg: hawl, adroddiad, deg
gwasanaeth: gweini, gofal
isod: i-lawr
pleser: hapus
hanes: stori, dyddiad, hanesyddol
Nodyn: cofiwch, nodiant
er-bod: er
blaen: gyferbyn, ymlaen, cyn
mawr: mawr, enfawr
yn-sicr: llym, cwrs, wirioneddol
gwynt: aer, atig
derbyn: derbynneb, cymryd, deillio
sylw: gofal, blaenoriaeth, ffocws, sylw, pwyslais
cryfder: pŵer
yn-ôl-pob tebyg: efallai
falch: hapus, doniol, bodlon
pwysig: angenrheidiol, ganlyniadol
eich-hun: hun, eu-hunain
gyd: cydweithiwr, ffrind
barn: Mynegwyd-barn-gan, syniad
ffydd: yn-credu, teyrngarwch
yn-ôl: ddwyrain, yna,, cyn, ymlaen, yn-ôl
codi-tâl: toll, traul, cymryd
fraich: llaw, gwael, llawes, breichiau, ysgwydd
olaf: diwethaf
gwrthrych: pwrpas, dim-byd, pwnc
gŵr-bonheddig: gwrywaidd, syr, meistr
arbennig: yn-enwedig, sef
prin: Ni, bron, prin
prif: rheolwr, pen
cyfle: cyd-ddigwyddiad, sefyllfa, achlysur, tebygolrwydd
bargen: cynllun, siop, cytundeb
meddwl: meddwl
trwm: ailadrodd, pwysau, o-ddifrif, caled
plaen: agored, syml, pant
ar-unwaith: unwaith, yn-fuan
geg: person
ofni: ofnus, ofn, bryderus
sengl: un, unig
llawenydd: hapus, cyffro
torri: sylffwr, torri
oni-bai-bod: ac-eithrio
cario: arth, gwisgo, dod-â, galluogi
dylanwad: effaith, y-ffliw
ymddangos: yn-dod-i'r amlwg, ymddengys
tu-allan: allan, ac-eithrio
os-gwelwch-yn dda: garedig, gofyn
ymddangosiad: yn-dod-i'r amlwg, ymddengys
yn-araf: yn-raddol, yn-hwyr
cyfnod: cam, amser
chwaer: brawd
brwydr: frwydr, rhyfel
cyn-: oed
ieuenctid: ifanc
yn-unig: yn-unig, syml, unig
cyrraedd: ymagwedd, cyflawni, dod
system: gorchymyn, hierarchaeth, sefydliad
cinio: nos, cinio
wedyn: dyfodol, ar-ôl
cerdded: gwadn, mynd, llawr, droed
Tybed: wyrth, rhyfedd, synnu
arferol: Yn-gyffredinol,, cyffredin, bob-amser
ffigur: digidol, ystadegau, siâp, rhif, toll, llun
hynafol: oed, hen-ffasiwn
barch: sylw, anrhydedd, perygl, tuag-at
trydydd: tri, Dydd-Mawrth
yn-parhau-i fod: aros
cymdeithas: cymdeithasol, cymuned, cwmni
canlyniad: casgliad, effaith
gorchymyn: gorchymyn
yn-unig: yn-unig, syml
wrth-ochr: pasio, nesaf, ac-eithrio
dawel: dawel
perffaith: priodol, mawr
stryd: ffordd
ysgrifennu: ysgrifennu, llythyr
pren: pren, coed, ffon
yn-gyflym: yn-fuan
rhybudd: gweld, ad, rhybudd
llachar: miniog, golau, sgleiniog, trawiadol
cwch: llong, arnofio, cwch-hwylio
nobl: mawr, gogoneddus
sydyn: yn-sydyn
gwerth: werth, rheng, pwysigrwydd
ddyledus: achos
darllen: darllen, cwestiwn
cytuno: cytundeb
aros: disgwyl, cynnal, aros
darn: sglodion, rhan, darn
ex: oed
sgwrs: sgwrs, deialog
cyfle: achlysur, sefyllfa
cost: traul, talu
sylweddol: mawr, ganlyniadol, trawiadol
eistedd: aros
top: optimaidd, crib, uchod, copa
priodas: briod
cam: gweithredu, gwadn, cam
dechrau: dechrau
fesul: pob-un, tuag-at
unigol: person, yn-unigol, atom
anodd: caled
bit: rhan, ychydig, lleuen, damaid
lleferydd: sgwrs
awdurdod: awdurdodaeth, pŵer
hapusrwydd: hapus
darparu: a-ddarperir, rhoi, sicrhau
astudiaeth: dysgu, dadansoddiad, stiwdio
personol: preifat, yn-unigol, staff
Gwylio: gwiriwch, monitor, gweld
falch: bodlon, hapus
poeth: cynnes, tân
ymdrech: ceisiwch, straen
paratoi: paratoi, eisoes
ymgais: ceisiwch, cwis, stab
cyflym: yn-fuan, ystwyth
dan: i-lawr, ar-ôl
bwriedir: yn-bwriadu, ffocws, pwrpas
syth: yn-uniongyrchol, syml
debygol: yn-hawdd, tebygolrwydd, efallai, sôn,
cyfiawnder: hawl
yn-syml: yn-unig, syml
ymddiriedaeth: yn-credu, teyrngarwch
darn: rhan, groesfan, colofn, pasio, darn
ar-gau: cau, gwŷdd, a-gwmpesir
ein-hunain: eu-hunain
pasio: pasio, mynd-heibio, groesfan
canolig: eilaidd, golygu
meddiant: eiddo
dymunol: gyfforddus, math
berffaith: yn-gyfan-gwbl, wirioneddol
Fel-arfer,: cyffredin, Yn-gyffredinol,, yn-tueddu
bedd: caled
sefydlog: atgyweiria, er, safonol, parhaol
filwyr: y-fyddin
cwrdd: sesiwn, cynulliad, cwrdd
gwersyll: gwersylla, maes
cenedl: gwlad, cenedlaethol
bodolaeth: presenoldeb
ateb: ateb, ad-daliad
awyr: awyrgylch, nefoedd
cyfartal: un-fath, gradd
ffortiwn: tynged, cyflwr, eiddo
parth: maes
sefyllfa: sefyllfa, cyflwr
canol: golygu, hanner-ffordd, canol
gaeaf: oer
caniatáu: caniatâd, galluogi
golau: melyn, lliw, llewygu, pastel, agored, golau
rhedeg: hil, rhedeg
crefyddol: crefydd, cemotherapi
arwain: cymell, dod-â
symud: gwadn, ddadl, Budge, symudiad, gweithredu
rhoi'r-gorau-i: egwyl, sefyll
llafar: dweud, llafar, sgwrs
bwrdd: yn-codi, panel, cyngor, ymyl, comisiwn
ofer: rhad-ac-am ddim, gwag
colled: anfantais, gollwyd, gollwng
cynnig: a-ddarperir, cynnig, rhoi, arddangosyn, gweini, braint
dosbarth: math, orbit, rheng
cwblhau: llawn
mynediad: ymweliad, ymagwedd, caffael
angerdd: brwdfrydedd, teimlad
corfforol: ffiseg, corff
enghraifft: enghraifft
cychwyn: dechrau
gwaethaf: dicter
difrifol: mawr, o-ddifrif, eithafol
arian: arian, Dydd-Gwener
digonol: digon
prif: pen, meistr, allweddol, gwreiddiol, stwffwl
hyfryd: rhyfedd, treisgar, mawr
llwybr: ffordd
golygu: connotation, golygu, pwysigrwydd, pwnc
cyd-fynd: siwt, priodol
llawer: màs, iawn, tynged
sedd: cadeirydd, gwarchae, pencadlys
gêm: gamblo, chwarae
datganiad: mynegiant, adroddiad
freuddwyd: hunllef, cysgu
graig: clogwyn, sgert, carreg
arbennig: yn-enwedig, preifat, arbenigwr
ffi: traul, toll, talu
rhannu: rhan, fantol, rôl, dosbarthu
lledaeniad: manylion, eang, gwasgariad, rheswm
gogoniant: anrhydedd, canmoliaeth
gofod: sefyllfa, neuadd, maes, gofodwr
cyffredin: cyffredin, syml
ystyried: meddwl, sylw
yn-fawr: iawn, i-raddau-helaeth
swyddog: swyddogol
cyfradd: safonol, anrhydedd, cwrs
arwydd: nodiant, ystum, marc, fan-a'r-lle
frodorol: natur, gwreiddiol, preswylydd
gweithio: cyflogai, gwaith
priodi: briod
raddau: rhwymo, cyfaint, gradd
dull: ffordd, unwaith, ymagwedd
rhagorol: gwell, mawr
hyder: yn-credu
yn-union: wirioneddol, yn-enwedig, llawn, yn-gyfan-gwbl
helaeth: mawr
ffansi: dychymyg, hardd
cyflym: yn-fuan, ystwyth
ie: yeah, a-thrwy-hynny
rhyddid: rhad-ac-am ddim, annibyniaeth
diddorol: tynnu, chwilfrydig
neilltu: gwahanu, i'r-ochr, ac-eithrio
pur: ffres, veridical
yn-ymwneud: uchod, am, sylw
tystiolaethol: tystiolaeth, yn-amlwg
bell: i-ffwrdd, bell
tebyg: yn-debyg, un-fath, gyfath, cymaradwy
cul: tenau, byr
yn-gyfan-gwbl: yn-gyfan-gwbl
dudalen: ochr, iard
yn-enwedig: yn-enwedig
mynydd: bryn
falch: balchder
yn-glir: benodol, agored, yn-amlwg
pris: anrhydedd
sâl: sâl
dyfarniad: penderfyniad, dedfryd, rheol, barnwr, awdurdodaeth, argyfwng
derbyn: derbyniol, cyfaddef, cymryd
rhywogaethau: math
ceisio: chwilio
anrhydedd: anrhydedd
clust: caniatâd
gwaelod: i-lawr, llawr, sylfaen
cymorth: cymhorthion, helpu, cefnogaeth
llawn: llawn, yn-gyfan-gwbl
hyfrydwch: hapus, annymunol
swm: cwantwm, cyfaint, dorf, rhif
cael: caffael, deillio, cymryd
treth: rhent, llinell
croesi: groesfan, pasio, yn-fwy-na
ddieithryn: gwestai, rhyfedd, tramor, anhysbys
Dare: dewrder
tyfu: yn-codi
ffug: gorwedd, anghywir, sâl, ddiffygiol
tal: hir, llawr
giât: drws
rhydd: annibyniaeth, rhad-ac-am ddim, yn-annibynnol, rhydd
ergyd: sioc, strôc, ergyd, cic
ffasiwn: ymagwedd, dod
bob-dydd: diwrnod
dosbarthu: dosbarthu
cyfoeth: arian, eiddo
rhyddid: rhad-ac-am ddim, annibyniaeth
ymlaen-llaw: cynnydd
addfwyn: meddal, melys
yn-sicr: cwrs, wirioneddol
sicrhau: yn-ddiogel, gwarchod, sicrhau
meddiannu: atafaelu, cenllysg, cymryd-rhan
cam: llwyfan, gweithredu, cam, cyflwr, olygfa
dogn: rhan, dogn
tafod: iaith, tafod
ddig: dicter
cerbyd: trên, troli, gwennol
tywydd: hinsawdd, aer, amser
rheidrwydd: pwysigrwydd
arfer: ymarfer-corff, gweithredu, arfer
hawliad: cais, siwt
tywysog: dug
grŵp: set, conglomerate, ddiadell, band, panel
drwy-gydol: ym-mhob-man
ychwanegu: ehangu, ychwanegol, cynyddu
gweddïo: gofyn
arwain: ganlyniadol, meistr
llwyd: brown, lludw
yn-aml: yn-aml, dro-ar-ôl tro, parhaol
enwog: poblogaidd, dda---hysbys, llafariad
pwerus: pŵer, gallu
yn-fyw: byw
wan: llewygu, gwael
deunydd: cynnwys, pwnc
gonest: onest, Axiom
gwres: haf, cynnes
gard: gwarchod, gofal
yr-un-mor: cydbwysedd, un-fath, yn-yr-un modd
yn-naturiol: natur
rhyfeddol: rhyfedd, anarferol, mawr
lleuad: mis
bychan: ychydig, yn-hawdd, golau, tenau, byr
arddull: golau
pigfain: hemisffer, miniog
egwyddor: theori, Axiom, dechrau
ar-unwaith: yn-fuan, yn-uniongyrchol
barod: eisoes, flaenau-eich-traed, filltir
canlyniad: ganlyniadol, effaith, casgliad
tendr: meddal, cytundeb, hil
diddordeb: yn-bwriadu, llog
chwarter: droed
uwch: uchod, ymlaen
yn-ôl-pob golwg: benodol, sôn,, ymddengys
weithgar: gwaith, gweithredu
ymwybodol: yn-fwriadol, yn-gwybod
peryglus: perygl, niweidiol, bygythiol
dawel: dawel
sanctaidd: ddwyfol, sanctaidd
deyrnas: brenhinol
cyfan: yn-gyfan-gwbl, i-gyd, llawn
'n-glws: hardd
arfer: nodweddiadol, ffordd, arfer
uniongyrchol: yn-amlwg, yn-uniongyrchol, uniongyrchol
mewn-gwirionedd: wirioneddol, ffaith
clyw: clywed
cerdded: gwadn, droed, cerddwyr
taflu: allyrru, bwrw, ergyd
doethineb: deallusol
gyriant: gyrru, corws, alldaith, gwthio, rhedeg, disg
fai: bai, anghywir
berthynas: beth, pwnc, cysylltiadau
cysylltu: gohebiaeth, cyffwrdd
orsaf: sefyll, canolfan, tymor
gwrando: clywed, gofyn, ufuddhau
brifo: anaf, poen, glwyfo
mynegi: mynegiant, eglurwch
ffafrio: ochr, gras, maeth
uchder: hyd
maint: dimensiwn, maint, llawn
tasg: gweithredu, gwaith, dyletswydd
cydymdeimlad: empathi, biti
nadd: gwisg
farther: ymlaen
llestr: offeryn, llong
anwyldeb: caru
dioddef: artaith, diflastod, chwerw, trafferth
cnawd: cig, corff
grand: enfawr, mawr
swydd: rheng, ôl--swyddfa, ar-ôl, anfon, sefyllfa
casgliad: cronni, set, oriel, casgliad
dychmygu: dychymyg, meddwl
cyrraedd: dod
uchel: mynnu, mawr, caled
hyfryd: hardd, gogoneddus
anghyffredin: rhyfedd, anarferol
yn-digwydd: nac
brecwast: bore, cinio
poblogaeth: dorf
cyfres: cadwyn, set
rhyddhad: cymhorthion, cysur, glyph
argraff: effaith, teimlad, greu-argraff, print
boddhad: bodlon
siâp: dimensiwn, ffurflen, siâp
genedigaeth: eni
ystyriaeth: syniad, sylw
rheolaidd: cyfnodol, dro-ar-ôl tro, trefnol
symud: Budge, symudiad
prysur: cymryd-rhan
ansawdd: màs, gradd
darganfod: dod-o-hyd, chwilio, datgelu
y-tu-mewn: mewnol, dwfn, dan-do
pridd: mwd, llawr, solo, gwlad
yn-gyfan-gwbl: yn-gyfan-gwbl
neges: gwybodaeth, newyddion
ymadrodd: mynegiant, dedfryd
sôn: gwrywaidd
pâr: hawl, cwpl
teitl: pennawd, pen, pwnc
dealltwriaeth: deall, empathi
Dydd-Sul: wythnos
mad: crackpot, ffwl
gwbl: yn-gyfan-gwbl, llym
araf: dawel
drugaredd: biti, gras
cynnwys: Gan-gynnwys, cynnwys
galar: tristwch, poen
milwr: y-fyddin, gwystlo
blaenorol: ddwyrain
esboniad: eglurwch, gwybodaeth
gweddi: cais
cred: yn-credu, teyrngarwch
gyson: dro-ar-ôl tro, safonol, atgyweiria, parhaol
terfynol: diwethaf, yn-olaf
taith: marchogaeth, safari, yn-codi, gyrru
polisi: gwleidyddol
lluniadu: llun, tynnu, cynllun
marw: marwolaeth, yn-marw
galw: cais, cwestiwn
uchaf: uchod
swm: ac, ioga, rhif
cynnig: symudiad, cynnig
cymorth: cefnogaeth, helpu
urddas: anrhydedd
dal: cynnal, cymryd, beichiogi
ymysg: rhwng
ar-hyn-o bryd: bresennol, nant
o-bosibl: tebygolrwydd, efallai, gallai
ar-wahân: gwahanu, gwahaniaeth, solo
gwaethaf: waeth, gwael
arswyd: ofn, terfysgol
rheoli: rheoleiddio, dan-reolaeth, gwiriwch, rheoli
alluog: galluogi, gallu, medrus, sgiliau
cwmni: cwmni, er
uwchraddol: gwell
ysbrydol: yn-feddyliol, moesol, deallusol
prawf: profi, tystiolaeth
perthynas: cysylltiadau, adroddiad, sylw
dan-sylw: gofal, bryderus, cysylltiedig
ddwfn: dwfn, manylion
canu: darllen
gyfeillgar: gyfath, garedig, cyfeillgarwch, math
fynedfa: drws, derbynneb
cyflenwad: lled, a-ddarperir
glân: ffres, daclus
defnyddiol: angenrheidiol, effeithiol
cain: bregus, tenau, cain
tynnu: gwared, dileu, tynnu
dewis: dewis, etholiad, gwiriwch
enfawr: enfawr, mawr
methu: Ni-all, Ni, methu
clawr: cot, cynhwysiant, blanced, lapio, palmant
dwbl: dau-wely, ddwywaith, cwpl
buddugoliaeth: llwyddiant
yn-gyson: yn-aml, dro-ar-ôl tro, bob-amser, parhau
lefel: safonol, cyflwr, wyneb
rhyddhau: rhyddhau, cyhoeddi, rhad-ac-am ddim
garw: waeth, drwg---tymer, anghwrtais
ymlaen: ymlaen, uchod
cysylltu: rhwymo, ynghlwm, cysylltiedig, cyfun
ennill: caffael, mantais
Hefyd: ychwanegol, ategu
siambr: ystafell, neuadd, camera
gydnabod: cyfarwydd, primer
camgymeriad: anghywir
yn-seiliedig: sylfaen, termau
car: trên
neb: unrhyw-un, dim-byd
ynni: pŵer
moel: agored, bar, cywilydd, pant, moel
yn-rhannol: hanner-ffordd, rhan, braidd
lliw: lliw
diogelwch: yn-ddiogel, iachawdwriaeth, gofal
disgrifiad: disgrifiwch, gwybodaeth, disgrifydd, diffiniad
cysgu: cysgu
gollwng: dip, syrthio, gollwng
gwych: gogoneddus, sgleiniog, mawr
cryno: acronym, byr
llwyd: brown, lludw
iawn: iawn
gyffrous: cyffro, llidiog
anobaith: rhwystredigaeth, llewygu
rhwyddineb: cysur, lleihau
cyfanswm: gros, i-gyd
caredigrwydd: rhinwedd, gras
cylch: cylch, fflat, rownd, olwyn
ddiflas: turio
bwriad: yn-bwriadu, pwrpas
dymor: termau, semester, dyddiad-cau
yn-drylwyr: gyfforddus, yn-gyfan-gwbl
berthnasol: defnydd
llafur: gwaith
cudd-wybodaeth: deallusol
streic: ymosodiad, trawiadol
yn-deg: yn-gyfan-gwbl, digon, iawn
cydymffurfio: cwrdd, ufuddhau, cynnwys
digwyddiad: digwyddiad, achlysur, sioe
ysgafn: meddal, garedig
cysylltiad: cyd, atodiad, galwad
amddiffyn: gwarchod, lloches, gofal
ymwybodol: effro, yn-fwriadol, teimlad
rhifyn: traul, print, cyhoeddi, caniatâd
hedfan: aderyn, hedfan, esgyn
amrywiaeth: math, amrywiol
ar-wahân: gwahanu, i-ffwrdd, ac-eithrio, yn-annibynnol
ofnadwy: ofnadwy, biti
pawb: i-gyd, unrhyw-un
llafur: gwaith
gariad: annwyl, gariad
canu: cân
awyddus: dymuniad, ddiamynedd, chwilfrydig, bryderus
ei-gwneud-yn ofynnol: gofyn, cais, mynnu
pryd-bynnag: pryd
llwyddiannus: llwyddiant
codi: ehangu, lifft, cynyddu, yn-codi
datblygiad: cynnydd
cwl: oer, hardd
treial: probe, proses, llys
dramor: tramor, alltudiaeth
ffyddlon: teyrngarwch, ffyddlon
llenyddol: llenyddiaeth
awdur: awdur
stoc: ffon, rôl, gweithredu
math: math, ysgrifennu, wasg
digonedd: gyfoethog, diswyddo, digon
osgoi: atal
ffafrio: ochr, gras, maeth
meddyliol: deallusol, yn-feddyliol, mewnol
agwedd: Cipolwg, sefyll, ystum, ymagwedd, dibyniaeth, paragraff
edmygedd: canmoliaeth
pryder: bryderus, ofn, pwyslais-mawr, cyffro
dysgu: yn-gwybod, dysgu
yn-weladwy: yn-gwybod
arwain: llawlyfr, tystiolaeth, gyrru
gwirioneddol: rhithwir, ffaith, brenhinol
ddiflas: annigonol, drist, anhapus, diflastod, ddiymadferth
niwed: drwg, niweidiol, anaf, biti
pardwn: maddau, n-chwith, yn-ymddiheuro, gras
anaml: weithiau
cofnod: cofrestru, disg, arbed
braster: olew, trwchus
fflat: fflat, noncommittal, cynllun
rhodd: Gwobr, bresennol
deml: tŷ, eglwys-gadeiriol
trwydded: caniatâd
caniatâd: cymeradwyaeth, caniatâd
yn-ddigonol: llawn, digon
clwyf: anaf, glwyfo, wlser
beiddgar: dewrder, dewr
yn-unrhyw-le: rhywle, ym-mhob-man
tyst: tystiolaeth
ffôl: anwybodus, ffwl
unrhyw-un: unrhyw-un, pwy-bynnag
hunan: preifat, eu-hunain, hun
hynod-o: iawn, anarferol
triniaeth: therapi, gofal
gwddf: gwddf, esgyn, ciwcymbr
claf: sâl
twf: cynyddu
maint: cwantwm, màs, dorf, dos, rhif, maint
difrifol: llym, treisgar, caled
esgus: maddau, rheswm, transitive, n-chwith
tarddiad: gwreiddiol, natur
cynulleidfa: goddefol, cyhoeddus
sy'n-weddill: gweddillion
ennill: llwyddiant
morwyn: gwas
dawel: meddal, dawel
realiti: ffaith
safle: olygfa, gwefan, fan-a'r-lle
hwylio: llong, llen
siop: siop, storio, arbed
sylw: Mynegwyd-barn-gan, sylw
saib: egwyl
werthfawr: werth
felly: a-thrwy-hynny, felly,
planhigion: yn-codi, coed, felin
iâ: eira
absoliwt: llawn, yn-gyfan-gwbl
yn-rhwydd: yn-hawdd, yn-fuan
ffyrnig: miniog, treisgar, caled, creulon, ysglyfaethwr, gwyllt
rage: dicter
darganfyddiad: dod-o-hyd, chwilio, ddyfais, agor
gysylltiedig: cysylltiedig
cosb: dedfryd
ychydig: ychydig, yn-hawdd, braidd
dirgel: gyfrinach, amwys, anweledig
cysgod: cysgod, tôn, naws
llofruddiaeth: lladd
emosiwn: teimlad, angerddol
dinistrio: adfail, dinistrio
arswyd: ofn
lleol: yn-lleol, mewnol, fan-a'r-lle
ystod: amrywiol, pellter, set
llu: y-fyddin, gwestai, dorf
gwlyb: glaw, llaith
dirgelwch: gyfrinach
meddu-ar: hun, arth
ymwybyddiaeth: rhesymoledd, teimlad, cydwybod
gynt: cyn
cynhyrchu: cynhyrchu
dec: bont
ystâd: eiddo
teyrnasu: Brenin, breindal
cydymffurfiaeth: dilyn, addasu
hers: ei
anffodus: yn-anffodus, cyd-ddigwyddiad, anhapus, biti, annigonol
blodyn: treulio, llog, mwd
diolch: diolch
yn-perthyn: eiddo, Gan-gynnwys
farchnad: prynu
cap: het, corc
falch-iawn: hapus
cartref: teulu, tŷ
fflyd: llong, nefi, arnofio
babi: plant, ddol
rhanbarth: maes
union: blawd, priodol, llawn, gofalus
image: llun
amheuaeth: amheuaeth, amheus
gwrthod: gwadu, feto, gwastraff
atebolrwydd: dyletswydd, bai
cywilydd: cywilydd
pryd-o-fwyd: bwyd, bwyta, blawd
statws: sefyllfa, cyflwr
dangos: fynd-i-mewn, sioe
cerdd: barddoniaeth, cân
codi: yn-dod-i'r amlwg, yn-codi
mordaith: safari, alldaith
mynychu: ymuno
fforddio: prynu, rhoi, arth
rhoi: cyfrannu, rhoi
swydd: gwaith
symud-ymlaen: parhau, cynyddu, cynnydd, pasio
difaru: n-chwith
risg: perygl
cyflym: yn-fuan, ystwyth
ar-wahân: gwahanu, gwahaniaeth
yn-briodol: priodol, gyfforddus
enwogrwydd: canmoliaeth
unigol: unedig, uned
gwall: anghywir
enw-da: canmoliaeth
apêl: tynnu, galwad
diffyg: torri, ddiffygiol, absenoldeb
trais: treisgar
rendr: gwneud, cyflwyno, rhoi
gyrfa: proffesiwn, gwaith
dylunio: beichiogi, cynllun
awgrym: dedfryd, cynnig
llwyr: ynganu, llawn
penderfyniad: penderfyniad, casgliad, dadansoddiad, ehangu
sbâr: yn-ail, ychwanegol, cymryd-lle, picell
cartref: sifil, mewnol, preswylydd, cenedlaethol
cyfeirnod: cyfeiriadol, cof
yn-bodoli: presenoldeb, bresennol
mater: broblemus, termau, trafferth, pwnc, cwestiwn, allyriadau
gan-ddarparu: a-ddarperir, rhoi
fflam: tân
anwybodaeth: anwybodus, anwybyddu
o-bryd-i'w gilydd: weithiau, dro-ar-ôl tro
hedfan: hedfan
brethyn: ffabrig, dillad
elw: mantais
pedwerydd: pedwar, Dydd-Mercher, ystafell
cloch: larwm, awr
budd-dal: mantais
pennod: drws, rhan, pen, tymor, cyfalaf, eu-hunain
twll: turio, pwll
rhesymol: priodol, ddoeth, rhesymegol
siwgr: meddwdod, ffordd
amnewid: cymryd-lle, yn-lle-hynny, lwfans, yn-ail, cyfnewid
byrdwn: mynnu, wau, talu, gwthio, impulse
ffrâm: graddfa, cyfreithiol, ergyd
sylwedd: pwnc
e-bost: anfon
is-adran: rhan
caethwasiaeth: gaethweision
pennill: barddoniaeth, paragraff
tebygol: efallai
boenus: chwerw, poen
am-byth: bob-amser, tragwyddol
cefnfor: môr
cefn: ar-ôl, yn-ôl, cefn
arweinydd: pen, rheolwr, arweinydd, llawlyfr
awyddus: yn-bwriadu, bryderus, miniog
lwc: tynged
yn-amlwg: yn-amlwg, Axiom
brysiwch: yn-fuan, llo
cynllun: cynllun, streipiog, siart
ddiwerth: gwastraff
serch-hynny: er, serch-hynny
llyfn: meddal
solid: dangosol, sefydlu, er, compact
o-reidrwydd: rhaid-i, angenrheidiol
adeiladu: creu, adeilad, llunio
ymgais: ceisiwch, stab
cyfwerth: un-fath
diweddar: Yn-ddiweddar,, modern, diwethaf
teithio: ymweliad, twristiaeth
canol-dydd: prynhawn, de
lleoli: syrthio
cyhoeddiad: ad
yn-dod-i ben: atal
amgylchiadau: cyflwr, amlen
pabell: caban, olygfa
yn-aml: dro-ar-ôl tro, yn-aml
yn-uchel: llais
annibynnol: annibyniaeth, rhydd, yn-annibynnol
hanfodol: angenrheidiol, stwffwl
arsylwi: arsylwi
diolchgarwch: diolch
cadw: cadw, storio, gwarchod
agwedd: elfen, ochr
arswyd: ofn, ffobia, ofnus
clyfar: medrus, ddoeth
dosbarth: byw
methiant: methu, anghywir, methdaliad, camesgoriad
cant: ceiniog, y-cant, cant
sentiment: teimlad
asiant: golygu
anobeithiol: llewygu
undeb: cynghrair, unedig
grant: cyfaddef
taro: lluoswch, cic, llwyddiant
enfawr: mawr, enfawr
euogfarn: dedfryd
twymyn: tân, y-ffliw
drin: therapi, proses, gwella
ni: gwanwyn, ni
camgymryd: anghywir, cam-drin, ddiffygiol
ddelfrydol: gwell
brwyn: dorf, strôc
gywir: priodol, hawl, ffyddlon, atgyweiria
perfformio: sioe, gwneud
rhywsut: braidd
syniad: beichiogi, connotation, syniad
trafodaeth: trafod, ddadl
yn-gadarn: sefydlu, er
cyson: safonol, atgyweiria, cyson, parhaol
ymerodraeth: brenhinol
pen: pensil, pen
trwydded: caniatâd
cynnal: cynnal, gwarchod, cadw
gorlawn: dorf, dwysedd
cyfyngiad: rhwymo, ataliaeth
erchyll: ofnadwy
porthladd: harbwr, drws
profiadol: profiad, medrus, arbenigwr
yn-gwrthwynebu: gwrthwynebiad, gyferbyn, tuag-at, cyferbyniol
cytuniad: memorandwm, cytundeb
yn-digwydd: dod
ceisio: beg, chwilio
ymarferol: bron, wirioneddol, ymarferol
olrhain: marc, feto
siriol: hapus, doniol
trefniant: gorchymyn, gwarediad, drefnu, cytundeb
orllewin: orllewin
pwysau: pwyslais, print, gwthio, pwysau
gwleidyddiaeth: gwleidyddol
gwyddonol: gwyddoniaeth, gwyddonydd
teilyngdod: canmoliaeth, yn-gymwys, werth
cyfweliad: ymweliad, cyfwelydd
diriogaeth: maes
rhyw: pidyn, rhywiol, chwech
creu: creu, llunio, sefydlu
llwybr: marc, etholiad, ffordd
gobaith: gobeithio, tebygolrwydd, gweledigaeth, olygfa
llawdriniaeth: drifft, proses, gweithredu, llawfeddyg
dwys: dwfn
gêm: gamblo, cyd-daro, cyd-ddigwyddiad, hil
gwisg: gwisg
dyled: bai, crefydd, dyletswydd, credyd
menter: antur, buddsoddiad, cwmni
gweithredu: gweithredu
hwyliau: teimlad, hiwmor, gwarediad
criw: staff
canfod: deall, beichiogi, gweld
datgan: eglurwch
fersiwn: copi, cell
od: rhyfedd, anarferol
ddiolchgar: diolch
ddiddiwedd: tragwyddol, berfenw
diogelwch: yn-ddiogel, gofal
synhwyrol: ddoeth, rhesymegol, dueddol
bwthyn: cwt, caban
capasiti: gallu, sgiliau, cyfaint
setlo: aros
cymryd-rhan: cymryd-rhan, ymuno
cyngor: cyngor
arholiad: probe, gwiriwch, dewis
dur: haearn
prawf: gwiriwch, ceisiwch
elusen: caru
sied: arllwys, bwrw
cyfathrebu: gohebiaeth, cysylltiadau
rhywun: pwy-bynnag, person, unrhyw-un
rhes: llinell, trefnol, set, llywodraeth, gorchymyn
tlodi: gwael
dwys: ymyl, eithafol, treisgar
cweryl: frwydr
ar-gael: a-ddarperir, bresennol
ymwrthedd: gwrthwynebiad
anarferol: anarferol, cyffredin
anghyfannedd: wedi'u-gadael, anialwch
bleidlais: dewis, llais
goddef: arth, cefnogwr, diwethaf, yn-dioddef
llwyddo: llwyddiant
goes: droed, asgwrn
cais: cynnig, cais
tu: mewnol
ysgafn: yn-hawdd, golau
arddangos: sioe, arddangosyn, sgrin, olygfa, tystiolaeth
cyfyngu: cyfyngedig, yn-unig
nod: pwrpas, ffocws
beirniadol: angenrheidiol, beirniad
bag: poced, sach, basged
ailadrodd: ailadrodd, yn-ôl, dro-ar-ôl tro
trac: monitor, cân, ffordd, dilyn
preswylio: lloches
hwyl: hapus, doniol, adloniant
amddiffyn: gwarchod
drwm: pwysau, o-ddifrif
stwff: cynnwys, nwyddau, beth
adran: rhan, dyrannu
anheddiad: cytundeb, lloches, rheoleiddio
plât: panel, disg, disgo
goresgyn: ymdopi, yn-fwy-na, guro
tiroedd: rheswm, termau, motiff
marmor: carreg
gallu: gallu, sgiliau, talent
don: llanw, amwys
gwerin: a-pobl, poblogaidd
posibilrwydd: tebygolrwydd, gallu
menyn: olew
casineb: ddirmyg, casineb
mynd-ar-drywydd: chwilio
tynnu: tynnu, siswrn
signal: ystum, marc, cyfrinair
yn-ddiogel: yn-ddiogel
llosgi: llosgi, mwg
gwers: addysg, pwnc, cwrs
blynyddol: blwyddyn
cerdyn: cardfwrdd, map, byr, papur
cais: defnydd, meddalwedd, cais
deallus: deallusol, ddoeth
sir: boicot, rhanbarthol, dinas, gwlad
fformat: ffurflen, bwrw
llif: nant
difrod: adfail, anaf, biti
ar-ben-hynny: ychwanegol, hyd-yn-oed, mwy
fasnach: fasnach
deheuol: de
allanol: allan
cyfartaledd: eilaidd, golygu
noeth: cywilydd
amlwg: yn-amlwg, agored, Axiom
sylfaen: sylfaen, llwyfan
pryder: gofal, bryderus, cysylltiedig, llog, pwyslais-mawr
hud: swyn
ymgyrch: symudiad, alldaith
rhyddfrydol: hael
cyffredin: cyffredin, yn-aml, Yn-gyffredinol,
hela: hela
athro: awdur
cyn-bo-hir: yn-fuan, byr, bron
bendith: bendithia
bach: ychydig, micro
sydyn: cyflymder, miniog, o-ddifrif
frest: fron
dyfnder: dwfn
perfformiad: sioe, cynhyrchiant
ffyniant: ffynnu, llwyddiant, lles
clerc: cyflogai, swyddogol
penderfynu: penderfyniad, benderfynir, bendant, hydoddyn
dioddefwr: hela, aberth, toll
cymhelliad: yn-bwriadu, motiff, modur, pwrpas, ysgogiad
pendant: benderfynir, yn-amlwg
tuedd: nodweddiadol, filltir, gwarediad, drifft
gorffen: gorffenedig, lliw
flag: banner, yn-gwybod
gweinyddiaeth: rheol, rheoli
anaml: prin
dilys: rhithwir, gwreiddiol
hyfforddiant: addysg, addysgu
wael: anghywir, iawn, waeth, drwg, sâl
feed: bwyta, maeth, bwyd
canolog: canolfan, ffederal
cyferbynnu: cyferbyniol, gwrthwynebiad, gwrthdaro
strwythur: adeilad, strwythurol, sefydliad
taliad: talu
cyflymder: cyflymder
ymchwiliad: probe, cais, chwilio
lle-bynnag-y bo: lle
ddyledus: yn-euog, dyletswydd
trin: proses, rheoli, ymdopi, trin
taith: ymweliad, safari, sightsee, alldaith
saethu: ergyd, alltudiaeth, allyrru
cyflogaeth: yn-ddi-waith, pwyslais-mawr, gwaith
torri: torri
wrthsefyll: gwrthwynebiad
penderfynu: determiner, benderfynir, bendant, gosod, atgyweiria
masnachwr: ddeliwr, person-busnes, fasnach
bywiog: byw
awel: aer
perthynas: cefnder
a-thrwy-hynny: a-thrwy-hynny
darpariaeth: cyflwyno, a-ddarperir, lles, rhandir, gwarediad
ynghylch: am, sylw
ddewis: dewis, cymryd
adfeiliedig: dinistrio
cyflwyno: rhoi, cyflwyno
annisgwyl: syndod
desg: tabl, swyddfa
lôn: llinell, band
gynrychioli: cynrychiolydd, enghraifft
parchus: anrhydedd
cyfrifoldeb: dyletswydd, bai
siomedig: uchelgais, siomedig
addas: cyd-daro, priodol
yn-dibynnu: dibyniaeth, rhwymo
cawr: mawr, anghenfil
gafael: deall, atafaelu
cyrraedd: dod, cyflawni
symlrwydd: syml, gostyngeiddrwydd
hydref: syrthio
absennol: absenoldeb, i-ffwrdd
gwae: tywyll
sydd-dan-amheuaeth: dyfalu, amheuaeth, amheus
penderfyniad: benderfynir, penderfyniad, adroddiad, diffiniad
sail: sylfaen, termau
archwilio: arsylwi, gwiriwch, dadansoddiad
gwobr: Gwobr, premiwm
prynu: prynu
rhywun: person, unrhyw-un, er
sylweddoli: cyflawni, deall
trechu: guro, mwclis, methu
troseddol: gwaed
gwirion: ffwl, anwybodus
dwyn-i-gof: cofiwch
galwedigaeth: cyrch, proffesiwn, galwedigaethol, ymosodol
disgwrs: modern, sgwrs
cynorthwyo: helpu, cefnogaeth, cydweithredu
gwerthu: arwerthiant, gwerthu, disgownt
gwahoddiad: gwahodd, galwad
israddol: annigonol, i-lawr, waeth
cydnabod: cyfaddef, diagnosis
portread: llun
awgrymu: cynnig, Mae'n-debyg
siom: rhwystredigaeth, uchelgais, disgynneb, siomedig, cyfrif
adeiladu: adeilad
zeal: brwdfrydedd, diwydrwydd
cyfrifol: dyletswydd
gwella: therapi, gwella, gofal
cynnwys: Gan-gynnwys, fynd-i-mewn, cynhwysiant, deall, cynnwys
Bodloni: cwrdd, bodlon, cynnwys, fwynhau
agony: chwerw
dwp: crackpot, anwybodus, ffwl
mwynhad: mwynhau
cuddio: cuddio
yn-union: priodol, llawn
cymryd-yn-ganiataol: beg, Mae'n-debyg, sylw
amcangyfrif: asesiad, dyfalu
llwybr: ffordd
ymwelwyr: teithiwr, gwestai, arsylwr
nad-ydynt-yn: Ni
gwifren: llinell
yn-bennaf: yn-enwedig, i-raddau-helaeth
anymwybodol: llewygu
cilyddol: eich-gilydd, cyffredin
allanol: allan, tramor
bydysawd: cosmos, byd
cloc: awr
cyfarwyddyd: addysgu, cyfarwyddyd, llawlyfr
ddolurus: wlser, sâl, poen
disgyblaeth: pwnc
cyflwyniad: cyflwyno, a-ddarperir, dyrchafiad, primer, mewnforio
anialwch: anialwch
ddryslyd: nerfus, rhwystredigaeth
priodas: briod
rhan: cynrychiolydd, ochr, gras, rhan
cyfrif: yn-credu, cyfrifiad, cyfrif
ansicr: ansicrwydd, anwastad, amwys
ymgysylltu: cymryd-rhan, enwebiad
budr: allyriadau, gros
meddyg: meddyg
yn-cwmpasu: a-gwmpesir, cynhwysiant, to, lapio
diffuant: onest, wirioneddol, veridical
teimlad: teimlad
penodol: yn-enwedig, preifat, arbenigwr
tafarn: gwesty
stiff: caled
gyd-fynd: dilyn
sgôr: marc, adroddiad
virgin: merch
newyn: llwglyd
hoff: hoff
tollau: traddodiad, modfedd, dyletswydd, arfer
argraff: teimlad
ysglyfaeth: hela, loot, aberth
cerddorol: cerddoriaeth, cerddor
boddhaol: clefyd
chwerthinllyd: anwybodus, doniol
taflen: papur, dail, taflen
warth: cywilydd
yn-wreiddiol: gwreiddiol
cyflogau: talu
eang: eang, dwfn
hamdden: adloniant, gwag, ymddeol, ymlacio
ên: barf
glow: llacharedd, golau, ymbelydredd, fflach
cenfigen: genfigennus
rheilffordd: Railroad, trên
punt: llyfr
ddwyreiniol: ddwyrain
dinesydd: sifil
traeth: arfordir
nodwedd: elfen, nodweddiadol, eiddo
wrth-gefn: cadw, llyfr
ru: sŵn
rhyfedd: rhyfedd
rhisgl: cortecs, croen
derbynfa: croeso, derbynneb
braf: annymunol, math
deffro: effro
ymchwil: dadansoddiad, chwilio
teyrn: ymerawdwr, Brenin
dillad: ffabrig, gwisg, dillad
salwch: clefyd, sâl
chellwair: jôc, eironi, chwerthin
sylwadau: eglurwch
metel: haearn, mwynau
ateb: atgyweiria, penderfyniad, ateb
tybaco: sigarét, mwg
endid: offeryn, uned, presenoldeb, sefydliad, cwmni, person
gadael: ymadawiad, digress, crac, mynd
chwerw: chwerw
heddychlon: dawel
dychryn: bryderus
tric: recriwtio, gwadn, ffwl, trin, cyfrwys
ariannol: arian, economaidd
paratoi: paratoi
cragen: pod, cortecs, croen
nyth: byw, soced
beichiogi: beichiogi, deall, meddwl
penodiad: enwebiad, addewid
nôl: dod-â, adfer, cymryd
cannwyll: golau, cwyr
trosedd: ymosodiad, trosedd, màs
cymysgedd: cymysg
model: enghraifft
nam: bai, wrinkle, anabledd
gwrthwynebiad: anghytundeb, gwrthwynebiad, gwrthddywediad
crefft: celf, galwedigaethol, sgiliau
esgeulustod: anwybyddu, wedi'u-gadael, hepgoriad, boicot
data: gwybodaeth
arf: breichiau, gwn
pinc: rhosyn
defnyddiwr: am, buddiolwr
tad-cu: hynafiad, cu
null: sero, gwag
egnïol: treisgar
mellt: electronig, bollt, fflach
chwaraeon: symudiad, ymarfer-corff
powdr: blawd, llwch
peintio: llun, panel
gweiddi: sŵn, cyllell, crio
ddiofal: di-hid, difaterwch
deilliadol: deillio
drws: drws
cyfleus: syml, ymarferol, gyfforddus, yn-hawdd, priodol
bost: ôl--swyddfa, llythyr
paent: lliw
ildio: traddodiad
sefydlu: cyflwyno, sefydlu, atgyweiria
ysgafn: meddal, golau
yn-brydlon: unwaith, priodol
adran: rhan
haeddu: werth, yn-gymwys
rhoi'r-gorau-iddi: wedi'u-gadael, yn-dod-i'r amlwg, crac, bwrw
sicrwydd: sicrhau, mechnïaeth
drych: gwydr
plot: gynllwynio, cynllun, stori
i-fyny: mwy
yn-anffodus: drist, yn-anffodus
cymedrol: cyffredin, syml, gostyngeiddrwydd, gynnil
dysgl: llys, bwyd, bwyta
net: we, veridical, sanctaidd
cynhesrwydd: brwdfrydedd, cynnes
aflonydd: bryderus
arbrawf: peilot, profiad, ceisiwch
heddiw: diwrnod
aruthrol: ofnadwy, mawr, enfawr, iawn
gwella: diwygio, trwsio, cynnydd, adferiad, gwella
anghydfod: anghytundeb, ddadl
cynnig: cynnig, dedfryd
Efallai: efallai, gallai
reiffl: gwn
darian: gwarchod
cyflogi: rhent, defnydd
yn-wahanol-i: amrywiol
adennill: arbed, adfer, adferiad
ffrind: tafod, cydweithiwr, ffrind
trefnu: gorchymyn, ddeddfu, drefnu
bwyllgor: panel, comisiwn
oed: oed
ysbryd: enaid
datguddiad: mynegiant
cydnabyddiaeth: cyfaddef, cyffes
clai: mwd, man-geni
cefnffyrdd: llwyth, bagiau, lesewch
rheoli: rheoli, gyrru
adfer: cadw, yn-ôl, adferiad, adfer
protest: gwrthwynebiad, mawrth
pentwr: dymp, fantol, dorf
cymedrol: eilaidd, golygu
sillafu: swyn, sillafu
ardal: maes, rhanbarthol, wyneb
ffurfiol: swyddogol
golygydd: awdur, cyhoeddwr
cydnabod: cyffes, cyfaddef
rhwymedi: meddygaeth, therapi, atgyweiria
mynd-ar-drywydd: fwynhau, monitor, treulio, dilyn
polyn: n-chwith, colofn, eithafol, navel
hanfodol: angenrheidiol, bendant, allweddol
lywydd: pen
ward: adain, rhanbarthol, rhan
ms: 
hwyl: galon, brwdfrydedd
cyfiawnhau: rhesymegol, hawl, cyfiawnhau
edmygu: canmoliaeth
agored: benodol, agored, agor
addasu: newid, addasu
dramatig: drama, dangosol
i-fyny'r-grisiau: uchod, waeth
amrywiol: amrywiol
disgyniad: natur
eiddigedd: genfigennus
llwyth: pwysau, straen, bar, llwyth
esgus: feign, drama
mewnol: mewnol
llen: llen, sgrin
iach: iechyd
aneglur: amwys, Eclipse
canolfan: canolfan
gystadleuaeth: hil
newid: trosi, newid, cymryd-lle
cipolwg: Cipolwg, gweledigaeth
contract: memorandwm, gorchymyn, cynnal, cytundeb
gan-arbed: arbed, storio, economeg
llinyn: rhaff, cadwyn, set
cyfuniad: cyd-ddigwyddiad, cymysg, set, galwad
arestio: Caewch, beichiogi
tymheredd: cynnes
llym: llym, miniog, caled
proffesiynol: proffesiwn, galwedigaethol
hanafu: glwyfo, anaf
cymdogaeth: cyfagos, byw, amgylcheddol
ysmygu: mwg, sigarét
meddygol: meddyg
llywio: papur-newydd
amlwg: poblogaidd, cofiadwy, ganlyniadol, allweddol, dda---hysbys
sefydliad: drefnu, cwmni, sefydliad
pecyn: lapio, cau, pecynnu
anguish: chwerw, diflastod, poen, tristwch
yn-amlwg: yn-amlwg, agored, benodol
dal: swyno, cymryd, beichiogi
digon: digon, annigonol
ystafell-wely: ystafell
yn-unig: yn-unig, yn-gyfan-gwbl, sanctaidd
ar-y-cyd: cyffredin, cymysg, galwad
gyfeirio: cyfeiriadol, ymgynghori
nodi: hunaniaeth, adnabyddadwy, atgyweiria
fainc: banc
achub: adferiad, arbed
terfyn: rhwymo, talfyrru
disgwyliad: disgwyl
rhaglen: cynllun, agenda
trydan: electronig
cyfwng: dros-dro, egwyl
hela: hela
meddiannu: cymryd, atafaelu
gown: cot, gwisg, siwt
cloi: castell
cynnig: cynnig, dedfryd, cynllun, casgliad
hapus: hapus
dilynol: nesaf
anesmwyth: anwastad, annymunol, bryderus, caled
disgleirio: llacharedd, fflach
peiriannau: mecanyddol, peiriant, mecanwaith
deniadol: magnetig, tynnu, ddymunol
cynnyrch: nwyddau
salwch: clefyd
peiriant: modur, peiriant
nhw: maent
lledr: croen
cynnil: micro, tenau
llethr: filltir, dip, plygu
poeni: bryderus, pwyslais-mawr
dreisgar: caled
penodedig: benderfynir
pren: pren, ffon, coed
cyfrifo: cyfrifiad, cyfrif
lladd: lladd
ddoniol: rhyfedd, doniol
sarhad: ddirmyg, cywilydd
analluog: gallu
bwyta: bwyta
sensitif: dueddol, allweddol
archwaeth: dymuniad
cwrteisi: gwrtais, anrhydedd
sffêr: maes, pêl, rhanbarthol
anrhydeddus: anrhydedd
euogrwydd: yn-euog, trosedd, bai, pechod
blasus: blasus, blas
gwenith: llên-gwerin, grawn, corn
hiwmor: hiwmor
yn-dod-ar draws: ymdopi, cwrdd, dyddiad
gyda'r-hwyr: wawr
parc: gardd
economi: economaidd, economeg
llywodraethu: rheoli, rheol, meistr
ffurfiant: addysg, llunio
heb-lawer-o fraster: filltir, tenau
guro: petruso, pat, guro
undod: unedig, uned, undod
mawr: arloeswr, allweddol, rhiant, mawr, stwffwl
rhagarweiniol: agor, gwreiddiol
border: rhwymo, ymyl
anadlu: anadl
eithriedig: rhad-ac-am ddim, gwared, maddau
cyfoethog: gyfoethog
ysbrydoliaeth: impulse, ysbrydoli
pawb: i-gyd
doreithiog: gyfoethog
peintiwr: artist
sbectol: gwydr
saethu: ergyd, hela
wagen: trên, troli
rhoi-benthyg: rhoi, credyd, quote
ymgymryd-â: dechrau, gwneud
sêl: ffoniwch
clerigwyr: offeiriad
mount: instal, cynyddu, bryn
arae: colofn, set, gorchymyn
cylchgrawn: wasg
llym: caled, llym
er-gwaethaf: er
dynn: llym
tirwedd: senario, amgylcheddol, gweledigaeth
rhoi'r-gorau: wedi'u-gadael
artistig: celf
yn-bennaf: yn-enwedig, i-raddau-helaeth
ffyddlon: teyrngarwch, onest, ffyddlon
addas: gyfath, cyd-daro, priodol
cynghori: cyngor, ymgynghorydd
sefydlog: sefydlu, benderfynir, safonol
uchafswm: gwneud-y-mwyaf, eithafol
ymrwymo: addewid, gwneud
yn-effeithio-ar: effaith, greu-argraff
werin: ffermwr
yn-sylweddol: iawn, ganlyniadol
ymestyn: manylion, ehangu, darn
yn-bersonol: yn-unigol, preifat, hun
moesoldeb: moesol
gwrthryfel: rebel, chwyldro
edau: llinell, sbin
copr: pres
ymateb: adwaith, ateb
imperial: brenhinol
wag: gwag, pant, gwyn
mân: eilaidd, ychydig, glöwr
fargen: fasnach, achlysur
blinder: wedi-blino, straen
ddim-yn-ei hoffi: ddirmyg, casineb, amharodrwydd
normal: cyffredin
braslun: amlinelliad, cynllun
rhinweddol: rhinwedd
beth-bynnag: serch-hynny, eisoes
gyrrwr: modurwr, gyrru, arweinydd
datganiad: ad
dros-ben: ychwanegol, diswyddo
gwahanu: datgysylltiad, pellter, gwahanu
ffieiddio: ddirmyg, ffobia, casineb
yn-gywir: un-fath, priodol
mob: dorf, màs
diangen: gwastraff, rhaid-i
ffwr: croen, cot
annog: ysbrydoli, gwthio
deyrnged: rhent
lleddfu: lleihau, gwared, maddau
deddfwriaeth: ddeddfu, rheol, deddfwrfa
prosiect: cynllun
tylwyth-teg: angel, glas, fila
casgliad: cynnal, casgliad
lwcus: hapus
lap: pen-glin, ffedog, rownd
difetha: loot, adfail, sophisticate
atebol: yn-hawdd, yn-tueddu, dueddol
meddylgar: gofalus, bryderus, ddoeth
ffafriol: gyfath, flex, ddymunol
tun: banc
dibynnol: dibyniaeth, ynghlwm, cyflogai
gwarant: sicrhau, cyfiawnhau, memorandwm
gwyn: gwyn
confensiwn: memorandwm, cytundeb
ongl: cornel, polygon
eang: eang, iawn, Yn-gyffredinol,, i-raddau-helaeth
buwch: gwartheg
rhagfarn: casineb
porth: neuadd, balconi
syndod: rhyfedd, amaze, syndod, trawiadol
ffynnon: ffynhonnell
briodol: priodol, siwt, cyson
hyderus: dewrder, yn-ddiogel, yn-credu
organ: offeryn, aelod, elfen, corff
detholiad: dewis, enwebiad, etholiad
parchedig-ofn: ffobia, ofn
cymharu: cymhariaeth
berthnasol: Caewch, bachyn, cysylltiadau, cysylltiedig
dybio: yn-credu, dyfalu, Mae'n-debyg, sylw
ar-goll: gollwyd
ffasiynol: modern, cain
yn-gadarnhaol: cadarnhaol
rhesymu: syniad, ddadl
tarfu: nerfus, ymosodol, ymyrryd, blino
partner: gariad, cyffredin, cyfranddaliwr
cymdeithas: cyd, sylw
nith: nai, wyres
corfforol: ffisiolegol, corff
cyfadran: coleg, ffactoraidd
canon: pêl, magnelau, gwn
hwylio: llong, llen
smart: ddoeth
mân: ffoniwch, ddibwys, ychydig
rhybudd: rhybudd, gofal
llawysgrif: bil
rhyfelwr: arwr
hylif: dŵr
cysyniad: beichiogi, connotation
arbennig: yn-enwedig
neidio: hedfan, dawns, sawdl, bownsio
amharod: yn-bwriadu
ychwanegol: ychwanegol
traw: palmant, tôn, Ni
lletchwith: annigonol, rhyfedd
gwerthfawrogi: yn-cymeradwyo, mwynhau
goroesi: byw, aros
yn-fyr: acronym, byr
reis: pres
guy: person
ymddygiad: nodweddiadol, ymddygiad
mabwysiadu: Mae'n-debyg, cymryd
yn-rheolaidd: yn-aml, dro-ar-ôl tro, parhaol, priodol
ymchwiliad: probe, chwilio
cyfansoddiadol: cyfansoddiad
diweddaraf: diwethaf
disgybl: myfyriwr
gwbl: yn-gyfan-gwbl
dirdroi: plygu
yn-wahanol: gwahanu, gwahaniaeth, amrywiol
trychineb: adfail
bet: fantol, cyflwr, feto
amrwd: byw, ffynhonnell, gros, gwyrdd
log: fynd-i-mewn, cofrestru, clwb
lletygarwch: hael
cert: trên, troli
gwisg: gwisg
ymgysylltu: ynghlwm, defnydd, rhent, cadw
fuches: ddiadell
casglu: casglu
padell: pot
ymosodiad: ymosodiad, cyrch
twyllo: ffwl, bradychu
alaru: tristwch
tynnu'n-ôl: gwared, tynnu, ymddeol
dôn: cân, cytgord
tosturi: empathi, biti
guddio: cuddio
trawsgrifio: copi
dogfen: ffeil
cymydog: cyfagos
bloc: atal, cyfaint
rhwymedigaeth: dyletswydd
dirywiad: gwadu, syrthio
uchelgeisiol: uchelgais
gwyliau: ystod-y-gwyliau, gwledd
dwrn: yn-gyntaf
eryr: hebog, tei
anrhydeddus: anrhydedd
arwyddocaol: angenrheidiol, ganlyniadol, trawiadol
trwchus: compact, trwchus
ffuglen: nofel, dychymyg, stori
argymell: cynnig, cyflwyno, cyngor
addysgol: addysg
i-fyny: mwy, uchod
corn: corn
cronfa: blwch, cyfalaf
porthdy: cwt, ffeil, caban
gwisgoedd: gwisg, siwt, arfer
pris: rhent, mynd, map
cymeradwyaeth: yn-cymeradwyo, cymeradwyaeth
atgoffa: cofiwch, yn-debyg
gobennydd: afon
unman: fan-a'r-lle
corff: corff
hanfod: cell, creadur
drychiad: serth
deyrnas: maes, byd
grisiau: grisiau, graddfa
cyd-fynd: memorandwm, compact, siwt, cyd-daro, cytundeb
les: spike, incwm
ysgolhaig: myfyriwr, gwyddonydd
pren-mesur: dug, llywodraethwr
crazy: crackpot, ffwl
diddanu: croeso, difyrru, adloniant
cyfarch: croeso, cerdyn-post
feminine: benywaidd
gwrthun: anghenfil, ofnadwy
gyfleuster: offer
rob: dwyn, loot
ysgol: grisiau, arweinydd, graddfa, ysgol
yn-dod-i ben: diwethaf
rhaniad: gwahaniaeth, dosbarthu
anhygoel: rhyfedd, anarferol
bwa: bwa
ethol: etholiad, dewis
swil: swildod, cywilydd
niwl: niwl
lliw: lliw
rhybuddio: rhybudd, cymell
bas: dwfn
anogaeth: ysgogiad, cysur
afreolaidd: cyffredin, anarferol
ffyddlon: teyrngarwch, ffyddlon, priodol
trosglwyddo: cyfieithu
sylfaenol: sylfaen, stwffwl
bwndel: cau, ffibr
trasig: ofnadwy
adolygiad: adolygu, beirniadaeth
ofnadwy: ofnadwy, iawn, waeth
coginio: cogydd, cegin
gwrthryfel: rebel, chwyldro
gwella: atgyweiria, gwella
llongddrylliad: dinistrio
argyhoeddi: perswadio, sicrhau
powlen: cwpan
darlunio: enghraifft, llun
nerf: gwythïen, dewrder, nerfus
syllu: atgyweiria
canfod: yn-gwybod, sicrhau, benderfynir, gwiriwch, atgyweiria
addewid: sicrhau, addewid, gwystl, mechnïaeth, gwystlo
ennill: gweini
dewiswch: dewis
diwydiannol: ddiwydiannu, diwydiant
dehongli: cyfieithu
her: galwad
gwahardd: atal, gwadu
thema: motiff, pwnc
derbyn: derbynneb
pwll: pwll-Nofio, pwll
cynhadledd: sesiwn, cynulliad
cydraddoldeb: cyfatebiaeth, cydbwysedd, cywerthedd, hafaliad
sydd-newydd: neo, Yn-ddiweddar,, nofel
amgylchoedd: amgylcheddol, cyfagos
goresgyniad: ymosodiad, cyrch
patrwm: enghraifft, unwaith, safonol, ffurflen
datgelu: datgelu, bradychu
datrys: rhydd, atgyweiria
pregethu: bregeth
nain: briodferch, cu
gwlân: cotwm
cyfathrebu: deialog, cymdeithasu, cysylltiadau
yn-y-bôn: termau
yn-gwrthwynebu: gwrthwynebiad
sbesimen: enghraifft
llusgo: tynnu, siswrn
cnwd: cnydau, cynhaeaf, torri
gywir: priodol, blawd, gofalus
cyrchfan: cymryd, lloches, egwyl
gwrthod: gwadu, gwastraff
bond: allweddol, mechnïaeth, copula
gydymdeimladol: biti
cyflog: talu
parhaus: parhau
cyffroi: cymell, ysgogi
wyllt: gwyllt, treisgar
tristwch: tristwch, drasiedi
cysylltiedig: unedig, cysylltiedig
nenfwd: blanced, to
nod: ffocws, pwrpas
arian-parod: arian
gwag: agored, rhad-ac-am ddim, gwag, rhydd, amwys
dirmygu: ddirmyg
lawnt: glaswellt, dôl
twrci: 
cymydog: cyfagos
yn-y-pen draw: diwethaf, eithafol, yn-olaf, stwffwl
cyflwyniad: ufuddhau, anfon
mynediad: fynd-i-mewn
drylwyr: dwfn, llawn
cyffrous: tynnu, chwilfrydig
ennill: llwyddiant
ceidwadol: uniongred, llywodraethwr
brwdfrydig: brwdfrydedd, bryderus
i-lawr-y grisiau: i-lawr
berwi: cogydd, wlser
hardd: harddwch, hardd
yfory: ddoe
anghyfforddus: bryderus, annymunol
cyfarpar: offer
mynnu: mynnu
ymadrodd: ynganu, mynegiant
rheilffyrdd: Railroad, trên
amherffaith: llawn, anabledd, ddiffygiol
caffael: caffael, deillio, prynu
sarhaus: cyrch, ymosodiad, ymosodol
coldly: oer
darlith: cwrs
lle: lle
canfyddiad: teimlad, Cipolwg, beichiogi
datblygu: ymhelaethu
swyddogaeth: seremoni, gwaith, gweithgaredd
bullet: tabled, ergyd, pêl
rhwymo: Caewch, rhwymo
union-yr-un fath: un-fath
sylweddol: dangosol, mawr, ganlyniadol, trawiadol
swmp: màs, maint, cyfaint, tiwmor
hir: hir, Linger
flin: llidiog, annymunol
cynhyrfu: nerfus, drist
criw: copula, band
gwair: glaswellt, gwellt
dadl: anghytundeb, ddadl
llonyddwch: tawelwch
rhannol: eithriad, rhan
cig-eidion: cig
uno: undod, harnais, cysoni, ymuno
llafn: dail, cleddyf, cyllell
ffatri: felin
null: sero, gwag
cyfnodolyn: papur-newydd, wasg
yn-onest: teyrngarwch, onest
cyfreithlon: cyfreithiol
acen: ynganu, pwyslais, ffocws
ddiffuant: o-ddifrif
cynghrair: cynghrair
cymeradwyo: cymeradwyaeth
aelod: aelod, eithafol
stiward: rheolwr, gwas
esblygiad: diwygio, esblygiadol
arolwg: gwiriwch, chwilio
cyfoes: modern
sgandal: llygredd
bwriadol: yn-fwriadol
symbol: nodiant, ystum
golchi: golchi, golchi-dillad
manwl-gywir: priodol, blawd, gofalus
digwyddiad: digwyddiad, achlysur
siafft: ffos, ysgwydd, coed
coesyn: sych, llwyth, gwraidd
gorfforaeth: cwmni, sefydliad
dewis: braint, Mae'n-well, mantais, dewis
annog: cymell, impulse, dymuniad
cael-gwared: pellter
honiad: cymeradwyaeth, pwyslais
hygyrch: ymweliad, dod-o-hyd
comedi: hiwmor
fflysio: lliw, cyffro
cod: iard, amgodio
digonol: digon, priodol
rhaniad: dosbarthu
hanesydd: hanesyddol
dwysedd: dwysedd, straen
democratiaeth: gweriniaeth
credo: cyffes
atyniad: swyn, disgyrchiant
cyngerdd: wyl
ar-i-lawr: i-lawr
camlas: sianel, pibell
prydlon: yn-fuan, cais, ystwyth
efydd: pres, brown
dilledyn: dillad
edifeirwch: drist, biti
exclusive: monopoli, preifat
porthor: gwisgo, cludwr
dash: llinell
stribed: band
yn-y-pen draw: yn-olaf
tîm: corws
ddrud: annwyl
pencadlys: pencadlys, canolfan
acíwt: miniog
embaras: nerfus, cywilydd
epil: plant
rhwydwaith: we
awyren: aderyn, wyneb, peiriant
yn-rhannol: rhan
yn-falch: balchder
teras: balconi, to
gafael: cynnal, trap
chwyth: byrstio
milwyr: y-fyddin, milwrol
dynn: llym
cosb: biti, dedfryd
baw: llaith, feces, mwd
cyfnod: tymor
llysgennad: negesydd
bridio: lluoswch, hil
ymyrraeth: ymyrryd, annifyrrwch, anhrefn
cynnwys: pasio, cynnwys
derbyn: derbyniol, cymeradwyaeth, derbynneb
peiriannydd: mecanyddol
arosfa: droed
amgen: yn-ail, cymryd-lle
stamp: ffoniwch
cownter: disg, gwrthwynebiad, gyferbyn
gwener: Dydd-Gwener
dychmygol: dychymyg
dringo: yn-codi, ymgripiad
denu: tynnu, greu-argraff
rhyfeddol: syndod, trawiadol
cystadleuaeth: wrthwynebydd
grisial: gwydr
cawod: bath, glaw
athronyddol: athronydd, athroniaeth
swnllyd: sŵn
dyfais: offer
cludiant: traffig, gwennol
yn-y-pen draw: yn-olaf
ofnadwy: iawn, ofnadwy
myfyrdod: adlewyrchu, myfyrio
gweithgynhyrchu: diwydiant, cynhyrchu
gyfforddus: gyfforddus
arddangosfa: arddangosyn, adroddiad
amaethyddol: amaethyddiaeth, fferm
hymgais: chwilio
estyniad: manylion, ehangu
ddadlau: gwrthddywediad, ddadl
yn-fras: bron
uwchben: uchod
atal: ataliad, atal, ataliaeth, cadw
cadwraeth: arbed, gofal, cadw
tafarn: bar
basn: cwm, pwll-Nofio, sinc
alaw: tôn
llogi: rhent
poeni: bryderus, nerfus
henoed: hen---oed, oed
prifysgol: coleg
ofalus: gofalus
ymlaen-llaw: ddwyrain, cyn
cymhleth: cymhleth, caled, ymhelaethu
ymddiheuriad: yn-ymddiheuro, n-chwith
ofnus: ofnus, ofn
rhodder: yn-ail, lwfans, cymryd-lle
defnydd: defnydd
adfer: trwsio, adferiad, adfer
gwrych: ffens
cynradd: meistr, sylfaen, gwreiddiol, stwffwl
trawst: ray
taith: ymweliad, alldaith
gorliwio: halen
gymwys: galluogi, gallu
brys: yn-fuan, gwaddod
effro: rhybudd, larwm, effro
popty: stôf
crwn: rownd
confensiynol: cyffredin
pledio'n: beg, cyfiawnhau
llinyn: rhaff
ochr-yn-ochr â: cyfochrog, nesaf, cyd
dyfyniad: quote, sudd
ysgafnach: golau
peint: cwrw
tiwb: pibell
avenue: achlysur
effeithlon: medrus, effeithiol, effaith
cymysgu: cymysg, gynnwrf
aflonyddwch: anhrefn, annifyrrwch
gweithredol: rheolwr
degfed: deg
cymharol: cymhariaeth
a.m.: bore, sgleiniog
cawell: castell, cell
carchar: carchar, cadwyn
medrus: medrus, cyfrwys, gallu
sgrechian: crio
cyfaddawd: cytundeb, cytgord
bwledi: ergyd
cynorthwy-ydd: cefnogwr, helpu
gansen: ffon
dadlau: trafod, mynnu
rhesymeg: ddadl, rhesymegol, rhesymoledd
panig: ofn
cylchrediad: beicio, cylch, traffig, sightsee
straen: straen
bwyta: defnydd, defnyddio, bwyta
cynnal: cefnogaeth, cadw, cynnal, yn-dioddef
damwain: syrthio, gwrthdaro
ddiffygiol: annigonol, torri, ddiffygiol
graddol: yn-raddol
malwch: dinistrio, disgyrchiant, sboncen
ffenomen: digwyddiad, beth
gweithredu: rhedeg, gweithredu
cyfarch: iechyd, croeso, cenllysg
frenhiniaeth: brenhinol, eiddo
yn-ymddwyn: byw
rhwystr: rhwystr, trothwy
gromlin: bwa
yn-dibynnu: cyfrif
cyfleustra: yn-hawdd, cysur
cig-oen: defaid, ymgripiad
rhesymegol: rhesymegol
diet: bwyd
barnwrol: llys, cyfreithiol
diffyg-ymddiriedaeth: amheuaeth, teyrngarwch
bluen: gwanwyn, biti
gwirfoddol: gwirfoddolwr
siaced: cot, siwmper
nofio: nofio
trawiadol: trawiadol
oddi-tano: i-lawr, ar-ôl
taleithiol: gwledig, talaith
iawndal: wneud-iawn, lwfans
gweinydd: gwas
hyrwyddo: cyflymiad, dyrchafiad, maeth, gwthio, cyfrannu
neilltuo: yn-bwriadu
gelyniaeth: gelyniaethus
planhigfa: fferm, meithrinfa
agored: amlinelliad, datgelu, agored
chlytia: fan-a'r-lle, atodiad
ymyrraeth: egwyl, annifyrrwch
bawd: modfedd
chwyldroadol: chwyldro
anhygoel: rhyfedd, amaze
tip: hemisffer, spike, eithafol, barf, copa, cyngor
bygythiad: bygythiol, perygl
jyngl: coedwig
nodweddiadol: cyffredin, nodweddiadol
tanwydd: olew
tawel: dawel
cyrchfan: ailadrodd, pwrpas, tynged
pin: gyfrinach, nodwydd
mars: mawrth
cysylltiol: cysylltiedig, cydweithiwr, cyd, cyffredin, cyfochrog, ynghlwm
dieflig: anfoesol, drwg
wledd: gwledd
manwl: ymhelaethu, dwfn, colfach, manylion, gofalus
closet: cabinet
deddfwriaethol: ddeddfu, deddfwrfa
ymyl: ymyl, maes
pencampwr: arwr
pwls: impulse
ffoi: rhedeg, dianc
cymal: nant, paragraff
cyfansoddyn: cyd, cymhleth
cwlwm: cynnal, wau
perthynas: cysylltiadau, adroddiad, sylw
asiantaethol: sefydliad, cwmni, swyddfa
grin: gwenu, grimace
arddangosiad: sioe, mawrth
iselder: tristwch
gerbyd: peiriant
benthyg: credyd, quote
chwyddo: chwyddo
pwnc: motiff, pwnc, pennawd
rheithfarn: penderfyniad, rheol
Saboth: Dydd-Sadwrn
adnabod: adnabyddadwy, hunaniaeth, diffiniad
llun: llun, ergyd
gynghreiriad: ffrind, cyfeillgarwch, unedig
llwybr: ffordd, darn, ddadl
rhuban: band, ffilm
yn-ogystal: mwy
tryloyw: tryloywder, yn-amlwg
persawr: arogl
trafferthu: trafferth, ymyrryd, blino, annifyrrwch
cymwysedig: gallu, yn-gymwys, medrus
traethawd: erthygl, adroddiad
reidiwr: marchog, marchogaeth
unigrwydd: unig
arddwrn: llaw
fân: meddal, tenau, yn-olaf
null: sero, gwag
condemnio: dedfryd
ên: pinwydd
unigryw: unedig
yn-anochel: anochel
drwm: dawns, gwag
bin: blwch, basged
hyd: dros-dro, parhaol, amser, hyd
pwyso: mesur, pwysau
mynachlog: abaty
cyhoeddi: cyhoeddi, dosbarthu, datgelu
mewnwelediad: gweledigaeth
yn-bendant: yn-amlwg, llym, cwrs, wirioneddol, benodol
sifft: newid
heno: diwrnod
ffactor: rheswm, cyflogai, cyfernod
llanast: ymosodol, anhrefn, dryswch
ymarfer: ymarfer-corff, gweithredu
cysegr: allor
crebachu: acronym, casglu
gwariant: traul, defnydd, treulio
calonogol: galon, ysbrydoli
amlygiad: mynegiant, arddangosyn, adroddiad, effaith
crai: gros, gwyrdd
tocyn: banner, map
yn-ôl: yn-ôl
esgid: esgidiau, lesewch
twyll: rhith
ffrwydrad: byrstio
lle-tân: simnai
jar: gwydr, potel, piser, pot
saws: dresin
pwdr: ddiog, anfoesol, gwael
ymddygiad: nodweddiadol, ymddygiad
benthyciad: credyd, quote
afresymol: rhesymegol, lol
chwant: uchelgais
yn-flynyddol: blwyddyn
hylif: dŵr
fyn: plant
wallgof: crackpot, ffwl
dymchweliad: arllwys
cyflawniad: llwyddiant, rheng, manteisio
rhagdybiaeth: Mae'n-debyg, dychymyg, sôn,
doniol: hiwmor, doniol
ecstasi: brwdfrydedd
ymddeol: ymddeol, ymddiswyddiad, pensiwn
senedd: deddfwrfa, senedd
argyfwng: bryderus, argyfwng
parsel: lapio, rhan, cau
drôr: blwch, grisiau
cyfraniad: cyfrannu, fantol
cyswllt: atodiad
pluo'n: dewrder, extort
argraffu: cyhoeddi, print, wasg
eiriolwr: cyfreithiwr, cyfiawnhau, diffynnydd
amgylchedd: awyrgylch, amgylcheddol
cadarnhau: profi, sicrhau, atgyfnerthu
cyhoeddi: datgelu, cyhoeddi
ymddiswyddo: ymddiswyddiad, ymddeol
gwrthod: gwadu, feto
anodd: caled, creulon
darn: sglodion, damaid, sgrap, darn
myfyrdod: gofal, adlewyrchu
staen: fan-a'r-lle
claddu: angladd, claddu
ddamcaniaeth: Mae'n-debyg
damcaniaethol-hwyliau: hapfasnachol-hwyliau, assumptive-hwyliau, amodol-hwyliau
trafodiad: gweithgaredd, fasnach
dicter: dicter, ddirmyg, cywilydd
yn-amrywio: newidyn, amrywiol, cymryd-lle
atwrnai: cyfreithiwr, cynrychiolydd
troseddu: yn-euog
paced: lapio, poced, cau
clasurol: clasurol
ranch: fferm
pei: cacen, pi
yn-gywir: hawl, cywirdeb, llym
fling: bwrw
morol: nefi, môr
canwr: darllenydd
trydan: electronig, nant
estron: tramor, gwestai, allfydol
cracio: byrstio, crac
isel-eu-hysbryd: drist, tristwch
drwchus: trwchus
rhesymol: rheswm, rhesymegol
cebl: pant, flex
dangos: eglurwch, adlewyrchu
mabwysiadu: cymeradwyaeth, derbynneb
drwg-enwog: dda---hysbys
anafu: anaf
yn-gywir: cywirdeb, priodol, hawl
tir-pori: helyg, dôl
mwydyn: mwgwd, dwfn
amcangyfrif: asesiad, dyfalu
gwisg: sefydliad, dillad, offer, gwisg
anlwcus: anhapus, yn-anffodus
wythfed: wyth
hamddenol: cysur, ymlacio, dawel
cyfagos: bron, cyfagos
uwch: cyn-filwr, rhiant, pen
dychryn: larwm
tiwtor: hyfforddwr
lladrad: loot, dwyn
masnachu: fasnach, masnachol
diflannu: diflannu
lwmp: màs, Torus, tolc
damweiniol: ar-hap, dros-dro, cyd-ddigwyddiad, syndod
safleoedd: tŷ, fan-a'r-lle, adeilad, dan-do
cyflwyno: cyflwyno
crwm: plygu, flex
cynhyrchiol: manufacturer, cynhyrchu
wedi-chwyddo: chwyddo
meithrin: maeth, fferm
amrywiad: newid, gwahaniaeth
gwrthwynebydd: wrthwynebydd, gwrthwynebiad
ŵyr: wyres, nai
ewinedd: hoelion, spike, bollt
haelioni: hael, lles, rhinwedd, gras
trachywiredd: cywirdeb
arwydd: marc
gostyngiad: lleihau, torri
bol: stumog, navel
ffieiddio: casineb
cyfansoddi: ysgrifennu, creu
teithwyr: teithiwr
Sting: stab, chwerw, brathu
ar-yr-un pryd: yn-y-cyfamser
bennod: ganlyniadol, rhan
parhaus: cyson, parhau, parhaol
llwgu: llwglyd
ymgynghori: ymgynghori, cyngor
sur: asid
tanlinellu: mynnu, pwyslais
gorymdaith: mawrth
helmed: het
cyhoeddi: propaganda, cyhoeddi
llety: gwesty
chwistrellu: meddygaeth
yn-ffurfiol: swyddogol
tarfu: nerfus, ymyrryd, bryderus, blino
ragweld: Disgwylir, disgwyl
gradd: bont, cyfernod, rheng, asesiad, gradd
stôl: feces, cadeirydd
cyfiawnhad: cyfiawnhau
estron: tramor, gwestai
cludiant: traffig, gwennol
deall: deall
cyfarwyddwr: rheolwr, pen
tymhorol: dros-dro, amser
'n-glws: hardd
gorfodi: gosod, gorfodi, galluogi, heddlu
cynhwysfawr: dwfn, llawn
bygwth: bygythiol
blaengar: cynnydd, radical
adnodd: ffynhonnell
cyfyngu: cyfyngedig, atafaelu, talfyrru, lleihau
longyfarch: canmoliaeth
yswiriant: yn-ddiogel
penodi: llygad
torri-ar-draws: rhwystr, torri, ymyrryd, trychu, egwyl
atal: orthrymu, atal
haen: colofn
cliw: tystiolaeth, allweddol
dant: dannedd, deintydd, tolc
gwarant: sicrhau, mechnïaeth
gweithdrefn: proses, mecanwaith, gweithredu, ymagwedd
argymhelliad: cyngor
bwlch: egwyl, agor
awgrymu: golygu
atodi: ynghlwm, sbleis, Caewch
osgo: ystum, dangosydd, sefyllfa, sefyll
suite: adain, set, fflat
em: trysor, ffynnu
emosiynol: teimlad, angerddol, dueddol
concrid: dangosol, cyson
cyfuno: cynghrair, cyd
brig: copa
arian-cyfred: arian, darn-arian
amcan: pwrpas, ffocws
cofeb: cof, rhybudd
ar-wahân: gwahanu, gwahaniaeth, yn-unigol, unig
hambwrdd: disg
llorweddol: cydbwysedd
siarter: cyfansoddiad, papur, rhent
eitem: nwyddau, erthygl, elfen, llais, math, sefyllfa
ehangu: manylion, ehangu
Twist: bollt, sbin, eironi
traddodiadol: traddodiad, clasurol
cynnwys: Gan-gynnwys, cynhwysiant, cynnwys
arferol: cyffredin, mecanwaith
datrys: aradr, rhydd, atgyweiria
temtio: hudo, cymell
aflwyddiannus: methu
gwleidydd: gwleidyddol
caead: to
groes: anaf
cyffordd: trefnol, groesfan
bos: perchennog, rheolwr, cyflogwr, pen, lleidr
caledwedd: offer
llinyn: arfordir, band
fin: ymyl, clogwyn, gwefus
nwyddau: fasnach, nwyddau
oeraidd: gwahanu, i-ffwrdd, bell
lloches: ysbyty, lloches
cadarnhau: profi, sicrhau
amserlen: tabl, calendr, siart, gwarediad
ffos: ffos
bwrdeistrefol: dinas
terfysg: gynnwrf
tystio: profi
mamau: feichiog, mom
cerflunwaith: cerflun
blas: blas
brand: llawlyfr, marc
bagiau: bagiau
sbwriel: lol, sgrap, dymp
teclyn: offeryn
chaos: anhrefn, dryswch
erlyniad: siwt
amser: nerfus, amser
iâr: cyw-iâr
trim: addurn, lleihau, torri
synhwyrol: ddoeth
galaru: crio
tafodiaith: sglein
elfennol: sylfaen
cludo-nwyddau: bagiau, bar, lori
wipe: ysgubo
gwadu: gwadu
o-dan-y ddaear: gyfrinach
canolradd: gwiriwch
fformiwla: hafaliad, wasg
twyllo: ffwl, trin
haunt: petruso, ffobia
gofrestru: rhestr, cofrestru
amhenodol: amwys, aorist
gwarged: ychwanegol
ias: crynu
meinwe: sefydliad, we, ffabrig
drafft: amlinelliad
tegan: ddol, chwarae, gamblo
grisiau: grisiau, graddfa
pontio: haint, newid, transitive, groesfan
botwm: allweddol
angharedig: anghwrtais
rhaglen: cynllun, agenda
gweithgynhyrchu: ddiwydiannu, felin, cynhyrchu
parth: maes, rhanbarthol, band
nawfed: naw
alcohol: gwin
barus: uchelgais, trachwant
llywio: rheoli
ddylanwadol: effeithiol, treiddio
amgylchynu: coler, gwarchae
boddi: sinc, cornel
sleid: slip
hwch: yn-codi, bara, mochyn
dominyddol: mawr, cyrch
arweinyddiaeth: hierarchaeth, llawlyfr
dyddiadur: papur-newydd, calendr
dathlu: perswadio
ffwdan: cyffro, sŵn, blino, dryswch
dirprwy: cynrychiolydd, yn-ail
Automobile: modur
diwygiad: adolygu, newid
fertigol: sefyll, hydredol
annigonol: annigonol, digon
damn: tenau
casgliad: dyfalu, casgliad
casgliadol-hwyliau: anwythol-hwyliau
hysbyseb: ad, masnachol, propaganda
lladrad: dwyn, plagiarize
digymell: greddf, mympwyol
cyfleustodau: sefydliad, defnydd, offeryn
cysylltu: Caewch, bachyn, sbleis, ymuno
tuag-i-lawr: i-lawr
ymyrraeth: ymyrryd
adfywiad: adfywio, adferiad
rhyngrwyd: fasnach
yn-gorfforol: ffiseg, corff
dot: fan-a'r-lle
syfrdanol: sioc
rudely: anghwrtais
cytbwys: cyson
mynegai: ddehonglwr, rhestr, dangosydd
trosglwyddo: anfon, dosbarthu
ymlaen: uchod, allan, ymlaen
sgwrsio: sgwrs, ystadegau
ambr: melyn
tunnell: tôn
yn-esmwyth: gyfforddus
tensiwn: straen, cyffro
morfil: etholiad
gwenwynig: gwenwyn
consesiwn: Budge, braint, disgownt
gweithiwr: cyflogai
inclein: dip, cyfun
toiled: cabinet
trosedd: ymosodiad, trosedd
dig: casineb, dial
gwroldeb: amynedd, dewrder
rhagweld: gobeithio, disgwyl
rhythm: guro
llygoden-fawr: llygoden
cyfateb: gohebiaeth, siwt, priodol, ateb
cadw: atal, atafaelu, cadw
dehongli: eglurwch
salon: neuadd
gweithredu: trin, gwaith, rhedeg, gweithredu
draen: gwter, rhedeg
cyflog: talu
cas: casineb, drwg, annymunol, siomedig, hyll
fynwent: angladd
plastr: sialc
tap: pibell, llaeth
diswyddo: sach, anwybyddu, gwadu, feto, gwahaniaethu, diswyddo, maddau
pryfocio: cyffro, llidiog
byw: aros, byw
addurno: addurn
traed: flaenau-eich-traed, droed, bys, paw
anallu: anabledd, gwendid
dyfeisio: ddyfais
ddiffinio: determiner, ymhelaethu, disgrifiwch
cyfyngedig: cyfyngedig, rhwymo
cwpwrdd: cabinet, silff
rac: silff
uwch-arolygydd: arweinydd, arolygydd
cyflwyniad: cyflwyno, sioe, arddangosyn, dyrchafiad
rwber: pêl, elastig
cau-allan: amddifadu, dileu, gwahaniaethu
breintiedig: braint
feudwy: asgetig
crafu: crafu, dechrau
sgriw: bollt
archwilio: arsylwi, manteisio
yswirio: sicrhau
silindr: disg
crynodeb: amlinelliad, haniaethol
annhebygol: tebygolrwydd
haid: ddiadell, mab
systematig: mecanwaith
bron: wirioneddol, bron, ymarferol
cleient: arfer, gwestai
catalog: rhestr, tabl
cemeg: cemegol
pobi: bara, cogydd
pierce: stab, treiddio, turio, dyllu'r
snatch: rwygo, atafaelu, herwgipio
lansio: allyrru, bwrw
ffermio: amaethyddiaeth
actores: actor
theatr: theatr, neuadd
cyffuriau: meddygaeth
anffafriol: waeth, anfantais, cefn, negyddol, niweidiol
Candy: mintys, siocled, melys
past: set, mwclis
euogfarnu: trap, cosbi, yn-euog
ymchwilio: probe, arsylwi, gwiriwch
pecyn: lapio, set, cau
cropian: ymgripiad, cower
snap: pop, cliciwch, llun, llanw, yn-fuan
teiars: embryo, ffoniwch
amlwg: trawiadol, yn-amlwg
craidd: sylfaen
rhagflaenydd: hynafiad
yn-yr-un modd: yn-yr-un modd, un-fath
argae: llwch
llithrig: slip
trawsnewid: newid
ymylol: ymyl
lleoliad: sefyllfa, fan-a'r-lle
clwstwr: conglomerate, màs, band
dyfyniad: quote
y-ddalfa: diwydrwydd, gofal
credadwy: derbyniol
toss: bwrw
gris: gwadn
crynodiad: cronni, ffocws
'n-hylaw: ymarferol, gyfforddus
abwyd: blas, primer
amrywiol: amrywiol
tafell: sglodion, disg, damaid
dril: turio, gloddfa
ymateb: adwaith, ad-daliad, ateb
marwolaethau: marwolaeth
chwyn: glaswellt
gymharol: cyfaint
mathemategol: mathemateg, athletaidd
foesol: moesol
gasp: sigh, anadl
rasio: hil
unigedd: datgysylltiad, gwahanu
rywbryd: weithiau
oedolion: aeddfed
caledi: chwerw, diflastod, trafferth, annifyrrwch
si: clecs, llais
wrthsefyll: cadw, arth, diwethaf
iau: ifanc
gwau: wau
anuniongyrchol: yn-uniongyrchol
cynsail: enghraifft
eil: ray, neuadd, groesfan
gwrth-ddweud: gwrthddywediad, gwadu
wneud-iawn: arbed, wneud-iawn
llwybr: ffordd, crosswalk
gêr: offer, dannedd, asen, rhedeg
dathliad: gwledd
glyd: cynnes, gyfforddus
cyhoeddi: cyhoeddi, dosbarthu
cwsmer: gwestai, prynwr
ryg: carped, llawr, blanced
partition: cyfrif
outlook: Cipolwg, gweledigaeth
esthetig: harddwch
digio: casineb
peri: cynnig, cymell, sefyll
bodlonrwydd: bodlon
organeb: creadur
annealladwy: deall
pwysleisiol: pwyslais
canol-dydd: prynhawn, de
lili: darllen
enw: nominaleiddiad, enw
plygu: blygu, plygu
ddefnyddiol: helpu
parhau: mynnu, parhau, diwethaf
allfa: allanfa, soced, ymadawiad
etifeddu: etifedd
cyflymder: cyflymder, gwaddod
sarhaus: llafar
diffyg: annigonol, torri, hepgoriad, ddiffygiol
sicrhau: sicrhau
annheg: hawl
is: cymryd-lle
bwced: gasgen, llwy
sefydliad: sefydliad
yn-bennaf: yn-enwedig
defodol: seremoni, addoli
clun: ham, droed
cwpwrdd-dillad: dillad, cabinet
gwead: sefydliad
aflonydd: treisgar
gors: gors
anymwybodol: anwybodus
cychwynnol: agor, gwreiddiol, dechrau, yn-gyntaf, cyntefig
isafswm: lleiaf
cywiro: diwygio, adolygu, trwsio
edrych-dros: anwybyddu, anghofio
unfrydol: unedig
carbon: glo
coil: ffeil, y-gofrestr, cyrliog
creision: bregus, miniog
geirfa: geiriadur
dro: crwydro
ffitrwydd: ymarfer-corff, gymnasteg, cyflwr
cenedligrwydd: cenedlaetholdeb, cenedlaethol
blas: blas
ddibwys: angenrheidiol, ddibwys, amherthnasol
pwnsh: guro
stride: cynnydd, gwadn
echel: ysgwydd, print
boddhaol: clefyd, bodlon
dibynadwy: ffyddlon
ffiaidd: casineb, hyll
moesegol: moesol
cwymp: syrthio
clustog: afon
drysu: ffugio, dinistrio, amaze, methu, godi-cywilydd
myth: stori, chwedl
perchnogaeth: eiddo
dychryn: ofnus, ofnadwy, ofn
brêc: egwyl
cnau: ffa, hadau
chwyddo: chwyddo, cynyddu
solar: heulwen
big: gwefus, uned
prydles: dennyn, rhent
cymhareb: cysylltiadau, cymhariaeth, graddfa, adroddiad, cyfatebiaeth
crib: brwsh, ysgwydd, crib
cyfieithu: cyfieithu, fflip
hamdden: adloniant, ystod-y-gwyliau, ymlacio
fympwy: lliw
sampl: enghraifft, ceisiwch
lluosog: màs
menter: cynllun, ceisiwch
jeli: jam, llaeth
anarchiaeth: anhrefn
proffil: amlinelliad, ffeil, gwefan
cyllid: arian
sylfaenol: sylfaen, stwffwl
gael-gwared: dymp, cyrch
trydanol: electronig
perlysiau: glaswellt
ffynnu: ffynnu
tebygrwydd: cyfatebiaeth, yn-debyg, undod
preifatrwydd: preifat
arena: maes
teithiwr: teithiwr
gronynnau: atom, hadau
cynhenid: gwreiddiol
preswylydd: preswylydd
ffliwt: chwiban
atgynhyrchu: ffrwythlondeb
span: hyd
salad: letys, pŵer
llifyn: lliw
dangos: profi
moeseg: moesol
yn-swyddogol: swyddogol
cythruddo: ymyrryd, blino, hudo, ysgogi, turio
gleidio: slip
nodwedd: nodweddiadol, eiddo, darn
cyfansoddwr: cerddor
pêl-droed: cic
partneriaeth: cydweithredu, cynghrair, cyfrannu
parhad: parhau
annormal: anarferol, crackpot
dilyniant: cadwyn
gwasgfa: gwthio
mynd-i'r-afael â: atafaelu, ymdopi, offer
cwrbyn: ataliad, palmant, ataliaeth
hysbysebu: ad, propaganda
tynnu'n-ôl: atchweliad, soced, casgliad
morgais: gwystl, credyd, gwystlo
goddefgarwch: amynedd, arth
repress: atal, orthrymu
priod: gŵr
ddilys: effeithiol
falf: van
adeiladu: creu, adeilad, llunio, cam
anwedd: stêm, cwpl
ystlumod: ffon, clwb, ymlaen
gwrth-ddweud: gwrthddywediad, amherthnasol, cyferbyniol
awtomatig: yn-uniongyrchol
penodol: agored, tryloywder, Axiom
effeithiol: effeithiol, effaith
ddibyniaeth: dibyniaeth
arolygu: arsylwi, gwiriwch, sightsee, dadansoddiad
rhyfedd: rhyfedd, anarferol
haul: tynnu, loot
embaras: cywilydd, godi-cywilydd
anabl: anabledd, goddefol
drahaus: balchder
cwrl: cyrliog, ffoniwch
drysor: carreg, ffynnu
pen-blwydd: pen-blwydd
bri: credyd
esgeulustod: hepgoriad, ddirmyg, difaterwch
hunan-: preifat
gwahaniaethu: eithriad, gwahaniaethu
cyfandirol: cyfandir
targed: pwrpas
stondin: siop, sefyll
buddsoddi: buddsoddiad
mordeithio: llong
rali: undod, gweithredu
si: clecs, llais
yn-weithredol: o-ddifrif
gwiriwch: gwiriwch
compartment: fflat
yn-benodol: yn-enwedig
bang: pop, byrstio, ergyd
cyfanred: gros, cyffredin
ffracsiwn: rhan, fantol
anghyfreithlon: anghyfreithlon, gwyllt
hydoddi: dileu, hydawdd, toddydd
cydbwysedd: cydbwysedd
archwilio: probe, dadansoddiad
nionyn: bwa
affinedd: cyfatebiaeth, undod, dibyniaeth
anonest: ffyddlon
gwrthdaro: gwrthdaro, sioc, ymyrryd
cadair-freichiau: cadeirydd, soffa
toes: blawd, màs, burum, cacen
cychwyn: ymuno
trance: gweledigaeth
gwrthod: gwadu, gwastraff
amrywiant: gwahaniaeth, priodol, gwrthddywediad
amsugno: croen
ar-y-cyd: màs
amserol: amser
ymosod: ymosodiad
diswyddo: sach, diswyddo
yn-sylweddol: i-raddau-helaeth
arbrofol: peilot
ffilm: ffilm, tv, llun
cyhoeddusrwydd: propaganda, dyrchafiad, ad
ehangu: ehangu, manylion
dillad: baglu, syrthio, dip, dillad
efail: creu, ffugio
ffosil: olew, archeolegol
cyfyngiad: rhwystr, rheoleiddio, ataliaeth
croen: brwdfrydedd, sbeis, profiad, blas, croen
fastidious: blino
pentrefan: maestref, pentref
ffyniant: ffynnu, bownsio, byrstio
atgynhyrchu: copi, dynwared
gyngres: cynulliad
grawnwin: gwin
gweithdy: stiwdio, seminar
gostwng: lleihau, torri, syrthio
ynganiad: ynganu
dyfarniad: penderfyniad, dedfryd, rheol, barnwr, awdurdodaeth, argyfwng
canolbwyntio: gofalus, ffocws
dadwneud: datgelu, yn-ôl
fferi: cwch-hwylio, llong
syml: syml, yn-uniongyrchol, yn-hawdd, tryloywder, llinol
uchder: hyd
ddynodi: sioe, golygu
allforio: allanfa
troseddwr: comed, yn-euog
anghymeradwyaeth: gwrthwynebiad, feto
par: cwpl, cydbwysedd
ddiddymu: dileu
addasu: adolygu, atgyweiria, addasu
aelodaeth: aelod
medrydd: mesur, graddfa, maint, tenau, dangosydd
goddef: maddau
clun: pen-ôl, canol
cadw: dilyn, ymuno, ffon, cadw
gwrthyrru: atal
aflonyddwch: anhrefn
chastity: cywirdeb, purdeb
slac: ymlacio, rhydd
cyfangiad: swildod
newyddiadurwr: gohebydd
symptom: arddangosyn
beic: beicio, cylch
tar: palmant
troellog: sbin
sylwebaeth: brechlyn, diffiniad
trosglwyddo: haint
pleidlais: llais, etholiad
potensial: gallu
gymwys: gallu, hawl, yn-gymwys, priodol
dolen: beicio, colfach, ffoniwch
labrwr: cyflogai
erlyn: bai
trwydded: caniatâd
rhoi'r-gorau: rhyddhau
ego: eu-hunain, anadl
jet: ddiarddel, aderyn, nant
torri: anufuddhau, torri
gaeth: dibyniaeth
goroesi: oes, llafariad
rhewi: rhewi
gwehyddu: wau
periglor: sefydlu, buddiolwr
difaterwch: difaterwch
trefnu: sefydliad, paratoi, ddeddfu, drefnu
yn-ôl-pob tebyg: efallai, sôn,
chord: cytundeb
gwaedu: gwaed, gwaedlyd
canfod: dod-o-hyd, chwilio, datgelu
Smash: dinistrio, egwyl
hwyluso: cyflymiad, maeth, cyfrannu
amledd: cylch, petruso
pwyth: gwnïo
cyfeiriadur: tystiolaeth
torri: brathu, torri, stêc
gwresogi: cynnes
ddigalon: siomedig, drist
coup: chwyldro, ergyd, strôc
tosturiol: biti
meddyliwr: deallusol
cyllideb: cydbwysedd
dinesig: sifil, trefol
mewnosod: fynd-i-mewn, cynyddu
meditate: adlewyrchu, meddwl
hyblyg: syml, flex, elastig
slab: panel, tabled, stôf
cymhwyster: talent, yn-gymwys
switsh: cefn, trosi, allweddol
tywel: ffabrig
degawd: deg, cynnal
lluosog: amrywiol, mwy
rhwymyn: dresin, Caewch
daclus: daclus
clap: pat, yn-cymeradwyo
masarn: palmwydd
rhaca: ysgubo
gwacter: gwag
mêr: olew, ymennydd, cicaion
wain: cot, amlen, pod
amsugno: manteisio, sugno, gofleidio
rhagfynegiad: rhagweladwy, dyfalu
addysgu: addysg, trên, addysgu
ymchwiliad: probe, cais, chwilio
domination: rheol
rhieni: rhiant
cymryd-rhan: delta, ymuno, cymryd-rhan
elevator: lifft
ochrol: ochr
ohirio: oedi
chasineb: ddirmyg, casineb
cnewyllyn: niwclear, cell, embryo
trosiad: enghraifft
bachigol: ychydig, micro
bom: pwmp
feirniadol: dwfn, beirniad
rhwd: pasio
neilltuad: cadw, atafaelu
gwnïo: gwnïo
fferyllydd: cemegol
lolfa: egwyl, neuadd
dechrau: dechrau, cyrch, ymosodiad
plymio: dip
anghyfeillgar: gelyniaethus
cyfrifiad: cyfrifiad
Gyfrannog-ymwrthod: cyhuddo, dedfryd
llin: llieiniau
atal: atal
slap: guro
ymlacio: ymlacio
carwriaeth: iard
nwyddau: nwyddau
parhad: cyd
cilyddol: cyfnewid, gwrthdroad
presgripsiwn: meddygaeth, copi
swigen: ewyn
rhaw: gefeiliau, rhwyf
defnyddio: manteisio, defnydd, treulio, harnais, defnyddio
gwydn: hir
llinach: cyfarwydd
sinc: sinc
pa-un-bynnag: Beth-bynnag, sy'n
cyfyngedig: cyfyngedig, yn-olaf, gorffenedig
ategol: cefnogwr, cymhorthion
scramble: ystumio, frwydr, strôc
academaidd: addysg
teiars: embryo, ffoniwch
defnyddwyr: defnydd
dilysrwydd: werth, credyd
tua: bron, bras
gwau: wau
microsgop: telesgop
sifil: sifil
strap: dennyn, rhaff
symbolaidd: ystum, hunaniaeth
addasu: addasu, ymdopi, drawsgrifio
tebygolrwydd: tebygolrwydd, gallu
goddrychol: yn-feddyliol
rhagenw: cydwybod
anghywir: anghywir, cam-drin
annog-pobl-i beidio: godi-cywilydd, uchelgais
newydd-ddyfodiad: gwestai
anfeidredd: berfenw
graffeg: siart
ffig: siâp, llun
arbenigol: cyson, allweddol
siomi: siomedig, bradychu, methu
amcanestyniad: cynllun, sioe
rhyddhau: rhyddhau, iachawdwriaeth
rysáit: ysgogiad
fasnachfraint: braint
anghydweddol: lol, amherthnasol, annigonol
cylchdro: cylch, chwyldro, sbin
knob: blaguryn
metr: mesur
cyfyngiad: rhwymo, ataliaeth, rheoleiddio
categori: cymuned, rheng
hiliol: hil, hiliaeth
amnewid: yn-lle-hynny, cymryd-lle, newid
arloesedd: ddyfais
wynebu: ymdopi
gwaharddiad: gwadu
addurnol: addurn
lobïo: cymell, neuadd
Hurl: bwrw, cyrliog
sgrolio: llyfr, y-gofrestr, cyrliog
mecanic: mecanyddol, grefftwr
ymddygiad-ymosodol: ymosodiad, ymosodol, yn-fwy-na
hey: Helo, croeso
mesur: mesur
cystadlu: wrestle, wrthwynebydd
academi: coleg
newyddian: recriwtio, ffres
wedi-ysgaru: ysgariad
llaeth: llaeth
cronfa-ddŵr: tanc
siopa: siop, fasnach
ymhlyg: cyson
strategol: strategaeth
llwydni: modulo, ffurflen, print, bwrw
ymarfer: ymarfer-corff, ailadrodd
mynnu: mynnu
rhagflaenu: cyn
canol: ganoloesol, hanner-ffordd, canol
twristiaeth: teithiwr, twristiaeth
diod: diod
gadw-mewn-cof: gofalus
mynegi: eglurwch, mynegiant
ail-: yna,, yn-ôl
diwygio: adolygu, newid, cymryd-lle, sbleis, diwygio
diagram: siart, map
diddwythol-hwyliau: anwythol-hwyliau
gorlethu: orthrymu
ffôn-symudol: ffôn, cell
dyrchafu: dyrchafiad, lifft
paradocs: gwrthddywediad
gor-ddweud: halen, gwneud-y-mwyaf
melyn: melyn
ciw: marc, cyfrinair, ffon
rhedwr: neuadd
trafod: sgwrs, trafod
gyfundrefn: rheol
goddefgarwch: goddefgar, arth
opsiwn: yn-ail, ciwcymbr
crwsâd: symudiad
epidemig: drasiedi, cyfieithu
techneg: technegol, ymagwedd, peirianneg, offer
terfynell: yn-olaf
raddedig: pasio
allbwn: traul, casgliad, cyhoeddi, ymadawiad, cynhyrchiant, allanfa
o-hyd: fan-a'r-lle
ddiofyn: hepgoriad, safonol
cyd-destun: amgylcheddol, olygfa, connotation
glymblaid: cynghrair
nam: bai, anghywir, anabledd, anfantais
ildio: cyfaddef
darlledu: cyhoeddi, anfon
deialu: dewis, ffoniwch, casglu
nifer-yr-achosion: poblogaidd
yn-gynyddol: i-gyd
trawsnewid: newid, trosi
barcud: dragon
amwys: amwys, gwrthddywediad
caffi: coffi, bar
dyfarniad: Gwobr, premiwm, cyfaddef
label: stiwdio, marc
cymeradwyo: cymeradwyaeth, cyfaddef
carennydd: cyfatebiaeth, sosialaidd
realistig: wirioneddol
ymlusgiaid: neidr
awyr-agored: allan, agored
wleidyddol: gwleidyddol
gweddillion: gweddillion, gwastraff
tâp: casét, band, ffilm
ddiafael: meddal, melys
llafar: llafar, gwefus
dyfalu: dyfalu
ddiarddel: ddiarddel, rhyddhau
blemish: fan-a'r-lle, anabledd
skip: dawns, treulio
myg: cwpan, grimace
lletem: spike, fantol, cornel
eithriad: disgownt, eithriad, diswyddo
cludadwy: ychydig
lapio: pecynnu, lapio
disgleirdeb: talent, harddwch, llacharedd
asgell: rhwyf, bale
sibrwd: sibrwd
aeron: bae
mewnfudo: mudo
hoe: aradr
llawdriniaeth: llawfeddyg
cronni: cronni, blaendal, casglu
baw: feces, pibell
abdomen: stumog
goblygiad: connotation, cynhwysiant, casgliad
cymhelliant: ysgogiad
wrench: sgriwdreifer, allweddol
cefn-gwlad: gwledig, maestref, maes, pentref
diraddio: dinistrio, lleihau
cynhenid: natur, gwreiddiol, preswylydd
pentwr: dymp, crib, simnai
disg: disg
tuedd: ymddygiad, cyfarwyddyd, plygu, gwarediad, drifft
corfforaethol: cwmni, cyffredin
ddieuog: gwared
ansefydlog: anwastad, byrhoedledd
gydnaws: cyson, cyfochrog, gyfath
ffôn: ffôn
gwactod: gwag
chrafangia: stab, cymryd, atafaelu
ffit: daeargryn, byrstio
ddiflas: diflasu, turio, blino
portffolio: set, waled
agennau: crac
cymhlethdod: broblemus, toll
ymyrryd: ymyrryd
polar: polaredd, eithafol
cynadleddwr: cynrychiolydd, negesydd
wirfodd: grym-ewyllys, dymuniad
rhagfynegi: rhagweladwy, dyfalu
optimistiaeth: gobeithio, yn-credu
croen: croen, pod, cortecs
gerfio: brathu
hofran: arnofio, esgyn, petruso
sector: maes, diwydiant, rhanbarthol, rhan
cyfenw: enw, maent
sefydliad: drefnu, cwmni, sefydliad
brys: bryderus
bleserus: math
atal: atal
negyddu: gwadu
enillydd: llwyddiant
cyfansawdd: cymysg
effaith: effaith, gwrthdaro
ffibr: ffibr
sipian: llyncu
gweledol: optegol, olygfa
grafanc: paw
plaintiff: actor, cludwr, rheswm
yn-gresynu: biti
camarwain: ystumio, amaze, ffwl
gwahardd: ataliad, atal, gwadu
perfformiwr: actor, artist, chwaraewr
twrnamaint: hil
gofyniad: cais, cyflwr
minws: lleiaf
anniben: di-hid
heintus: haint
pwysleisio: mynnu, pwyslais
pants: trowsus
drysu: pos, amaze, godi-cywilydd
gysegru: gwirfoddolwr, yn-bwriadu
llawfeddygol: llawfeddyg
geirwiredd: ffaith, cywirdeb
canfed: cant
lethr: serth, dip, plygu
gerllaw: bron, yn-fuan, cyfagos
Fel-arfer,: cyffredin, yn-aml, Yn-gyffredinol,, yn-tueddu
ddryslyd: gwrthddywediad, pos, dryswch
gyfrannol: cymaradwy, cydbwysedd
anghytuno: anghytundeb
lidio'r: dicter, ymyrryd, hudo, llidiog
rhagorol: gwell, trawiadol
cychwyn: dechrau
dyodiad: gwaddod
dychryn: larwm
hobi: adloniant
gramadegol: gramadeg
rhifiadol: rhif, digidol
maen-prawf: safonol
rhagolwg: rhagweladwy, dyfalu
anghymeradwyo: gwadu
egsotig: tramor, rhyfedd
bwlb: lamp
gwella: ehangu, cynyddu, gwneud-y-mwyaf, gwella
ymasiad: toddi, galwad
pôl: etholiad
talentog: talent, medrus
dadmer: toddi
sythu: darn, atgyweiria
addurno: addurn
arlywyddol: llywyddiaeth
bump: cynamserol, lluoswch, cic, tolc, tiwmor
llongyfarch: canmoliaeth
sgan: ysgubo
hawl: galluogi, hawl
betio: cyflwr
dechnegol: technegol, peirianneg
empirig: profiad
dra-arglwyddiaethu: meistr
hysbysebu: ad, propaganda
trylediad: dosbarthu, cyhoeddi
pori: crafu
cit: offer, blwch, set
ymarferydd: meddyg, hyfforddwr
socian: sugno, dip
cadwraeth: gwarchod, arbed, gofal
llysnafedd: mwd, palmant, driblo
heriol: caled
llygredd: llygru, llygredd
cemegolion: cemegol
swp: ddiadell, impulse, cyfaint
mom: mom
brawychus: ofnadwy, bygythiol
arbenigol: arbenigwr
dyheu: dymuniad
ystafell-ymolchi: bath
Gamble: gamblo, chwarae, antur
annatod: angenrheidiol, integredig
dileu: gwared, dileu
pys: ffa
atodiad: atodiad, ychwanegol, lwfans
cylchredeg: dosbarthu
gynhwysol: unedig
gwerthwr: ddeliwr
aflonyddu: nerfus, ymyrryd, obsesiwn
ffrwydro: byrstio
pry: chwilfrydedd, lifer
arllwysiad: gollwng, arllwys
gratis: rhad-ac-am ddim
cynhwysyn: elfen
diffyg: agored
gofidus: nerfus, blino, annymunol, drist, anhrefn
tai: tŷ
ffotograffig: cam, llun, ffotograffydd
pla: pryfed
bilsen: tabled
Ar-hyn-o bryd: bresennol
cyfryngau: wasg
llanast: adfail
corpws: corff, set
dewislen: rhestr
torasgwrn: crac
fforwm: llwyfan, turio, llys
momentwm: cyflymder, impulse
gogwydd: liwt, plygu
teils: brics
cwpwrdd-llyfrau: llyfrgell, siop-lyfrau
cyfrifiant: cyfrifiad
cynhyrchydd: manufacturer
ariannol: arian
darlunio: disgrifiwch, adlewyrchu, cyflwyno
chwyddiant: chwyddo
ymylol: ymyl
ffantasi: dychymyg
tanseilio: dinistrio
cydlynol: llym, cyd, cyson
sylfaenol: termau
bwriadol: yn-fwriadol
goroeswr: teulu
fflwcs: afon, nant
gystadleuol: wrthwynebydd
gemwaith: addurn
alcoholaidd: feddw, gwin
wahaniaethu: gwahaniaethu
milwriaethus: radical, terfysgol, milwrol
ddiarfogi: breichiau
hanfodol: angenrheidiol, bendant
aseiniad: gwaith, ymarfer-corff, dyletswydd, rhandir
cwota: braint, rhandir, cwantwm
cloddio: pwll, gloddfa
calsiwm: cic
goffáu: perswadio
yn-hanesyddol: hanesyddol
hi: Helo, croeso, iachawdwriaeth
dileu: gwared, hepgoriad, dileu
taut: daclus
ymlacio: cysur, gyfforddus, ymlacio
effeithiolrwydd: effeithiol, effaith, sgiliau
agored-i-niwed: dueddol
athletwr: athletaidd
streipen: streipiog, llinell, band, ffilm
ffasâd: mwgwd, gweledigaeth
clip: stwffwl, gefeiliau
prototeip: enghraifft, gwreiddiol
wrthbwyso: ymdopi, wneud-iawn, gwyriad
null: sero, gwag
cyfyngu: atal, talfyrru, lleihau
tic: marc, lleuen
TAW: tanc
treisio: yn-fwy-na
null: sero, gwag
amodol: ynghlwm
diwylliannol: diwylliant
technoleg: technegol, offer
marchnata: fasnach
necktie: tei
yn-economaidd: economaidd
gweinyddwr: rheolwr, ymddiriedolwr
portreadu: disgrifiwch, cyflwyno
wyres: wyres, nai
deuol: dau, cwpl, dau-wely
synthesis: gwreiddiol, instal, set
arbenigedd: galwedigaethol, nodweddiadol
rhyfedd: rhyfedd
ymgeisydd: ymgeisydd
ieithyddol: iaith, ieithyddiaeth
madarch: corc, sbwng
pwmpen: sboncen, cicaion
codiad: lifft, yn-codi, cynnydd
rhyfeddol: anarferol, solo, super
deinamig: pŵer
adolygu: adolygu, atgyweiria, gwiriwch
torri-lawr: datgysylltiad, syrthio, dadansoddiad
blinedig: wedi-blino
campws: coleg, ysgol
traethawd-hir: thesis
ystadegol: ystadegau, yn-ystadegol
llunio: paratoi, llunio
brechdan: bara
null: sero, gwag
symbyliad: cyflymiad, cyffro, llidiog
sensoriaeth: sensro, rheoleiddio
arfogi: ategu
enwebu: enwebiad, cynnig
canslo: dileu, sgrap, rhwystredigaeth
metr: mesur
ostwng: orthrymu
Mister: syr, meistr
ail-greu: trwsio, adferiad
dyfarnwr: rheol, barnwr
atomig: atom, niwclear
ddadleuol: gwrthddywediad
soffistigedig: cymhleth, modern
twitch: shrug
amhriodol: amherthnasol, annigonol
gwaddod: gwaddod
snub: ddirmyg, bai
amrywiad: amrywiol
beirniadu: beirniadaeth
diflastod: diflasu, annifyrrwch, diflastod
cydweithredu: cydweithredu, cyd
dadansoddi: dadansoddiad, dadansoddwr
glawiad: glaw
sprout: blaguryn
awyrennau: aderyn
sbeislyd: miniog
hyblygrwydd: elastigedd
roced: taflegryn
adferf: amlen
ansefydlogrwydd: anwastad
amddifadedd: amddifadu, anfantais
Crouch: squat
cynhyrchu: cynhyrchu, creu
brasamcan: bras, ymagwedd, cydgyfeirio
morâl: effro, moesol, yn-feddyliol
optimistaidd: gobeithio, yn-credu
dosbarthu: dosbarthiad, dosbarthu
cwricwlwm: cwrs, agenda
yn-yr-awyr agored: allan
ymateb: adwaith, ferf
sgript: senario, llinell, ysgrythur
blacmel: extort
bonws: Gwobr, premiwm
ased: eiddo, presenoldeb, mantais, cyfalaf
amrywioldeb: gwahaniaeth
amwysedd: amwys, gwrthddywediad, ansicrwydd
null: sero, gwag
diryw: niwtral
handicap: godi-cywilydd, rhwystr, anabledd, anfantais
ffotograffiaeth: llun
prinder: torri, absenoldeb
dadleoliad: cymryd-lle
ffwng: bacteria, sbwng, corc
geiriad: llunio, testun
diplomydd: diplomyddol, negesydd
cychwyn: cyflwyno
uno: harnais
chwalu: egwyl
anadlu: ysbrydoli
pwli: rôl
denau: tenau
pleidleisiwr: etholaeth
ffederasiwn: ffederal
symudedd: symudiad
dadlwytho: rhyddhau
cynefin: lloches
ennyn: gynnwrf, cymell
gwanhau: tenau
Hwyl-fawr: Hwyl-fawr, ffarwel
dymchwel: dinistrio
cystrawen: pensiwn
pedol: ceffyl
afluniad: gwyriad, ystumio
gamp: guro
perthnasol: cyson, priodol, cysylltiedig
swyddogaethol: ymarferol, gwaith
dadleoli: cymryd-lle, ddiarddel, Budge
ymreolaeth: annibyniaeth
drewdod: arogl
gwahaniaethu: gwahaniaethu
argaeledd: caffael
israddedig: myfyriwr
graff: siart, map
hudo: swyno, hudo
'n-giwt: hardd, melys
abdomen: stumog
llythrennedd: addysg
synthetig: artiffisial
hyfforddwr: hyfforddwr
gwarchod: storio, arbed, gwarchod, cadw
garbage: sgrap, dymp, gwastraff
photo: llun, ergyd
gwerslyfr: llawlyfr, llyfr
atgyfnerthu: atgyfnerthu
cyfyngu: gorfodi, cyfyngedig, extort
economegydd: economaidd
athletau: athletaidd, ymarfer-corff
sleifio: grimace
ïodin: mwynau
heintio: haint, llygru
dylunydd: benderfynir
secretu: secretiad, cuddio, ddiarddel, gyfrinach, gwahaniaethu
sbigoglys: maeth, letys
dwys: eithafol, treisgar
argyhoeddiadol: dangosol
cyntaf: yn-gyntaf, dechrau
milfed: mil
dan-do: mewnol, dwfn, dan-do, a-gwmpesir
dirymu: amddifadu
osgled: maint
dimensiwn: cyfarwyddyd, ar-ôl, dimensiwn, nesaf
Beibl: ysgrythur
poster: banner, we
cyflymu: gwaddod
dwysau: atgyfnerthu, intensifier
erthyliad: camesgoriad
fel-arfer: Yn-gyffredinol,, cyffredin, yn-aml, yn-tueddu
ymrwymiad: addewid
ciw: cynffon, gorchymyn
braced: stwffwl, penelin, bachyn, cefnogwr, cefnogaeth
cyn-: oed
gwrthdro: cefn, gwrthdroad
anweddu: toddi, yawn
hedfan: awyrgylch, aer, hedfan
cydberthynas: cymhariaeth
ethnig: genedlaetholwr, cenedlaethol
slaes: torri, lleihau
anodd: cyfrwys, ymhelaethu, cymhleth, caled
cymeriadu: disgrifiwch, nodweddiadol
affix: sbleis, cyfochrog
moleciwl: moleciwlaidd
cyfluniad: gwarediad, strwythurol, cynulliad
rhyngweithio: sgwrs, gorgyffwrdd
meintiol: cyfaint
introspection: ôl-weithredol
Dwyrain: ddwyrain
sberm: hadau
cymeradwyo: cefnogaeth, cyfaddef, cymeradwyaeth
nad-ydynt-yn: nac, Ni
hygrededd: teyrngarwch, dibynadwyedd, credyd
subversion: adfail
gwyriad: drifft, gwyriad
pigiad: nodwydd
sandal: sliper, esgidiau
darn: sglodion, paragraff, darn
teledu: tv
grawnfwyd: grawn, ffa
cynhwysydd: offeryn, tanc, pot
ymfudo: mudo, crwydro
terminoleg: termau
etholwyr: etholaeth
dileu: dileu, dinistrio
cyfryngu: cysoni
cyfalafiaeth: gyfalafol
sgïo: sglefrio
clirio: gamblo, caniatâd
detholus: dewis
statig: safonol
cydgyfeirio: cwrdd, cydgyfeirio, ffocws
wyddor: wyddor
byd-eang: rhyngwladol, byd
anafedig: aberth
iawn: un-fath, atgyweiria, iawn
bragmatig: ymarferol
canolwr: rheol, barnwr
gwahaniaethol: gwahaniaeth
anadlu-allan: allyrru, anadl
drobwynt: dŵr
gêm: addasu, offer
gorsedda: instal, sefydlu, cau
cyseiniant: dirgryniad
Yn-draddodiadol,: traddodiad
ystafell-ddosbarth: orbit
protocol: cytundeb
calcwlws: cyfrifiad, bil
gram: cynnes, glaswellt
petrol: gasoline
galaeth: names
glasoed: ifanc
dylino'n: trafferth
radiwm: radio
rarefied: tenau
awyren: aderyn
pedal: gwadn
circa: bron, am
flashlight: lens
gês: blwch, bagiau
cyfnewid: cyfnewid
dewisol: arfer
matrics: stumog
portread: ysgwydd, llun
cyn: ddwyrain, cyn, dôl
hysbyseb: ad
syfrdanu: amaze
nifer-yr-achosion: digwyddiad, dip
topple: arllwys, galon
synhwyraidd: teimlad, angerddol
consensws: cytundeb
goruchwylio: rheoli, monitor, heddlu
trawsblaniad: yn-ail
alwminiwm: alwminiwm
amrywiad: osgiliad
efelychu: dynwared, feign
cymhlethu: cymhleth
mentor: ymgynghorydd, hyfforddwr
slot: agor
Rook: frân, twr, castell, gwn
trin: trin, gynnwrf
llysieuol: llysiau
norm: fanyleb, safonol, rheol
isffordd: twnnel
anadlol: anadl
efelychiad: dynwared
chwistrell: nodwydd
treiglad: newid, trosi
dillad-isaf: underpants, llieiniau
fagina: bae
gwahaniaethu: gwahaniaethu, gwahaniaeth
tymhorol: tymor
pentrefwr: gwledig
sesame: man-geni
coma: coma
gwrthdro: gwrthdroad, cefn
goruchwyliwr: arsylwr, llawlyfr
oust: ddiarddel
archwiliad: gwiriwch, adolygu
hike: esgyn, crwydro, lifft
locws: fan-a'r-lle
dirwasgiad: economeg
ysbeilio: loot
slogan: cyfrinair
ffetws: embryo
integreiddio: cydweithredu, cynhwysiant
magenta: porffor, cyan
lleihau: lleiaf, lleihau
preswyl: lloches
rhifolyn: digidol, rhif
hallt: halen
null: sero, gwag
damcaniaethwr: theori
acwariwm: pysgod
traction: feto
parasiwt: ymbarél
bwysicach: angenrheidiol
ar-y-cyfan: Yn-gyffredinol,, i-gyd, cyffredin
dirywio: pydredd
null: sero, gwag
rhywioldeb: rhywiol
sbŵl: cyfaint, lapio
yn-bennaf: i-raddau-helaeth
gludiog: gludiog
coluddyn: perfedd
archaeoleg: archeolegol
pysgnau: ffa
apposition: lwfans
popty: stôf, cegin
trowsus: trowsus
meini-prawf: safonol, dangosydd
trosolwg: amlinelliad
ansoddol: nodweddiadol
eyeglasses: gwydr
genetig: morffolegol, geneteg, genyn
cyfranogwr: ymuno, rôl, rhangymeriad
repertoire: talent, meddalwedd
cylchdroi: cylch, sbin
cynllun: sefydliad, cynllun, gwarediad
taleb: plwg, derbynneb
theorem: dedfryd, theori, Axiom
gwybyddol: diagnosis
egluro: ymhelaethu, eglurwch
wenwynig: gwenwyn
Pwysleisiodd: pwyslais
stylus: nodwydd
cwymp: argyfwng
darparu-ar: gweini, a-ddarperir, sicrhau
gwrth-: gwrthwynebiad
resistant: cronig, gwrthwynebiad, imiwnedd
byrbryd: tost
sinema: ffilm, ffilm---theatr
faucet: pibell
marciwr: marc
ymylol: cyfagos, rhanbarthol
bendant: benderfynir, predicative, ymosodol, bendant, styfnig
nod: wau
ordew: trwchus
tynnu: ddiarddel, lleihau, tynnu, amddifadu
intransitive: angenrheidiol
helics: Malwoden, cyrliog
cwci: bisged, cacen
chwyddo: chwyddo
electroneg: electronig
ailysgrifennu: drawsgrifio
lab: labordy
galwedigaethol: proffesiwn, masnachol, galwedigaethol, gwaith
graddiant: filltir, dip
lliwgar: lliw
sylw: a-gwmpesir, brechlyn, gofal, blanced, to, sylw, cyfaint
cyfranogiad: ymuno, cynhwysiant
cyfeiriadedd: cyfarwyddyd
fabricate: creu, cynhyrchu
thermol: olew
stereoteip: eithriad
tech: technegol
gweddilliol: gweddillion, diswyddo
lori: lori
stadiwm: maes
cydlynu: cydlynu
bacteriol: bacteria
rhyngwyneb: ymagwedd
silicon: pi
cof: cof, arbed, cofiwch
diagnostig: diagnosis
maes-llafur: haniaethol
dargludiad: llinell, herwgipio
filiynfed: miliwn
manwerthwr: ddeliwr
bariwm: bar
prif-ffrwd: allweddol, eilaidd
ystyrlon: golygu, ganlyniadol
sain: llais
cysyniadol: beichiogi
grid: we
gofodol: awyrgylch, dimensiwn
arholiad: cwis
canol: eilaidd, canol
colur: wneud-iawn
arwahanol: gwahanu, solo
lesteirio: ataliad, atal
aml: amrywiol, mwy, iawn
muggy: llaith, cynnes
morffoleg: morffolegol
diagnosis: diagnosis
ffliw: y-ffliw
graffeg: siart
coronaidd: clefyd
pen-ôl: pen-ôl, ham
archif: ffeil
gwrthdaro: frwydr, gwrthdaro, cymhariaeth
lori: lori
gorau-posibl: optimaidd, mawr
yn-y-bôn: termau
cymhelliant: ysgogiad
caill: wy
sylffwr: sylffwr
gweithredol: trin, gweithredu
taflwybr: orbit, ffordd
perthnasedd: cysylltiedig, pwysigrwydd, cysylltiadau
beic: beicio, cylch, olwyn
gyfarwyddeb: dangosol
cwmni-hedfan: aderyn, aer
litr: litr
cam-yn-ôl: rhwystredigaeth, sioc, atchweliad, methu, rhwystr
uno: harnais, cysoni
safiad: sefyll, sefyllfa, paragraff
ychydig-iawn-o: lleiaf
cylchol: beicio, cyfnodol
swbstrad: moleciwlaidd
o-dan-y dŵr: llong-danfor
arbenigedd: profiad, sgiliau
null: sero, gwag
electron: electronig
rhyngweithiol: gorgyffwrdd
yn-y-lle cyntaf: gwreiddiol
sabotage: dinistrio
rhyngweithio: sgwrs, cymdeithasu
mathemateg: mathemateg
ffetws: embryo
moderneiddio: modern, diweddariad
eithafol: radical, eithafol
piss: wrin
snuggle: gofleidio
iawn: atgyweiria, iawn
swipe: dwyn
bwriadus: yn-fwriadol
lled: hanner-ffordd, gwerthu, falu, lled
nerfol: nerfus
gwrth: gwrthwynebiad
ffacbys: lens
procsimol: bron
maetholion: mwynau, bwyd
aneglur: amwys, yn-amlwg
trawma: sioc, anaf, wlser
Gyfnewid: cyfnewid
fector: cludwr
dacteg: ymagwedd
gwerthuso: asesiad
null: sero, gwag
clôn: copi
hyfyw: mantais, effeithiol
dyblygu: copi
adweithiol: adwaith
amserlen: calendr, amser, gwarediad
cystrawennol: tynged
sefydlogi: dawel
gwrthwynebol: wrthwynebydd
adborth: adwaith
holiadur: cwis
oxidize: galwad
milimedr: milimedr
seiciatrig: deallusol
syndrom: clefyd
paradeim: enghraifft
activate: galluogi, gwneud, gweithredu
ar-hap: ar-hap, cyd-ddigwyddiad, i-achos
diarddel: gwahanu, boicot
is-set: rhan
methodoleg: ffordd, ymagwedd, unwaith
gwaith-celf: gwaith
dilyniannol: cyson, trefnol
gronni: cynnal, atafaelu, cau
cilometr: cilometr
amlwladol: rhyngwladol
cynllunydd: tenant, streipiog, cynllun
esbonyddol: ddehonglwr
colli'ch: colli
ymchwilydd: gwyddonydd
archfarchnad: mall
dyrannu: rhandir, gwahaniaethu, dosbarthu, dyrannu
null: sero, gwag
pêl-droed: cic
hawl: hawl, priodol
bwyd-sydd-dros ben: gweddillion, gwastraff
cynaliadwy: safonol
llong-ofod: gwennol
drwy-brofiad: profiad
semantig: connotation, pwnc
mewnol: mewnol, aelod
tunnell: tôn
modiwl: modulo, uned, cyfaint
ensym: burum
ffordd-o-fyw: oes
pasta: màs
dorm: lloches
blentyn-yn-ei arddegau: ifanc
uchafbwynt: marc
negyddu: gwadu, dinistrio
cariad: gariad, ffrind
ymddygiadol: ymddygiad
Diolch: diolch
Mastermind: ymennydd, enaid
ecolegol: ecoleg, amgylcheddol
mewnfudwr: ffoaduriaid
gwreiddio: cynhwysiant, dip, claddu
llungopi: copi, llun
actifydd: gweithredu
crys-t: shirt
therapydd: meddyg, therapi
Tycoon: Brenin
cyffroad: cyffro
cydamseru: Cydamseru
asidig: asid
geiriadurol: geiriadur, gair
Torri-mewn: egwyl
classifier: dosbarthiad
avant---garde: arloeswr
gadeirydd: pen
taflen: taflen
carismatig: swyn
scandiwm: tellurium
canllaw: llawlyfr
hypothesize: Mae'n-debyg, sôn,
oergell: oergell
reboot: Ail-ddechrau
Taflu-syniadau: ysgwyd, syniad
ailadrodd: copi, dynwared, ailadrodd
angst: ofn
cadoediad: cadoediad
gaffe: hepgoriad, anghywir
industrialize: ddiwydiannu, diwydiant
brawd-neu-chwaer: brawd
llefarydd: siaradwr, cynrychiolydd
herwgipio: herwgipio, aradr
nad-ydynt-yn metel: metalloid
rhedeg: y-ffliw, llaith, rhedeg
agwedd: cyfarwyddyd, siâp, ochr
o-achos: 
daioni: rhinwedd, mantais
llac: rhydd, rhad-ac-am ddim
wedi-hynny: dyfodol, yna,, ar-ôl
anhawster: trafferth
garfan: band
yn-fras: lled, ehangu, Yn-gyffredinol,
cydberthyn: cysylltiedig, bachyn
yn-ôl: yn-ôl
null: sero, gwag
bwletin: taflen, gwybodaeth
disapproving: cymeradwyaeth, annerbyniol
bathtub: bath
difyr: adloniant, difyrru, doniol
neilltu---o: ac-eithrio
ymddangosiad: yn-dod-i'r amlwg, allanfa, yn-codi
null: sero, gwag
foch: chwarae
gorfod: rhaid-i, dyletswydd
y---cant: y-cant
ymgyfreitha: siwt
null: sero, gwag
trwy: pasio, uchod
soprano: plentynnaidd
ddoniol: doniol
p.m.: prynhawn, nos
wy---gwyn: protein
tywallt-gwaed: gwaedlyd
Thwliwm:-atom: thoriwm-atom
plygu: plygu, flex
linker: cyd
exhortative: hortative
terbiwm-atom: thoriwm-atom
ar-rent: rhent
colur: wneud-iawn
wisecrack: jôc
config: strwythurol
y-gorffennol: diwethaf
i---hollt: gwahaniaethu, dosbarthu
athro: meistr
Rhodiwm-atom: thoriwm-atom
wladwriaeth-marciwr: 
gofod-marciwr: 
fiwrocrataidd: biwrocratiaeth
gwregys: band, harnais
null: sero, gwag
gwerthwr: ddeliwr
null: sero, gwag
Lanthanwm:: tellurium
pwnc-achos: pwnc-achos
adeiladol: creu, llunio, manufacturer
null: sero, gwag
feminine: benywaidd
archwilydd: arolygydd, cyfrifydd
meicroffon: micro
y-tu-allan - o: allan, ac-eithrio
cofnodi: cynhwysiant, cofrestru
mynegai---bys: dangosydd
nawdd: ysgoloriaeth, gofal
anwybodus: anwybodus
null: sero, gwag
safoni: fanyleb, safonol
o'r-gloch: fan-a'r-lle, awr
landlord: perchennog
ymchwilydd: determiner, gwyddonydd, ditectif
waethygodd: llosgi
null: sero, gwag
awdurdodi: galluogi
amddiffyniad: gofal
cyntedd: neuadd
negodi: sgwrs
newydd-wedd: ffres, diweddariad
dolennog: plygu
ymlaen: yn-gyntaf, nesaf, ymlaen
anadlu: imiwnedd, anadl
null: sero, gwag
dilyniant: cynnydd
intransitive: angenrheidiol
ewfforia: brwdfrydedd
eang: ehangu, lled, eang
intransitive: angenrheidiol
gyferbyniol: cyferbyniol, ymdopi
rhyfeddu: synnu
atgyfeirio: cyflwyno
disgynnydd: cyfarwydd, wyres, genhedlaeth
hufen-ia: hufen
radiws: ray
fel-arall: fel-arall
cymdogaeth: cyfagos, byw, amgylcheddol
arfer: arfer
embaras: cywilydd, anhrefn
yn-sylweddol: i-raddau-helaeth
ffres: ffres, Yn-ddiweddar,, gwraidd
dawnsio: chwarae, dawns
null: sero, gwag
swm-marciwr: 
cymdeithasol-marciwr: 
beirniadaeth: beirniadaeth
rwbidiwm-atom: thoriwm-atom
frwydr: frwydr, gwrthdaro, rhyfel
cwyno: am
null: sero, gwag
fanadiwm-atom: thoriwm-atom
diryw-rhyw: gwrywaidd-rhyw
fflworin-atom: thoriwm-atom
taith: ymweliad, safari, alldaith
gwrywaidd: gwrywaidd
null: sero, gwag
datblygiadol: esblygiadol, cynnydd
gymhwysol: ymarferol
i---ben: cau
Brag: afradlon
yn-ôl: yn-ôl
y-yn-bresennol: bresennol
null: sero, gwag
randomize: ar-hap
cydweithredol: cydweithiwr
wedi-ymddeol: ymddeol
null: sero, gwag
difyrru: hapus, doniol, difyrru
approximative: bras
Dyadig: deuaidd
atodol: ategu, ychwanegol
cyfathrebol: gohebiaeth, siaradus
null: sero, gwag
yn-achos: i-achos
poloniwm-atom: thoriwm-atom
torri-lawr: datgysylltiad, dadansoddiad
lliw-haul: brown
problem: broblemus, trafferth
cyfieithu: cyfieithu, fflip
null: sero, gwag
thaliwm-atom: thoriwm-atom
clic: conglomerate, cliciwch
hawdd: yn-hawdd, syml
safonwr: hwylusydd, rheolwr
yn-gymdeithasol: cymdeithasol
paru: siwt, cyd-daro
damwain: digwyddiad
hynny--a-oedd: sy'n
ddiddorol: tynnu
wyneb-i-waered: cefn
chwynladdwr: gwenwyn
null: sero, gwag
cystadleuydd: rhangymeriad
er-enghraifft: enghraifft
tiwmor: tiwmor
pydredd: pydredd
null: sero, gwag
gwefan: gwefan
aruthrol: enfawr, iawn, super
Bydd-darpar: 
perthynas-achos: perthynas-achos
amcan-achos: cyrchfan-achos
talu: wneud-iawn, talu
gam-drin: anghywir
Braid: crib, wau
yn-lle: yn-lle-hynny
archaeoleg: archeolegol
cysylltydd: copula, plwg, atodiad, soced
null: sero, gwag
cyffredinoli: cyffredinoli
strontiwm-atom: thoriwm-atom
ruthenium-atom: thoriwm-atom
eithrio: ac-eithrio
null: sero, gwag
encil: digress, atchweliad, ymddeol
ymddeol: ymddeol
Ei-gilydd: eich-gilydd, eraill
eang: eang
cyfrifiadura: cyfrifiad, cyfrifiadur, cyfrifiannell
busnes-person: person-busnes
ci-poeth: selsig
goruchafiaeth: effaith, pŵer, mantais
unquote: quote
meddiannol-achos: genidol-achos, meddiannol-achos
yn-enetig: genyn, geneteg
concessive: Budge, meddal
anuniongyrchol-gwrthrych: uniongyrchol-gwrthrych
waharddol-hwyliau: waharddol-hwyliau
gwaith---allan: ymarfer-corff, gwaith, ymhelaethu
delimited: cyfyngedig, gwahanu
groes: cefn, gwrthwynebiad, gyferbyn, gwrthdroad, cyferbyniol
dringo: yn-codi
anhygoel: anarferol, super
null: sero, gwag
cau: cau, gwŷdd
rhad: rhad
cynfas: ffabrig, we
addysgedig: addysg, gwrtais
bywyd-gwyllt: natur, gwyllt
gwrthwynebu: gwrthwynebiad, gyferbyn, tuag-at
null: sero, gwag
cloddio: gloddfa
heintio: haint
null: sero, gwag
arfog: breichiau
h.y.: sef
neb: dim-byd
rhegi: tyngu, expletive
lleihau'n-raddol: tenau, côn
diddanwr: adloniant, artist
ac-ati: 
heblaw-am: ac-eithrio
cyfuchlin: amlinelliad, amgylcheddol, ffurflen
Ffôn-Symudol: Ffôn-Symudol, cell
miss: torri, colli, treulio
brawychus: ofnadwy, bryderus
y-dyfodol: dyfodol
y-dibynnol-hwyliau: amodol-hwyliau, eith-hwyliau
dylai: rhaid-i
beic-modur: beic-modur, modur
cerdyn-credyd: credyd
null: sero, gwag
y-cyhoeddus: cyhoeddus
Ffôn-Symudol: Ffôn-Symudol, cell
null: sero, gwag
coluddion: perfedd
defnyddio: dosbarthu, gwasgariad, defnyddio
alltudio: ddiarddel
cyfran: fantol, rhan, cwantwm
cymhwysedd: sgiliau, awdurdodaeth
tirfeddiannwr: angel
arddodiadol-achos: 
dyraniad: rhandir, difidend, lwfans
peri-pryder: bryderus
iawn: un-fath, iawn
gorfodi: gorfodi
pro-ymadrodd: pro-dedfryd
derbynnydd: daliwr
chwistrellu: cyflwyno
syfrdanol: amaze, trawiadol
pesychu: peswch
nesaf---i: nesaf
