berfenw: ddiddiwedd, anfeidredd
enwol-achos: 
accusative-achos: 
pwnc-achos: pwnc-achos
rhiant: rhieni, mawr, uwch
dad: tad
mom: mom, mam, mamau
Helo: bye, hi, hey
hynafiad: rhagflaenydd, tad-cu
cu: tad-cu, nain
llwglyd: newyn, llwgu
genidol-achos: meddiannol-achos
ansoddair: 
ac: swm, gan
mi: fy-hun, ff, fy, rydym
chi: nhw, ti, ti
ni: rydym, ein, ni
mae'n: ef, bod, hi, hwn, rhain
cyrchfan-achos: amcan-achos
derbyniol-achos: 
tu-cyd-destun: 
person-cyd-destun: 
dibynnol-cymal: 
perfective-agwedd: 
gorffennol-amser: 
gwrywaidd-rhyw: diryw-rhyw
comitative-achos: 
yn-bresennol-amser: 
benefactive-achos: 
essive-achos: 
Ni: dim, nad-ydynt-yn, prin, methu, nad-ydynt-yn, traw
ei: eu, ei, hi, ef, y-rhai, hers, o
wyneb-cyd-destun: 
adpositional-achos: 
lleoliad-achos: 
gofod-cyd-destun: 
ffordd-achos: 
offerynnol-achos: 
sy'n: pwy, fel, y-mae-ei, unrhyw, nid, bod, pwy, hynny--a-oedd, beth, pob, pa-un-bynnag
gofynnol-hwyliau: 
ac-neu: 
exclusive---neu: 
ffynhonnell-achos: 
abladol-achos: 
dangosol: solid, sylweddol, concrid, argyhoeddiadol, gyfarwyddeb, dramatig
ond: eto, fodd-bynnag
i-gyd: pawb, pawb, cyfanswm, cyfan, ar-y-cyfan, cyfan, popeth, unrhyw, yn-gynyddol
feminine-rhyw: 
maent: nhw, hi, y-rhai, eu, nhw, cyfenw, rhain
plural-rhif: 
un: sengl, a, i-mewn-i, ei-ben-ei hun
dyfodol-amser: 
cymdeithasol-cyd-destun: 
pryd: pryd-bynnag
imperfective-agwedd: 
yno: 
amodol-hwyliau: y-dibynnol-hwyliau, damcaniaethol-hwyliau
mwy: dros, y-rhan-fwyaf o, ymhellach, tu-hwnt, i-fyny, i-fyny, aml, na, yn-hytrach, hefyd, ar-ben-hynny, yn-ogystal, dal, eto, arall, nifer, lluosog
allan: tu-allan, allanol, allanol, awyr-agored, yn-yr-awyr agored, off, y-tu-allan - o, tu-hwnt, i-fyny, ar, ymlaen
perthynas-achos: perthynas-achos
illative-achos: 
gwneud: gwneud, perfformio, ymgymryd-â, rendr, activate, gwnaeth, ymrwymo
gyfarwyddeb-hwyliau: dangosol-hwyliau
deontic-hwyliau: 
cwestiwn-gair: 
copula: cysylltydd, bond, criw
person: dyn, pobl, unigol, rhywun, rhywun, guy, dynol, wyneb, geg, endid
gwrywaidd: gwrywaidd, sôn, gŵr-bonheddig, dyn
gallai: gall, gallai, o-bosibl, Efallai
eraill: arall, gorffwys, ail, arall, gwahanol, Ei-gilydd
rhif: swm, swm, ffigur, rhifiadol, rhifolyn, maint
iawn: yn-fawr, hynod-o, ofnadwy, llawer, hefyd, ofnadwy, eang, iawn, 'n-sylweddol, wael, aruthrol, yn-sylweddol, llawer, aml, aruthrol, y-rhan-fwyaf o, yn-eithaf, yn-deg, yn-hyn, 'n-bert, iawn, iawn, iawn
amser: tra, hyn-o-bryd, yn-ystod, amserol, hyd, tymhorol, amser, amserlen, cyfnod, tywydd
amser-cyd-destun: 
tymhorol-achos: 
am: ynghylch, yn-ymwneud, bron, circa, o, gan, na, o-gwmpas, ar-gyfer, defnyddiwr, cwyno, ar
epistemic-hwyliau: 
yn-unig: dim-ond, yn-unig, yn-syml, pwynt, yn-unig, yn-unig, cyfyngu
ychydig: bach, bach, bychan, ychydig, bit, mân, mân, bachigol, cludadwy, ychydig
yna,: eto, ail-, ya, ers, yn-ôl, yn-ddiweddarach, wedi-hynny
hortative-hwyliau: 
ôl-weithredol-agwedd: 
mawr: mawr, mawr, nobl, difrifol, helaeth, uchel, enfawr, cawr, aruthrol, dominyddol, dda, dirwy, sylweddol, enfawr, sylweddol, hyfryd, rhagorol, gorau-posibl, grand, mawr, perffaith, rhyfeddol, gwych
volitive-hwyliau: 
cyn: ymlaen-llaw, cyn, yn-ôl, rhagflaenu, nes, blaen, gynt, erbyn
rhaid-i: Dylai, o-reidrwydd, diangen, gorfod, angen, rhaid, dylai, eisiau, i
dau: deuol, ddau
gweld: edrych, golygfa, golwg, rhybudd, canfod, Gwylio
yn-gwybod: canfod, ymwybodol, dysgu, flag, yn-weladwy
i-lawr: ar-i-lawr, tuag-i-lawr, dan, isod, dan, oddi-tano, llai, gwaelod, israddol, i-lawr-y grisiau
ar-ôl: cefn, ar, swydd, dimensiwn, yn-ddiweddarach, wedi-hynny, wedyn, canlynol, gorffennol, dan, oddi-tano
yn-gyntaf: cyntaf, cychwynnol, ers, ymlaen, dwrn
hun: ei-hun, eich-hun, meddu-ar, yn-bersonol, ei, ei-hun, hunan
alienable-meddiant: 
byth: erioed
anaralladwy-meddiant: 
oed: a-ddefnyddir, hynafol, oed, henoed, cyn-, ex, cyn-, oed
cydgynghorol-hwyliau: 
diwrnod: bob-dydd, heddiw, heno
lle: lle-bynnag-y bo, lle, lle
dod: i, cyrraedd, cyrraedd, cyrraedd, yn-dod-yn, ffasiwn, yn-digwydd
ffordd: dull, methodoleg, fodd, llwybr, llwybr, llwybr, llwybr, llwybr, modd, ffordd, stryd, siwgr, trac, taflwybr, arfer
gwaith: swydd, aseiniad, weithgar, tasg, llafur, llafur, gyrfa, swyddogaeth, gweithredu, swyddogaethol, busnes, act, gwaith---allan, cyflogaeth, galwedigaethol, gweithio, gwaith-celf
llafariad: enwog, bywyd, goroesi
mynd: cerdded, pris, gadael
perlative-achos: 
blaengar-agwedd: 
hir: hir, gwydn, tal, hyd
dweud: llafar, dweud, siarad
sut: hoffi, fel, na
hyd-yn-oed: hefyd, naill-ai, nes, ar-ben-hynny, hefyd
yn-ôl: y-tu-ôl, cefn, yn-ôl, yn-ôl, dychwelyd, ail-, adfer, dadwneud, eto, ailadrodd, yn-ôl, yn-ôl
yma: 
meddwl: meddwl, meddwl, ystyried, dychmygu, beichiogi, meditate, byddai, gelwir, meddwl
un-fath: union-yr-un fath, tebyg, cyfartal, cyfwerth, yn-gywir, iawn, iawn, ei-hun, yr-un-mor, yn-yr-un modd
diwethaf: diwedd, olaf, terfynol, yn-y-pen draw, arall, arall, diweddaraf, diweddar, yn-dod-i ben, gorffennol, y-gorffennol, goddef, wrthsefyll, rhoi, parhau
i-ffwrdd: yn-hyn, bell, off, ar-wahân, oeraidd, Gadawodd, gadael, absennol
dan-cyd-destun: 
cymryd: cyrchfan, meddiannu, nôl, mabwysiadu, chrafangia, cael, derbyn, ddewis, dal, dal, derbyn, cael, codi-tâl
dod-o-hyd: dod-o-hyd i, darganfod, darganfyddiad, canfod, hygyrch
llaw: fraich, arddwrn
ifanc: ieuenctid, iau, glasoed, blentyn-yn-ei arddegau, newydd
er: er-bod, serch-hynny, sefydlog, cwmni, solid, yn-gadarn, er-gwaethaf, fodd-bynnag, rhywun
rhoi: rhoi-benthyg, darparu, cynnig, gan-ddarparu, cyflwyno, rendr, fforddio, rhoi, rhoi, gadewch
duw: 
delative-achos: 
dim-byd: rhywbeth, gwrthrych, neb, unrhyw-beth, dim, neb
hawl: pâr, gywir, yn-gywir, deg, cyfiawnder, cyfiawnhau, annheg, gymwys, hawl, gyfraith, yn-gywir, yn-wir, penodol, yn-siwr, hawl, yn-dda
unwaith: ar-unwaith, yn-brydlon, dull, patrwm, methodoleg, eto
semelfactive-agwedd: 
rhan: adran, yn-rhannol, dogn, yn-rhannol, parsel, ffracsiwn, rhannu, bit, darn, darn, is-set, pennod, adran, bennod, rhannol, is-adran, ward, sector, cyfran, rhan
gwelodd: 
tŷ: cartref, safleoedd, deml, tai, cartref
byd: deyrnas, byd-eang, bydysawd
pen: teitl, prif, prif, pennod, arweinydd, lywydd, gadeirydd, cyfarwyddwr, bos, uwch, pen
tri: trydydd
neo: newydd, sydd-newydd
ffocws: bwriedir, nod, nod, amcan, canolbwyntio, sylw, crynodiad, acen, cydgyfeirio
caru: anwyldeb, elusen, hoffi
bob-amser: am-byth, yn-gyson, erioed, arferol
nos: gyda'r-nos, cinio, p.m.
pob-un: fesul, pob, unrhyw
Brenin: teyrnasu, arglwydd, teyrn, Tycoon
rhwng: ymhlith, ymysg, o
galon: hwyl, calonogol, topple
paucal-rhif: 
achos: ddyledus, ers, achos, achos
achosol-achos: 
beth: mater, berthynas, ffenomen, stwff, beth
set: grŵp, rhoi, cadw, lleyg, past, casgliad, cyfuniad, arae, suite, pecyn, portffolio, synthesis, gyda'n-gilydd, cyfres, dro, ystod, rhes, llinyn, cit, corpws
enw: cyfenw, enw
priodol-noun: 
hortative: exhortative
gwlad: cenedl, tir, ddaear, wladwriaeth, ddaear, sir, pridd, parti
gofynnwyd-i: 
yn-weladwy-tystiolaethol: 
gwell: uwchraddol, gorau, rhagorol, ddelfrydol, rhagorol
ochr: ochrol, ffafrio, ffafrio, rhan, dro, dudalen, agwedd, hanner, agwedd
cwrs: cwricwlwm, gwers, darlith, yn-sicr, yn-sicr, yn-bendant, cyfradd
benywaidd: lady, feminine, feminine, menywod, merch, gwraig
digon: digonol, yn-ddigonol, digonol, digon, yn-deg, digonedd, annigonol, yn-eithaf, 'n-bert
yn-fuan: cyn-bo-hir, cyflym, prydlon, yn-gyflym, cyflym, ar-unwaith, cyflym, brysiwch, brys, felly, ar-unwaith, yn-rhwydd, gerllaw, yn-gynnar, snap
llawn: llawn, yn-ddigonol, absoliwt, cwblhau, amherffaith, cyfan, yn-union, union, llwyr, yn-union, drylwyr, cyfan, cynhwysfawr, maint
ystafell: siambr, pedwerydd, ystafell-wely, heddwch
bron: bron, ymarferol, tua, circa, ger, o-gwmpas, cau, cyfagos, bron, gerllaw, cyn-bo-hir, procsimol, yn-fras, prin
Ni-all: methu
dŵr: hylif, hylif, drobwynt
desiderative-hwyliau: 
golau: glow, llachar, cannwyll, bychan, arddull, ysgafn, ysgafn, ysgafnach, golau, glir
nac: nid, nad-ydynt-yn, eto, beth, yn-digwydd, neu
gair: geiriadurol
drws: giât, drws, fynedfa, pennod, porthladd
defnydd: defnyddio, defnydd, bwyta, gwariant, defnyddwyr, ymgysylltu, cais, cyfleustodau, berthnasol, cyflogi
bore: a.m., brecwast
terminative-achos: 
pŵer: cryfder, ynni, gallai, cryf, grym, pwerus, deinamig, salad, goruchafiaeth, awdurdod
eu-hunain: ein-hunain, eich-hun, ei-hun, fy-hun, hi-ei-hun, ei-hun, hunan, ego, pennod
bresennol: ar-hyn-o bryd, y-yn-bresennol, bellach, Ar-hyn-o bryd, rhodd, yn-bodoli, ar-gael
llais: sain, yn-uchel, pleidlais, sain, bleidlais, eitem, si, si
gwyn: wag, gwyn
arian: cyfoeth, arian, ariannol, arian-parod, arian-cyfred, cyllid, ariannol
nesaf: wrth-ochr, ochr-yn-ochr â, nesaf---i, canlynol, yn-ddiweddarach, dimensiwn, ymlaen, dilynol
gwael: fraich, tlodi, drwg, gwaethaf, pwdr, wan
marwolaeth: marwolaethau, marw, marw
ffurflen: siâp, llwydni, fformat, cyfuchlin, patrwm
inessive-achos: 
math: dosbarth, didoli, rhywogaethau, amrywiaeth, math, gyfeillgar, eitem, dda, dymunol, braf, bleserus
yn-aml: yn-aml, yn-gyson, yn-rheolaidd, yn-aml, cyffredin, Fel-arfer,, fel-arfer
blwyddyn: blynyddol, yn-flynyddol, pump
ffrind: gynghreiriad, cariad, gyd, ffrind
gorchymyn: system, trefniant, trefnu, contract, arae, gorchymyn, dro, rhes, ciw
hanfodol-hwyliau: 
rownd: crwn, cylch, lap
yn-credu: ymddiriedaeth, cyfrif, dybio, ffydd, cred, hyder, hyderus, optimistiaeth, optimistaidd
cyhoeddus: y-cyhoeddus, cyffredinol, cynulleidfa
wladwriaeth-cyd-destun: 
mab: haid, bachgen
cant: canfed, wyneb, cant
plant: fyn, epil, plentyn, babi
a-thrwy-hynny: a-thrwy-hynny, felly, felly, fath, ie
gobeithio: dymuno, gobaith, rhagweld, optimistiaeth, optimistaidd
uchod: i-fyny, dros, i-fyny'r-grisiau, uchel, top, uwch, uchaf, ar-draws, yn-ymwneud, trwy, ar, uwchben, ymlaen, ymlaen, i-fyny
annwyl: gariad, ddrud
darllen: darllen, canu, lili
dinas: tref, bwrdeistrefol, sir
eisoes: barod, paratoi, barod, beth-bynnag
ffaith: gwirionedd, realiti, geirwiredd, yn-wir, go-iawn, gwirioneddol, yn-wir, 'n-sylweddol, mewn-gwirionedd, gwnaeth
factive-tystiolaethol: 
clywed: gwrando, clyw, teimlo
lleiaf: ychydig-iawn-o, isafswm, lleihau, minws, llai
efallai: yn-ôl-pob tebyg, Efallai, yn-ôl-pob tebyg, gallai, o-bosibl, bosibl, debygol, tebygol
agored: glir, plaen, yn-glir, moel, yn-amlwg, gwag, penodol, amlwg, awyr-agored, diffyg, golau, agored, agored
corff: cnawd, corfforol, corfforol, yn-gorfforol, corpws, organ, corff
aer: gwynt, awel, hedfan, tywydd, cwmni-hedfan
natur: naturiol, frodorol, yn-naturiol, tarddiad, disgyniad, cynhenid, bywyd-gwyllt, cymeriad
helpu: cynorthwyo, ddefnyddiol, cymorth, cymorth, cynorthwy-ydd, lleyg
llythyr: bost, ysgrifennu
pedwar: pedwerydd
eith-hwyliau: y-dibynnol-hwyliau
tân: poeth, fflam, twymyn
felly,: felly
awr: cloc, o'r-gloch, cloch
rhad-ac-am ddim: rhyddid, rhyddid, eithriedig, gratis, ofer, rhydd, gwag, llac, rhyddhau
rhyfel: brwydr, frwydr
p'un-a: os, ei-hun
rheswm: achos, cyfrif, ffactor, rhesymol, esgus, tiroedd, lledaeniad, plaintiff
unedig: unigol, undod, gynhwysol, undeb, cysylltiedig, gynghreiriad, unigryw, unfrydol
galwad: her, oxidize, apêl, ar, cysylltiad, cyfuniad, ar-y-cyd, ymasiad, gwahoddiad
pam: 
gollwyd: colled, ar-goll
mil: milfed
teulu: cartref, goroeswr
enaid: ysbryd, ysbryd, Mastermind
cwestiwn: mater, galw, darllen, mater
gofal: dan-sylw, pryder, sylw, myfyrdod, gwasanaeth, nawdd, gard, diogelwch, amddiffyn, diogelwch, cadwraeth, cadwraeth, sylw, amddiffyniad, rhybudd, gwella, triniaeth, y-ddalfa
realis-hwyliau: 
golygu: awgrymu, synnwyr, golygu, ystyrlon, ddynodi, canol, asiant, canolig, cyfartaledd, cymedrol
potensial-hwyliau: 
tuag-at: tuag-at, erbyn, yn-gwrthwynebu, gwrthwynebu, fesul, barch, ar-gyfer
allative-achos: 
anthropic-rhyw: 
byr: llai, isel, cryno, cyn-bo-hir, yn-fyr, cerdyn, cul, bychan
gallu: gall, cymwysedig, gymwys, alluog, capasiti, gallu, analluog, gymwys, potensial, posibilrwydd, tebygolrwydd, cryf, pwerus, medrus, gall
byw: bywyd, goroesi, yn-ymddwyn, byw, nyth, dosbarth, cymdogaeth, cymdogaeth, yn-fyw, bywiog, amrwd, byw
pwnc: disgyblaeth, thema, pwnc, gwers, sylwedd, mater, gwrthrych, golygu, deunydd, semantig, mater, berthynas, teitl
yr-un-pwnc marciwr: 
gwahanol-pwnc: 
ateb: gogledd, ateb, ymateb, ateb, cyfateb, ymateb
môr: cefnfor, morol
ofn: arswyd, ofni, arswyd, parchedig-ofn, ofnus, panig, pryder, angst, arswyd, dychryn
deall: dealltwriaeth, deall, canfod, gafael, beichiogi, annealladwy, cynnwys, sylweddoli
caled: anodd, stiff, cymhleth, llym, uchel, dreisgar, ffyrnig, anodd, llym, heriol, anodd, trwm, bedd, difrifol, anesmwyth
termau: dymor, terminoleg, mater, yn-seiliedig, tiroedd, sail, yn-y-bôn, sylfaenol, yn-y-bôn
amheuaeth: amheuaeth, diffyg-ymddiriedaeth, sydd-dan-amheuaeth
dubitative-hwyliau: 
gofyn: gweddïo, ei-gwneud-yn ofynnol, gwrando, os-gwelwch-yn dda
breichiau: arf, ddiarfogi, arfog, fraich
du: 
dod-â: nôl, cario, byddai, arwain
hardd: dda, 'n-glws, hyfryd, hardd, 'n-glws, 'n-bert, ffansi, cwl, 'n-giwt
tywyll: gwae
cynnal: cadw, cynnal, dal, gafael, contract, casgliad, cwlwm, degawd, gronni, aros, hoffi, cynnal
deg: degawd, degfed, deg
sioe: arddangos, perfformio, perfformiad, arddangosiad, cyflwyniad, dangos, ddynodi, digwyddiad, amcanestyniad
stori: myth, hanes, ffuglen, plot
cyffredin: cyffredinol, arferol, arferol, Fel-arfer,, cyffredin, anarferol, cyffredin, cymedrol, normal, afreolaidd, confensiynol, nodweddiadol, Fel-arfer,, fel-arfer, ar-y-cyd, partner, cysylltiol, cyfanred, ar-y-cyfan, cilyddol, corfforaethol
llyfr: sgrolio, wrth-gefn, punt, gwerslyfr
electronig: electroneg, electron, mellt, trydan, trydan, trydanol
sgwrs: sgwrs, sgwrsio, trafod, rhyngweithio, rhyngweithio, negodi, siarad, lleferydd, llafar, disgwrs
marc: marciwr, olrhain, llwybr, sgôr, uchafbwynt, tic, arwydd, signal, arwydd, ciw, brand, cymeriad, label
llog: blodyn, diddordeb, pryder
ysgrifennu: cyfansoddi, ysgrifennu, math, ysgrifenedig
gwely: 
angenrheidiol: hanfodol, pwysig, defnyddiol, beirniadol, hanfodol, arwyddocaol, ddibwys, annatod, hanfodol, bwysicach, angen, o-reidrwydd, intransitive, intransitive, intransitive
syniad: meddwl, ystyriaeth, rhesymu, barn, syniad, Taflu-syniadau
celf: crefft, artistig
vialis-achos: 
brawd: brawd-neu-chwaer, chwaer
weithiau: anaml, o-bryd-i'w gilydd, rywbryd
llinell: gwifren, edau, rhes, lôn, dargludiad, dash, streipen, treth, sgript
tabl: desg, amserlen, catalog
afon: gobennydd, clustog, fflwcs
llygad: penodi, o-gwmpas
gwybodaeth: neges, esboniad, disgrifiad, bwletin, gwybodaeth, data
yn-sydyn: sydyn
rhyfedd: rhyfedd, syndod, rhyfedd, od, Tybed, hyfryd, rhyfeddol, anghyffredin, anhygoel, anhygoel, rhyfedd, ddoniol, ddieithryn, egsotig, lletchwith
dwfn: ddwfn, dyfnder, eang, bas, drylwyr, manwl, cynhwysfawr, feirniadol, dwys, o-fewn, y-tu-mewn, dan-do, mwydyn
newid: addasu, amrywiad, trawsnewid, trawsnewid, treiglad, sifft, newid, diwygio, pontio, diwygiad, amnewid
teimlad: teimlo, teimlad, canfyddiad, argraff, emosiwn, hwyliau, argraff, emosiynol, synhwyraidd, sentiment, synnwyr, angerdd, ymwybodol, ymwybyddiaeth
cwrdd: cael, cydgyfeirio, yn-dod-ar draws, cydymffurfio, Bodloni, cwrdd
pwrpas: gwrthrych, nod, amcan, nod, cyrchfan, bwriad, bwriedir, cymhelliad, targed
hapus: siriol, difyrru, pleser, falch, llawenydd, hapusrwydd, hyfrydwch, falch-iawn, hwyl, hapus, lwcus, falch
ymddengys: ymddangosiad, ymddangos, yn-ôl-pob golwg
gwaed: gwaedu, troseddol
rhosyn: pinc
de: deheuol, canol-dydd, canol-dydd
oer: gaeaf, cwl, coldly
ymlaen: ymhellach, farther, ymlaen, golwg, blaen, uwch, yn-ôl, ystlumod, ymlaen, ymlaen
sefyllfa: lleoliad, sefyllfa, statws, cyfle, cyfle, gofod, safiad, osgo, lle, swydd, eitem
yn-hwyr: yn-araf, diwedd
sefyll: orsaf, fertigol, agwedd, safiad, rhoi'r-gorau-i, osgo, peri, stondin
Mae'n-debyg: rhagdybiaeth, ddamcaniaeth, cymryd-yn-ganiataol, mabwysiadu, dybio, hypothesize, awgrymu
merch: merch, virgin
mwynglawdd: fy
torri: diffyg, ddiffygiol, gostyngiad, diffyg, gostwng, prinder, miss, torri, torri-ar-draws, torri, slaes, cnwd, trim, torri, torri
copi: atgynhyrchu, dyblygu, ailadrodd, trawsgrifio, llungopi, clôn, fersiwn, presgripsiwn
gŵr: dyn, priod
chwech: rhyw
cofiwch: Nodyn, dwyn-i-gof, atgoffa, cof
effaith: dylanwad, yn-effeithio-ar, argraff, effaith, goruchafiaeth, effeithlon, effeithiol, effeithiolrwydd, canlyniad, canlyniad, amlygiad
syrthio: hydref, achos, lleoli, damwain, dillad, torri-lawr, cwymp, gollwng, dirywiad, gostwng
ac-eithrio: oni-bai-bod, tu-allan, y-tu-allan - o, heblaw-am, ar-wahân, eithrio, wrth-ochr, neilltu, neilltu---o
gwallt: 
pasio: gan, drwy, pasio, trwy, ger, wrth-ochr, cynnwys, raddedig, rhwd, croesi, darn, symud-ymlaen
hawlfraint: 
y-fyddin: filwyr, milwyr, llu, milwr
rhedeg: ffoi, draen, rhedeg, gweithredu, gweithredu, gyriant, rhedeg, gêr
ceffyl: pedol, ar
dyfodol: y-dyfodol, yn-ddiweddarach, wedyn, wedi-hynny
orllewin: orllewin
talu: cyflogau, cyflog, cyflog, byrdwn, taliad, talu, ffi, cost
Coch: 
aur: 
dymuniad: wirfodd, awyddus, archwaeth, dymuno, dyheu, annog
chwarae: dawnsio, Gamble, gêm, foch, tegan
meistr: arglwydd, cynradd, prif, athro, dra-arglwyddiaethu, llywodraethu, mr, gŵr-bonheddig, arwain, Mister
swyddfa: asiantaethol, desg
llywodraeth: wladwriaeth, rhes
eglwys: 
hyd: uchder, uchder, span, hyd, hyd
cwmni: cwmni, gorfforaeth, cymdeithas, busnes, corfforaethol, endid, sefydliad, asiantaethol, sefydliad, menter
papur: taflen, cerdyn, siarter
tebygolrwydd: posibilrwydd, tebygolrwydd, debygol, o-bosibl, annhebygol, gobaith, cyfle
yn-enwedig: arbennig, arbennig, yn-benodol, yn-enwedig, arbennig, yn-union, yn-bennaf, yn-bennaf, yn-bennaf, penodol
arth: cario, goddef, wrthsefyll, goddefgarwch, goddefgarwch, cael, meddu-ar, fforddio
ffenestr: 
cytundeb: protocol, anheddiad, cyfaddawd, consensws, cytuniad, cytuno, bargen, cyd-fynd, tendr, chord, contract, confensiwn, trefniant
harddwch: hardd, disgleirdeb, esthetig
dyletswydd: atebolrwydd, cyfrifoldeb, rhwymedigaeth, cyfrifol, tollau, tasg, aseiniad, dyled, ddyledus, gorfod
anfon: trosglwyddo, cyflwyniad, swydd, darlledu, e-bost
pellter: cael-gwared, ystod, gwahanu
tawelwch: llonyddwch
droed: goes, arosfa, clun, traed, chwarter, cerdded, cerdded
gwyllt: wyllt, anghyfreithlon, ffyrnig, bywyd-gwyllt
yn-marw: marw, marw
arbed: gan-arbed, cadwraeth, adennill, gwarchod, cadwraeth, cof, siop, wneud-iawn, achub, cofnod
gwyrdd: amrwd, crai
trafferth: trafferthu, mater, problem, caledi, anhawster, dylino'n, dioddef
gwenu: grin
anghywir: camgymeriad, gwall, camgymryd, wael, gam-drin, ffug, fai, methiant, nam, anghywir, gaffe
amrywiol: gwahanol, amrywiol, lluosog, ystod, amrywiol, aml, yn-wahanol-i, amrywiad, yn-wahanol, yn-amrywio, amrywiaeth
cysgu: cysgu, freuddwyd
quotative-achos: 
dechrau: dechrau, cychwyn, ymgymryd-â, crafu, dechrau, yn-gynnar, cychwynnol, cychwyn, cyntaf, egwyddor
gweithredu: tasg, pwynt, cam, cam, act, gweithdrefn, weithgar, llawdriniaeth, gweithredol, activate, actifydd, symud, arfer, ymarfer, gweithredu, stoc, rali, gweithredu, gweithredu
ymweliad: mynediad, cyfweliad, hygyrch, teithio, taith, taith, taith
dilyn: cydymffurfiaeth, cadw, canlynol, mynd-ar-drywydd, trac, gyd-fynd
ceisiwch: ymgais, ymgais, ymdrech, menter, arbrawf, prawf, sampl
presenoldeb: bodolaeth, yn-bodoli, endid, ased
melys: Candy, addfwyn, ddiafael, 'n-giwt
gyfoethog: digonedd, doreithiog, cyfoethog
gelyn: 
llong: cwch, hwylio, fflyd, hwylio, llestr, mordeithio, fferi
cyflwr: bet, betio, wladwriaeth, sefyllfa, amgylchiadau, statws, ffortiwn, cam, lefel, ffitrwydd, gofyniad
Gan-gynnwys: cynnwys, cynnwys, cynnwys, yn-perthyn
gynhwysol-person: 
gyfrinach: dirgel, dirgelwch, pin, o-dan-y ddaear, secretu
precative-hwyliau: 
gwrtais-gofrestru: 
drwg: niwed, cas, dieflig, drwg, wael
mawrth: gorymdaith, protest, arddangosiad, mars
Beth-bynnag: unrhyw-beth, pa-un-bynnag
aros: yn-parhau-i fod, eistedd, setlo, goroesi, byw, aros
yn-lle-hynny: yn-lle, yn-hytrach, amnewid, amnewid
glas: tylwyth-teg
amhosibl: 
ysgol: campws, ysgol
achlysur: cyfle, digwyddiad, digwyddiad, cyfle, avenue, fargen
briod: priodas, priodi, priodas
bwyd: pryd-o-fwyd, diet, dysgl, feed, maetholion
ugain: 
dawel: dawel, tawel, sefydlogi, dawel, heddychlon, araf, hamddenol, dawel
yn-hawdd: debygol, yn-rhwydd, atebol, hawdd, cyfleustra, bychan, ychydig, ysgafn, cyfleus, syml
darpar-agwedd: 
iaith: ieithyddol, tafod
mynegiant: mynegi, datganiad, ymadrodd, mynegi, datguddiad, amlygiad, ymadrodd
wythnos: Dydd-Sul
neuadd: porth, theatr, cyntedd, gofod, siambr, salon, lolfa, eil, rhedwr, lobïo
perygl: peryglus, risg, barch, bygythiad
eiddo: ased, yn-perthyn, perchnogaeth, frenhiniaeth, meddiant, nodwedd, nodwedd, ystâd, ffortiwn, cyfoeth
eni: genedigaeth
llys: barnwrol, dysgl, fforwm, treial
Yn-gyffredinol,: arferol, fel-arfer, cyffredinol, ar-y-cyfan, eang, Fel-arfer,, cyffredin, Fel-arfer,, yn-fras
gnomic-agwedd: 
werth: haeddu, gwerth, werthfawr, dilysrwydd, teilyngdod
syml: symlrwydd, syml, cyfleus, hyblyg, hawdd, dim-ond, yn-syml, plaen, cymedrol, yn-unig, yn-unig, syth, cyffredin
coed: planhigion, pren, siafft, pren
frwydr: frwydr, brwydr, gwrthdaro, cweryl, scramble
wal: 
nefoedd: awyr
inchoative-agwedd: 
jussive-hwyliau: 
tôn: traw, alaw, tunnell, tunnell, cysgod
sylw: barch, cymryd-yn-ganiataol, dybio, sylw, ystyriaeth, ystyried, perthynas, cymdeithas, perthynas, yn-ymwneud, ynghylch, sylw, sylw
Disgwylir: ragweld
mis: lleuad
profiad: empirig, drwy-brofiad, profiadol, arbenigedd, croen, arbrawf
yn-gyfan-gwbl: gwbl, berffaith, llawn, yn-gyfan-gwbl, yn-eithaf, yn-gyfan-gwbl, gwbl, absoliwt, cyfan, yn-drylwyr, yn-deg, yn-unig, yn-union
ffres: ffres, pur, glân, newydd-wedd, newydd, newyddian
dug: pren-mesur, tywysog
a-gwmpesir: yn-cwmpasu, sylw, off, ar-gau, dan-do
rhwymo: raddau, cyfyngiad, terfyn, border, cyfyngiad, cyfyngedig, cysylltu, yn-dibynnu, rhwymo
ddwyrain: ddwyreiniol, yn-ôl, blaenorol, ymlaen-llaw, cyn, Dwyrain
carreg: marmor, graig, drysor
braidd: rhywbeth, unrhyw-beth, rhai, yn-eithaf, yn-hytrach, ychydig, yn-rhannol, rhywsut
cyfarwyddyd: cyfeiriadedd, dimensiwn, tuedd, agwedd, cyfarwyddyd
cadeirydd: sedd, cadair-freichiau, stôl
cefnogaeth: cynnal, cymeradwyo, cymorth, cynorthwyo, braced, cymorth
dyddiad: hanes, yn-dod-ar draws
pentref: pentrefan, cefn-gwlad
maes: sffêr, deyrnas, rhanbarth, diriogaeth, ardal, parth, sector, parth, arena, stadiwm, gofod, ymyl, cefn-gwlad, gwersyll
caniatâd: caniatáu, clust, trwydded, clirio, gadael, trwydded, trwydded, caniatâd, rhifyn
caniataol-hwyliau: 
llwyddiant: llwyddiannus, llwyddo, ffyniant, cyflawniad, buddugoliaeth, ennill, taro, ennill, enillydd
priodol: yn-briodol, gywir, rhesymol, briodol, gywir, manwl-gywir, hawl, union, yn-union, yn-brydlon, ffyddlon, yn-gywir, yn-gywir, amrywiant, cyd-fynd, addas, cyfleus, addas, cyfateb, gymwys, perthnasol, perffaith, digonol, yn-rheolaidd
bryn: mynydd, mount
cerddoriaeth: cerddorol
distal-dangosol: 
prynhawn: p.m., canol-dydd, canol-dydd, gyda'r-nos
crio: galaru, gweiddi, sgrechian
anrhydedd: anrhydedd, barch, urddas, parchus, anrhydeddus, anrhydeddus, cwrteisi, gogoniant, cyfradd, pris
saith: 
preifat: personol, hunan, yn-bersonol, hunan-, arbennig, preifatrwydd, penodol, exclusive
newyddion: neges
olygfa: safle, golwg, cyd-destun, arddangos, gweledol, cam, golygfa, gobaith, pabell
gardd: parc
hil: hiliol, rasio, rhedeg, gystadleuaeth, twrnamaint, tendr, bridio, gêm
dosbarthol-achos: 
dysgu: astudiaeth, dysgu
gwleidyddol: gwleidyddiaeth, wleidyddol, gwleidydd, polisi
gorwedd: ffug
bwrw: Hurl, taflu, fling, toss, fformat, llwydni, lansio, sied, rhoi'r-gorau-iddi
bwyta: pryd-o-fwyd, feed, dysgl, bwyta, bwyta
llawr: ryg, ddaear, gwaelod, pridd, cerdded, uchel, tal
sâl: sâl, claf, ddolurus, salwch, ffug, wael
gwreiddiol: tarddiad, yn-wreiddiol, rhagarweiniol, cychwynnol, synthesis, yn-y-lle cyntaf, frodorol, dilys, cynhenid, cynhenid, prif, cynradd, prototeip
haf: gwres
crefydd: crefyddol, dyled
llun: portread, peintio, image, llun, ffotograffig, ffotograffiaeth, photo, llungopi, lluniadu, snap, ffilm, darlunio, portread, ffig, ffigur
dianc: ffoi
awdur: awdur, athro, golygydd
brown: llwyd, llwyd, lliw-haul, efydd
benderfynir: penderfyniad, penderfynu, penderfynu, pendant, bendant, dylunydd, penodedig, canfod, sefydlog, penodol
poen: brifo, anguish, boenus, galar, ddolurus
gwanwyn: bluen, ein, ni
ganrif: oed
meddal: concessive, llyfn, fân, tendr, ysgafn, dawel, addfwyn, ddiafael, ysgafn
cornel: ongl, lletem, boddi
cynhyrchu: cynhyrchu, cynhyrchu, cynhyrchiol, fabricate, gweithgynhyrchu, gweithgynhyrchu
chwerthin: chellwair
anghofio: edrych-dros
ewrop: 
wyth: wythfed
gwisg: gwisgoedd, dillad, gown, gwisg, nadd, gwisg, gwisg
ofnadwy: ofnadwy, erchyll, ofnadwy, brawychus, aruthrol, trasig, brawychus, dychryn, gwrthun, ofnadwy
anadl: anadlol, anadlu, anadlu, anadlu-allan, ego, gasp
ddoeth: rhesymol, synhwyrol, synhwyrol, meddylgar, clyfar, smart, deallus
meddiannol-marciwr: 
cof: cof, cyfeirnod, cofeb
modern: cyfoes, soffistigedig, moderneiddio, ffasiynol, diweddar, disgwrs
fan-a'r-lle: pwynt, dot, o'r-gloch, lleoliad, staen, blemish, chlytia, lle, unman, safleoedd, locws, safle, lleol, o-hyd, arwydd, ddaear
yn-codi: planhigion, dringo, hwch, dringo, i-fyny, bwrdd, taith, codiad, codi, codi, ymddangosiad, tyfu
egwyl: Torri-mewn, brêc, cyrchfan, lolfa, ymyrraeth, cyfwng, bwlch, Smash, chwalu, rhoi'r-gorau-i, saib, torri-ar-draws
hanner-cant: 
ynys: 
cyffwrdd: cysylltu
addewid: ymrwymo, ymrwymiad, addewid, penodiad
commissive-hwyliau: 
gradd: cyfartal, raddau, gradd, ansawdd
cynllun: cynllun, bargen, rhaglen, rhaglen, menter, cynllunydd, cynnig, prosiect, plot, braslun, amcanestyniad, cynllun, fflat, lluniadu, dylunio
ymddygiad: tuedd, ymddygiad, ymddygiad, ymddygiadol
syndod: rhyfeddol, annisgwyl, damweiniol, syndod
munud: 
ergyd: saethu, saethu, bullet, bwledi, llun, photo, ergyd, bang, coup, taflu, ffrâm
waeth: drwg, gwaethaf, garw, anffafriol, wael, ofnadwy, israddol, i-fyny, i-fyny'r-grisiau
gwydr: drych, grisial, jar, sbectol, eyeglasses
enghraifft: enghraifft, darlunio, model, patrwm, trosiad, prototeip, fel, gynrychioli, sbesimen, achos, cynsail, sampl, paradeim, er-enghraifft
yn-ddiogel: sicrhau, diogelwch, diogelwch, yn-ddiogel, hyderus, yswiriant
meddyg: meddyg, therapydd, ymarferydd, meddygol
completive-agwedd: 
dro-ar-ôl tro: yn-aml, rheolaidd, gyson, yn-gyson, o-bryd-i'w gilydd, yn-aml, yn-rheolaidd, ailadrodd
milwrol: milwyr, milwriaethus
cynnes: poeth, glyd, gwres, cynhesrwydd, tymheredd, gwresogi, gram, muggy
diod: diod
cwestiynau: 
dicter: ddig, rage, dicter, lidio'r, gwaethaf
yn-uniongyrchol: syth, uniongyrchol, anuniongyrchol, awtomatig, syml, ar-unwaith
het: cap, helmed
ci: 
gwas: stiward, gweinydd, morwyn
balchder: drahaus, falch, yn-falch
dorf: brwyn, gorlawn, mob, swm, maint, poblogaeth, llu, pentwr
trên: cerbyd, car, wagen, cert, rheilffordd, rheilffyrdd, addysgu
moesol: moesoldeb, foesol, moesegol, moeseg, morâl, ysbrydol
cysylltiedig: cysylltiol, perthnasedd, cydberthyn, gysylltiedig, dan-sylw, pryder, perthnasol, hyd, cysylltu, berthnasol, cysylltiedig
fynd-i-mewn: log, mynediad, wladwriaeth, dangos, mewnosod, cynnwys
rheol: gweinyddiaeth, domination, gyfundrefn, dyfarniad, rheithfarn, dyfarniad, dyfarnwr, canolwr, llywodraethu, gyfraith, deddfwriaeth, norm
cleddyf: llafn
ymosodiad: goresgyniad, ymosod, ymddygiad-ymosodol, trosedd, ymosodiad, trosedd, streic, dechrau, sarhaus
iechyd: iach, cyfarch
paragraff: pennill, cymal, darn, pwynt, agwedd, safiad
cymdeithasol: cymdeithas, yn-gymdeithasol
ad-daliad: ateb, ymateb, dychwelyd
n-chwith: difaru, polyn, pardwn, esgus, ymddiheuriad
dewrder: pluo'n, beiddgar, hyderus, nerf, gwroldeb, Dare
gras: ffafrio, ffafrio, drugaredd, caredigrwydd, haelioni, rhan, pardwn
swyddogol: ffurfiol, yn-ffurfiol, yn-swyddogol, swyddog, clerc
a-ddarperir: darparu, cynnig, gan-ddarparu, cyflwyniad, ar-gael, cyflenwad, darpariaeth, darparu-ar, os
cais: gweddi, galw, hawliad, ei-gwneud-yn ofynnol, gofyniad, ymchwiliad, ymchwiliad, prydlon, cais, cais
Cipolwg: cipolwg, golygfa, agwedd, canfyddiad, outlook, golwg, edrych
symudiad: cynnig, ymgyrch, chwaraeon, crwsâd, act, symud, symudedd, busnes, symud
disgwyl: disgwyliad, ragweld, rhagweld, aros
gyferbyn: blaen, yn-gwrthwynebu, groes, gwrthwynebu, ar-draws, cownter
deuddeg: 
cymryd-rhan: ymgysylltu, prysur, cymryd-rhan, cymryd-rhan, meddiannu
gwin: grawnwin, alcohol, alcoholaidd
blas: blas, blas, blasus, abwyd, croen
haearn: dur, metel
dosbarthu: trosglwyddo, defnyddio, cyhoeddi, cyhoeddi, trylediad, cylchredeg, dosbarthu, dyrannu, rhannu, rhaniad, rhaniad, i---hollt, dosbarthu
fasnach: masnachu, busnes, fasnach, nwyddau, rhyngrwyd, fargen, trafodiad, masnachwr, siopa, marchnata
mantais: ennill, elw, budd-dal, hyfyw, daioni, ased, dewis, goruchafiaeth
dillad: cwpwrdd-dillad, brethyn, dillad, gwisg, dilledyn, dillad
barnwr: dyfarniad, dyfarniad, dyfarnwr, canolwr
gwahaniaeth: gwahaniaethol, gwahaniaethu, gwahanol, ar-wahân, ar-wahân, yn-wahanol, amrywiad, ar-wahân, amrywioldeb, amrywiant, rhaniad
bryderus: argyfwng, brys, dan-sylw, dychryn, poeni, pryder, pryder, poeni, meddylgar, anghyfforddus, peri-pryder, ofni, awyddus, tarfu, brawychus, brwdfrydig, awyddus, aflonydd, anesmwyth
capten: 
gorffenedig: gorffen, diwedd, cyfyngedig, barod
rhoi'r-gorau-i agwedd: 
chwilfrydig: awyddus, diddorol, cyffrous
tramor: dramor, estron, estron, egsotig, ddieithryn, allanol
intensifier: dwysau
pwysigrwydd: rheidrwydd, perthnasedd, golygu, gwerth
yn-olaf: yn-y-pen draw, yn-y-pen draw, cyfyngedig, terfynol, yn-y-pen draw, terfynell, fân
bil: act, llawysgrif, cyfrif, calcwlws
profi: prawf, cadarnhau, cadarnhau, dangos, tystio
atal: yn-dod-i ben, gwahardd, cadw, repress, cyfyngu, lesteirio, bloc, atal, atal, gwahardd, osgoi, gwrthyrru, atal, atal
gwddf: gwddf
cyfreithiol: barnwrol, gyfraith, cyfreithlon, ffrâm
sych: coesyn
gweini: gwasanaeth, ennill, darparu-ar, cynnig
colli: miss, colli'ch
tystiolaeth: tystiolaethol, prawf, arwain, cliw, cyfeiriadur, arddangos, tyst
tystiolaethol-achos: 
cynnydd: stride, dilyniant, datblygiad, blaengar, datblygiadol, ymlaen-llaw, symud-ymlaen, gwella, codiad
adeilad: adeiladu, strwythur, adeiladu, adeiladu, safleoedd
chwilio: dod-o-hyd i, darganfod, darganfyddiad, hymgais, canfod, ceisio, ceisio, ymchwil, arolwg, mynd-ar-drywydd, ymchwiliad, ymchwiliad, ymchwiliad
drist: isel-eu-hysbryd, yn-anffodus, ddiflas, gofidus, cynhyrfu, edifeirwch, ddigalon
pechod: euogrwydd
deg-ar-hugain: 
onest: diffuant, ffyddlon, yn-onest, gonest
cau: cau, ar-gau, cau, off, gorsedda, i---ben, pecyn, bwndel, parsel, paced, pecyn, gronni
banc: fainc, tun
tynged: ffortiwn, lwc, cystrawennol, cyrchfan, llawer
coedwig: jyngl
mesur: medrydd, mesur, pwyso, metr, metr
fel-arall: fel-arall
nant: llif, cymal, ar-hyn-o bryd, trydan, fflwcs, jet
bara: pobi, hwch, brechdan
ychwanegol: ychwanegol, sbâr, ar-ben-hynny, dros-ben, gwarged, ymhellach, Hefyd, atodol, ychwanegu, atodiad
dewis: dewis, detholiad, dewiswch, detholus, ddewis, ethol, deialu, bleidlais, arholiad, dewis
anifeiliaid: 
zoic-rhyw: 
eventive-hwyliau: 
yr-un-digwyddiad marciwr: 
lluosogol-achos: 
trwchus: ordew, drwchus, trwchus, braster
creadur: organeb, hanfod
glaw: gwlyb, glawiad, cawod
wyneb: wyneb, lefel, awyren, ardal
sanctaidd: sanctaidd, net, yn-unig
Gorffennaf: 
adroddiad: penderfyniad, datganiad, cymhareb, perthynas, perthynas, deg, arddangosfa, traethawd, amlygiad, sgôr
arfordir: llinyn, traeth
ffeil: dogfen, coil, porthdy, proffil, archif
ysgwydd: siafft, echel, portread, crib, fraich
synnu: rhyfeddu, Tybed
brenhinol: imperial, frenhiniaeth, deyrnas, ymerodraeth, go-iawn, gwirioneddol
cân: dôn, trac, canu, cerdd
cysur: rhwyddineb, hamddenol, ymlacio, anogaeth, cyfleustra, gorffwys, rhyddhad
unrhyw-un: unrhyw-un, rhywun, rhywun, neb, pawb
glaswellt: gwair, chwyn, perlysiau, lawnt, gram
tynnu: llusgo, tynnu, haul, diddorol, apêl, deniadol, tynnu'n-ôl, cyffrous, denu, ddiddorol, lluniadu, tynnu, tynnu
agor: rhagarweiniol, cychwynnol, darganfyddiad, bwlch, slot, agored
Mehefin: 
pysgod: acwariwm
cyfalaf: pennod, cronfa, ased
fron: frest
eira: iâ
addysg: addysgu, gwers, addysgol, llythrennedd, ffurfiant, hyfforddiant, addysgedig, academaidd
miniog: llachar, ffyrnig, llym, sydyn, sbeislyd, pigfain, acíwt, awyddus, creision
biti: drugaredd, tosturi, cydymdeimlad, gydymdeimladol, tosturiol, ofnadwy, cosb, bluen, anffodus, yn-gresynu, niwed, difrod, edifeirwch
traul: ffi, gwariant, cost, rhifyn, allbwn, codi-tâl
eich-un-chi: eich
miliwn: filiynfed
wedi-blino: blinder, blinedig
lladd: llofruddiaeth, lladd
cysgod: cysgod
pwysau: llwyth, trwm, drwm, pwyso, pwysau
màs: ansawdd, ar-y-cyd, maint, swmp, lluosog, llawer, lwmp, clwstwr, mob, trosedd, toes, pasta
sefydlu: gorsedda, solid, yn-gadarn, sefydlog, creu, sefydlu, periglor
dewr: beiddgar
tenau: denau, gwanhau, lleihau'n-raddol, cul, heb-lawer-o fraster, dirwy, cynnil, fân, bychan, damn, rarefied, cain, medrydd
bodlon: falch, boddhad, bodlonrwydd, falch, Bodloni, boddhaol
gwiriwch: gwiriwch, edrych, Gwylio, dewis, archwilio, arolygu, arholiad, prawf, archwiliad, canolradd, arolwg, ymchwilio, canfod, adolygu, rheoli
rhinwedd: caredigrwydd, rhinweddol, daioni, haelioni
cenedlaethol: cenedl, cenedligrwydd, ethnig, cartref
ddwyfol: sanctaidd
cwm: basn
dyfalu: casgliad, sydd-dan-amheuaeth, dybio, amcangyfrif, amcangyfrif, rhagfynegiad, rhagfynegi, rhagolwg, dyfalu
hapfasnachol-hwyliau: damcaniaethol-hwyliau
melyn: golau, ambr, melyn
gweddillion: gweddillion, gweddilliol, sy'n-weddill, bwyd-sydd-dros ben, gorffwys
plygu: crwm, plygu, dolennog, tuedd, dirdroi, llethr, lethr, gogwydd, plygu
blwch: gês, drôr, cronfa, cit, gall, bin
tymor: tymhorol, pennod, orsaf, cyfnod
gwyddoniaeth: gwyddonol
turio: twll, dril, ddiflas, ddiflas, pierce, cythruddo, fforwm
ewythr: 
rhestr: mynegai, catalog, dewislen, gofrestru
Awst: 
poblogaidd: nifer-yr-achosion, enwog, amlwg, gwerin
anhysbys: ddieithryn
cyfarwydd: gydnabod, llinach, disgynnydd
cyfarwydd-gofrestru: 
darllenydd: canwr
ymagwedd: cyrraedd, mynediad, techneg, dacteg, methodoleg, agwedd, modd, dull, ffasiwn, gweithdrefn, brasamcan, rhyngwyneb
ddwywaith: dwbl
deallusol: meddwl, cudd-wybodaeth, meddyliol, deallus, seiciatrig, meddyliwr, doethineb, ysbrydol
wirioneddol: 'n-sylweddol, yn-wir, yn-union, mewn-gwirionedd, ymarferol, bron, yn-wir, diffuant, realistig, berffaith, yn-bendant, yn-siwr, yn-sicr, yn-sicr
offeiriad: clerigwyr
glwyfo: hanafu, clwyf, brifo
tristwch: galar, tristwch, iselder, isel-eu-hysbryd, alaru, anguish
palas: 
guro: trechu, pwnsh, slap, guro, gamp, rhythm, goresgyn
eh?: 
ffwl: gwirion, tric, twyllo, twyllo, dwp, ffôl, mad, crazy, wallgof, camarwain
ymyl: fin, ymylol, ymylol, dwys, border, ymyl, bwrdd
naw: nawfed, newydd
byrstio: chwyth, ffrwydrad, ffrwydro, cracio, ffyniant, ffit, bang
yn-dioddef: goddef, cynnal
sŵn: swnllyd, gweiddi, ffwdan, ru
llenyddiaeth: llenyddol
cyngor: cyngor, argymell, argymhelliad, cynghori, ymgynghori, bwrdd, tip
gwag: wag, gwag, drwm, hamdden, null, gwacter, gwactod, ofer
rheng: swydd, gradd, cyflawniad, categori, gwerth, dosbarth
storm: 
poced: bag, paced
dychymyg: ffansi, dychmygu, rhagdybiaeth, ffantasi, ffuglen, dychmygol
dedfryd: dyfarniad, dyfarniad, cynnig, theorem, awgrym, cynnig, cosb, euogfarn, ymadrodd, condemnio, Gyfrannog-ymwrthod, cosb
Tachwedd: 
Rhagfyr: 
absenoldeb: absennol, diffyg, prinder
diolch: diolchgarwch, ddiolchgar, diolch, Diolch
cyfeiriad: 
aderyn: hedfan, awyren, jet, awyrennau, awyren, cwmni-hedfan
perchennog: bos, landlord
cot: gown, wain, clawr, siaced, ffwr
paratoi: barod, paratoi, trefnu, paratoi, llunio
cysylltiadau: perthynas, perthynas, cymhareb, perthnasedd, berthnasol, berthynas, cyfathrebu, cyfathrebu
mwg: ysmygu, tybaco, llosgi
Ionawr: 
peiriant: peiriannau, peiriant, awyren, gerbyd
cynnwys: deunydd, stwff, cydymffurfio, Bodloni, cynnwys, cynnwys, cynnwys, cynnwys
dannedd: dant, gêr
cywilydd: warth, cywilydd, swil, embaras, embaras, embaras, moel, noeth, sarhad, dicter
bae: aeron, fagina
ymennydd: Mastermind, mêr
ffoniwch: mân, deialu, cwrl, dolen, teiars, teiars, sêl, stamp
ymadrodd-marciwr: 
sgwâr: 
ffrwythau: 
te: 
eglurwch: esboniad, dangos, mynegi, mynegi, datgan, egluro, dehongli, sylwadau
croeso: cyfarch, derbynfa, diddanu, hey, hi, cyfarch
barddoniaeth: cerdd, pennill
prynu: prynu, caffael, fforddio, farchnad
ffyddlon: anonest, ffyddlon, ffyddlon, ffyddlon, gywir, dibynadwy
cyffro: symbyliad, gyffrous, ffwdan, tensiwn, pryfocio, llawenydd, cyffroad, fflysio, pryder
deugain: 
Ebrill: 
garedig: os-gwelwch-yn dda, gyfeillgar, ysgafn
Hydref: 
chwerw: caledi, agony, anguish, chwerw, dioddef, boenus, Sting
gaethweision: caethwasiaeth
rhydd: annibynnol, llac, datrys, datrys, slac, gwag, rhydd
testun: geiriad
credyd: morgais, cerdyn-credyd, dyled, rhoi-benthyg, benthyg, benthyciad, bri, dilysrwydd, hygrededd
pymtheg: 
creulon: ffyrnig, anodd
ymuno: cymryd-rhan, mynychu, cymryd-rhan, cychwyn, cadw, cyfranogwr, cyfranogiad, uno, cysylltu
proses: trin, gweithdrefn, drin, llawdriniaeth, treial
trosedd: euogrwydd, trosedd, trosedd
llwch: argae, powdr
ymarferol: swyddogaethol, bragmatig, ymarferol, cyfleus, bron, 'n-hylaw, gymhwysol
lliw: lliw, paent, fympwy, llifyn, golau, lliw, lliwgar, fflysio, gorffen
dinistrio: llongddrylliad, tanseilio, sabotage, diraddio, dymchwel, malwch, Smash, adfeiliedig, drysu, dileu, negyddu, dinistrio
cynyddu: symud-ymlaen, gwella, mount, codi, ychwanegu, mewnosod, twf, chwyddo
trwyn: 
cyfaddef: cydnabyddiaeth, ildio, derbyn, cydnabod, cydnabod, cymeradwyo, cymeradwyo, grant, dyfarniad
ddoe: yfory
hesternal-amser: 
methu: methiant, aflwyddiannus, trechu, cam-yn-ôl, methu, drysu, siomi
parhau: symud-ymlaen, parhaus, parhaus, parhad, yn-gyson, parhau
gwisgo: cario, porthor
ddall: 
dwsin: nifer
hedfan: hedfan, neidio, hedfan, hedfan
canmoliaeth: edmygedd, edmygu, enw-da, teilyngdod, longyfarch, llongyfarch, gogoniant, enwogrwydd
diafol: 
yn-raddol: yn-araf, graddol
aberth: dioddefwr, ysglyfaeth, anafedig
ymarfer-corff: athletau, gwaith---allan, aseiniad, arfer, ymarfer, chwaraeon, ffitrwydd, ymarfer
cydwybod: rhagenw, ymwybyddiaeth
theori: egwyddor, damcaniaethwr, theorem
gweinidog: 
casineb: cas, ffiaidd, casineb, ddim-yn-ei hoffi, rhagfarn, dig, digio, ffieiddio, chasineb, ffieiddio
llyn: 
canolfan: canolog, canolfan, orsaf, pencadlys
llewygu: anymwybodol, anobaith, anobeithiol, wan, golau
rhesymegol-rhyw: 
gofalus: meddylgar, gadw-mewn-cof, canolbwyntio, ofalus, union, gywir, manwl-gywir, manwl
mwynhau: mwynhad, gwerthfawrogi
addoli: defodol
nwyddau: cynnyrch, eitem, nwyddau, nwyddau, stwff
croen: lledr, amsugno, rhisgl, cragen, croen, ffwr, croen
to: teras, nenfwd, yn-cwmpasu, sylw, caead
goron: 
castell: cawell, Rook, cloi
orsedd: 
ynghlwm: ymgysylltu, amodol, atodi, cysylltu, dibynnol, cysylltiol
filltir: tuedd, llethr, heb-lawer-o fraster, graddiant, barod
eithafol: uchafswm, yn-y-pen draw, polyn, polar, eithafol, difrifol, dwys, dwys, aelod, tip
carchar: carchar
cwpan: myg, powlen
aelod: organ, aelodaeth, aelod, mewnol
sifil: cartref, dinesydd, dinesig, sifil
ym-mhob-man: drwy-gydol, yn-unrhyw-le
yn-amlwg: amlwg, yn-amlwg, tystiolaethol, uniongyrchol, yn-amlwg, yn-bendant, pendant, glir, yn-glir, tryloyw, aneglur, amlwg
cwpl: pâr, par, dwbl, deuol, ychydig, nifer, anwedd
cyfaint: sbŵl, llawer, raddau, swm, gymharol, meintiol, bloc, swp, modiwl, swmp, capasiti, sylw
arfer: cleient, dewisol, gwisgoedd, tollau, arfer, arfer, arfer
bwa: bwa, nionyn, gromlin
siwt: cyd-fynd, gwisgoedd, briodol, cyd-fynd, cyfateb, paru, achos, erlyniad, ymgyfreitha, gown, hawliad
cig: cnawd, cig-eidion
llaeth: llaeth, tap, jeli
vegetal-rhyw: 
gweledigaeth: golwg, trance, mewnwelediad, ffasâd, golygfa, cipolwg, gobaith, tirwedd, outlook
prin: anaml, prin
cefnder: perthynas
bont: gradd, dec
gwarchod: amddiffyn, cadwraeth, gard, darian, amddiffyn, cadw, cynnal, gwarchod, sicrhau
halen: gorliwio, gor-ddweud, hallt
diniwed: 
brenhines: 
cyfrif: partition, cyfrif, cyfrifo, yn-dibynnu, siom, cyfrif
chwilfrydedd: pry
dawns: drwm, dawnsio, neidio, skip
gwesty: llety, tafarn
llenwi: 
carcharor: 
siop: siop, stondin, busnes, bargen, siopa
grisiau: grisiau, grisiau, ysgol, drôr
beg: ceisio, cymryd-yn-ganiataol, pledio'n
tywod: 
treisgar: trais, ffyrnig, aflonydd, hyfryd, difrifol, cryf, dwys, egnïol, wyllt, dwys
Medi: 
ymadawiad: gadael, gadael, allfa, allbwn
adfail: dinistrio, subversion, difrod, difetha, trychineb, llanast
sgiliau: gallu, alluog, capasiti, effeithiolrwydd, cymhwysedd, crefft, arbenigedd
gwartheg: buwch
offer: cyfarpar, dyfais, cit, gêr, gwisg, mynd-i'r-afael â, caledwedd, techneg, technoleg, gyfleuster, gêm
cegin: coginio, popty
gwerthu: gwerthu, lled
cyflymder: cyflymder, cyflymder, momentwm, sydyn
casgliad: casgliad, tynnu'n-ôl, allbwn, goblygiad, penderfyniad, canlyniad, canlyniad, casgliad, casgliad, cynnig
cyfrifiadur: cyfrifiadura
tragwyddol: erioed, am-byth, ddiddiwedd
cyfyngedig: cyfyngedig, cyfyngu, cyfyngu, delimited, cyfyngedig, cyfyngu
llyfrgell: cwpwrdd-llyfrau
sylfaen: sylfaen, sail, yn-seiliedig, sylfaenol, cynradd, elfennol, craidd, sylfaenol, gwaelod
dryswch: llanast, chaos, ffwdan, ddryslyd
gogoneddus: gwych, hyfryd, nobl
yn-yr-un modd: yn-yr-un modd, hefyd, yr-un-mor
ofnus: ofni, ofnus, arswyd, dychryn
anhapus: anffodus, anlwcus, ddiflas
erthygl: traethawd, eitem
cogydd: coginio, pobi, berwi
band: gwregys, rhuban, tâp, garfan, grŵp, stribed, streipen, parth, llinyn, criw, clwstwr, lôn
anialwch: anialwch, anghyfannedd
cusan: 
pêl: rwber, sffêr, canon, bullet
ffon: stoc, gansen, cadw, pren, pren, ystlumod, ciw
ddadl: rhesymeg, symud, rhesymu, ddadlau, trafodaeth, dadl, anghydfod, llwybr
arsylwi: arolygu, archwilio, archwilio, ymchwilio, arsylwi
bendith-hwyliau: 
trawiadol: rhagorol, syfrdanol, streic, sylweddol, arwyddocaol, sylweddol, amlwg, trawiadol, syndod, rhyfeddol, glir, llachar
yn-euog: euogrwydd, ddyledus, troseddu, troseddwr, euogfarnu
gwn: reiffl, arf, canon, Rook
heddlu: gorfodi, goruchwylio
cuddio: cuddio, secretu, guddio
alldaith: ymgyrch, gyriant, taith, taith, mordaith, taith
anwybodus: anwybodaeth, anymwybodol, anwybodus, ffôl, gwirion, dwp, chwerthinllyd
hael: rhyddfrydol, lletygarwch, haelioni
cloud: 
gwastraff: ddiwerth, diangen, gwrthod, gwrthod, gwrthod, gweddillion, bwyd-sydd-dros ben, garbage
Chwefror: 
clefyd: salwch, salwch, coronaidd, boddhaol, boddhaol, syndrom
treulio: blodyn, defnyddio, gwariant, mynd-ar-drywydd, skip, miss
ffynhonnell: adnodd, amrwd, ffynnon
menter-achos: 
modryb: 
oedi: ohirio
oedi-hanfodol: 
adroddwyd-tystiolaethol: 
canol-nos: gogledd
arwr: rhyfelwr, pencampwr
athroniaeth: athronyddol
bys: traed
gyfforddus: yn-dda, yn-drylwyr, yn-briodol, yn-esmwyth, gyfforddus, cyfleus, ymlacio, dymunol, glyd, 'n-hylaw
rhywle: yn-unrhyw-le
wasg: cyfryngau, cylchgrawn, cyfnodolyn, argraffu, math, fformiwla
staff: criw, personol
Gwobr: gwobr, rhodd, dyfarniad, bonws
bai: fai, nam, nam, dyled, euogrwydd, snub, erlyn, atebolrwydd, cyfrifoldeb
diflastod: caledi, dioddef, anguish, ddiflas, diflastod
talcen: 
ad: hysbyseb, hysbysebu, hysbysebu, hysbyseb, cyhoeddiad, cyhoeddusrwydd, rhybudd, datganiad
angel: tirfeddiannwr, tylwyth-teg
unigol-rhif: 
wawr: gyda'r-hwyr
masnachol: galwedigaethol, hysbyseb, masnachu, busnes
maddau: esgus, pardwn, goddef, eithriedig, lleddfu, diswyddo
defaid: cig-oen
amynedd: gwroldeb, goddefgarwch
fferm: ranch, meithrin, planhigfa, amaethyddol
cyfeiriadol: cyfeirnod, gyfeirio
corn: gwenith, corn
allweddol: bond, botwm, wrench, switsh, prif, hanfodol, amlwg, sensitif, mawr, arbenigol, prif-ffrwd, cliw
mwyafrif: llawer, y-rhan-fwyaf o
gwendid: anallu
awyrgylch: amgylchedd, awyr, hedfan, gofodol
sigh: gasp
dynoliaeth: dynol
gwrthwynebiad: yn-gwrthwynebu, yn-gwrthwynebu, gwrthwynebu, cyferbynnu, wrthsefyll, protest, groes, ymwrthedd, cownter, gwrthwynebydd, anghymeradwyaeth, gwrth-, resistant, gwrth, gwrthwynebiad
disg: disg, tafell, cownter, silindr, plât, cofnod, hambwrdd, gyriant
unig: ei-ben-ei hun, unigrwydd, ar-wahân, sengl, yn-unig
artist: perfformiwr, peintiwr, diddanwr
marchog: reidiwr
swyn: carismatig, atyniad, hud, sillafu
penderfyniad: penderfynu, dyfarniad, rheithfarn, dyfarniad, penderfyniad, penderfyniad, ateb
llywodraethwr: ceidwadol, pren-mesur
gangen: 
gwarediad: trefniant, cyfluniad, tuedd, tuedd, darpariaeth, cynllun, hwyliau, amserlen, amserlen
brwdfrydedd: zeal, cynhesrwydd, brwdfrydig, croen, ewfforia, angerdd, ecstasi, hwyl
anwythol-hwyliau: casgliadol-hwyliau, diddwythol-hwyliau
cymuned: cymdeithas, categori, pobl
olew: braster, tanwydd, ffosil, mêr, thermol, menyn
pibell: tiwb, tap, faucet, baw, camlas
print: rhifyn, pwysau, argraffu, echel, llwydni, argraff
oh: ya
disgwrs-cyd-destun: 
vocative-achos: 
caban: bwthyn, pabell, porthdy
larwm: cloch, effro, dychryn, dychryn
nerfus: amser, ddryslyd, tarfu, cynhyrfu, embaras, tarfu, aflonyddu, gofidus, nerfol, poeni, nerf
parhaol: hyd, yn-aml, yn-rheolaidd, parhaus, gyson, sefydlog, cyson
cyllell: gweiddi, llafn
sidan: 
ddirmyg: dirmygu, casineb, ddim-yn-ei hoffi, ffieiddio, chasineb, snub, sarhad, dicter, esgeulustod
uffern: 
gwahanu: ar-wahân, neilltu, ar-wahân, ar-wahân, yn-wahanol, ar-wahân, oeraidd, arwahanol, unigedd, diarddel, delimited, gwahanu
o-ddifrif: difrifol, ddiffuant, trwm, drwm, sydyn, yn-weithredol
cymysg: cymysgedd, cyfuniad, cyfansawdd, cymysgu, ar-y-cyd
pren: pren, pren
Mae'n-well: dewis
rhybudd: rhybudd, rhybuddio, effro, cofeb, rhybudd
admonition-hwyliau: 
impulse: ysbrydoliaeth, pwls, swp, annog, momentwm, byrdwn
uchelgais: siomedig, siom, chwant, barus, annog-pobl-i beidio, uchelgeisiol
gwadu: gwrthod, gwrthod, gwadu, gwrthod, negyddu, gwrthod, negyddu, dirywiad, anghymeradwyo, diswyddo, gwahardd, gwaharddiad, gwahardd, gwrth-ddweud
cyfansoddiad: siarter, cyfansoddiadol
offeryn: teclyn, llestr, endid, organ, cynhwysydd, cyfleustodau
parhaus-agwedd: 
llanw: don, snap
coleg: cyfadran, academi, campws, prifysgol
cynffon: ciw
genhedlaeth: disgynnydd
cath: 
uniongyrchol-tystiolaethol: 
wedi'u-gadael: esgeulustod, gadael, anghyfannedd, rhoi'r-gorau-iddi, rhoi'r-gorau
un-ar-ddeg: 
greddf: digymell
nodweddiadol: nodwedd, arbenigedd, cymeriad, arfer, tuedd, ymddygiad, ymddygiad, nodwedd, cymeriadu, ansoddol, nodweddiadol
llwyth: cefnffyrdd, coesyn, llwyth
bryderus-hwyliau: 
lloches: cyrchfan, preswylio, anheddiad, cynefin, preswyl, amddiffyn, dorm, lloches
anghwrtais: rudely, garw, angharedig
marchogaeth: taith, reidiwr
ysgwyd: Taflu-syniadau
diwydiant: sector, gweithgynhyrchu, diwydiannol, industrialize
proffesiwn: galwedigaethol, gyrfa, galwedigaeth, proffesiynol
lamp: bwlb
coffi: caffi
ufuddhau: cyflwyniad, cydymffurfio, gwrando
gogleddol: gogledd
nyrs: 
sicrhau: sicrwydd, gwarant, addewid, gwarant, yswirio, sicrhau, canfod, cadarnhau, darparu, darparu-ar, yn-siwr, argyhoeddi, cadarnhau, sicrhau
cadwyn: dilyniant, cyfres, llinyn, carchar
addysgu: cyfarwyddyd, addysgu, hyfforddiant
esgidiau: esgid, sandal
iard: cod, dudalen, carwriaeth
amwys: amwysedd, aneglur, amwys, aneglur, dirgel, ansicr, amhenodol, don, gwag
mewn-mannau-eraill: arall
fflat: fflat, cylch, compartment, suite
gweithgaredd: trafodiad, swyddogaeth
Dydd-Sadwrn: Saboth
heulwen: solar
gweddw: 
elfen: agwedd, nodwedd, eitem, cynhwysyn, organ
myfyrio: myfyrdod
sefydliad: meinwe, sefydliad, trefnu, gwisg, gorfforaeth, cyfleustodau, asiantaethol, endid, system, strwythur, gwead, cynllun, sefydliad, sefydliad
seren: 
digwyddiad: digwyddiad, digwyddiad, ffenomen, nifer-yr-achosion, damwain, achos
gwestai: ddieithryn, ymwelwyr, estron, estron, newydd-ddyfodiad, cleient, cwsmer, llu
bar: moel, tafarn, llwyth, cludo-nwyddau, caffi, bariwm
potel: jar
bendithia: bendith
gynnwrf: trin, cymysgu, ennyn, terfysg
mewnol: o-fewn, y-tu-mewn, tu, mewnol, lleol, cartref, dan-do, meddyliol, mewnol
atgyweiria: sefydlog, addasu, adolygu, ateb, datrys, datrys, rhwymedi, gwella, sythu, iawn, iawn, gyson, cyson, syllu, gywir, penderfynu, sefydlu, nodi, canfod
deillio: cael, caffael, deilliadol, cael, derbyn
pant: plaen, moel, wag, cebl
talaith: taleithiol
gwareiddiad: 
hongian: 
sioc: ergyd, cam-yn-ôl, trawma, syfrdanol, gwrthdaro
eithriad: rhannol, gwahaniaethu, stereoteip, eithriad
straen: straen, tensiwn, llwyth, blinder, ymdrech, dwysedd
safonol: maen-prawf, meini-prawf, cyfradd, lefel, ddiofyn, norm, sefydlog, gyson, cyson, sefydlog, statig, cynaliadwy, safoni, patrwm
gyrru: gyriant, gyrrwr, arwain, rheoli, taith
gwared: tynnu, tynnu'n-ôl, dileu, dileu, eithriedig, lleddfu, ddieuog
tyngu: rhegi
trysor: em
hadau: sberm, cnau, gronynnau
twr: Rook
hoff: hoff
Yn-ddiweddar,: diweddar, ffres, sydd-newydd
diweddar-gorffennol-amser: 
effro: ymwybodol, morâl, deffro, effro
dodrefn: 
rhaff: llinyn, llinyn, strap
antur: menter, Gamble
breindal: teyrnasu
gwledd: parti, dathliad, wledd, gwyliau
disgrifiwch: disgrifiad, cymeriadu, darlunio, portreadu, ddiffinio
trigain: 
graddfa: ffrâm, medrydd, cymhareb, ysgol, grisiau, grisiau
seremoni: defodol, swyddogaeth
hela: hela, dioddefwr, ysglyfaeth, hela, saethu
sibrwd: sibrwd
i-raddau-helaeth: yn-sylweddol, yn-sylweddol, y-rhan-fwyaf o, yn-bennaf, yn-bennaf, yn-fawr, eang, yn-bennaf
Cristnogaeth: 
cyfreithiwr: atwrnai, eiriolwr
manylion: lledaeniad, ymestyn, estyniad, ehangu, ehangu, ddwfn, manwl
tywysoges: 
allor: cysegr
we: rhwydwaith, net, grid, meinwe, cynfas, poster
porffor: magenta
casglu: casglu, cronni, crebachu, deialu
etholiad: dewis, ethol, llwybr, pôl, morfil, detholiad, pleidlais
beichiogi: syniad, cysyniad, beichiogi, canfyddiad, canfod, cysyniadol, dylunio, dal, arestio, dal
feddw: alcoholaidd
arllwys: topple, sied, arllwysiad, dymchweliad
lifft: elevator, dyrchafu, codiad, codi, hike
ystum: arwydd, signal, symbol, symbolaidd, agwedd, osgo
rheoli: rheoli, goruchwylio, trin, gweinyddiaeth, llywodraethu, llywio, rheoli
cyfnewid: cyfnewid, cilyddol, Gyfnewid, amnewid
pendant-erthygl: 
ymerawdwr: teyrn
bell: bell, yn-hyn, oeraidd
hyll: cas, ffiaidd
ddiniwed: 
y-gofrestr: sgrolio, coil
modfedd: tollau, bawd
papur-newydd: cyfnodolyn, llywio, dyddiadur
barf: tip, ên
rwygo: snatch
comisiwn: bwyllgor, bwrdd
tra: tra, yn-ystod
groesfan: croesi, cyffordd, darn, pasio, pontio, eil
annibyniaeth: annibynnol, rhyddid, rhydd, rhyddid, ymreolaeth
arogl: drewdod, persawr
deunaw: 
hanesyddol: yn-hanesyddol, hanes, hanesydd
gros: cyfanswm, cyfanred, budr, amrwd, crai
gwraidd: coesyn, ffres
mwd: pridd, llysnafedd, clai, baw, blodyn
briodferch: nain
llen: llen, hwylio, hwylio
theatr: theatr
cymhariaeth: cymharu, cymharol, cydberthynas, cymhareb, gwrthdaro
wrthwynebydd: gwrthwynebydd, gwrthwynebol, cystadleuaeth, gystadleuol, cystadlu
cydbwysedd: cydbwysedd, yr-un-mor, cydraddoldeb, llorweddol, gyfrannol, par, cyllideb
hyfforddwr: hyfforddwr, ymarferydd, tiwtor, mentor
hiwmor: hiwmor, doniol, hwyliau, comedi
nofel: ffuglen, newydd, sydd-newydd
dial: dig
genfigennus: cenfigen, eiddigedd
olwyn: beic, cylch
llosgi: llosgi, waethygodd
fflach: mellt, glow, disgleirio
creu: creu, adeiladu, adeiladu, adeiladol, gwneud, fabricate, cyfansoddi, efail, cynhyrchu
gwrthdaro: gwrthdaro, frwydr, gwrthdaro, cyferbynnu, damwain, effaith
curse: 
imprecatory-hwyliau: 
ddiymadferth: ddiflas
cadarnhaol: yn-gadarnhaol
clwb: ystlumod, log
llifogydd: 
grawn: grawnfwyd, gwenith
difaterwch: difaterwch, ddiofal, esgeulustod
gorwel: 
assumptive-hwyliau: damcaniaethol-hwyliau
serth: drychiad, lethr
cytgord: cyfaddawd, dôn
taranau: 
plentyndod: 
pen-glin: lap
meddalwedd: cais, repertoire
anaf: brifo, niwed, difrod, anafu, clwyf, trawma, hanafu, groes
derbynneb: derbyn, fynedfa, derbynfa, derbyn, derbyn, taleb, mabwysiadu
galluogi: alluog, gymwys, activate, caniatáu, hawl, cario, gorfodi, gadewch, awdurdodi
protasis: 
slip: llithrig, sleid, gleidio
chwyldro: chwyldroadol, coup, cylchdro, gwrthryfel, gwrthryfel
ffermwr: werin
strôc: ergyd, coup, brwyn, scramble
llwyfan: cam, fforwm, sylfaen
negesydd: cynadleddwr, llysgennad, diplomydd
braint: breintiedig, dewis, cwota, fasnachfraint, cynnig, consesiwn
drefnu: sefydliad, trefnu, sefydliad, trefniant, trefnu
myfyriwr: disgybl, ysgolhaig, israddedig
ogof: 
traddodiad: traddodiadol, Yn-draddodiadol,, tollau, ildio
drasiedi: epidemig, tristwch
ffarwel: Hwyl-fawr, bye
beirniadaeth: beirniadu, beirniadaeth, adolygiad
cotwm: gwlân
ysbyty: lloches
rhent: pris, llogi, treth, deyrnged, prydles, cyflogi, ymgysylltu, ar-rent, siarter
nwy: 
anochel: yn-anochel
marwol: 
dail: taflen, llafn
cyhoeddi: cyhoeddi, cyhoeddi, argraffu, cyhoeddi, darlledu, rhyddhau, allbwn, trylediad, rhifyn, cyhoeddi
gelyniaethus: anghyfeillgar, gelyniaeth
cyfieithu: cyfieithu, cyfieithu, dehongli, epidemig, trosglwyddo
angladd: claddu, fynwent
blawd: powdr, toes, union, gywir, manwl-gywir, pryd-o-fwyd
gohebiaeth: cyfateb, cysylltu, cyfathrebu, cyfathrebol
rhamantus: 
cwt: bwthyn, porthdy
cynnig: peri, cynnig, cynnig, cynnig, cynnig, awgrymu, argymell, awgrym, cais, enwebu
mimetic: 
doler: 
golau-dydd: 
un-ar-bymtheg: 
cynulliad: cwrdd, cynhadledd, gyngres, cyfluniad
nythfa: 
adain: ward, suite
llew: 
diwylliant: diwylliannol
colofn: arae, haen, polyn, darn
cyfrwys: anodd, tric, medrus
drama: esgus, dramatig
jôc: chellwair, wisecrack
niwl: niwl
meddygaeth: cyffuriau, rhwymedi, chwistrellu, presgripsiwn
pedwar-ar-ddeg: 
asid: sur, asidig
sef: unrhyw, h.y., arbennig
incwm: les
esgob: 
orange: 
bath: ystafell-ymolchi, cawod, bathtub
cyntefig: yn-gynnar, cychwynnol
basged: bin, bag
ysgrifennydd: 
gwellt: gwair
ddiamynedd: awyddus
iachawdwriaeth: diogelwch, rhyddhau, hi
hodiernal-amser: 
yn-bwriadu: bwriedir, bwriad, diddordeb, awyddus, cymhelliad, amharod, neilltuo, gysegru
stêm: anwedd
gwenwyn: gwenwynig, wenwynig, chwynladdwr
talent: disgleirdeb, talentog, cymhwyster, gallu, repertoire
hinsawdd: tywydd
effeithiol: ddilys, effeithiol, effeithlon, effeithiolrwydd, ddylanwadol, defnyddiol, hyfyw
gwahaniaethu: gwahaniaethu, wahaniaethu, gwahaniaethu, gwahaniaethu, dyrannu, i---hollt, diswyddo, cau-allan, secretu
golchi: golchi
cyffes: cydnabod, credo, cydnabyddiaeth
lol: sbwriel, afresymol, anghydweddol
glo: carbon
canŵ: 
dros-dro: cyfwng, hyd, tymhorol, damweiniol, tra
delimitative-agwedd: 
asgwrn: goes
Dydd-Llun: 
Dydd-Mawrth: trydydd
Dydd-Mercher: pedwerydd
ffederal: ffederasiwn, canolog
ddymunol: deniadol, ffafriol
cynrychiolydd: gynrychioli, rhan, cynadleddwr, atwrnai, dirprwy, llefarydd
llieiniau: llin, dillad-isaf
sinc: boddi, basn, sinc
nai: nith, ŵyr, wyres
gwaedlyd: tywallt-gwaed, gwaedu
gwarchae: amgylchynu, sedd
stumog: bol, abdomen, abdomen, matrics
pres: efydd, copr, reis
copa: brig, top, tip
pumed: pump
rhad: rhad, isel
exclusive-person: 
atafaelu: mynd-i'r-afael â, cyfyngu, cadw, neilltuad, snatch, meddiannu, meddiannu, gronni, chrafangia, gafael
ffens: gwrych
cerflun: cerflunwaith
magnelau: canon
gofleidio: amsugno, snuggle
cyfagos: o-gwmpas, cymdogaeth, cymydog, cymydog, cymdogaeth, ymylol, amgylchoedd, cyfagos, gerllaw
llym: llym, cydlynol, yn-gywir, dynn, difrifol, yn-sicr, gwbl, yn-bendant, dynn, llym
ceirw: 
llwyn: 
Railroad: rheilffordd, rheilffyrdd
rhyddhau: rhyddhau, dadlwytho, rhyddhau, rhoi'r-gorau, ddiarddel
etifedd: etifeddu
derw: 
annymunol: hyfrydwch, braf, anesmwyth, flin, gofidus, cas, anghyfforddus
ddyfais: dyfeisio, darganfyddiad, arloesedd
piano: 
perswadio: argyhoeddi, dathlu, goffáu
anweledig: dirgel
dda---hysbys: enwog, drwg-enwog, amlwg
creulondeb: 
temtasiwn: 
Telic-agwedd: 
economaidd: economi, yn-economaidd, economegydd, ariannol
rhyngwladol: byd-eang, amlwladol
ymyrryd: ymyrraeth, ymyrraeth, ymyrryd, tarfu, trafferthu, tarfu, torri-ar-draws, cythruddo, lidio'r, aflonyddu, gwrthdaro
athronydd: athronyddol
cain: ffasiynol, cain
lles: haelioni, ffyniant, darpariaeth
pysgota: 
dwyn: lladrad, rob, lladrad, swipe
gwefus: big, llafar, fin
ymddeol: ymddeol, wedi-ymddeol, ymddeol, encil, gorffwys, hamdden, tynnu'n-ôl, ymddiswyddo
darn: sythu, ymestyn, llwybr, nodwedd, darn, darn, darn, darn
oriel: casgliad
cyfochrog: ochr-yn-ochr â, gydnaws, cysylltiol, affix
atelic-agwedd: 
cyfandir: cyfandirol
waharddol-hwyliau: waharddol-hwyliau
tei: necktie, eryr
cell: hanfod, cnewyllyn, cawell, fersiwn, ffôn-symudol, Ffôn-Symudol, Ffôn-Symudol
wy: caill
artiffisial: synthetig
yn-y-cyfamser: ar-yr-un pryd
argyfwng: cwymp, dyfarniad, dyfarniad, argyfwng
gwrtais: cwrteisi, addysgedig
cinio: brecwast, cinio
pinwydd: ên
gwthio: gwasgfa, gyriant, annog, hyrwyddo, byrdwn, pwysau
cynghrair: undeb, cynghrair, glymblaid, cyfuno, partneriaeth
canol: clun, bywyd, byw, canol, canol, canol
wyrth: Tybed
morwr: 
purdeb: chastity
gweriniaeth: democratiaeth
ffôn: ffôn, ffôn-symudol
chwip: 
shirt: crys-t
cyflwyno: cyflwyniad, cyflwyniad, sefydlu, cychwyn, rendr, darpariaeth, argymell, atgyfeirio, chwistrellu, cyflwyno, cyflwyno, darlunio, portreadu
soffa: cadair-freichiau
ysgubo: wipe, rhaca, sgan
lleidr: bos
cadw: cadw, wrth-gefn, neilltuad, adfer, cadw, atal, cadw, wrthsefyll, ymgysylltu, cadwraeth, cynnal, gwarchod, cynnal, cadw
sianel: camlas
personoliaeth: cymeriad
diwygio: gwella, cywiro, esblygiad, diwygio
bygythiol: bygythiad, bygwth, peryglus, brawychus
palmwydd: masarn
siaradwr: llefarydd
trothwy: rhwystr
cymell: lobïo, annog, achos, rhybuddio, cyffroi, peri, arwain, temtio, ennyn
picell: sbâr
daclus: daclus, glân, taut
sesiwn: cwrdd, cynhadledd
artaith: dioddef
llaith: baw, gwlyb, rhedeg, muggy
crib: top, Braid, pentwr, crib
teithiwr: ymwelwyr, teithiwr, twristiaeth, teithwyr
felin: ffatri, gweithgynhyrchu, planhigion
map: cerdyn, diagram, graff, pris, tocyn
coler: amgylchynu
cymryd-lle: amnewid, dadleoli, sbâr, amgen, rhodder, amnewid, dadleoliad, newid, yn-amrywio, diwygio, is
yn-fwriadol: bwriadol, bwriadol, ymwybodol, ymwybodol, bwriadus
cwrw: peint
melfed: 
disgyrchiant: atyniad, malwch
bregeth: pregethu
cam-drin: camgymryd, anghywir
ddiadell: grŵp, fuches, swp, haid
tri-ar-ddeg: 
cyfiawnhau: gwarant, pledio'n, eiriolwr, cyfiawnhad, cyfiawnhau
Dydd-Gwener: arian, gwener
brwsh: crib
download: 
hufen: hufen-ia
clogwyn: graig, fin
rheithgor: 
anghenfil: cawr, gwrthun
rhewi: rhewi
pot: padell, jar, cynhwysydd
ceiniog: cant
mynnu: uchel, byrdwn, mynnu, tanlinellu, pwysleisio, parhau, mynnu, ei-gwneud-yn ofynnol, dadlau
afal: 
trafod: trafodaeth, trafod, dadlau
cefndir: 
drawsgrifio: addasu, ailysgrifennu
cyfnodol: rheolaidd, cylchol
adloniant: hamdden, diddanwr, hamdden, difyr, diddanu, hwyl, hobi
firws: 
plentynnaidd: soprano
adlewyrchu: myfyrdod, myfyrdod, meditate, dangos, darlunio
trosi: newid, trawsnewid, switsh, treiglad
amlinelliad: proffil, cyfuchlin, crynodeb, braslun, agored, trosolwg, drafft
opera: 
cymeradwyaeth: cymeradwyo, disapproving, caniatâd, derbyn, honiad, cymeradwyo, cymeradwyo, mabwysiadu, cymeradwyaeth
bradychu: datgelu, twyllo, siomi
cosbi: euogfarnu
penelin: braced
atodiad: atodiad, cysylltiad, chlytia, cyswllt, cysylltydd
trwsio: adfer, gwella, ail-greu, cywiro
amheus: amheuaeth, sydd-dan-amheuaeth
saith-deg: 
ysgrythur: Beibl, sgript
pwll: twll, cloddio, pwll
anhrefn: chaos, anarchiaeth, aflonyddwch, aflonyddwch, llanast, gofidus, ymyrraeth, embaras
deuaidd: Dyadig
abaty: mynachlog
arrow: 
yn-tueddu: atebol, Fel-arfer,, Fel-arfer,, fel-arfer
ymhelaethu: manwl, ddiffinio, egluro, datblygu, cymhleth, anodd, gwaith---allan
teyrngarwch: ffyddlon, ffyddlon, ymddiriedaeth, ffyddlon, yn-onest, diffyg-ymddiriedaeth, hygrededd, ffydd, cred
darn-arian: arian-cyfred
crynu: ias
alltudiaeth: saethu, dramor
mecanyddol: peiriannau, mecanic, peiriannydd
trap: gafael, euogfarnu
cacen: pei, cwci, toes
syr: mr, Mister, arglwydd, gŵr-bonheddig
petruso: guro, haunt, amledd, hofran
un-deg-saith: 
mêl: 
fantol: bet, cyfran, lletem, pentwr, rhannu, ffracsiwn, cyfraniad
gwadn: symud, tric, cerdded, cerdded, pedal, cam, stride, gris
brics: teils
wyth-deg: 
yn-anffodus: anffodus, anlwcus, yn-anffodus
ymgynghori: ymgynghori, gyfeirio
chwedl: myth
cynhaeaf: cnwd
dyrchafiad: dyrchafu, hyrwyddo, cyflwyniad, cyflwyniad, cyhoeddusrwydd
stôf: popty, slab, popty
rebel: gwrthryfel, gwrthryfel
hen-ffasiwn: hynafol
chwyddo: chwyddo, wedi-chwyddo, chwyddiant, chwyddo, chwyddo
gors: gors
dresin: saws, rhwymyn
asgetig: feudwy
rheolwr: stiward, prif, bos, gweinyddwr, cyfarwyddwr, safonwr, arweinydd, gweithredol
corws: gyriant, tîm
rhesymegol: cyfiawnhau, rhesymeg, rhesymegol, afresymol, synhwyrol, rhesymol, rhesymol
prosesu: 
Blaidd: 
carped: ryg
hynafiaeth: 
ffrwythlon: 
chwiban: ffliwt
caws: 
brathu: torri, gerfio, Sting
gwahodd: gwahoddiad
eglwys-gadeiriol: deml
harbwr: porthladd
crwydro: dro, ymfudo, hike
cnydau: cnwd
nefi: morol, fflyd
mwgwd: ffasâd, mwydyn
pensil: pen
llysiau: llysieuol
arddangosyn: arddangosfa, cynnig, arddangos, cyflwyniad, symptom, amlygiad
trowsus: trowsus, pants
llygredd: sgandal, llygredd
cabinet: cwpwrdd, closet, cwpwrdd-dillad, toiled
cawl: 
llawfeddyg: llawdriniaeth, llawfeddygol, llawdriniaeth
lwfans: amnewid, rhodder, iawndal, apposition, dyraniad, atodiad
sbïo: 
di-hid: ddiofal, anniben
clecs: si, si
tocyn: 
haniaethol: crynodeb, maes-llafur
Dydd-Iau: 
traffig: cylchrediad, cludiant, cludiant
pensaernïaeth: 
crac: agennau, cracio, gadael, rhoi'r-gorau-iddi, torasgwrn
addurn: addurno, addurnol, addurno, gemwaith, trim
cefn: groes, gwrthdro, switsh, gwrthdro, anffafriol, wyneb-i-waered, cefn
difyrru: diddanu, difyr, difyrru
adferiad: adfer, achub, gwella, adfywiad, adennill, adfer, ail-greu
palmant: cwrbyn, traw, tar, llysnafedd, clawr
bendant: hanfodol, hanfodol, penderfynu, penderfynu, bendant
negyddol: anffafriol
wyl: cyngerdd
lleihau: gostyngiad, gostwng, rhwyddineb, lleddfu, lleihau, diraddio, slaes, trim, tynnu, cyfyngu, cyfyngu
brad: 
helwyr: 
neidr: ymlusgiaid
batri: 
cwyr: cannwyll
ditectif: ymchwilydd
dadansoddiad: dadansoddi, ymchwil, astudiaeth, archwilio, arolygu, archwilio, penderfyniad, torri-lawr, torri-lawr
pwyslais: pwysleisiol, pwysau, tanlinellu, pwysleisio, Pwysleisiodd, acen, honiad, sylw
nofio: nofio
amlen: amgylchiadau, adferf, wain
pwy-bynnag: pwy, rhywun, pwy, unrhyw-un
sigarét: ysmygu, tybaco
modur: Automobile, peiriant, cymhelliad, beic-modur
gwirfoddolwr: gysegru, gwirfoddol
adwaith: adweithiol, ymateb, ymateb, ymateb, adborth
bagiau: bagiau, cludo-nwyddau, cefnffyrdd, gês
byddar: 
sudd: dyfyniad
gostyngeiddrwydd: symlrwydd, cymedrol
gweinidogaeth: 
rhywiol: rhyw, rhywioldeb
diamedr: 
bwyell: 
diemwnt: 
yn-ail: sbâr, amgen, rhodder, opsiwn, dirprwy, amnewid, trawsblaniad
echo: 
ataliaeth: atal, cwrbyn, cyfyngiad, cyfyngiad, cyfyngiad
hunaniaeth: nodi, adnabod, symbolaidd
sgrin: arddangos, llen
ddiog: pwdr
momentane-agwedd: 
compact: cyd-fynd, solid, trwchus
drifft: llawdriniaeth, gwyriad, tuedd, tuedd
diflannu: diflannu
ray: trawst, eil, radiws
inc: 
enfawr: mawr, grand, enfawr, enfawr, aruthrol, mawr, aruthrol
seler: 
cofiadwy: amlwg
llacharedd: glow, disgleirio, disgleirdeb
senedd: senedd
arch: 
maddeuant: 
llyncu: sipian
fwynhau: mynd-ar-drywydd, Bodloni
swing: 
dôl: tir-pori, cyn, lawnt
cymhleth: cymhleth, cymhlethu, soffistigedig, cyfansoddyn, anodd
ymddiswyddiad: ymddiswyddo, ymddeol
ostyngedig-gofrestru: 
gynllwynio: plot
pupur: 
merlyn: 
ymgeisydd: ymgeisydd
llwynog: 
simnai: lle-tân, pentwr
awdurdodaeth: awdurdod, dyfarniad, dyfarniad, cymhwysedd
amaethyddiaeth: ffermio, amaethyddol
cywirdeb: trachywiredd, chastity, yn-gywir, yn-gywir, geirwiredd
cyn-ymadawedig: 
democrataidd: 
blaguryn: knob, sprout
blanced: nenfwd, clawr, ryg, sylw
cenllysg: meddiannu, cyfarch
mochyn: hwch
siâp: ffigur, siâp, ffig, agwedd
ifori: 
clasurol: clasurol, traddodiadol
arsylwr: goruchwyliwr, ymwelwyr
eliffant: 
hoelion: ewinedd
gwenyn: 
claddu: claddu, gwreiddio
actor: actores, perfformiwr, plaintiff
chwys: 
sglein: tafodiaith
rhith: twyll
ansicrwydd: ansicr, amwysedd
eilaidd: mân, canolig, cyfartaledd, cymedrol, prif-ffrwd, canol
blygu: plygu
gwledig: taleithiol, cefn-gwlad, pentrefwr
ochneidio: 
yn-debyg: tebyg, tebygrwydd, atgoffa
quote: dyfyniad, dyfyniad, unquote, rhoi-benthyg, benthyg, benthyciad
sach: diswyddo, diswyddo, bag
annifyrrwch: aflonyddwch, ymyrraeth, ymyrraeth, caledi, diflastod, trafferthu
nodwydd: pigiad, chwistrell, stylus, pin
dan-reolaeth: rheoli
cyw-iâr: iâr
cyson: parhaus, gydnaws, concrid, ymhlyg, briodol, arbenigol, perthnasol, cydlynol, dilyniannol, cytbwys, cyson
gasgen: bwced
arferol-agwedd: 
arbenigwr: arbenigol, profiadol, arbennig, penodol
greu-argraff: yn-effeithio-ar, argraff, denu
olewydd: 
van: falf
rhwystr: torri-ar-draws, cyfyngiad, handicap, rhwystr, cam-yn-ôl
nodio: 
maeth: meithrin, sbigoglys, hyrwyddo, hwyluso, feed, ffafrio, ffafrio
diffiniad: sylwebaeth, adnabod, disgrifiad, penderfyniad
pen-blwydd: pen-blwydd
morthwyl: 
persawrus: 
ailadrodd: trwm, cyrchfan, ailadrodd, ailadrodd, ymarfer
ddibwys: mân, ddibwys
cic: taro, bump, pêl-droed, calsiwm, pêl-droed, ergyd
gloddfa: cloddio, dril, cloddio
anifeiliaid-anwes: 
penglog: 
deddfwrfa: senedd, deddfwriaethol, deddfwriaeth
sawdl: neidio
gwgu: 
patent: 
biliwn: 
cemegol: cemeg, cemegolion, fferyllydd
peilot: arbrawf, arbrofol
dynwared: efelychu, efelychiad, ailadrodd, atgynhyrchu
sgert: graig
anarferol: anarferol, annormal, od, rhyfeddol, anghyffredin, anhygoel, afreolaidd, rhyfeddol, anhygoel, hynod-o, rhyfedd
wythnosol: 
technegol: techneg, technoleg, dechnegol, tech
llystyfiant: 
frân: Rook
sunrise: 
oes: bywyd, goroesi, ffordd-o-fyw, byw
cyfrannu: cyfraniad, rhoi, partneriaeth, hyrwyddo, hwyluso
bachyn: berthnasol, cysylltu, cydberthyn, braced
teigr: 
treiddio: pierce, drwy, ddylanwadol
llawes: fraich
priffyrdd: ffordd
milisia: 
ffos: ffos, siafft
uniondeb: 
pedwar-ar-bymtheg: 
organig: 
diwinyddiaeth: 
arnofio: cwch, hofran, fflyd
wrach: 
diflasu: ddiflas, diflastod
diplomyddol: diplomydd
stiwdio: label, gweithdy, astudiaeth
yn-fwy-na: ymddygiad-ymosodol, treisio, goresgyn, croesi
siampên: 
ysbrydoli: annog, ysbrydoliaeth, calonogol, anadlu
banner: flag, poster, tocyn
ysgariad: wedi-ysgaru
bollt: mellt, ewinedd, Twist, sgriw
gwythïen: nerf
goddefol: cynulleidfa, anabl
ewyn: swigen
graean: 
ffedog: lap
blaned: 
silff: rac, cwpwrdd
gefnogwr: 
trofannol: 
cam: ffotograffig, cam, cyfnod, adeiladu, cam
mympwyol: digymell
ynganu: ynganiad, acen, ymadrodd, llwyr
mercwri: 
ymgripiad: cropian, dringo, cig-oen
hunanladdiad: 
gohebydd: newyddiadurwr
amddifadu: amddifadedd, dirymu, cau-allan, tynnu
medrus: medrus, effeithlon, alluog, talentog, profiadol, cymwysedig, clyfar
balconi: teras, porth
fforc: 
cyflogai: gweithiwr, labrwr, gweithio, ffactor, dibynnol, clerc
cyflogwr: bos
lled: yn-fras, cyflenwad, eang, lled
llidiog: flin, gyffrous, lidio'r, pryfocio, symbyliad
cyhuddo: Gyfrannog-ymwrthod
pensiwn: ymddeol, cystrawen
ferf: act, ymateb
mwnci: 
derbyniol: derbyn, derbyn, credadwy
llofnod: 
uniongred: ceidwadol
eironi: chellwair, Twist
meithrinfa: planhigfa
amharodrwydd: ddim-yn-ei hoffi
mewnforio: cyflwyniad
tortsh: 
gramadeg: gramadegol
blaendal: cronni
trefedigaethol: 
cwch-hwylio: fferi, cwch
ganlyniadol: canlyniad, bennod, pwysig, sylweddol, arwain, amlwg, yn-sylweddol, arwyddocaol, sylweddol, ystyrlon
cromen: 
trwch: 
styfnig: bendant
cyhyrau: 
maint: maint, swmp, osgled, medrydd, maint
rhwbio: 
llwfr: 
harnais: uno, uno, uno, defnyddio, gwregys
tost: byrbryd
llygoden: llygoden-fawr
sillaf: 
pat: clap, guro
deialog: cyfathrebu, sgwrs
niwtral: diryw
diwydrwydd: zeal, y-ddalfa
gwrthddywediad: gwrth-ddweud, ddadlau, amwys, ddryslyd, ddadleuol, amwysedd, paradocs, gwrth-ddweud, amrywiant, gwrthwynebiad
cyflawni: sylweddoli, cyrraedd, cyrraedd
gafr: 
ffynnu: ffyniant, ffynnu, ffyniant, em, drysor
gosod: grym, gorfodi, penderfynu
dienw: 
ffurfiol-gofrestru: 
llo: brysiwch
llawlyfr: arwain, canllaw, brand, arweinyddiaeth, gwerslyfr, cyfarwyddyd, arweinydd, goruchwyliwr
toddi: anweddu, dadmer, ymasiad
dileu: dileu, hydoddi, canslo, tynnu, cau-allan, ddiddymu, dileu, dileu
ymbarél: parasiwt
lesewch: esgid, cefnffyrdd
mwynau: ïodin, maetholion, metel
cadoediad: cadoediad
hwyaden: 
cynllunio: 
sebon: 
ddol: babi, tegan
sgerbwd: 
fila: tylwyth-teg
gwnïo: pwyth, gwnïo
cysoni: cyfryngu, uno, uno
tegell: 
aeddfed: oedolion
cwningen: 
arweinydd: ysgol, uwch-arolygydd, gyrrwr, arweinydd
dibyniaeth: yn-dibynnu, ddibyniaeth, dibynnol, gaeth, affinedd, agwedd
chwaraewr: perfformiwr
pryfed: pla
bwyty: 
tylluan: 
radical: milwriaethus, eithafol, blaengar
preswylydd: preswylydd, frodorol, cartref, cynhenid
dragon: barcud
clywedol-tystiolaethol: 
sychedig: 
Linger: hir
cyfrifiad: cyfrifo, cyfrifiant, cyfrifiadura, calcwlws, cyfrif, cyfrif, cyfrifiad
rheoleiddio: sensoriaeth, rheoli, cyfyngiad, cyfyngiad, anheddiad
maer: 
lleiafrifol: 
caffael: cael, ennill, caffael, mynediad, argaeledd
cyn-filwr: uwch
gerddorfa: 
cig-moch: 
anfantais: colled, amddifadedd, anffafriol, nam, handicap
ffabrig: brethyn, dillad, tywel, cynfas, meinwe
cerddor: cyfansoddwr, cerddorol
yn-feddyliol: ysbrydol, meddyliol, morâl, mana, goddrychol
cyd: cydweithredu, cysylltiad, cyfansoddyn, cymdeithas, cysylltiol, cyfuno, cydlynol, ochr-yn-ochr â, parhad, linker
annigonol: ddiffygiol, annigonol, diffyg, ddiflas, israddol, lletchwith, digon, anffodus, anghydweddol, amhriodol
pensaer: 
lemon: 
peswch: pesychu
cur-pen: 
tenant: cynllunydd
ffrwythlondeb: atgynhyrchu
gwella: gwella, gwella, gwella, gwella, drin
naw-deg: 
ar-hap: ar-hap, randomize, damweiniol
llwy: bwced
balŵn: 
sialc: plastr
casgliadol-tystiolaethol: 
cyhoeddwr: golygydd
finegr: 
lludw: llwyd, llwyd
expletive: rhegi
adfywio: adfywiad
dueddol: agored-i-niwed, sensitif, synhwyrol, emosiynol, atebol
twnnel: isffordd
pos: drysu, ddryslyd
mecanwaith: gweithdrefn, arferol, systematig, peiriannau
mathemateg: mathemateg, mathemategol
pylu: 
afu: 
sublative-achos: 
dip: plymio, gwreiddio, gollwng, dillad, nifer-yr-achosion, llethr, inclein, lethr, graddiant, socian
uned: undod, endid, modiwl, big, unigol
monopoli: exclusive
gamblo: Gamble, gêm, gêm, clirio, tegan
llong-danfor: o-dan-y dŵr
daeargryn: ffit
labordy: lab
corc: madarch, ffwng, cap
hunan-rheoli: 
Buddha: 
wau: gwau, gwehyddu, byrdwn, gwau, cwlwm, nod, Braid
llysgenhadaeth: 
pellaf: 
declarative-hwyliau: 
ysgogiad: anogaeth, cymhelliant, rysáit, cymhelliant, cymhelliad
siocled: Candy
cyd-ddigwyddiad: cyfle, cyfuniad, anffodus, ar-hap, damweiniol, gêm
maneg: 
penlinio: 
daearyddiaeth: 
buddsoddiad: buddsoddi, menter
llafar: llafar, llafar, sarhaus
cyfatebiaeth: cydraddoldeb, tebygrwydd, affinedd, carennydd, cymhareb
seciwlar: lleyg
hebog: eryr
seicoleg: 
Caewch: berthnasol, rhwymo, cysylltu, rhwymyn, arestio, atodi
sgrap: canslo, sbwriel, garbage, darn
rôl: pwli, rhannu, stoc, cyfranogwr
dos: maint
eog: 
pwdin: 
magnetig: deniadol
pwmp: bom
ocsigen: 
tystysgrif: 
medal: 
rhethreg: 
crafu: crafu, pori
rhwyf: rhaw, asgell
telesgop: microsgop
mwclis: trechu, past
sillafu: sillafu
wisgi: 
helyg: tir-pori
camel: 
amatur: 
allanfa: allforio, allfa, ymddangosiad, allbwn
bywgraffiad: 
asyn: 
misol: 
anwybyddu: esgeulustod, edrych-dros, diswyddo, anwybodaeth
ystod-y-gwyliau: gadael, gwyliau, hamdden, gorffwys
cliciwch: clic, snap
hirgrwn: 
elastig: rwber, hyblyg
geiriadur: geiriadurol, geirfa
ham: clun, pen-ôl
enfys: 
defnyddio: bwyta, defnyddio, defnyddio
tafod: ffrind, tafod
tanc: cronfa-ddŵr, cynhwysydd, TAW
cydweithiwr: cydweithredol, gyd, ffrind, cysylltiol
glöyn-byw: 
siart: diagram, graff, graffeg, graffeg, amserlen, cynllun
dau-wely: dwbl, deuol
yn-annibynnol: annibynnol, rhydd, ar-wahân
bambŵ: 
ddeliwr: manwerthwr, gwerthwr, gwerthwr, masnachwr
cronni: cronni, casgliad, crynodiad
arolygydd: archwilydd, uwch-arolygydd
damaid: darn, tafell, bit
hunllef: freuddwyd
jam: jeli
amgueddfa: 
wyddor: wyddor
gwasgariad: defnyddio, lledaeniad
cyrch: galwedigaeth, goresgyniad, ymosodiad, sarhaus, dechrau, dominyddol, gael-gwared
datgelu: cyhoeddi, datgelu, canfod, agored, dadwneud, cyhoeddi, darganfod
pydredd: pydredd, dirywio
ymosodol: tarfu, llanast, galwedigaeth, ymddygiad-ymosodol, sarhaus, bendant
ffrithiant: 
pier: 
pry-cop: 
tatws: 
adolygu: addasu, diwygiad, adolygu, cywiro, diwygio, adolygiad, archwiliad
trachwant: barus
cynamserol: yn-gynnar, bump
lluoswch: taro, bridio, bump
sbin: cylchdroi, cylchdro, troellog, edau, Twist
ystadegau: ystadegol, ffigur, sgwrsio
calendr: amserlen, amserlen, dyddiadur, golygfa
enwebiad: enwebu, penodiad, detholiad, ymgysylltu
triliwn: 
atig: gwynt
gadarnhaol-hwyliau: 
ceisiadau: 
nominal: 
anfodlonrwydd: 
haint: heintio, heintio, pontio, trosglwyddo, heintus
piser: jar
shrug: twitch
arloeswr: mawr, avant---garde
hepgoriad: ddiofyn, gaffe, diffyg, esgeulustod, esgeulustod, dileu
bresych: 
athletaidd: athletau, mathemategol, athletwr
meddwdod: siwgr
idiophone: 
lifer: pry
seneddwr: 
iris: 
ant: 
bug: 
feichiog: mamau
gwaddod: dyodiad, gwaddod, cyflymder, brys, cyflymu
ffêr: 
dosbarthiad: didoli, dosbarthu, classifier
newidyn: yn-amrywio
lapio: pecyn, parsel, paced, pecyn, sbŵl, lapio, clawr, yn-cwmpasu
cyrliog: cwrl, Hurl, coil, sgrolio, helics
sylffwr: sylffwr, torri
arddweud: 
yn-dod-i'r amlwg: ymddangos, ymddangosiad, codi, ymddangosiad, rhoi'r-gorau-iddi
llyffant: 
gormodol-achos: 
sbwng: ffwng, madarch
blino: gofidus, tarfu, trafferthu, ffwdan, cythruddo, ddiflas, fastidious, tarfu
wiwer: 
falu: hanner, lled
irrealis-hwyliau: 
llosgfynydd: 
dan-do: dan-do, y-tu-mewn, o-fewn, safleoedd
manteisio: defnyddio, amsugno, cyflawniad, archwilio
daearegol: 
pasbort: 
anfoesol: dieflig, pwdr
bisged: cwci
cydweithredu: cydweithredu, partneriaeth, integreiddio, cynorthwyo
tabled: bullet, bilsen, slab
ymlacio: slac, hamddenol, hamdden, ymlacio, ymlacio, hamdden
atom: atomig, gronynnau, unigol
cymhorthion: cymorth, rhyddhad, ategol
pyramid: 
cylch: cylch, cylchrediad, amledd, cylchdro, cylchdroi, beic, beic
nap: 
anghyfreithlon: anghyfreithlon
paw: grafanc, traed
swildod: swil, cyfangiad
Eclipse: aneglur
liwt: gogwydd
banadl: 
panel: plât, slab, peintio, bwrdd, grŵp, bwyllgor
seryddiaeth: 
ddrysfa: 
ysgoloriaeth: nawdd
crwban: 
ymgynghorydd: mentor, cynghori
ffibr: ffibr, bwndel
criced: 
colomen: 
addasu: addasu, gêm, cydymffurfiaeth, addasu, addasu
triongl: 
trysorydd: 
hydrogen: 
bregus: cain, creision
argraffydd: 
tagu: 
cronig: resistant
ymdopi: yn-dod-ar draws, addasu, wynebu, wrthbwyso, goresgyn, mynd-i'r-afael â, gyferbyniol, trin
penbleth: 
peirianneg: techneg, dechnegol
camera: siambr
yn-ymddiheuro: ymddiheuriad, pardwn
llyfu: 
dawnsiwr: 
mudo: ymfudo, mewnfudo
tennis: 
asgwrn-cefn: 
ffrio: 
gwŷdd: ar-gau, cau
stab: Sting, pierce, chrafangia, ymgais, ymgais
cyfrinair: signal, ciw, slogan
hemisffer: pigfain, tip
strategaeth: strategol
cwarts: 
siswrn: tynnu, llusgo
patrôl: 
rhewlif: 
hanner-ffordd: hanner, yn-rhannol, lled, canol, canol
memorandwm: cytuniad, contract, confensiwn, cyd-fynd, gwarant
côn: lleihau'n-raddol
cymesuredd: 
manufacturer: cynhyrchiol, cynhyrchydd, adeiladol
diffynnydd: eiriolwr
mosg: 
gwyddbwyll: 
toll: codi-tâl, ffi, dioddefwr, ffigur, cymhlethdod
ceirios: 
eang: eang, eang, lledaeniad, eang, eang
baglu: dillad
lori: lori, cludo-nwyddau, lori
mwstard: 
y-cant: y---cant, cant
arwerthiant: gwerthu
ridyll: 
anwastad: ansefydlog, ansefydlogrwydd, ansicr, anesmwyth
magnet: 
sugno: amsugno, socian
islam: 
flaenau-eich-traed: traed, barod, barod
pilen: 
eillio: 
gitâr: 
sgleiniog: llachar, a.m., gwych
llwyfen: 
esgyn: hike, hofran, gwddf, hedfan
rhagenw-marciwr: 
stwffwl: clip, braced, hanfodol, sylfaenol, sylfaenol, prif, mawr, yn-y-pen draw, cynradd
sbeis: croen
mechnïaeth: bond, sicrwydd, addewid, gwarant
cludwr: fector, plaintiff, porthor
dirgryniad: cyseiniant
hudo: temtio, cythruddo, lidio'r, hudo
aradr: datrys, hoe, herwgipio
ffisiolegol: corfforol
gwter: draen
comed: troseddwr
ganoloesol: canol
aderyn-y-to: 
wneud-iawn: talu, iawndal, wrthbwyso, wneud-iawn, colur, colur
plastig: 
troednodyn: 
orbit: dosbarth, ystafell-ddosbarth, taflwybr
gynnil: cymedrol
golff: 
sero: null
sglodion: darn, darn, tafell, darn
orthrymu: atal, repress, ostwng, gorlethu
yawn: anweddu
anghydraddoldeb: 
man-geni: sesame, clai
crochenwaith: 
gwraig-tŷ: 
rhyg: 
anufuddhau: torri
goddefgar: goddefgarwch
embryo: teiars, teiars, ffetws, ffetws, cnewyllyn
glöwr: mân
yn-cymeradwyo: gwerthfawrogi, cymeradwyaeth, clap
burum: ensym, toes
premiwm: bonws, gwobr, dyfarniad
eirin: 
methdaliad: methiant
dyfrhau: 
mintys: Candy
gyfalafol: cyfalafiaeth
elastigedd: hyblygrwydd
siarc: 
recriwtio: tric, newyddian
storio: cadw, gwarchod, siop, gan-arbed
realaeth: 
sinsir: 
ambiwlans: 
cymaradwy: gyfrannol, tebyg
waled: portffolio
grimace: myg, grin, sleifio
gwyddonydd: gwyddonol, ysgolhaig, ymchwilydd, ymchwilydd
perfedd: coluddion, coluddyn
equanimity: 
radio: radiwm
amherthnasol: gwrth-ddweud, amhriodol, anghydweddol, ddibwys
ffa: cnau, pys, pysgnau, grawnfwyd
anffurfiol: 
wyres: ŵyr, wyres, nith, disgynnydd
anghytundeb: gwrthwynebiad, dadl, anghydfod, anghytuno
stêc: torri
nitrogen: 
rasel: 
cyferbyniol: cyferbynnu, gyferbyniol, gwrth-ddweud, yn-gwrthwynebu, groes
propaganda: cyhoeddi, cyhoeddusrwydd, hysbyseb, hysbysebu, hysbysebu
tân-gwyllt: 
pop: snap, bang
dadwisgo: 
rhych: 
niweidiol: niwed, peryglus, anffafriol
Iddewiaeth: 
ategu: atodol, arfogi, Hefyd
lens: ffacbys, flashlight
pegative-achos: 
canser: 
gwystlo: morgais, milwr, addewid
darlithydd: 
gollwng: arllwysiad, colled, gollwng
yn-gymwys: gymwys, teilyngdod, haeddu, cymwysedig, cymhwyster
dwysedd: gorlawn, dwysedd
cynefino: 
cnoi: 
siaradus: cyfathrebol
cimychiaid: 
disgownt: eithriad, gwerthu, consesiwn
tacsi: 
hierarchaeth: arweinyddiaeth, system
jâd: 
y-chwyrn: 
madfall: 
rhaeadr: 
siomedig: ddigalon, siom, siomi, siomedig, cas
feto: gwrthod, olrhain, gwrthod, diswyddo, anghymeradwyaeth, bet, traction
llywyddiaeth: arlywyddol
prynwr: cwsmer
galwyn: 
mosgito: 
gwyriad: gwyriad, afluniad, wrthbwyso
wrestle: cystadlu
mosaic: 
plwg: cysylltydd, taleb
squat: Crouch
groser: 
gomiwnyddol: 
amaze: syndod, anhygoel, syfrdanol, camarwain, drysu, syfrdanu, drysu
prosecutive-achos: 
names: galaeth
unben: 
pwyslais-mawr: cyflogaeth, pryder, poeni, pryder
lloeren: 
sliper: sandal
cytsain: 
bras: brasamcan, tua, approximative
yn-ddi-waith: cyflogaeth
cefnogwr: cynorthwy-ydd, ategol, goddef, braced
Lotus: 
letys: salad, sbigoglys
clorid: 
bacteria: ffwng, bacteriol
gludiog: gludiog
cydran: 
cnewyllyn: 
feign: esgus, efelychu
beit: 
secretiad: secretu
benodol: yn-glir, agored, yn-ôl-pob golwg, yn-amlwg, yn-bendant
cyd-daro: gêm, addas, addas, cyd-fynd, paru
bale: asgell
wrin: piss
garlleg: 
mynd-heibio: gorffennol, pasio
economeg: economi, dirwasgiad, gan-arbed
dosbarth-canol: 
ystwyth: cyflym, cyflym, cyflym, prydlon
gefeiliau: rhaw, clip
golchi-dillad: golchi
mefus: 
trefol: dinesig
godi-cywilydd: annog-pobl-i beidio, handicap, embaras, drysu, drysu
llyfr-nodiadau: 
albwm: 
pêl-fas: 
arogli: 
bwffe: 
rhangymeriad: cyfranogwr, cystadleuydd
garej: 
diagnosis: diagnostig, diagnosis, gwybyddol, cydnabod
crutch: 
extort: blacmel, pluo'n, cyfyngu
cofrestru: cofnod, gofrestru, cofnodi, log
hydawdd: hydoddi
ffosfforws: 
strwythurol: strwythur, cyfluniad, config
glud: 
thesis: traethawd-hir
grefftwr: mecanic
Banana: 
Axiom: theorem, gonest, yn-amlwg, amlwg, penodol, egwyddor
asen: gêr
nicel: dim
pi: bye, pei, silicon
bws: gadewch
sensro: sensoriaeth
taflegryn: roced
selsig: ci-poeth
trin: gweithredu, trin, gweithredol, tric, twyllo, trin
tomato: 
atgyfnerthu: atgyfnerthu, dwysau, cadarnhau
soced: tynnu'n-ôl, allfa, cysylltydd, nyth
potasiwm: 
adfer: nôl, adennill, adfer, adfer
rhithwir: go-iawn, gwirioneddol, dilys
algebra: 
deintydd: dant
optegol: gweledol
Budge: consesiwn, concessive, symud, symud, dadleoli
bioleg: 
diweithdra: 
lindysyn: 
solo: ar-wahân, rhyfeddol, arwahanol, pridd, ei-ben-ei hun
porwr: 
bell-gorffennol-amser: 
hanesyddol-amser: 
niwclear: cnewyllyn, atomig
sbectrwm: 
sodiwm: 
hysteria: 
ymddiriedolwr: gweinyddwr
gwystl: morgais, addewid
cicaion: pwmpen, mêr
wrinkle: nam
tryloywder: tryloyw, penodol, syml
spike: lletem, les, tip, ewinedd
blaenoriaeth: sylw
cerddwyr: cerdded
anffyddiaeth: 
monitor: trac, goruchwylio, Gwylio, mynd-ar-drywydd
etholaeth: pleidleisiwr, etholwyr
heb-ei-reoli: 
probe: arholiad, ymchwiliad, ymchwiliad, ymchwilio, ymchwiliad, archwilio, treial
platinwm: 
deuol-rhif: 
ysgyfaint: 
super: rhyfeddol, aruthrol, anhygoel
troli: cerbyd, cert, wagen
yn-lleol: lleol
ysgogi: cyffroi, cythruddo
gasoline: petrol
yr-arennau: 
loot: lladrad, ysbeilio, ysglyfaeth, difetha, rob, haul
asesiad: amcangyfrif, amcangyfrif, gwerthuso, gradd
arsenig: 
Malwoden: helics
ceiliog-rhedyn: 
hafaliad: fformiwla, cydraddoldeb
sosialaidd: carennydd
hidlo: 
synhwyraidd-tystiolaethol-hwyliau: 
ehangu: ehangu, eang, ychwanegu, codi, gwella, ymestyn, yn-fras, penderfyniad, estyniad, ehangu
allyrru: lansio, taflu, anadlu-allan, saethu, gadewch
dennyn: prydles, strap
mandarin: 
joci: 
niwmonia: 
undod: uno, rali, affinedd, undod, tebygrwydd
colfach: manwl, dolen
hydredol: fertigol
difidend: dyraniad
sglefrio: sgïo
ddehonglwr: mynegai, esbonyddol
anabledd: handicap, anallu, nam, amherffaith, anabl, nam, blemish
obsesiwn: aflonyddu
rhandir: dyraniad, dyrannu, darpariaeth, cwota, aseiniad
ffotograffydd: ffotograffig
delta: cymryd-rhan
digidol: ffigur, rhifolyn, rhifiadol
ast: 
amrant: 
lletraws: 
subconscious: 
ael: 
tisian: 
doniol: siriol, hwyl, falch, ddoniol, difyr, ddoniol, difyrru, doniol, chwerthinllyd
Hindŵaeth: 
ffoaduriaid: mewnfudwr
gwennol: llong-ofod, cerbyd, cludiant, cludiant
protein: wy---gwyn
dymp: pentwr, pentwr, gael-gwared, sbwriel, garbage
mireinio: 
cyfog: 
genyn: yn-enetig, genetig
freshman: 
cymdeithaseg: 
sboncen: pwmpen, malwch
Fisher: 
rhanbarthol: sir, ardal, parth, ward, sffêr, sector, ymylol
cynnig-i-fyny'r allt: 
ôl-weithredol: gorffennol, introspection
gorwynt: 
gwrthdroad: gwrthdro, groes, cilyddol, gwrthdro
tv: teledu, ffilm
ciwb: 
cynhyrchiant: perfformiad, allbwn
moron: 
moleciwlaidd: moleciwl, swbstrad
conglomerate: clic, grŵp, clwstwr
cyfrifydd: archwilydd
ciwcymbr: opsiwn, gwddf
orgy: 
toddydd: hydoddi
ffosffad: 
primer: abwyd, gydnabod, cyflwyniad
alcalïaidd: 
gymnasteg: ffitrwydd
coma: coma, parti
cynnig-i-lawr y rhiw: 
camesgoriad: erthyliad, isel, methiant
pod: cragen, wain, croen
rhoddwr: 
manganîs: 
seicolegydd: 
clorin: 
bysellfwrdd: 
elitaidd: 
parenthesis: 
rygbi: 
wlser: ddolurus, clwyf, trawma, berwi
ffurfdroëdig: 
cnoi: 
cwantwm: swm, maint, cwota, cyfran
siwmper: siaced
esblygiadol: datblygiadol, esblygiad
nodiant: arwydd, symbol, Nodyn
bownsio: ffyniant, neidio
dyrannu: dyrannu, adran
cache: 
llinol: syml
antimoni: 
superessive-achos: 
tiwmor: tiwmor, swmp, bump
erydiad: 
alffa: 
navel: bol, polyn
imiwnedd: anadlu, resistant
y-ffliw: ffliw, rhedeg, twymyn, dylanwad
bragdy: 
symleiddio: 
talfyrru: terfyn, cyfyngu, cyfyngu
tolc: lwmp, bump, dant
swyno: dal, hudo
gorfodi: cyfyngu, grym, gorfodi, gorfodi
hosan: 
ffilm: ffilm, sinema, rhuban, tâp, streipen
cosmos: bydysawd
llygru: llygredd, heintio
heidiol: 
pidyn: rhyw
coedwigaeth: 
alwminiwm: alwminiwm
osgiliad: amrywiad
horoscope: 
ddiarddel: jet, ddiarddel, oust, alltudio, secretu, dadleoli, tynnu
cynhwysiant: cofnodi, integreiddio, gwreiddio, clawr, cynnwys, yn-cwmpasu, goblygiad, cynnwys, cyfranogiad
buddiolwr: periglor, defnyddiwr
dolffin: 
llofrudd: 
mamaliaid: 
dangosydd: osgo, mynegai, meini-prawf, mynegai---bys, medrydd
deuocsid: 
colon: 
biwrocratiaeth: fiwrocrataidd
ystumio: camarwain, scramble, afluniad
oergell: oergell
archeolegol: archaeoleg, archaeoleg, ffosil
annerbyniol: disapproving
fanyleb: norm, safoni
taflen: bwletin, taflen, taflen
anthropoleg: 
blasus: blasus
transitive: esgus, pontio
cower: cropian
blodyn-yr-haul: 
lleuen: tic, bit
ion: 
twristiaeth: twristiaeth, teithio
modem: 
cyflymiad: hyrwyddo, hwyluso, symbyliad
ffugio: drysu, efail
allyriadau: budr, mater
herwgipio: herwgipio, dargludiad, snatch
gorgyffwrdd: rhyngweithio, rhyngweithiol
trin-gwallt: 
llên-gwerin: gwenith
capilari: 
cenedlaetholdeb: cenedligrwydd
pen-ôl: clun, pen-ôl
motiff: thema, pwnc, cymhelliad, tiroedd
sublimate: 
rhwystredigaeth: cam-yn-ôl, anobaith, siom, ddryslyd, canslo
cobalt: 
ceirch: 
cynnig-fyny'r-afon: 
anws: 
buchol: 
fflip: cyfieithu, cyfieithu
diswyddo: digonedd, gweddilliol, dros-ben, diswyddo, diswyddo, eithriad
'n-fideo: 
boicot: sir, diarddel, esgeulustod
cwis: ymgais, arholiad, holiadur
hoci: 
gerila: 
magnesiwm: 
radar: 
tsimpansî: 
dibynadwyedd: hygrededd
petryal: 
môr-wiail: 
cyffredinoli: cyffredinoli
cyrffyw: 
cyfunrywiol: 
senario: sgript, tirwedd
llunio: adeiladu, adeiladu, adeiladol, geiriad, creu, ffurfiant, llunio
ailymgnawdoliad: 
tanio: 
wraniwm: 
daliwr: derbynnydd
cydlynu: cydlynu
trethdalwr: 
integredig: annatod
Mynegwyd-barn-gan: golygfa, barn, sylw
gama: 
safari: taith, mordaith, taith, taith
cynnig-lawr-yr afon: 
cyfernod: gradd, ffactor
pennawd: teitl, pwnc
dadansoddwr: dadansoddi
checkmate: 
mall: archfarchnad
bismwth: 
cerdyn-post: cyfarch
cydgyfeirio: brasamcan, cydgyfeirio
digress: encil, gadael
cyfranddaliwr: partner
microb: 
organau-rhywiol: 
morffolegol: genetig, morffoleg
beta: 
jîns: 
Cronfa-ddata: 
cyfrifiannell: cyfrifiadura
pelydr---x: 
dosrannu: 
amgylcheddol: tirwedd, amgylchoedd, amgylchedd, cyd-destun, ecolegol, cymdogaeth, cymdogaeth, cyfuchlin
sigma: 
datgysylltiad: unigedd, gwahanu, torri-lawr, torri-lawr
agenda: rhaglen, rhaglen, cwricwlwm
fisa: 
seilwaith: 
Firefly: 
synhwyrydd: 
ymaddasol: 
biolegydd: 
sbleis: affix, diwygio, atodi, cysylltu
bromin: 
Palladium: 
faglu: 
pastel: golau
sw: 
clinig: 
connotation: goblygiad, golygu, semantig, syniad, cysyniad, synnwyr, cyd-destun
ioga: swm
siop-lyfrau: cwpwrdd-llyfrau
therapi: triniaeth, drin, gwella, rhwymedi, therapydd
genedlaetholwr: ethnig
behead: 
yeah: ie
broblemus: mater, problem, cymhlethdod
jazz: 
twngsten: 
terfysgol: milwriaethus, arswyd
driblo: llysnafedd
metaboledd: 
alimoni: 
penwythnos: 
chrysanthemum: 
brechlyn: sylwebaeth, sylw
beic-modur: beic-modur
mantra: 
semester: dymor
heroin: 
ffolder: 
catod: 
ideoleg: meddwl
parcio: 
theta: 
disgynneb: siom
seleniwm: 
beicio: cylchrediad, dolen, cylchol, beic, beic
cortecs: rhisgl, cragen, croen
cywerthedd: cydraddoldeb
ar-hyn-o bryd perthnasedd marciwr: 
maes-awyr: 
trychu: torri-ar-draws
pêl-fasged: 
imposter: 
chwilod-duon: 
cromiwm: 
litr: litr
serch-hynny: serch-hynny, eto, fodd-bynnag, beth-bynnag
hormon: 
ddiffygiol: diffyg, diffyg, amherffaith, camgymryd, ffug, ddiffygiol
dyllu'r: pierce
animism: 
polygon: ongl
ffeministaidd: 
cyfun: inclein, cysylltu
ewro: 
ginseng: 
algorithm: 
laser: 
drugstore: 
milimedr: milimedr
flex: plygu, crwm, hyblyg, ffafriol, cebl
anod: 
naws: cysgod
rhan-amser: 
sensitifrwydd: 
arddangoswr: 
heliwm: 
dwyieithog: 
acronym: cryno, yn-fyr, crebachu
initialism: 
gerund: 
plasma: 
cromosom: 
trefnol: cyffordd, rhes, rheolaidd, dilyniannol
cilometr: cilometr
ffacs: 
geneteg: genetig, yn-enetig
freckle: 
sgriwdreifer: wrench
brocoli: 
preterite: 
fitamin: 
cadmiwm: 
awyren-fomio: 
graffigol: 
titaniwm: 
afradlon: Brag
lamda: 
gariad: partner, cariad, gariad, merch
copulate: 
hourglass: 
empathi: cydymdeimlad, tosturi, dealltwriaeth
boron: 
hofrennydd: 
tellurium: scandiwm, Lanthanwm:
dyddiad-cau: dymor
alinio: 
centimetr: 
molybdenwm: 
lithiwm: 
amlgyfrwng: 
diweddariad: moderneiddio, newydd-wedd
calorïau: 
robot: 
gwaith-Cartref: 
logarithm: 
mantis: 
instal: mount, gorsedda, synthesis
amino: 
glyph: rhyddhad
aorist: amhenodol
ecoleg: ecolegol
sophisticate: difetha
marijuana: 
micro: cynnil, bach, bach, bachigol, meicroffon
cilogram: 
gorfwyta: 
rhagweladwy: rhagfynegiad, rhagfynegi, rhagolwg
pizza: 
eavesdrop: 
ieithyddiaeth: ieithyddol
haircut: 
iridium: 
hiliaeth: hiliol
optimaidd: top, gorau-posibl
ddiwydiannu: industrialize, diwydiannol, gweithgynhyrchu
pencadlys: pencadlys, sedd
Ceriwm: 
gyfath: gyfeillgar, addas, ffafriol, gydnaws, tebyg
partitive-achos: 
casét: tâp
grym-ewyllys: wirfodd, bydd
dimensiwn: maint, siâp, dimensiwn, gofodol
paramedr: 
Cydamseru: cydamseru
gwneud-y-mwyaf: uchafswm, gwella, gor-ddweud
seminar: gweithdy
disgo: plât
neon: 
osmiwm: 
Ystwyll: 
plagiarize: lladrad
artifact: 
adweithydd: 
oregano: 
plwtoniwm: 
Ytriwm: 
cynyddol: 
enw-defnyddiwr: 
ôl-raddedig: 
asgell-dde: 
argon: 
ffobia: arswyd, parchedig-ofn, haunt, ffieiddio
cymdeithasu: cyfathrebu, rhyngweithio
globaleiddio: 
tonfedd: 
amgodio: cod
ailgylchu: a-ddefnyddir
Ail-ddechrau: reboot
hepatitis: 
Torus: lwmp
cemotherapi: crefyddol
modulo: llwydni, modiwl
proton: 
ddisgen: 
milligram: 
picsel: 
tantalum: 
hydoddyn: penderfynu
hil-laddiad: 
ysglyfaethwr: ffyrnig
gallium: 
sirconiwm: 
determiner: penderfynu, ddiffinio, ymchwilydd
aflinol: 
plaleiddiaid: 
beryliwm: 
neuron: 
predicative: bendant
underpants: dillad-isaf
ffactoraidd: cyfadran
niwtronau: 
niobium: 
germaniwm: 
metalloid: nad-ydynt-yn metel
rhoi-ar: 
prolative-achos: 
bioamrywiaeth: 
ffon-reoli: 
gwrthfiotig: 
actiniwm: 
gofodwr: gofod
allfydol: estron
crackpot: dwp, mad, crazy, wallgof, annormal
marathon: 
yterbiwm: 
awtistiaeth: 
ionize: 
radon: 
nerium: 
epidemioleg: 
hen---oed: henoed
gwersylla: gwersyll
streipiog: streipen, cynllun, cynllunydd
indium: 
veridical: diffuant, pur, net
gwefan: gwefan, safle, proffil
Koran: 
flatware: 
nfed---gwraidd: 
lawrenciwm: 
sifil-ar-hawliau: 
Ffôn-Symudol: Ffôn-Symudol, Ffôn-Symudol
barlysu: 
protactiniwm: 
ymbelydredd: glow
yn-dibynnu-ar: 
thoriwm-atom: Thwliwm:-atom, terbiwm-atom, Rhodiwm-atom, rwbidiwm-atom, fanadiwm-atom, fflworin-atom, poloniwm-atom, thaliwm-atom, strontiwm-atom, ruthenium-atom
glas---jean: 
planhigion-tŷ: 
yn-unigol: yn-bersonol, unigol, personol, ar-wahân
llif---gyfredol: 
triphlyg---bwynt: 
dynol---gorff: 
ffiseg: corfforol, yn-gorfforol
manwerthu-siop: 
caesiwm: 
hir-yn-ôl: 
taenlen: 
uned--of-- màs: 
llunio: 
gwerth-deuaidd: 
dynol-sef: 
gan-fodd-o: 
depan-dari: 
praseodymiwm: 
cardfwrdd: cerdyn
cyfyngedig-ferf: 
treial-rhif: 
pro-dedfryd: pro-ymadrodd
beirniad: beirniadol, feirniadol
pecynnu: lapio, pecyn
byrhoedledd: ansefydlog
yn-y-rhan fwyaf o: 
disgrifydd: disgrifiad
neodymiwm: 
cyfeillgarwch: gyfeillgar, gynghreiriad
darllen-yn-unig: 
founds: 
gnomic-hwyliau: 
ffonem: 
rhesymoledd: ymwybyddiaeth, rhesymeg
ffonolegol: 
bwyta-ystafell: 
byw-ystafell: 
ganolog-achos: 
cyn-hodiernal: 
claf-achos: 
oblique-achos: 
gwledig-ardal: 
recurse: 
canol-llais: 
meitnerium: 
bost---cludwr: 
noncommittal: fflat
stoc-farchnad: 
adnabyddadwy: adnabod, nodi
nod-sbardun: 
un---eiliad: 
lative-achos: 
dogn: dogn
nad-ydynt-yn dynol: 
byw-beth: 
hefyd-ychydig: 
ffilm---theatr: sinema
hassium: 
attenuative: 
multal-rhif: 
llaethog-ffordd: 
neptwniwm: 
ghostwriter: 
trans-rhifolyn: 
ffwl---o gwmpas: 
Americiwm: 
bore-gogoniant: 
diffoddwr-tân: 
berkelium: 
galaeth-rhyw: 
Nobeliwm:: 
Hwyl-fawr: bye, Hwyl-fawr, nes
bwdhaeth: 
Fermiwm: 
cyan: magenta
soia: 
dosbarthwr: 
strikebreaker: 
prosesydd: 
abessive-achos: 
adessive-achos: 
i-achos: yn-achos, ar-hap
agentive-achos: 
Rutherfordiwm: 
gwrthgyrff: 
fel-llawer-fel: 
asiant-sbardun: 
actor-rôl: 
ethidium: 
cyffredin-rhyw: 
deithydd: 
safflower: 
Ffransiwm: 
Erbium: 
goddefol-llais: 
astatin: 
cnoi-gwm: 
seren-rhyw: 
dyfyniad-ffurflen: 
curium: 
comic---stribed: 
lliw---ddall: 
euler's---rif: 
edrych-yn: 
crosswalk: llwybr
gad: 
modurwr: gyrrwr
--Cylched-byr: 
llafar-noun: 
crio-allan: 
yn-ystadegol: ystadegol
iogwrt: 
xenon: 
hypnotize: 
cymryd-off: 
cymal---gynffon: 
uniongyrchol-gwrthrych: anuniongyrchol-gwrthrych
groser-siop: 
cynnwys-o: 
ergative-achos: 
yn---iaith: 
uniongyrchol: uniongyrchol
locative-achos: 
pwll-Nofio: pwll, basn
adferfol-achos: 
sightsee: taith, arolygu, cylchrediad
teledu-set: 
terfynol-gronynnau: 
evitative-achos: 
adsefydlu: 
atchweliad: dychwelyd, tynnu'n-ôl, encil, cam-yn-ôl
bloc-o-fflatiau: 
deffro-i-fyny: 
heddlu-swyddog: 
rhegi---mewn: 
cyfwelydd: cyfweliad
rheniwm: 
aerosol: 
meddiannol-achos: meddiannol-achos
nominaleiddiad: enw
meddu-achos: 
overcharge: 
ategol-ferf: 
cynradd-gwrthrych: 
cyfrifiadur--firws: 
person-busnes: busnes-person, masnachwr
a-pobl: pobl, gwerin
antessive-achos: 
Prif-Weinidog: 
Lwtetiwm: 
europium: 
emote: 
werin---cerddoriaeth: 
bardd: 
ôl--swyddfa: swydd, bost
sôn,: rhagdybiaeth, hypothesize, yn-ôl-pob tebyg, yn-ôl-pob golwg, debygol
animeiddio-rhyw: 
subessive-achos: 
nwy---bedal: 
polaredd: polar
cerbyd-rhyw: 
mwynau-rhyw: 
berf---ddodiad: 
angerddol: emosiwn, emosiynol, synhwyraidd
Samarium: 
hwylusydd: safonwr
dychmygol---uned: 
cyflymder--of-- golau: 
llu-Awyr: 
empathetig-llawenydd: 
yn-feirniadol-- bwynt: 
llawn-amser: 
Haffniwm: 
ataliad: atal, cwrbyn, lesteirio, gwahardd
newid-o-digwyddiad: 
holmiwm: 
gwahanol-digwyddiad: 
bydysawd-rhyw: 
ardal-rhyw: 
rhithwir-peiriant: 
ymchwil-rhyw: 
artistig-rhyw: 
crastinal-amser: 
haniaethol-rhyw: 
exocentric-achos: 
transitive-ferf: 
morpheme: 
chauvinist: 
gorffennol-perfective: 
galwedigaethol: arbenigedd, galwedigaethol, galwedigaeth, crefft, proffesiynol
anuniongyrchol-lleferydd: 
ail-iaith: 
i-fod: 
fynwent-sifft: 
ar-y-cyd noun: 
absolutive-achos: 
claf-sbardun: 
hunan-hyder: 
feces: stôl, baw, baw
atblygol-llais: 
amhersonol-ferf: 
Seaborgiwm: 
gofod-gwyn: 
foddol-achos: 
difywyd-rhyw: 
causative: 
propositive-hwyliau: 
trydan-ar-hyn o bryd: 
cysylltiadol-achos: 
radd-eithaf-achos: 
hefyd-llawer: 
planedol-rhyw: 
animeiddiedig-cartŵn: 
cilyddol-llais: 
ddeddfu: deddfwriaeth, deddfwriaethol, trefnu, trefnu
yn-lleiaf: 
gramadegol---achos: 
defnyddiwr: 
craidd-benefactive: 
gôl-geidwad: 
:-except-for: 
enwadur: 
arall---os: 
i'r-ochr: neilltu
eich-gilydd: Ei-gilydd, cilyddol
olynol-cymal: 
gwisgo---allan: 
siorts: 
dysprosiwm: 
cyn-bo-hir dyfodol amser: 
si-unedau: 
crypton: 
mendelevium: 
applicative-llais: 
antipassive-llais: 
continuative-agwedd: 
ymbelydredd---salwch: 
necessitative-hwyliau: 
sengl-gweithredu-ferf: 
railcar: 
radd-eithaf-radd: 
dirfodol-cymal: 
Califforniwm: 
yn-bresennol-rhangymeriad: 
luminous-dwysedd: 
singulative-rhif: 
gramadegol---gwrthrych: 
goddefol-rhangymeriad: 
gormodol-hyd: 
supercritical---hylif: 
swm-o-sylweddau: 
postpositional-achos: 
dewisol-quantifier: 
gadoliniwm: 
epenthetic-morpheme: 
negyddu-quantifier: 
einsteiniwm: 
artiffisial-iaith: 
cysylltiol-gronynnau: 
bell-dyfodol-amser: 
frequentative-agwedd: 
dosbarthol-rhagenw: 
allocution-cytundeb: 
moel: moel
maestref: pentrefan, cefn-gwlad
cyffredinol-quantifier: 
cyfrifiadur-rhaglennu: 
teledu-rhaglen: 
fel-y-bo'r angen - pwynt- rif: 
dirfodol-quantifier: 
y-dydd-ar ôl yfory: 
amgen-quantifier: 
drwg---tymer: garw
gorffennol-goddefol-rhangymeriad: 
y-dydd-cyn ddoe: 
locative-cyfeiriadol-achos: 
gwrthffeithiol-amodol: 
