berfenw: hnit
enwol-achos: hnak
accusative-achos: hkak
pwnc-achos: htak
rhiant: hmat
dad: hpap
mom: hmam
Helo: hnat
hynafiad: htat
cu: hyat
llwglyd: hcac
genidol-achos: hnik
ansoddair: hcit
ac: hwan
mi: hmic
chi: hnan
ni: hnam
mae'n: hyic
cyrchfan-achos: htas
derbyniol-achos: htik
tu-cyd-destun: htis
person-cyd-destun: hpak
dibynnol-cymal: htan
perfective-agwedd: htap
gorffennol-amser: hkat
gwrywaidd-rhyw: hsan
comitative-achos: hmik
yn-bresennol-amser: hyan
benefactive-achos: hpik
essive-achos: swik
Ni: hnic
ei: hsis
wyneb-cyd-destun: hsak
adpositional-achos: hpan
lleoliad-achos: hwak
gofod-cyd-destun: hnos
ffordd-achos: hrak
offerynnol-achos: hsik
sy'n: hkan
gofynnol-hwyliau: hnim
ac-neu: htam
exclusive---neu: hkit
ffynhonnell-achos: hsok
abladol-achos: hlak
dangosol: hdit
ond: hlan
i-gyd: hsut
feminine-rhyw: hnin
maent: hwin
plural-rhif: hlun
un: hyik
dyfodol-amser: hwet
cymdeithasol-cyd-destun: hson
pryd: hkap
imperfective-agwedd: hmap
yno: hkac
amodol-hwyliau: hcan
mwy: hdoc
allan: htac
perthynas-achos: hrik
illative-achos: hlik
gwneud: hkas
gyfarwyddeb-hwyliau: hden
deontic-hwyliau: hdim
cwestiwn-gair: hwac
copula: hkok
person: hpon
gwrywaidd: hman
gallai: kwat
eraill: hcon
rhif: hnoc
iawn: tcac
amser: htim
amser-cyd-destun: htos
tymhorol-achos: hmak
am: hkam
epistemic-hwyliau: hsim
yn-unig: htun
ychydig: hcak
yna,: pcan
hortative-hwyliau: hton
ôl-weithredol-agwedd: hrip
mawr: hcat
volitive-hwyliau: hlim
cyn: hsec
rhaid-i: pcic
dau: htut
gweld: tcan
yn-gwybod: hsat
i-lawr: hcin
ar-ôl: hcas
yn-gyntaf: hpas
hun: hpun
alienable-meddiant: hlic
byth: hnac
anaralladwy-meddiant: hkic
oed: hwat
cydgynghorol-hwyliau: hcim
diwrnod: htin
lle: hnap
dod: hlat
ffordd: hyas
gwaith: hkaf
llafariad: hwaf
mynd: hkun
perlative-achos: pwik
blaengar-agwedd: hpip
hir: hlac
dweud: hsac
sut: hkin
hyd-yn-oed: hpit
yn-ôl: hwap
yma: hcic
meddwl: hcik
un-fath: hsam
diwethaf: kcac
i-ffwrdd: twan
dan-cyd-destun: hnas
cymryd: htit
dod-o-hyd: hfan
llaw: cyat
ifanc: hyac
er: hyap
rhoi: hkik
duw: hmac
delative-achos: lwak
dim-byd: hmin
hawl: hyit
unwaith: hyam
semelfactive-agwedd: fwip
rhan: hpat
gwelodd: htic
tŷ: hfas
byd: tcat
pen: hcaf
tri: tyin
neo: hnon
ffocws: hcok
caru: hpac
bob-amser: hsit
nos: hwit
pob-un: hmit
Brenin: hyak
rhwng: hsin
galon: cyin
paucal-rhif: plom
achos: hyok
achosol-achos: ksak
beth: hkis
set: swat
enw: hnem
priodol-noun: hran
hortative: hrat
gwlad: hlit
gofynnwyd-i: hput
yn-weladwy-tystiolaethol: crit
gwell: pcac
ochr: psac
cwrs: hkus
benywaidd: hfin
digon: kyat
yn-fuan: hpuc
llawn: hcun
ystafell: hfac
bron: hlap
Ni-all: nyat
dŵr: hwik
desiderative-hwyliau: hdin
golau: lyak
nac: hnun
gair: slat
drws: tyan
defnydd: hpus
bore: hsap
terminative-achos: twik
pŵer: hkuk
eu-hunain: hmis
bresennol: hyin
llais: hwas
gwyn: hpis
arian: tlan
nesaf: kyak
gwael: hyis
marwolaeth: hmut
ffurflen: hfam
inessive-achos: nwik
math: tyac
yn-aml: tsan
blwyddyn: nwan
ffrind: myat
gorchymyn: hyut
hanfodol-hwyliau: hpim
rownd: hcut
yn-credu: hban
cyhoeddus: hpin
wladwriaeth-cyd-destun: hsas
mab: psat
cant: hmas
plant: hcis
a-thrwy-hynny: tyak
gobeithio: hcap
uchod: hyip
annwyl: pyin
darllen: pyac
dinas: hsic
eisoes: hpic
ffaith: hfat
factive-tystiolaethol: hfit
clywed: hsun
lleiaf: hmim
efallai: pyat
agored: kcat
corff: tcic
aer: cwac
natur: nyit
helpu: mlat
llythyr: lyat
pedwar: ksat
eith-hwyliau: hpam
tân: hfak
felly,: hyif
awr: hcam
rhad-ac-am ddim: tyit
rhyfel: syat
p'un-a: hsaf
rheswm: kyan
unedig: hnut
galwad: hkuc
pam: hwam
gollwyd: hkut
mil: tsas
teulu: hfic
enaid: twam
cwestiwn: swac
gofal: kcan
realis-hwyliau: hlin
golygu: mwit
potensial-hwyliau: hten
tuag-at: cyan
allative-achos: lwik
anthropic-rhyw: hrin
byr: kyut
gallu: hyuk
byw: hkip
pwnc: hsek
yr-un-pwnc marciwr: hcek
gwahanol-pwnc: hfek
ateb: tsat
môr: mwat
ofn: hcoc
deall: pcat
caled: kyin
termau: tyut
amheuaeth: hdac
dubitative-hwyliau: twin
gofyn: psan
breichiau: tcas
du: clis
dod-â: tyat
hardd: ksis
tywyll: tcak
cynnal: psak
deg: htaf
sioe: pyan
stori: hkif
cyffredin: kwan
llyfr: hkup
electronig: lyin
sgwrs: plak
marc: myac
llog: nyis
ysgrifennu: kcit
gwely: pwat
angenrheidiol: syis
syniad: hwis
celf: klat
vialis-achos: hlas
brawd: pyak
weithiau: ksas
llinell: lyan
tabl: tlas
afon: nwit
llygad: kyac
gwybodaeth: fyin
yn-sydyn: tfan
rhyfedd: hgan
dwfn: ksan
newid: hrit
teimlad: nwac
cwrdd: mlit
pwrpas: htuc
hapus: hcuc
ymddengys: syit
gwaed: cyac
rhosyn: kwas
de: swan
oer: tlat
ymlaen: myik
sefyllfa: psis
yn-hwyr: tyam
sefyll: syan
Mae'n-debyg: nlas
merch: pyit
mwynglawdd: myan
torri: hkim
copi: hfap
gŵr: hgat
chwech: hlis
cofiwch: twat
effaith: hyaf
syrthio: htuk
ac-eithrio: hsip
gwallt: hpaf
pasio: pyas
hawlfraint: pcit
y-fyddin: cyit
rhedeg: kcak
ceffyl: kcas
dyfodol: hwic
orllewin: pcak
talu: plit
Coch: hyun
aur: tcun
dymuniad: hdan
chwarae: plin
meistr: mwas
swyddfa: hfus
llywodraeth: syak
eglwys: kyas
hyd: hlen
cwmni: ksin
papur: kyis
tebygolrwydd: hbin
yn-enwedig: cyas
arth: pcas
ffenestr: cyak
cytundeb: hgac
harddwch: syac
dyletswydd: tfac
anfon: fyan
pellter: htif
tawelwch: slan
droed: fyat
gwyllt: kyik
yn-marw: myam
arbed: pfan
gwyrdd: kcin
trafferth: mlan
gwenu: myak
anghywir: clat
amrywiol: pcin
cysgu: slit
quotative-achos: kwik
dechrau: cwan
gweithredu: kfan
ymweliad: fwat
dilyn: nlan
ceisiwch: tcis
presenoldeb: psit
melys: tlit
gyfoethog: tcin
gelyn: tcam
llong: hcip
cyflwr: kyit
Gan-gynnwys: hkum
gynhwysol-person: hlon
gyfrinach: kwit
precative-hwyliau: pwim
gwrtais-gofrestru: hbit
drwg: pwac
mawrth: myas
Beth-bynnag: kwac
aros: hlam
yn-lle-hynny: plat
glas: plan
amhosibl: psap
ysgol: hsuk
achlysur: ksac
briod: nwat
bwyd: hcuk
ugain: tsis
dawel: tcit
yn-hawdd: hnis
darpar-agwedd: hrap
iaith: lyac
mynegiant: syas
wythnos: hsus
neuadd: hcum
perygl: kcic
eiddo: myit
eni: nyan
llys: kcut
Yn-gyffredinol,: tyap
gnomic-agwedd: hmip
werth: tyas
syml: syap
coed: pyic
frwydr: pyap
wal: twit
nefoedd: cwak
inchoative-agwedd: htip
jussive-hwyliau: hjin
tôn: twun
sylw: klan
Disgwylir: pcik
mis: hmaf
profiad: nyap
yn-gyfan-gwbl: nyac
ffres: tsac
dug: hnuk
a-gwmpesir: kwak
rhwymo: hyim
ddwyrain: tyuk
carreg: pwan
braidd: kfat
cyfarwyddyd: tlac
cadeirydd: kwis
cefnogaeth: syut
dyddiad: tyic
pentref: klac
maes: clit
caniatâd: nwin
caniataol-hwyliau: hmom
llwyddiant: slak
priodol: hric
bryn: clin
cerddoriaeth: ksik
distal-dangosol: hdat
prynhawn: htup
crio: hyuc
anrhydedd: hnaf
saith: swit
preifat: pfat
newyddion: nwas
olygfa: slac
gardd: cyam
hil: htus
dosbarthol-achos: twak
dysgu: clan
gwleidyddol: syik
gorwedd: kcun
bwrw: tsak
bwyta: kcam
llawr: hlaf
sâl: pwin
gwreiddiol: mlin
haf: kyam
crefydd: tlam
llun: ksit
dianc: plap
awdur: hlut
brown: pyun
benderfynir: htem
poen: hdon
gwanwyn: psin
ganrif: syic
meddal: mwan
cornel: kyun
cynhyrchu: psas
chwerthin: cyaf
anghofio: flat
ewrop: hyup
wyth: lwat
gwisg: lwac
ofnadwy: cyap
anadl: syaf
ddoeth: hbas
meddiannol-marciwr: srak
cof: myin
modern: fwan
fan-a'r-lle: tcap
yn-codi: hyus
egwyl: pyik
hanner-cant: hfis
ynys: tlap
cyffwrdd: hsuc
addewid: pcam
commissive-hwyliau: mwin
gradd: tfat
cynllun: plac
ymddygiad: nyak
syndod: cran
munud: hmun
ergyd: hwut
waeth: pcap
gwydr: klak
enghraifft: tlin
yn-ddiogel: hsif
meddyg: tsit
completive-agwedd: hmep
dro-ar-ôl tro: tyun
milwrol: slin
cynnes: nyam
diod: pfin
cwestiynau: pcaf
dicter: nran
yn-uniongyrchol: tyik
het: hcup
ci: kwap
gwas: hnuc
balchder: hram
dorf: tcuc
trên: nyin
moesol: myut
cysylltiedig: kyim
fynd-i-mewn: fyak
rheol: nyas
cleddyf: cwat
ymosodiad: kfak
iechyd: clac
paragraff: pyaf
cymdeithasol: hsum
ad-daliad: tfit
n-chwith: hpec
dewrder: krac
gras: hnen
swyddogol: hfaf
a-ddarperir: tsik
cais: pwit
Cipolwg: klas
symudiad: hyon
disgwyl: cwit
gyferbyn: psam
deuddeg: tyaf
cymryd-rhan: nyut
gwin: hwun
blas: swut
haearn: fyac
dosbarthu: syin
fasnach: myap
mantais: twac
dillad: kfip
barnwr: fwak
gwahaniaeth: tfaf
bryderus: kcis
capten: kwin
gorffenedig: nlat
rhoi'r-gorau-i agwedd: hsep
chwilfrydig: kyic
tramor: kwic
intensifier: hnif
pwysigrwydd: myun
yn-olaf: hfim
bil: fwin
profi: hpuk
atal: flan
gwddf: cyun
cyfreithiol: hfik
sych: swak
gweini: syam
colli: pcut
tystiolaeth: pyut
tystiolaethol-achos: hdak
cynnydd: pyis
adeilad: klit
chwilio: syuc
drist: hrac
pechod: psip
deg-ar-hugain: tfis
onest: tsin
cau: kyap
banc: pcun
tynged: cyik
coedwig: hfun
mesur: mlac
fel-arall: htoc
nant: lyam
bara: hpup
ychwanegol: tfak
dewis: twas
anifeiliaid: nwam
zoic-rhyw: hzin
eventive-hwyliau: hwim
yr-un-digwyddiad marciwr: hcom
lluosogol-achos: tlak
trwchus: hmus
creadur: hyum
glaw: myic
wyneb: pfas
sanctaidd: swis
Gorffennaf: clim
adroddiad: hfut
arfordir: pwas
ffeil: hfif
ysgwydd: cwut
synnu: kran
brenhinol: klik
cân: hkuf
cysur: kfaf
unrhyw-un: nyic
glaswellt: kcap
tynnu: cwik
agor: cyic
Mehefin: cwun
pysgod: mlic
cyfalaf: klin
fron: cyut
eira: hcif
addysg: tlik
miniog: tcaf
biti: hdam
traul: fyas
eich-un-chi: hmuc
miliwn: mlun
wedi-blino: tcik
lladd: ksam
cysgod: cwap
pwysau: plas
màs: mlas
sefydlu: tlip
dewr: pyam
tenau: plic
bodlon: srat
gwiriwch: kcik
rhinwedd: hdet
cenedlaethol: nyaf
ddwyfol: swin
cwm: clak
dyfalu: kwam
hapfasnachol-hwyliau: hken
melyn: clas
gweddillion: mwac
plygu: nlac
blwch: pwak
tymor: tsim
gwyddoniaeth: slas
turio: kcuc
ewythr: hmuk
rhestr: lyit
Awst: ksut
poblogaidd: hlup
anhysbys: fyit
cyfarwydd: flak
cyfarwydd-gofrestru: krit
darllenydd: tsut
ymagwedd: pcuc
ddwywaith: tsap
deallusol: tfik
wirioneddol: tsam
offeiriad: pcis
glwyfo: fran
tristwch: hpom
palas: kfas
guro: clap
eh?: hnec
ffwl: myuk
ymyl: pfac
naw: nwun
byrstio: psut
yn-dioddef: tfas
sŵn: hcus
llenyddiaeth: lyic
cyngor: swas
gwag: kcuk
rheng: psik
storm: tcut
poced: kyip
dychymyg: nlin
dedfryd: cwas
Tachwedd: nwap
Rhagfyr: tsip
absenoldeb: psic
diolch: ryak
cyfeiriad: tyis
aderyn: pyuc
perchennog: mlik
cot: kwut
paratoi: tyip
cysylltiadau: lwan
mwg: htum
Ionawr: nwak
peiriant: clic
cynnwys: nyik
dannedd: tlis
cywilydd: hcet
bae: kcaf
ymennydd: pyuk
ffoniwch: klic
ymadrodd-marciwr: frak
sgwâr: ksap
ffrwythau: fyut
te: tsic
eglurwch: slam
croeso: cwam
barddoniaeth: pwis
prynu: klam
ffyddlon: hdic
cyffro: hcen
deugain: klis
Ebrill: pyip
garedig: kfit
Hydref: kfap
chwerw: kyuc
gaethweision: tlaf
rhydd: hluk
testun: tsus
credyd: cyip
pymtheg: pfit
creulon: kcim
ymuno: cluc
proses: hpif
trosedd: kyaf
llwch: tsuc
ymarferol: plik
lliw: nlak
dinistrio: nyuc
cynyddu: lyas
trwyn: hnus
cyfaddef: tyim
ddoe: kfac
hesternal-amser: tlen
methu: slap
parhau: tcim
gwisgo: pwam
ddall: nlit
dwsin: tsun
hedfan: fyap
canmoliaeth: cwin
diafol: cwaf
yn-raddol: twic
aberth: kyif
ymarfer-corff: cyis
cydwybod: tfin
theori: tlic
gweinidog: myis
casineb: hnet
llyn: cwic
canolfan: syun
llewygu: pfic
rhesymegol-rhyw: hron
gofalus: fwac
mwynhau: nlam
addoli: pwap
nwyddau: twap
croen: twaf
to: tlut
goron: gyan
castell: klap
orsedd: tcus
ynghlwm: nlaf
filltir: mlim
eithafol: krim
carchar: fyis
cwpan: kcip
aelod: mlam
sifil: syim
ym-mhob-man: tsaf
yn-amlwg: tfic
cwpl: pwaf
cyfaint: clam
arfer: ksaf
bwa: ksun
siwt: slut
cig: mwak
llaeth: hluc
vegetal-rhyw: hwen
gweledigaeth: slic
prin: nlap
cefnder: ksic
bont: pwut
gwarchod: pfak
halen: swam
diniwed: hwus
brenhines: kwim
cyfrif: kcus
chwilfrydedd: hras
dawns: tyus
gwesty: clut
llenwi: flin
carcharor: psun
siop: hjan
grisiau: sric
beg: hmen
tywod: sran
treisgar: hgit
Medi: hsem
ymadawiad: prac
adfail: crin
sgiliau: krin
gwartheg: hwec
offer: hwip
cegin: hkon
gwerthu: hbak
cyflymder: hsot
casgliad: clon
cyfrifiadur: hkot
tragwyddol: hsen
cyfyngedig: mrit
llyfrgell: hbek
sylfaen: hbac
dryswch: hrun
gogoneddus: cris
yn-yr-un modd: hjic
ofnus: hbic
anhapus: prin
erthygl: hrek
cogydd: kfin
band: hbat
anialwch: hget
cusan: hbun
pêl: hbot
ffon: hpot
ddadl: hrut
arsylwi: nrak
bendith-hwyliau: hbim
trawiadol: hrim
yn-euog: hdis
gwn: hgin
heddlu: plis
cuddio: hzan
alldaith: srin
anwybodus: nrin
hael: drac
cloud: blan
gwastraff: htek
Chwefror: frif
clefyd: hren
treulio: bwan
ffynhonnell: sron
menter-achos: hnok
modryb: hbam
oedi: dlic
oedi-hanfodol: hlip
adroddwyd-tystiolaethol: prat
canol-nos: dyit
arwr: nrac
athroniaeth: hfof
bys: hjit
gyfforddus: hzat
rhywle: hmoc
wasg: bran
staff: hraf
Gwobr: rwan
bai: dlac
diflastod: krat
talcen: htec
ad: glan
angel: htet
unigol-rhif: hgam
wawr: hbon
masnachol: krak
maddau: pran
defaid: hcec
amynedd: hpen
fferm: crac
cyfeiriadol: hrec
corn: mran
allweddol: kcif
mwyafrif: hmot
gwendid: hdut
awyrgylch: traf
sigh: tcoc
dynoliaeth: mlis
gwrthwynebiad: pric
disg: hdik
unig: hket
artist: nrat
marchog: cwis
swyn: tran
penderfyniad: drin
llywodraethwr: gran
gangen: rwac
gwarediad: hsoc
brwdfrydedd: tsum
anwythol-hwyliau: hdum
cymuned: hmum
olew: hyen
pibell: hbap
print: trat
oh: dyoc
disgwrs-cyd-destun: hros
vocative-achos: hwok
caban: ksen
larwm: plam
nerfus: hnes
parhaol: hset
cyllell: ksuk
sidan: slik
ddirmyg: grin
uffern: nrik
gwahanu: plen
o-ddifrif: mrat
cymysg: mrik
pren: mrak
Mae'n-well: hpet
rhybudd: trin
admonition-hwyliau: htom
impulse: hmos
uchelgais: mrac
gwadu: hnek
cyfansoddiad: swic
offeryn: srit
parhaus-agwedd: hnip
llanw: hgas
coleg: klen
cynffon: hkek
genhedlaeth: nric
cath: blat
uniongyrchol-tystiolaethol: hret
wedi'u-gadael: trac
un-ar-ddeg: hyec
greddf: nlik
nodweddiadol: trit
llwyth: hgik
bryderus-hwyliau: pcim
lloches: crat
anghwrtais: hruc
marchogaeth: hris
ysgwyd: hmon
diwydiant: hdot
proffesiwn: hres
lamp: hdap
coffi: kfif
ufuddhau: htot
gogleddol: nrit
nyrs: nris
sicrhau: hjat
cadwyn: ryin
addysgu: cric
esgidiau: hgut
iard: mram
amwys: hmec
mewn-mannau-eraill: hlet
fflat: pret
gweithgaredd: twot
Dydd-Sadwrn: cram
heulwen: hduc
gweddw: hwuc
elfen: hlem
myfyrio: hfen
sefydliad: hgis
seren: tram
digwyddiad: hgon
gwestai: hgip
bar: brap
potel: hbet
bendithia: blak
gynnwrf: crak
mewnol: trik
atgyweiria: krik
deillio: prit
pant: hcot
talaith: hpos
gwareiddiad: srac
hongian: hgak
sioc: crok
eithriad: swap
straen: tren
safonol: ryan
gyrru: dran
gwared: hruk
tyngu: kses
trysor: zran
hadau: hbis
twr: tras
hoff: fwit
Yn-ddiweddar,: hcem
diweddar-gorffennol-amser: hrot
effro: srik
dodrefn: mrin
rhaff: hkos
antur: hdas
breindal: ryit
gwledd: dyat
disgrifiwch: dras
trigain: hses
graddfa: hkem
seremoni: srec
hela: clik
sibrwd: psus
i-raddau-helaeth: ryat
Cristnogaeth: ksim
cyfreithiwr: hwif
manylion: drit
tywysoges: hrus
allor: dlat
we: hwes
porffor: brin
casglu: hkoc
etholiad: hben
beichiogi: kren
feddw: crik
arllwys: brac
lifft: hlif
ystum: hjis
rheoli: rwin
cyfnewid: tcen
pendant-erthygl: hdek
ymerawdwr: mras
bell: hroc
hyll: clup
ddiniwed: cras
y-gofrestr: hrof
modfedd: nlic
papur-newydd: grat
barf: dric
rwygo: srim
comisiwn: kson
tra: grak
groesfan: kcoc
annibyniaeth: htes
arogl: hwon
deunaw: hdec
hanesyddol: tris
gros: krut
gwraidd: hrok
mwd: hbik
briodferch: dlan
llen: pras
theatr: tret
cymhariaeth: kras
wrthwynebydd: rwis
cydbwysedd: slen
hyfforddwr: kron
hiwmor: hnum
nofel: rwas
dial: hbaf
genfigennus: ryut
olwyn: hlok
llosgi: glat
fflach: flac
creu: hkec
gwrthdaro: hnot
curse: hlos
imprecatory-hwyliau: pram
ddiymadferth: hces
cadarnhaol: hzit
clwb: klup
llifogydd: nras
grawn: gwan
difaterwch: hdun
gorwel: crim
assumptive-hwyliau: hsom
serth: htop
cytgord: mron
taranau: hgot
plentyndod: htok
pen-glin: hgun
meddalwedd: pwen
anaf: kram
derbynneb: ryis
galluogi: nlim
protasis: hpoc
slip: slok
chwyldro: hrif
ffermwr: hjim
strôc: trak
llwyfan: hpof
negesydd: hmes
braint: hpek
drefnu: hyot
myfyriwr: clen
ogof: hgec
traddodiad: rwat
drasiedi: tses
ffarwel: hjap
beirniadaeth: ryik
cotwm: krap
ysbyty: slot
rhent: kris
nwy: hges
anochel: pwic
marwol: hgim
dail: glit
cyhoeddi: plun
gelyniaethus: tsup
cyfieithu: dwan
angladd: jran
blawd: mrun
gohebiaeth: ryon
rhamantus: hrom
cwt: clun
cynnig: psot
mimetic: hmet
doler: dlon
golau-dydd: hjac
un-ar-bymtheg: hsos
cynulliad: hzac
nythfa: klon
adain: gyin
llew: hles
diwylliant: klut
colofn: hkom
cyfrwys: glak
drama: dram
jôc: hjuc
niwl: hdus
meddygaeth: dwas
pedwar-ar-ddeg: hkes
asid: sram
sef: hyet
incwm: hmok
esgob: hbip
orange: tron
bath: byan
cyntefig: rwit
basged: ksek
ysgrifennydd: sris
gwellt: prak
ddiamynedd: pfif
iachawdwriaeth: slon
hodiernal-amser: dlin
yn-bwriadu: zrin
stêm: tcip
gwenwyn: hwoc
talent: tlon
hinsawdd: lwim
effeithiol: fric
gwahaniaethu: tcif
golchi: dwac
cyffes: kfis
lol: hjas
glo: kyon
canŵ: kwon
dros-dro: tric
delimitative-agwedd: hdip
asgwrn: hcos
Dydd-Llun: nwic
Dydd-Mawrth: glac
Dydd-Mercher: bwac
ffederal: frin
ddymunol: hzic
cynrychiolydd: ryic
llieiniau: lwin
sinc: swuk
nai: bwin
gwaedlyd: kric
gwarchae: cren
stumog: hpem
pres: pcon
copa: hzik
pumed: pfik
rhad: brat
exclusive-person: kwen
atafaelu: zrat
ffens: hzas
cerflun: tfam
magnelau: tlep
gofleidio: mrap
cyfagos: sren
llym: srot
ceirw: hluf
llwyn: hbuc
Railroad: hrep
rhyddhau: hduk
etifedd: mris
derw: blun
annymunol: pren
ddyfais: hgic
piano: pyon
perswadio: swen
anweledig: gric
dda---hysbys: ryun
creulondeb: kluk
temtasiwn: hyoc
Telic-agwedd: hlep
economaidd: kfik
rhyngwladol: troc
ymyrryd: tcek
athronydd: flif
cain: gyit
lles: kyen
pysgota: mlak
dwyn: truc
gwefus: hloc
ymddeol: ryac
darn: sras
oriel: glen
cyfochrog: zlan
atelic-agwedd: htep
cyfandir: trap
waharddol-hwyliau: nrim
tei: dwat
cell: slep
wy: dyan
artiffisial: jrat
yn-y-cyfamser: nwis
argyfwng: ksot
gwrtais: sloc
cinio: lyon
pinwydd: pwon
gwthio: hcef
cynghrair: lyen
canol: hkop
wyrth: hmek
morwr: slis
purdeb: prut
gweriniaeth: hguk
ffôn: tfen
chwip: krip
shirt: cyim
cyflwyno: ryas
soffa: hsof
ysgubo: hsup
lleidr: ksif
cadw: nrec
sianel: kcen
personoliaeth: klim
diwygio: kfam
bygythiol: hzim
palmwydd: plim
siaradwr: hzak
trothwy: dwic
cymell: pris
picell: bzak
daclus: syec
sesiwn: cwen
artaith: crot
llaith: tcum
crib: grit
teithiwr: hyek
felin: mwik
map: jrac
coler: klok
cymryd-lle: klif
yn-fwriadol: drat
cwrw: hbif
melfed: hwem
disgyrchiant: gwit
bregeth: hpum
cam-drin: glas
ddiadell: hgen
tri-ar-ddeg: tres
cyfiawnhau: jyit
Dydd-Gwener: crum
brwsh: broc
download: dlas
hufen: krem
clogwyn: klaf
rheithgor: jrin
anghenfil: ksos
rhewi: hgoc
pot: pfot
ceiniog: psen
mynnu: srut
afal: hpep
trafod: drak
cefndir: prun
drawsgrifio: trim
cyfnodol: prik
adloniant: nren
firws: bris
plentynnaidd: blit
adlewyrchu: flit
trosi: kcet
amlinelliad: kluc
opera: hpop
cymeradwyaeth: nron
bradychu: rwak
cosbi: hzen
penelin: kcon
atodiad: tcet
trwsio: hrop
amheus: cyec
saith-deg: swet
ysgrythur: srip
pwll: grac
anhrefn: dlak
deuaidd: byin
abaty: bjan
arrow: tcec
yn-tueddu: trec
ymhelaethu: frat
teyrngarwch: hlot
darn-arian: syip
crynu: tcem
alltudiaeth: gwin
mecanyddol: myim
trap: crap
cacen: kyek
syr: cyes
petruso: sret
un-deg-saith: syet
mêl: myon
fantol: dzat
gwadn: hjam
brics: brit
wyth-deg: hpes
yn-anffodus: pcen
ymgynghori: kcot
chwedl: lwen
cynhaeaf: hfos
dyrchafiad: pfon
stôf: hsop
rebel: bric
hen-ffasiwn: hnom
chwyddo: cron
gors: swot
dresin: hdes
asgetig: pces
rheolwr: mren
corws: cros
rhesymegol: tson
prosesu: pson
Blaidd: blaf
carped: hgap
hynafiaeth: hjak
ffrwythlon: frut
chwiban: slif
caws: twis
brathu: byat
gwahodd: jwan
eglwys-gadeiriol: kyet
harbwr: brak
crwydro: djan
cnydau: tsos
nefi: nlen
mwgwd: mrok
pensil: pses
llysiau: sroc
arddangosyn: hzet
trowsus: tlun
llygredd: hrup
cabinet: nram
cawl: srup
llawfeddyg: syon
lwfans: tcot
sbïo: gyas
di-hid: hlec
clecs: gyic
tocyn: hzon
haniaethol: srok
Dydd-Iau: cwim
traffig: ryaf
pensaernïaeth: ryek
crac: rwaf
addurn: rwon
cefn: lwas
difyrru: mwun
adferiad: ksus
palmant: plut
bendant: dyin
negyddol: nraf
wyl: hfec
lleihau: hrum
brad: zyan
helwyr: djin
neidr: syen
batri: bret
cwyr: flam
ditectif: dlit
dadansoddiad: nlis
pwyslais: hzot
nofio: twen
amlen: lwaf
pwy-bynnag: hgek
sigarét: jrit
modur: mrot
gwirfoddolwr: hwot
adwaith: ryif
bagiau: blam
byddar: hboc
sudd: hjus
gostyngeiddrwydd: jlit
gweinidogaeth: mret
rhywiol: hjon
diamedr: dyam
bwyell: blac
diemwnt: dlam
yn-ail: hlek
echo: hgus
ataliaeth: swon
hunaniaeth: hdaf
sgrin: krun
ddiog: lwis
momentane-agwedd: hmop
compact: kfot
drifft: hdif
diflannu: hgaf
ray: ryen
inc: mwic
enfawr: mraf
seler: dyac
cofiadwy: nrun
llacharedd: klek
senedd: slet
arch: tfap
maddeuant: frac
llyncu: nlun
fwynhau: nlot
swing: swun
dôl: gram
cymhleth: klos
ymddiswyddiad: hzis
ostyngedig-gofrestru: nret
gynllwynio: swim
pupur: prip
merlyn: pron
ymgeisydd: hzam
llwynog: flik
simnai: tcon
awdurdodaeth: drik
amaethyddiaeth: rwic
cywirdeb: tcuk
cyn-ymadawedig: brim
democrataidd: mrek
blaguryn: hbos
blanced: bwat
cenllysg: hgep
mochyn: srus
siâp: krek
ifori: craf
clasurol: ksok
arsylwr: nwet
eliffant: lwit
hoelion: nwus
gwenyn: hmif
claddu: dzan
actor: bzat
chwys: zwan
sglein: ploc
rhith: hlus
ansicrwydd: pcet
eilaidd: syif
blygu: tsot
gwledig: grun
ochneidio: nyen
yn-debyg: slec
quote: hzun
sach: cyek
annifyrrwch: fren
nodwydd: hjun
dan-reolaeth: nroc
cyw-iâr: truk
cyson: kwot
gasgen: bras
arferol-agwedd: hcep
arbenigwr: ksec
greu-argraff: blin
olewydd: zlin
van: myen
rhwystr: bwak
nodio: kcec
maeth: plaf
diffiniad: fyic
pen-blwydd: gjin
morthwyl: hcof
persawrus: hfon
ailadrodd: trun
ddibwys: twut
cic: hjik
gloddfa: kwaf
anifeiliaid-anwes: plot
penglog: hcop
deddfwrfa: dlik
sawdl: cruk
gwgu: crun
patent: plet
biliwn: blim
cemegol: fyik
peilot: pyot
dynwared: mlot
sgert: kwet
anarferol: srap
wythnosol: jwik
technegol: tfip
llystyfiant: tset
frân: kraf
sunrise: sruc
oes: glin
cyfrannu: hyom
bachyn: hdok
teigr: blic
treiddio: crut
llawes: slun
priffyrdd: jras
milisia: mlip
ffos: kroc
uniondeb: kret
pedwar-ar-bymtheg: dzin
organig: rwik
diwinyddiaeth: flic
arnofio: flut
wrach: byac
diflasu: hwuk
diplomyddol: dyik
stiwdio: twos
yn-fwy-na: kcok
siampên: cyen
ysbrydoli: crif
banner: hbes
ysgariad: lwon
bollt: hbut
gwythïen: jyan
goddefol: psif
ewyn: hgum
graean: grik
ffedog: tyen
blaned: gren
silff: claf
gefnogwr: flon
trofannol: hjip
cam: fwas
mympwyol: rwen
ynganu: kfun
mercwri: krok
ymgripiad: hrem
hunanladdiad: tcos
gohebydd: prot
amddifadu: hpok
medrus: klun
balconi: blik
fforc: fras
cyflogai: mlek
cyflogwr: myot
lled: jrak
llidiog: djit
cyhuddo: klot
pensiwn: pyen
ferf: kres
mwnci: mwon
derbyniol: hwek
llofnod: tlim
uniongred: rwos
eironi: fron
meithrinfa: nrap
amharodrwydd: jlan
mewnforio: tyot
tortsh: croc
gramadeg: gjak
blaendal: gyat
trefedigaethol: plon
cwch-hwylio: jyat
ganlyniadol: kwec
cromen: kwun
trwch: hfot
styfnig: cyon
cyhyrau: hmup
maint: ryam
rhwbio: ryos
llwfr: rwam
harnais: gwac
tost: tros
llygoden: myus
sillaf: slim
pat: prap
deialog: dlaf
niwtral: nrot
diwydrwydd: dwin
gwrthddywediad: trot
cyflawni: kfic
gafr: byak
ffynnu: hfet
gosod: mlon
dienw: nwim
ffurfiol-gofrestru: frit
llo: hbof
llawlyfr: mwut
toddi: hjec
dileu: flas
ymbarél: gras
lesewch: bzut
mwynau: mrim
cadoediad: crus
hwyaden: hbok
cynllunio: pfam
sebon: hsuf
ddol: gwak
sgerbwd: klet
fila: blis
gwnïo: jlin
cysoni: dyak
tegell: kset
aeddfed: mruc
cwningen: kruc
arweinydd: nwot
dibyniaeth: djat
chwaraewr: jlic
pryfed: pset
bwyty: cret
tylluan: lwun
radical: djik
preswylydd: zwin
dragon: dron
clywedol-tystiolaethol: drot
sychedig: kyos
Linger: dren
cyfrifiad: glun
rheoleiddio: ryim
maer: mlap
lleiafrifol: mric
caffael: dwon
cyn-filwr: bren
gerddorfa: ryes
cig-moch: bjin
anfantais: zwat
ffabrig: frap
cerddor: gzik
yn-feddyliol: hnep
cyd: nyon
annigonol: nrip
pensaer: tsek
lemon: nyim
peswch: kcos
cur-pen: crek
tenant: ryet
ffrwythlondeb: srun
gwella: hfoc
naw-deg: nwon
ar-hap: hbec
llwy: kcek
balŵn: blon
sialc: hfip
casgliadol-tystiolaethol: nlet
cyhoeddwr: pcot
finegr: sruk
lludw: fyec
expletive: slek
adfywio: nrut
dueddol: kfim
twnnel: tfun
pos: hpef
mecanwaith: mwim
mathemateg: gzit
pylu: frun
afu: jwin
sublative-achos: bwik
dip: dris
uned: twim
monopoli: hnop
gamblo: hgup
llong-danfor: bzin
daeargryn: hbem
labordy: brot
corc: kruk
hunan-rheoli: syot
Buddha: hbus
wau: bjat
llysgenhadaeth: blas
pellaf: sres
declarative-hwyliau: drim
ysgogiad: tyuc
siocled: clot
cyd-ddigwyddiad: tyon
maneg: gwat
penlinio: hjek
daearyddiaeth: hjif
buddsoddiad: nwes
llafar: mrec
cyfatebiaeth: nlip
seciwlar: srek
hebog: blap
seicoleg: nloc
Caewch: gjan
sgrap: krep
rôl: cyum
dos: hdos
eog: slom
pwdin: pwun
magnetig: gyik
pwmp: pcom
ocsigen: ksip
tystysgrif: tfot
medal: hmem
rhethreg: trok
crafu: rwap
rhwyf: dyas
telesgop: trip
mwclis: clek
sillafu: prif
wisgi: hwos
helyg: hwof
camel: hlum
amatur: myet
allanfa: crec
bywgraffiad: brif
asyn: gzac
misol: mwis
anwybyddu: nruk
ystod-y-gwyliau: byit
cliciwch: lyik
hirgrwn: twon
elastig: lyet
geiriadur: kfon
ham: gzam
enfys: rwun
defnyddio: kcum
tafod: tcup
tanc: trek
cydweithiwr: clok
glöyn-byw: trif
siart: graf
dau-wely: jwat
yn-annibynnol: trem
bambŵ: hbum
ddeliwr: jlat
cronni: kles
arolygydd: nyet
damaid: hyos
hunllef: hbom
jam: gjam
amgueddfa: mrem
wyddor: lwam
gwasgariad: zras
cyrch: crip
datgelu: clus
pydredd: fraf
ymosodol: gris
ffrithiant: mroc
pier: gyac
pry-cop: brik
tatws: trut
adolygu: cwon
trachwant: jlac
cynamserol: ryot
lluoswch: gzan
sbin: pcip
ystadegau: tsok
calendr: klem
enwebiad: nwen
triliwn: tlos
atig: tlok
gadarnhaol-hwyliau: rwim
ceisiadau: pfen
nominal: nlon
anfodlonrwydd: sraf
haint: hfok
piser: krot
shrug: cyok
arloeswr: gzin
hepgoriad: nlif
bresych: glic
athletaidd: tlet
meddwdod: mrut
idiophone: hdof
lifer: lwek
seneddwr: syem
iris: nrif
ant: mwam
bug: hbop
feichiog: grim
gwaddod: hjet
ffêr: tcok
dosbarthiad: glik
newidyn: prim
lapio: ryap
cyrliog: krec
sylffwr: hsef
arddweud: dwik
yn-dod-i'r amlwg: brun
llyffant: fram
gormodol-achos: twek
sbwng: hjen
blino: djon
wiwer: slip
falu: zyin
irrealis-hwyliau: flim
llosgfynydd: glam
dan-do: gron
manteisio: kloc
daearegol: jlik
pasbort: psop
anfoesol: mlet
bisged: hbuk
cydweithredu: kros
tabled: tlot
ymlacio: kces
atom: trom
cymhorthion: hzip
pyramid: psim
cylch: swok
nap: hnup
anghyfreithlon: hjaf
paw: pfap
swildod: crom
Eclipse: klip
liwt: lwap
banadl: srum
panel: mwen
seryddiaeth: tcom
ddrysfa: blen
ysgoloriaeth: bwit
crwban: kfuc
ymgynghorydd: dwak
ffibr: fwic
criced: jrik
colomen: ksom
addasu: dyon
triongl: tfon
trysorydd: tsen
hydrogen: jron
bregus: hfuk
argraffydd: pyet
tagu: tcof
cronig: gzon
ymdopi: slaf
penbleth: dlim
peirianneg: jyin
camera: hkef
yn-ymddiheuro: pluc
llyfu: lwet
dawnsiwr: dret
mudo: mres
tennis: tces
asgwrn-cefn: clip
ffrio: zrac
gwŷdd: tfuc
stab: twuc
cyfrinair: psaf
hemisffer: praf
strategaeth: zrit
cwarts: krus
siswrn: jris
patrôl: proc
rhewlif: lwic
hanner-ffordd: dwam
memorandwm: mwap
côn: kwuc
cymesuredd: hzut
manufacturer: zrak
diffynnydd: fwik
mosg: djis
gwyddbwyll: cres
toll: htof
ceirios: tref
eang: kfen
baglu: tfok
lori: ryok
mwstard: mros
y-cant: pfet
arwerthiant: jlam
ridyll: srif
anwastad: swoc
magnet: gjat
sugno: syus
islam: slum
flaenau-eich-traed: twip
pilen: mlen
eillio: clet
gitâr: gjit
sgleiniog: bzan
llwyfen: hyem
esgyn: kcom
rhagenw-marciwr: ryec
stwffwl: pcus
sbeis: zlat
mechnïaeth: jlas
cludwr: zyac
dirgryniad: bron
hudo: trus
aradr: hlom
ffisiolegol: zlik
gwter: hgok
comed: cyet
ganoloesol: dyic
aderyn-y-to: grec
wneud-iawn: twet
plastig: psuk
troednodyn: cyot
orbit: rwot
gynnil: twum
golff: hgof
sero: zrun
sglodion: tcep
orthrymu: prok
yawn: gjac
anghydraddoldeb: gwas
man-geni: tloc
crochenwaith: frik
gwraig-tŷ: hgif
rhyg: rwem
anufuddhau: hyes
goddefgar: glon
embryo: brec
glöwr: jren
yn-cymeradwyo: zlac
burum: lyim
premiwm: pfim
eirin: plem
methdaliad: byas
dyfrhau: rwif
mintys: nyun
gyfalafol: glis
elastigedd: hlef
siarc: gyak
recriwtio: drut
storio: zren
realaeth: cles
sinsir: djic
ambiwlans: blus
cymaradwy: kwip
waled: bjap
grimace: glim
gwyddonydd: gyis
perfedd: grot
equanimity: hwum
radio: href
amherthnasol: zlit
ffa: bwam
anffurfiol: frim
wyres: gyut
anghytundeb: dloc
stêc: tfek
nitrogen: zron
rasel: hjut
cyferbyniol: krom
propaganda: pcoc
tân-gwyllt: fris
pop: pcop
dadwisgo: crop
rhych: cruc
niweidiol: hzaf
Iddewiaeth: hjum
ategu: pluk
lens: lyes
pegative-achos: pwek
canser: kfes
gwystlo: pyek
darlithydd: zyat
gollwng: hzuk
yn-gymwys: krif
dwysedd: djot
cynefino: dyis
cnoi: htuf
siaradus: bzit
cimychiaid: hgos
disgownt: dyut
tacsi: tsuk
hierarchaeth: crem
jâd: gyec
y-chwyrn: glaf
madfall: lyis
rhaeadr: crof
siomedig: djak
feto: frot
llywyddiaeth: ryip
prynwr: mrif
galwyn: jlen
mosgito: mruk
gwyriad: dwen
wrestle: lyut
mosaic: myok
plwg: plok
squat: pcuk
groser: ksoc
gomiwnyddol: myos
amaze: mwek
prosecutive-achos: rwuk
names: nlos
unben: dwit
pwyslais-mawr: tyet
lloeren: tlec
sliper: hlop
cytsain: fyon
bras: tsif
yn-ddi-waith: byet
cefnogwr: sros
Lotus: lwot
letys: sles
clorid: lwok
bacteria: bwic
gludiog: pcek
cydran: bwon
cnewyllyn: klec
feign: bjak
beit: bzet
secretiad: sruf
benodol: pres
cyd-daro: mloc
bale: blet
wrin: mrus
garlleg: lyun
mynd-heibio: hguc
economeg: kcem
dosbarth-canol: hdom
ystwyth: gjic
gefeiliau: htef
golchi-dillad: lyoc
mefus: srem
trefol: pcos
godi-cywilydd: mlaf
llyfr-nodiadau: tfut
albwm: zlam
pêl-fas: hbep
arogli: sluc
bwffe: hbuf
rhangymeriad: rwip
garej: grek
diagnosis: djas
crutch: ksuc
extort: srom
cofrestru: psuc
hydawdd: jlun
ffosfforws: psof
strwythurol: rwut
glud: glum
thesis: twes
grefftwr: clif
Banana: bwas
Axiom: kyom
asen: psos
nicel: nyek
pi: pyim
bws: bwos
sensro: swes
taflegryn: mlus
selsig: slos
trin: nlut
tomato: tfet
atgyfnerthu: kfut
soced: syok
potasiwm: tsom
adfer: prup
rhithwir: zwit
algebra: gjas
deintydd: dzit
optegol: pcok
Budge: bzen
bioleg: bwim
diweithdra: byim
lindysyn: krum
solo: slof
porwr: bjac
bell-gorffennol-amser: nyot
hanesyddol-amser: crep
niwclear: nluk
sbectrwm: pyem
sodiwm: syom
hysteria: syes
ymddiriedolwr: tyos
gwystl: byik
cicaion: gluk
wrinkle: kwuk
tryloywder: tfif
spike: swip
blaenoriaeth: pcif
cerddwyr: dyen
anffyddiaeth: tsem
monitor: mwot
etholaeth: nlec
heb-ei-reoli: hkof
probe: grok
platinwm: plip
deuol-rhif: dlun
ysgyfaint: pcep
super: syup
troli: trop
yn-lleol: lyot
ysgogi: gzat
gasoline: plif
yr-arennau: grif
loot: bzac
asesiad: dlen
arsenig: syek
Malwoden: nrok
ceiliog-rhedyn: tsec
hafaliad: fwen
sosialaidd: swos
hidlo: flot
synhwyraidd-tystiolaethol-hwyliau: hxin
ehangu: kyot
allyrru: mwet
dennyn: pwet
mandarin: drun
joci: hjok
niwmonia: hnof
undod: gret
colfach: cyif
hydredol: nruc
difidend: dwun
sglefrio: hkep
ddehonglwr: slop
anabledd: dlif
obsesiwn: bwen
rhandir: pfun
ffotograffydd: trof
delta: dlet
digidol: djim
ast: brut
amrant: hyop
lletraws: dyun
subconscious: byon
ael: bruc
tisian: pcec
doniol: dlis
Hindŵaeth: nwum
ffoaduriaid: nyif
gwennol: cwot
protein: pwot
dymp: hdop
mireinio: flen
cyfog: hwom
genyn: gyen
freshman: hdem
cymdeithaseg: syoc
sboncen: kwoc
Fisher: hfuc
rhanbarthol: jyen
cynnig-i-fyny'r allt: hvok
ôl-weithredol: hxik
gorwynt: gyon
gwrthdroad: nwos
tv: twif
ciwb: kfet
cynhyrchiant: pwuk
moron: krop
moleciwlaidd: mwuk
conglomerate: glet
cyfrifydd: ksum
ciwcymbr: kyok
orgy: drok
toddydd: jlet
ffosffad: psef
primer: gwik
alcalïaidd: flis
gymnasteg: jyas
coma: kwom
cynnig-i-lawr y rhiw: hvat
camesgoriad: jwac
pod: tcop
rhoddwr: dzon
manganîs: hzem
seicolegydd: syos
clorin: clos
bysellfwrdd: kyoc
elitaidd: zyit
parenthesis: pfaf
rygbi: rwoc
wlser: jlon
ffurfdroëdig: hxit
cnoi: nres
cwantwm: fwam
siwmper: swek
esblygiadol: fwis
nodiant: nyoc
bownsio: tcuf
dyrannu: drec
cache: kcep
llinol: lyec
antimoni: trum
superessive-achos: psek
tiwmor: twom
erydiad: cyos
alffa: flaf
navel: nwip
imiwnedd: myip
y-ffliw: flun
bragdy: bjit
symleiddio: slef
talfyrru: bram
tolc: djen
swyno: dwim
gorfodi: brok
hosan: bzas
ffilm: fyim
cosmos: klom
llygru: hpuf
heidiol: gjen
pidyn: zyis
coedwigaeth: lyif
alwminiwm: lwum
osgiliad: zlon
horoscope: ksop
ddiarddel: dlek
cynhwysiant: nluc
buddiolwr: byic
dolffin: dlip
llofrudd: cyus
mamaliaid: myaf
dangosydd: swif
deuocsid: dwis
colon: zlen
biwrocratiaeth: brus
ystumio: jric
oergell: frip
archeolegol: cluk
annerbyniol: kwok
fanyleb: pfis
taflen: pfut
anthropoleg: nlom
blasus: kyec
transitive: txit
cower: kwus
blodyn-yr-haul: hzuc
lleuen: glus
ion: lyos
twristiaeth: tyum
modem: myom
cyflymiad: jrun
ffugio: tsoc
allyriadau: hmef
herwgipio: drap
gorgyffwrdd: hwep
trin-gwallt: pfes
llên-gwerin: floc
capilari: plek
cenedlaetholdeb: nlum
pen-ôl: nros
motiff: hmuf
sublimate: slem
rhwystredigaeth: xras
cobalt: kwos
ceirch: gwam
cynnig-fyny'r-afon: trup
anws: gyam
buchol: bwun
fflip: flip
diswyddo: dzun
'n-fideo: hwop
boicot: bjik
cwis: cwif
hoci: cwok
gerila: grip
magnesiwm: hgem
radar: drek
tsimpansî: hzif
dibynadwyedd: kwif
petryal: tyec
môr-wiail: klep
cyffredinoli: jlak
cyrffyw: kfec
cyfunrywiol: mlok
senario: srop
llunio: flus
ailymgnawdoliad: nrom
tanio: zlak
wraniwm: ryum
daliwr: kwes
cydlynu: kyop
trethdalwr: nwaf
integredig: trep
Mynegwyd-barn-gan: hzap
gama: hxam
safari: fwim
cynnig-lawr-yr afon: ht6n
cyfernod: kfus
pennawd: zlic
dadansoddwr: nles
checkmate: hzes
mall: hmof
bismwth: bzim
cerdyn-post: psok
cydgyfeirio: bros
digress: djet
cyfranddaliwr: ksem
microb: mrip
organau-rhywiol: jwit
morffolegol: mluk
beta: byot
jîns: gjis
Cronfa-ddata: tles
cyfrifiannell: klus
pelydr---x: ksef
dosrannu: zram
amgylcheddol: zyen
sigma: zyim
datgysylltiad: hxon
agenda: gres
fisa: bzis
seilwaith: nyuk
Firefly: gyun
synhwyrydd: tyek
ymaddasol: dyip
biolegydd: byis
sbleis: pyec
bromin: brom
Palladium: plum
faglu: kfok
pastel: psec
sw: zwac
clinig: lyok
connotation: nwoc
ioga: hjoc
siop-lyfrau: byun
therapi: grap
genedlaetholwr: zlis
behead: zlet
yeah: swec
broblemus: byam
jazz: dzas
twngsten: tsof
terfysgol: gwis
driblo: droc
metaboledd: tlem
alimoni: lyaf
penwythnos: hfom
chrysanthemum: gzim
brechlyn: byap
beic-modur: tyok
mantra: dyot
semester: myes
heroin: gwon
ffolder: flap
catod: kfoc
ideoleg: dlec
parcio: prek
theta: fret
disgynneb: hxis
seleniwm: clem
beicio: blek
cortecs: pros
cywerthedd: swaf
ar-hyn-o bryd perthnasedd marciwr: hxak
maes-awyr: cwoc
trychu: gyet
pêl-fasged: bwet
imposter: mwip
chwilod-duon: tlek
cromiwm: hgom
litr: hl6t
serch-hynny: nwec
hormon: cwom
ddiffygiol: tluc
dyllu'r: prec
animism: nyom
polygon: cloc
ffeministaidd: hfes
cyfun: kcop
ewro: dros
ginseng: hjes
algorithm: hlof
laser: lwes
drugstore: dlot
milimedr: mlem
flex: flek
anod: nlok
naws: hzus
rhan-amser: prem
sensitifrwydd: nyec
arddangoswr: drom
heliwm: clum
dwyieithog: dzic
acronym: hqim
initialism: nl6m
gerund: gros
plasma: psem
cromosom: rwom
trefnol: rwok
cilometr: klum
ffacs: tfes
geneteg: nwek
freckle: frek
sgriwdreifer: dres
brocoli: blok
preterite: xrit
fitamin: tyem
cadmiwm: kyem
awyren-fomio: bwoc
graffigol: gjik
titaniwm: dyim
afradlon: clec
lamda: lwem
gariad: pcem
copulate: kyuk
hourglass: tlus
empathi: mlif
boron: bres
hofrennydd: cwet
tellurium: tlum
dyddiad-cau: jyic
alinio: gwic
centimetr: hfem
molybdenwm: mlom
lithiwm: tfim
amlgyfrwng: myum
diweddariad: dyet
calorïau: clom
robot: ryoc
gwaith-Cartref: groc
logarithm: grom
mantis: gzas
instal: nwut
amino: myoc
glyph: glif
aorist: pyos
ecoleg: plec
sophisticate: flok
marijuana: bjam
micro: mrom
cilogram: lwom
gorfwyta: jrot
rhagweladwy: dzik
pizza: zyas
eavesdrop: zris
ieithyddiaeth: bwis
haircut: braf
iridium: ryom
hiliaeth: gwim
optimaidd: gyim
ddiwydiannu: drif
pencadlys: krup
Ceriwm: zrim
gyfath: nrum
partitive-achos: pxik
casét: ksep
grym-ewyllys: blot
dimensiwn: dzen
paramedr: rwet
Cydamseru: nrop
gwneud-y-mwyaf: dzim
seminar: mwec
disgo: dyok
neon: nyok
osmiwm: hzom
Ystwyll: hp6n
plagiarize: lyap
artifact: rwek
adweithydd: fyet
oregano: ryop
plwtoniwm: pwum
Ytriwm: tyom
cynyddol: hxat
enw-defnyddiwr: mrum
ôl-raddedig: zrot
asgell-dde: dwaf
argon: jros
ffobia: hxot
cymdeithasu: sluk
globaleiddio: bluc
tonfedd: hnef
amgodio: kfom
ailgylchu: psoc
Ail-ddechrau: nrek
hepatitis: pyes
Torus: fros
cemotherapi: myep
modulo: mwok
proton: zwot
ddisgen: dwet
milligram: mlum
picsel: psep
tantalum: twem
hydoddyn: hjot
hil-laddiad: nyos
ysglyfaethwr: rwes
gallium: glem
sirconiwm: hzum
determiner: txin
aflinol: nlem
plaleiddiaid: pyif
beryliwm: brem
neuron: nrus
predicative: pxit
underpants: tlif
ffactoraidd: kref
niwtronau: zrut
niobium: nwom
germaniwm: hjem
metalloid: tlop
rhoi-ar: dlap
prolative-achos: hl6k
bioamrywiaeth: jwic
ffon-reoli: jyok
gwrthfiotig: twok
actiniwm: gjim
gofodwr: srof
allfydol: tyes
crackpot: hwup
marathon: mrof
yterbiwm: zwim
awtistiaeth: tyif
ionize: nlof
radon: cwos
nerium: nrem
epidemioleg: pwip
hen---oed: lyuc
gwersylla: kyep
streipiog: drip
indium: nyum
veridical: hvik
gwefan: bwes
Koran: kwek
flatware: fwet
nfed---gwraidd: tfec
lawrenciwm: lyem
sifil-ar-hawliau: glip
Ffôn-Symudol: mlof
barlysu: twoc
protactiniwm: prum
ymbelydredd: hd6n
yn-dibynnu-ar: pxin
thoriwm-atom: hxim
glas---jean: bjun
planhigion-tŷ: hxas
yn-unigol: dvit
llif---gyfredol: lwuk
triphlyg---bwynt: ht6t
dynol---gorff: hn6n
ffiseg: bzik
manwerthu-siop: hxan
caesiwm: hs6m
hir-yn-ôl: hqan
taenlen: hxet
uned--of-- màs: hn6m
llunio: ml6n
gwerth-deuaidd: vrim
dynol-sef: nyus
gan-fodd-o: hvan
depan-dari: pxat
praseodymiwm: pyom
cardfwrdd: kxat
cyfyngedig-ferf: hqik
treial-rhif: hr6n
pro-dedfryd: hr6t
beirniad: hk6k
pecynnu: pxas
byrhoedledd: pxan
yn-y-rhan fwyaf o: txas
disgrifydd: drop
neodymiwm: nyem
cyfeillgarwch: hvit
darllen-yn-unig: xyak
founds: xwan
gnomic-hwyliau: kxin
ffonem: hxom
rhesymoledd: xlit
ffonolegol: xlin
bwyta-ystafell: hxac
byw-ystafell: hxic
ganolog-achos: zrik
cyn-hodiernal: hx6n
claf-achos: hqak
oblique-achos: bwok
gwledig-ardal: hqat
recurse: hr6s
canol-llais: dyos
meitnerium: hm6m
bost---cludwr: hvak
noncommittal: kxit
stoc-farchnad: xrak
adnabyddadwy: hxap
nod-sbardun: krof
un---eiliad: hxen
lative-achos: dvak
dogn: hr6c
nad-ydynt-yn dynol: hg6n
byw-beth: hvic
hefyd-ychydig: hxut
ffilm---theatr: hvin
hassium: xyim
attenuative: ty6t
multal-rhif: ml6m
llaethog-ffordd: txam
neptwniwm: nwem
ghostwriter: txik
trans-rhifolyn: ts6s
ffwl---o gwmpas: hqun
Americiwm: myem
bore-gogoniant: txan
diffoddwr-tân: xran
berkelium: blem
galaeth-rhyw: kxan
Nobeliwm:: blum
Hwyl-fawr: hvac
bwdhaeth: hfum
Fermiwm: frem
cyan: xyan
soia: syof
dosbarthwr: qrit
strikebreaker: txak
prosesydd: ples
abessive-achos: bvak
adessive-achos: dvik
i-achos: kxak
agentive-achos: dvek
Rutherfordiwm: hr6m
gwrthgyrff: txip
fel-llawer-fel: hjos
asiant-sbardun: hg6t
actor-rôl: xram
ethidium: txim
cyffredin-rhyw: hk6n
deithydd: kl6n
safflower: kxam
Ffransiwm: fyam
Erbium: ry6m
goddefol-llais: xyis
astatin: hqit
cnoi-gwm: hqam
seren-rhyw: hqin
dyfyniad-ffurflen: ht6m
curium: jrim
comic---stribed: kxis
lliw---ddall: hqon
euler's---rif: hl6m
edrych-yn: kxas
crosswalk: pwok
gad: txat
modurwr: vrit
--Cylched-byr: txok
llafar-noun: hvis
crio-allan: hk6t
yn-ystadegol: xyit
iogwrt: txot
xenon: hs6n
hypnotize: hxif
cymryd-off: hxaf
cymal---gynffon: hxok
uniongyrchol-gwrthrych: dwot
groser-siop: kxun
cynnwys-o: hm6t
ergative-achos: gvik
yn---iaith: txic
uniongyrchol: pxam
locative-achos: hqok
pwll-Nofio: slup
adferfol-achos: vlak
sightsee: hqas
teledu-set: ht6s
terfynol-gronynnau: xlik
evitative-achos: hvek
adsefydlu: xlat
atchweliad: xris
bloc-o-fflatiau: kxot
deffro-i-fyny: hxup
heddlu-swyddog: ps6s
rhegi---mewn: vran
cyfwelydd: qrat
rheniwm: ryem
aerosol: xres
meddiannol-achos: kxik
nominaleiddiad: mlec
meddu-achos: dzak
overcharge: pxak
ategol-ferf: xyik
cynradd-gwrthrych: mlut
cyfrifiadur--firws: prus
person-busnes: hqis
a-pobl: hqen
antessive-achos: ts6k
Prif-Weinidog: pxis
Lwtetiwm: lyum
europium: rwum
emote: xrot
werin---cerddoriaeth: zyik
bardd: vwit
ôl--swyddfa: pxot
sôn,: hvas
animeiddio-rhyw: hven
subessive-achos: bvik
nwy---bedal: glep
polaredd: pr6t
cerbyd-rhyw: vlin
mwynau-rhyw: xrin
berf---ddodiad: hvif
angerddol: pc6n
Samarium: sr6m
hwylusydd: hs6t
dychmygol---uned: xyin
cyflymder--of-- golau: kxac
llu-Awyr: hxes
empathetig-llawenydd: pfec
yn-feirniadol-- bwynt: qyit
llawn-amser: hxem
Haffniwm: xyam
ataliad: hn6s
newid-o-digwyddiad: qrin
holmiwm: xlim
gwahanol-digwyddiad: hf6t
bydysawd-rhyw: hvip
ardal-rhyw: kxen
rhithwir-peiriant: hvim
ymchwil-rhyw: txen
artistig-rhyw: ts6n
crastinal-amser: sl6t
haniaethol-rhyw: srep
exocentric-achos: zrek
transitive-ferf: txif
morpheme: tfom
chauvinist: dvis
gorffennol-perfective: xrat
galwedigaethol: hy6n
anuniongyrchol-lleferydd: tyoc
ail-iaith: draf
i-fod: txis
fynwent-sifft: vrak
ar-y-cyd noun: hxos
absolutive-achos: bvuk
claf-sbardun: tr6t
hunan-hyder: hs6s
feces: hzos
atblygol-llais: hf6s
amhersonol-ferf: hxek
Seaborgiwm: br6m
gofod-gwyn: hxep
foddol-achos: dlok
difywyd-rhyw: hj6n
causative: qran
propositive-hwyliau: psom
trydan-ar-hyn o bryd: tr6n
cysylltiadol-achos: nwok
radd-eithaf-achos: tluk
hefyd-llawer: xyut
planedol-rhyw: pxen
animeiddiedig-cartŵn: nwuk
cilyddol-llais: vrik
ddeddfu: hqaf
yn-lleiaf: vlas
gramadegol---achos: qrak
defnyddiwr: pxut
craidd-benefactive: kfef
gôl-geidwad: hgop
:-except-for: kcef
enwadur: dvan
arall---os: lyek
i'r-ochr: hx6s
eich-gilydd: dles
olynol-cymal: lyuk
gwisgo---allan: hxun
siorts: ht6k
dysprosiwm: prom
cyn-bo-hir dyfodol amser: rwec
si-unedau: vyin
crypton: kxon
mendelevium: dlem
applicative-llais: hp6s
antipassive-llais: tsef
continuative-agwedd: ht6p
ymbelydredd---salwch: hr6k
necessitative-hwyliau: hn6t
sengl-gweithredu-ferf: hqek
railcar: xlak
radd-eithaf-radd: tlup
dirfodol-cymal: hs6k
Califforniwm: kf6n
yn-bresennol-rhangymeriad: vrat
luminous-dwysedd: hc6t
singulative-rhif: slus
gramadegol---gwrthrych: hy6t
goddefol-rhangymeriad: vris
gormodol-hyd: kxic
supercritical---hylif: sr6t
swm-o-sylweddau: ks6t
postpositional-achos: pxok
dewisol-quantifier: lwif
gadoliniwm: dl6n
epenthetic-morpheme: hp6m
negyddu-quantifier: nwif
einsteiniwm: ny6n
artiffisial-iaith: txac
cysylltiol-gronynnau: qrik
bell-dyfodol-amser: twec
frequentative-agwedd: hfep
dosbarthol-rhagenw: bvin
allocution-cytundeb: hk6m
moel: blos
maestref: syum
cyffredinol-quantifier: vlit
cyfrifiadur-rhaglennu: mr6m
teledu-rhaglen: tr6m
fel-y-bo'r angen - pwynt- rif: hvun
dirfodol-quantifier: tl6t
y-dydd-ar ôl yfory: dwek
amgen-quantifier: lw6t
drwg---tymer: hdup
gorffennol-goddefol-rhangymeriad: hp6t
y-dydd-cyn ddoe: txet
locative-cyfeiriadol-achos: tc6k
gwrthffeithiol-amodol: ht6c
