Infinitiv: hnit
Nominativ-Fall: hnak
Akkusativ-Fall: hkak
Thema-Fall: htak
Elternteil: hmat
Papa: hpap
Mama: hmam
Hallo: hnat
Vorfahr: htat
Großeltern-eltern~~POS=HEADCOMP: hyat
hungrig: hcac
Genitiv-Fall: hnik
Adjektiv: hcit
und: hwan
mich: hmic
Sie: hnan
uns: hnam
es: hyic
Reiseziel-Fall: htas
Dativ-Fall: htik
Innere-Kontext: htis
Person-Kontext: hpak
abhängig-Klausel: htan
perfektiv-Aspekt: htap
Vergangenheit-Tempus: hkat
männlich-Geschlecht: hsan
Komitativ-Fall: hmik
Geschenk-Tempus: hyan
benefactive-Fall: hpik
Essiv-Fall: swik
nicht: hnic
seine: hsis
Oberfläche-Kontext: hsak
adpositional-Fall: hpan
Lage-Fall: hwak
Raum-Kontext: hnos
Weg-Fall: hrak
instrumental-Fall: hsik
was: hkan
fragend-Stimmung: hnim
und-oder: htam
Exklusiv-oder: hkit
Quelle-Fall: hsok
Ablativ-Fall: hlak
demonstrativ: hdit
aber: hlan
alle: hsut
feminin-Geschlecht: hnin
sie: hwin
Plural--Nummer: hlun
ein: hyik
Zukunft-Tempus: hwet
Sozial--Kontext: hson
wenn: hkap
imperfective-Aspekt: hmap
Dort: hkac
bedingt-Stimmung: hcan
Mehr: hdoc
aus: htac
relativ-Fall: hrik
illative-Fall: hlik
machen: hkas
Direktive-Stimmung: hden
deontische-Stimmung: hdim
Frage-Wort: hwac
Kopula: hkok
Person: hpon
männlich: hman
könnte: kwat
andere: hcon
Anzahl: hnoc
sehr: tcac
Zeit: htim
Zeit-Kontext: htos
temporal-Fall: hmak
etwa: hkam
epistemischen-Stimmung: hsim
nur: htun
kleine: hcak
dann: pcan
anspornend-Stimmung: hton
retrospektiv-Aspekt: hrip
groß: hcat
volitive-Stimmung: hlim
Vor: hsec
Muss: pcic
zwei: htut
sehen: tcan
kennt: hsat
nach-unten: hcin
nach: hcas
erste: hpas
besitzen: hpun
veräußerlich-Besitz: hlic
nie: hnac
unveräußerlich-Besitz: hkic
alt: hwat
deliberativen-Stimmung: hcim
Tag: htin
woher: hnap
kommen: hlat
Weg: hyas
Arbeit: hkaf
Vokal: hwaf
gehen: hkun
perlative-Fall: pwik
progressiv-Aspekt: hpip
lange: hlac
sagen: hsac
Wie: hkin
sogar: hpit
Zurück: hwap
Hier: hcic
denken: hcik
gleich: hsam
letzte: kcac
ein-Weg: twan
unter-Kontext: hnas
nehmen: htit
gefunden: hfan
Hand: cyat
jung: hyac
obwohl: hyap
geben: hkik
Gott: hmac
delative-Fall: lwak
gar-nichts: hmin
Recht: hyit
einmal: hyam
semelfactive-Aspekt: fwip
Teil: hpat
sah: htic
Haus: hfas
Welt: tcat
Kopf: hcaf
drei: tyin
Neo: hnon
Fokus: hcok
Liebe: hpac
immer: hsit
Nacht-: hwit
jede-einzelne: hmit
König: hyak
zwischen: hsin
Herz: cyin
paucal-Nummer: plom
da: hyok
kausal-Fall: ksak
Ding: hkis
Set: swat
Name: hnem
richtig-Substantiv: hran
anspornend: hrat
Land: hlit
fragte: hput
sichtbar-beweiskräftig: crit
besser: pcac
Seite: psac
Kurs: hkus
weiblich: hfin
genug: kyat
bald: hpuc
voll: hcun
Zimmer: hfac
fast: hlap
kann-nicht: nyat
Wasser: hwik
desiderative-Stimmung: hdin
Licht: lyak
noch: hnun
Wort: slat
Tür: tyan
benutzen: hpus
Morgen-: hsap
terminative-Fall: twik
Power: hkuk
sich: hmis
Geschenk: hyin
Stimme: hwas
Weiß: hpis
Geld: tlan
Nächster: kyak
Arm: hyis
Tod: hmut
Form: hfam
Inessiv-Fall: nwik
Art: tyac
des-öfteren: tsan
Jahr: nwan
Freund: myat
Auftrag: hyut
Imperativ-Stimmung: hpim
runden: hcut
glauben: hban
Öffentlichkeit: hpin
Bundesland-Kontext: hsas
Sohn: psat
hundert: hmas
Kinder: hcis
so: tyak
Hoffnung: hcap
über: hyip
sehr-geehrter: pyin
lesen: pyac
Stadt: hsic
bereits: hpic
Tatsache: hfat
Factive-beweiskräftig: hfit
hören: hsun
am-wenigsten: hmim
vielleicht: pyat
öffnen: kcat
Körper: tcic
Luft: cwac
Natur: nyit
Hilfe: mlat
Brief: lyat
vier: ksat
Optativ-Stimmung: hpam
Feuer: hfak
deshalb: hyif
Stunde: hcam
frei: tyit
Krieg: syat
ob: hsaf
Grund: kyan
vereinigt: hnut
Anruf: hkuc
Wieso-den: hwam
hat-verloren: hkut
tausend: tsas
Familie: hfic
Seele: twam
Frage: swac
Pflege: kcan
realis-Stimmung: hlin
bedeuten: mwit
Potenzial-Stimmung: hten
gegenüber: cyan
Allativ-Fall: lwik
anthropische-Geschlecht: hrin
kurz: kyut
fähig: hyuk
Leben: hkip
Gegenstand: hsek
gleich-Fach-Marker: hcek
anders-Fach: hfek
Antworten: tsat
Meer: mwat
Angst: hcoc
verstehen: pcat
hart: kyin
Bedingungen: tyut
Zweifel: hdac
dubitative-Stimmung: twin
Frag: psan
Waffen: tcas
schwarz: clis
bringen: tyat
schön: ksis
dunkel: tcak
halten: psak
zehn: htaf
Show: pyan
Geschichte: hkif
gemeinsam: kwan
Buch: hkup
elektronisch: lyin
Gespräch: plak
Kennzeichen: myac
interessieren: nyis
schreiben: kcit
Bett: pwat
notwendig: syis
Idee: hwis
Kunst: klat
Vialis-Fall: hlas
Bruder: pyak
manchmal: ksas
Leitung: lyan
Tabelle: tlas
Fluss: nwit
Auge: kyac
Informationen: fyin
plötzlich: tfan
komisch: hgan
tief: ksan
Veränderung: hrit
Gefühl: nwac
treffen: mlit
Zweck: htuc
glücklich: hcuc
scheinen: syit
Blut: cyac
Rose: kwas
Süden: swan
kalt: tlat
Vorwärts-: myik
Position: psis
spät: tyam
Stand: syan
annehmen: nlas
Tochter: pyit
Bergwerk: myan
schneiden: hkim
Kopie: hfap
Mann: hgat
sechs: hlis
erinnern: twat
bewirken: hyaf
Fall: htuk
außer: hsip
Haar: hpaf
bestehen: pyas
Copyright: pcit
Armee: cyit
Lauf: kcak
Pferd: kcas
Zukunft: hwic
West-: pcak
zahlen: plit
rot: hyun
Gold-: tcun
Verlangen: hdan
spielen: plin
Meister: mwas
Büro: hfus
Regierung: syak
Kirche: kyas
Länge: hlen
Gesellschaft: ksin
Papier-: kyis
Wahrscheinlichkeit: hbin
besonders: cyas
Bär: pcas
Fenster: cyak
Vereinbarung: hgac
Schönheit: syac
Pflicht: tfac
senden: fyan
Entfernung: htif
Schweigen: slan
Fuß: fyat
wild: kyik
sterben: myam
sparen: pfan
grün: kcin
Schwierigkeiten: mlan
Lächeln: myak
falsch: clat
verschiedene: pcin
Schlaf: slit
quotative-Fall: kwik
Anfang: cwan
Aktion: kfan
Besuch: fwat
Folgen: nlan
Versuchen: tcis
Gegenwart: psit
süß: tlit
reich: tcin
Feind: tcam
Schiff: hcip
Zustand: kyit
einschließlich: hkum
inklusive-Person: hlon
Geheimnis: kwit
Precativ-Stimmung: pwim
höflich-Neu-registrieren: hbit
böse: pwac
März: myas
was-auch-immer: kwac
bleibe: hlam
stattdessen: plat
blau: plan
unmöglich: psap
Schule: hsuk
Gelegenheit: ksac
verheiratet: nwat
Lebensmittel: hcuk
zwanzig: tsis
ruhig: tcit
leicht: hnis
prospektiv-Aspekt: hrap
Sprache: lyac
Ausdruck: syas
Woche: hsus
Halle: hcum
Achtung: kcic
Eigentum: myit
geboren: nyan
Gericht: kcut
allgemein: tyap
gnomic-Aspekt: hmip
wert: tyas
einfach: syap
Baum: pyic
Kampf: pyap
Mauer: twit
Himmel: cwak
inchoative-Aspekt: htip
jussive-Stimmung: hjin
Ton: twun
betrachten: klan
erwartet: pcik
Monat: hmaf
Berufserfahrung: nyap
ganz: nyac
frisch: tsac
Herzog: hnuk
bedeckt: kwak
gebunden: hyim
Osten: tyuk
Stein: pwan
etwas: kfat
Richtung: tlac
Sessel: kwis
unterstützen: syut
Datum: tyic
Dorf: klac
Bereich: clit
Erlaubnis: nwin
freizügig-Stimmung: hmom
Erfolg: slak
richtig: hric
Hügel: clin
Musik-: ksik
distalen-demonstrativ: hdat
Nachmittag: htup
Schrei: hyuc
Ehre: hnaf
Sieben: swit
Privat-: pfat
Nachrichten: nwas
Szene: slac
Garten: cyam
Rennen: htus
distributive-Fall: twak
lernen: clan
politisch: syik
Lüge: kcun
Besetzung: tsak
essen: kcam
Boden: hlaf
krank: pwin
Original: mlin
Sommer-: kyam
Religion: tlam
Bild: ksit
Flucht: plap
Autor: hlut
braun: pyun
entschlossen: htem
Schmerz: hdon
Feder: psin
Jahrhundert: syic
weich: mwan
Ecke: kyun
produzieren: psas
Lachen: cyaf
vergessen: flat
Europa: hyup
acht: lwat
Kleid: lwac
furchtbar: cyap
Atem: syaf
weise: hbas
besitzergreifend-Marker: srak
Erinnerung: myin
im-Trend: fwan
Ort-und-Stelle: tcap
erhebt-euch: hyus
Unterbrechung: pyik
fünfzig: hfis
Insel: tlap
berühren: hsuc
versprechen: pcam
kommissiven-Stimmung: mwin
Grad: tfat
planen: plac
Verhalten: nyak
überraschen: cran
Minute: hmun
Schuss: hwut
schlimmer: pcap
Glas: klak
Beispiel: tlin
Safe: hsif
Arzt: tsit
completive-Aspekt: hmep
wiederholt: tyun
Militär-: slin
warm: nyam
Getränk: pfin
Fragen: pcaf
Zorn: nran
direkt: tyik
Hut: hcup
Hund: kwap
Diener: hnuc
Stolz: hram
Menge: tcuc
Bahn: nyin
Moral-: myut
damit-verbundenen: kyim
Eintreten: fyak
Regel: nyas
Schwert: cwat
Angriff: kfak
Gesundheit: clac
Absatz: pyaf
Sozial-: hsum
Rückerstattung: tfit
Es-tut-uns leid: hpec
Mut: krac
Anmut: hnen
offiziell: hfaf
sofern: tsik
anfordern: pwit
Blick: klas
Bewegung: hyon
damit-rechnen: cwit
Gegenteil: psam
zwölf: tyaf
beschäftigt: nyut
Wein: hwun
Geschmack: swut
Eisen: fyac
verteilen: syin
Handel: myap
Vorteil: twac
Kleider: kfip
Richter: fwak
Unterschied: tfaf
ängstlich: kcis
Kapitän: kwin
fertig: nlat
Einstellung-Aspekt: hsep
neugierig: kyic
fremd: kwic
Verstärker: hnif
Bedeutung: myun
endlich: hfim
Rechnung: fwin
beweisen: hpuk
verhindern: flan
Hals: cyun
legal: hfik
trocken: swak
dienen: syam
verlieren: pcut
Beweis: pyut
beweiskräftig-Fall: hdak
Progress: pyis
Gebäude: klit
Suche: syuc
traurig: hrac
Sünde: psip
dreißig: tfis
ehrlich: tsin
geschlossen: kyap
Bank: pcun
Schicksal: cyik
Wald: hfun
messen: mlac
Andernfalls: htoc
Strom: lyam
Brot: hpup
zusätzlich: tfak
wählen: twas
Tier: nwam
zoic-Geschlecht: hzin
eventive-Stimmung: hwim
gleich-Ereignis-Marker: hcom
Multiplikations-Fall: tlak
dick: hmus
Kreatur: hyum
Regen: myic
Oberfläche: pfas
heilig: swis
Juli: clim
Bericht: hfut
Küste: pwas
Datei: hfif
Schulter: cwut
überrascht: kran
königlich: klik
Lied: hkuf
Komfort: kfaf
jemand: nyic
Gras: kcap
zeichnen: cwik
Öffnung: cyic
Juni: cwun
Fisch: mlic
Hauptstadt: klin
Brust: cyut
Schnee: hcif
Bildung: tlik
scharf: tcaf
Mitleid: hdam
Ausgabe: fyas
Ihre: hmuc
Million: mlun
müde: tcik
töten: ksam
Schatten: cwap
Gewicht: plas
Masse: mlas
etabliert: tlip
trotzen: pyam
dünn: plic
zufrieden: srat
prüfen: kcik
Tugend: hdet
nationale: nyaf
göttlich: swin
Tal: clak
vermuten: kwam
spekulativ-Stimmung: hken
gelb: clas
Überreste: mwac
gebogen: nlac
Box: pwak
Saison: tsim
Wissenschaft: slas
Bohrloch: kcuc
Onkel: hmuk
Liste: lyit
August: ksut
Beliebt: hlup
unbekannt: fyit
familiär: flak
familiär-Neu-registrieren: krit
Leser: tsut
Ansatz: pcuc
zweimal: tsap
intellektuelle: tfik
wirklich: tsam
Priester: pcis
verwundet: fran
Trauer: hpom
Palast: kfas
schlagen: clap
eh?: hnec
Dummkopf: myuk
Rand: pfac
neun: nwun
platzen: psut
leiden: tfas
Lärm: hcus
Literatur: lyic
Rat: swas
leer: kcuk
Rang: psik
Sturm: tcut
Tasche: kyip
Phantasie: nlin
Satz: cwas
November: nwap
Dezember: tsip
Abwesenheit: psic
danken: ryak
Adresse: tyis
Vogel: pyuc
Inhaber: mlik
Mantel: kwut
vorbereiten: tyip
Verhältnis: lwan
rauchen: htum
Januar: nwak
Maschine: clic
Inhalt: nyik
Gebiss: tlis
Schande: hcet
Bucht: kcaf
Gehirn: pyuk
Ring: klic
Phrase-Marker: frak
Platz: ksap
Frucht: fyut
Tee: tsic
erklären: slam
herzlich-willkommen: cwam
Poesie: pwis
kaufen: klam
treu: hdic
Aufregung: hcen
vierzig: klis
April: pyip
freundlich: kfit
Oktober: kfap
bitter: kyuc
Sklave: tlaf
lose: hluk
Text: tsus
Kredit: cyip
fünfzehn: pfit
grausam: kcim
beitreten: cluc
verarbeiten: hpif
Kriminalität: kyaf
Staub: tsuc
praktisch: plik
Farbe: nlak
zerstören: nyuc
erhöhen,-ansteigen: lyas
Nase: hnus
zugeben: tyim
gestern: kfac
hesternal-Tempus: tlen
scheitern: slap
fortsetzen: tcim
tragen: pwam
blind: nlit
Dutzend: tsun
Fliege: fyap
loben: cwin
Teufel: cwaf
allmählich: twic
Opfer: kyif
Übung: cyis
Gewissen: tfin
Theorie: tlic
Minister: myis
Hass: hnet
See: cwic
Center: syun
Ohnmacht: pfic
rational-Geschlecht: hron
vorsichtig: fwac
genießen: nlam
Anbetung: pwap
Waren: twap
Haut: twaf
Dach: tlut
Krone: gyan
Schloss: klap
Thron: tcus
angebracht: nlaf
Meile: mlim
extrem: krim
Gefängnis: fyis
Tasse: kcip
Mitglied: mlam
bürgerlich: syim
überall: tsaf
offensichtlich: tfic
Paar: pwaf
Volumen: clam
Brauch: ksaf
Bogen: ksun
Anzug: slut
Fleisch: mwak
Milch: hluc
pflanzlich-Geschlecht: hwen
Vision: slic
Selten: nlap
Cousin: ksic
Brücke: pwut
schützen: pfak
Salz-: swam
unschuldig: hwus
Königin: kwim
Graf: kcus
Neugierde: hras
tanzen: tyus
Hotel: clut
füllen: flin
Gefangene: psun
Geschäft: hjan
Treppe: sric
betteln: hmen
Sand: sran
gewalttätig: hgit
September: hsem
Abreise: prac
Ruine: crin
Fähigkeit: krin
Rinder: hwec
Ausrüstung: hwip
Küche: hkon
verkaufen: hbak
Geschwindigkeit: hsot
Abschluss: clon
Computer: hkot
ewig: hsen
begrenzt: mrit
Bibliothek: hbek
Base: hbac
Verwirrung: hrun
herrlich: cris
Gleichfalls: hjic
erschrocken: hbic
unzufrieden: prin
Artikel: hrek
Koch: kfin
Band: hbat
Wüste: hget
Kuss: hbun
Ball: hbot
Stock: hpot
Argument: hrut
beobachten: nrak
Segen-Stimmung: hbim
auffallend: hrim
schuldig: hdis
Gewehr: hgin
Polizei: plis
verstecken: hzan
Expedition: srin
ignorant: nrin
großzügig: drac
Wolke: blan
Abfall: htek
Februar: frif
Krankheit: hren
verbringen: bwan
Quelle: sron
Initiative-Fall: hnok
Tante: hbam
verzögern: dlic
verspätet-Imperativ: hlip
berichtet-beweiskräftig: prat
Mitternacht: dyit
Held: nrac
Philosophie: hfof
Finger: hjit
bequem: hzat
irgendwo: hmoc
Drücken-Sie: bran
Personal: hraf
Belohnung: rwan
Schuld: dlac
Elend: krat
Stirn: htec
Anzeige: glan
Engel: htet
Singular-Nummer: hgam
Dämmerung: hbon
kommerziell: krak
verzeihen: pran
Schaf: hcec
Geduld: hpen
Bauernhof: crac
Bezugs: hrec
Mais: mran
Taste: kcif
Mehrheit: hmot
Schwäche: hdut
Atmosphäre: traf
Seufzer: tcoc
Menschheit: mlis
Opposition: pric
Scheibe: hdik
einsam: hket
Künstler: nrat
Ritter: cwis
Charme: tran
Entscheidung: drin
Gouverneur: gran
Zweig: rwac
Anordnung: hsoc
Begeisterung: tsum
induktiv-Stimmung: hdum
Gemeinschaft: hmum
Öl: hyen
Rohr: hbap
drucken: trat
Oh: dyoc
Diskurs-Kontext: hros
Vokativ-Fall: hwok
Kabine: ksen
Alarm: plam
nervös: hnes
Dauer: hset
Messer: ksuk
Seide: slik
Verachtung: grin
Hölle: nrik
getrennt: plen
ernst: mrat
gemischt: mrik
hölzern: mrak
bevorzugen: hpet
Warnung: trin
Ermahnung-Stimmung: htom
Impuls: hmos
Ambition: mrac
leugnen: hnek
Verfassung: swic
Instrument: srit
kontinuierlich-Aspekt: hnip
Tide: hgas
Hochschule: klen
Schwanz: hkek
Generation: nric
Katze: blat
direkt-beweiskräftig: hret
verlassen: trac
elf: hyec
Instinkt: nlik
Eigenschaft: trit
Stamm: hgik
besorgt-Stimmung: pcim
Schutz: crat
unhöflich: hruc
Reiten: hris
Shake: hmon
Industrie: hdot
Beruf: hres
Lampe: hdap
Kaffee: kfif
Folge-leisten: htot
Nord-: nrit
Krankenschwester: nris
versichern: hjat
Kette: ryin
Lehre: cric
Schuhe: hgut
Yard: mram
vage: hmec
anderswo: hlet
Wohnung: pret
Aktivität: twot
Samstag: cram
Sonnenschein: hduc
Witwe: hwuc
Element: hlem
Betrachtung: hfen
Organisation: hgis
Star: tram
Vorfall: hgon
Gast: hgip
Bar: brap
Flasche: hbet
segnen: blak
rühren: crak
innere: trik
Fix: krik
ableiten: prit
hohl: hcot
Provinz: hpos
Zivilisation: srac
aufhängen: hgak
Schock: crok
Ausnahme: swap
Belastung: tren
Standard: ryan
Fahren: dran
loswerden: hruk
schwören: kses
Schatz: zran
Samen: hbis
Turm: tras
Favorit: fwit
vor-kurzem: hcem
kürzlich-Vergangenheit-Tempus: hrot
wach: srik
Möbel: mrin
Seil: hkos
Abenteuer: hdas
Königtum: ryit
Fest: dyat
beschreiben: dras
sechzig: hses
Rahmen: hkem
Zeremonie: srec
Jagd: clik
flüstern: psus
weitgehend: ryat
Christentum: ksim
Anwalt: hwif
Detail: drit
Prinzessin: hrus
Altar: dlat
Netz: hwes
lila: brin
sammeln: hkoc
Wahl: hben
Konzeption: kren
betrunken: crik
gießen: brac
Aufzug: hlif
Geste: hjis
verwalten: rwin
Austausch-: tcen
eindeutig-Artikel: hdek
Kaiser: mras
entfernt: hroc
hässlich: clup
harmlos: cras
rollen: hrof
Zoll: nlic
Zeitung: grat
Bart: dric
reißen: srim
Kommission: kson
während: grak
Kreuzung: kcoc
Unabhängigkeit: htes
Geruch: hwon
achtzehn: hdec
historisch: tris
brutto: krut
Wurzel: hrok
Schlamm: hbik
Braut: dlan
Schleier: pras
Theater: tret
Vergleich: kras
Rivale: rwis
Balance: slen
Trainer: kron
Humor: hnum
Roman: rwas
Rache: hbaf
eifersüchtig: ryut
Rad: hlok
verbrannt: glat
blinken: flac
erstellen: hkec
Konflikt: hnot
Fluch: hlos
imprecatory-Stimmung: pram
hilflos: hces
positiv: hzit
Klub: klup
Flut: nras
Getreide: gwan
Gleichgültigkeit: hdun
Horizont: crim
assumptive-Stimmung: hsom
steil: htop
Harmonie: mron
Donner: hgot
Kindheit: htok
Knie: hgun
Software: pwen
Verletzung: kram
Eingang: ryis
aktivieren: nlim
protasis: hpoc
Beleg: slok
Revolution: hrif
Farmer: hjim
Schlaganfall: trak
Plattform: hpof
Bote: hmes
Privileg: hpek
organisiert: hyot
Schüler: clen
Höhle: hgec
Tradition: rwat
Tragödie: tses
Abschied: hjap
Kritik: ryik
Baumwolle: krap
Krankenhaus: slot
Miete: kris
Gas: hges
unvermeidlich: pwic
tödlich: hgim
Blatt: glit
Veröffentlichung: plun
feindlich: tsup
Übersetzung: dwan
Beerdigung: jran
Mehl: mrun
Korrespondenz: ryon
Romantiker: hrom
Hütte: clun
vorschlagen: psot
Mimetikum: hmet
Dollar: dlon
Tageslicht: hjac
sechzehn: hsos
Versammlung: hzac
Kolonie: klon
Flügel: gyin
Löwe: hles
Kultur: klut
Spalte: hkom
gerissen: glak
Drama: dram
Scherz: hjuc
Nebel: hdus
Medizin: dwas
vierzehn: hkes
Acid: sram
nämlich: hyet
Einkommen: hmok
Bischof: hbip
Orange: tron
Bad: byan
Primitive: rwit
Korb: ksek
Sekretär: sris
Stroh: prak
ungeduldig: pfif
Heil: slon
hodiernal-Tempus: dlin
wollen: zrin
Dampf: tcip
Gift: hwoc
Talent: tlon
Klima: lwim
Wirksam: fric
unterscheiden: tcif
waschen: dwac
Bekenntnis: kfis
Unsinn: hjas
Kohle: kyon
Kanu: kwon
temporäre: tric
delimitative-Aspekt: hdip
Knochen: hcos
Montag: nwic
Dienstag: glac
Mittwoch: bwac
Bundes-: frin
wünschenswert: hzic
Vertreter: ryic
Leinen-: lwin
sinken: swuk
Neffe: bwin
blutig: kric
Belagerung: cren
Bauch: hpem
Messing-: pcon
Gipfel: hzik
fünfte: pfik
billig: brat
exklusiv-Person: kwen
ergreifen: zrat
Zaun: hzas
Statue: tfam
Artillerie: tlep
Umarmung: mrap
umgebenden: sren
streng: srot
Hirsch: hluf
Busch: hbuc
Eisenbahn: hrep
entladen: hduk
Erbe: mris
Eiche: blun
unangenehm: pren
Erfindung: hgic
Klavier: pyon
überzeugen: swen
unsichtbar: gric
allgemein-bekannt: ryun
Grausamkeit: kluk
Versuchung: hyoc
telic-Aspekt: hlep
wirtschaftlich: kfik
international: troc
einmischen: tcek
Philosoph: flif
elegant: gyit
Wohlergehen: kyen
Angeln: mlak
stehlen: truc
Lippe: hloc
in-den-Ruhestand gehen: ryac
strecken: sras
Galerie: glen
parallel: zlan
Atelic-Aspekt: htep
Kontinent: trap
unerschwinglich-Stimmung: nrim
Krawatte: dwat
Zelle: slep
Ei: dyan
künstlich: jrat
in-der-gleichen Zeit: nwis
Krise: ksot
höflich: sloc
Mittagessen: lyon
Kiefer: pwon
drücken: hcef
Allianz: lyen
Taille: hkop
Wunder: hmek
Seemann: slis
Reinheit: prut
Republik: hguk
Telefon: tfen
Peitsche: krip
Hemd: cyim
vorstellen: ryas
Sofa: hsof
fegen: hsup
Dieb: ksif
behalten: nrec
Kanal: kcen
Persönlichkeit: klim
Reform: kfam
bedrohlich: hzim
Palme: plim
Lautsprecher: hzak
Schwelle: dwic
induzieren: pris
Speer: bzak
ordentlich: syec
Session: cwen
Folter: crot
feucht: tcum
Grat: grit
Reisende: hyek
Mühle: mwik
Karte: jrac
Halsband: klok
ersetzen: klif
bewusst: drat
Bier: hbif
Samt: hwem
Schwerkraft: gwit
Predigt: hpum
Missbrauch: glas
Herde: hgen
dreizehn: tres
rechtfertigen: jyit
Freitag: crum
Bürste: broc
herunterladen: dlas
Creme: krem
Cliff: klaf
Jury: jrin
Monster-: ksos
gefroren: hgoc
Pot: pfot
Penny: psen
darauf-bestehen: srut
Apfel: hpep
diskutieren: drak
Hintergrund: prun
transkribieren: trim
periodisch: prik
Unterhaltung: nren
Virus: bris
kindisch: blit
reflektieren: flit
konvertieren: kcet
skizzieren: kluc
Oper: hpop
Zustimmung: nron
verraten: rwak
bestrafen: hzen
Ellbogen: kcon
Befestigung: tcet
reparieren: hrop
verdächtig: cyec
siebzig: swet
Schrift: srip
Grube: grac
Störung: dlak
binär: byin
Abtei: bjan
Pfeil: tcec
neigen: trec
erarbeiten: frat
Loyalität: hlot
Münze: syip
zittern: tcem
Exil: gwin
mechanisch: myim
Falle: crap
Kuchen: kyek
Herr: cyes
zögern: sret
siebzehn: syet
Honig: myon
Anteil: dzat
treten: hjam
Ziegel: brit
achtzig: hpes
leider: pcen
konsultieren: kcot
Legende: lwen
Ernte: hfos
Beförderung: pfon
Herd: hsop
Rebell: bric
altmodisch: hnom
quellen: cron
Sumpf: swot
Dressing: hdes
Asket: pces
Manager: mren
Chor: cros
rational: tson
Verarbeitung: pson
Wolf: blaf
Teppich: hgap
Antike: hjak
fruchtbar: frut
pfeifen: slif
Käse: twis
beißen: byat
einladen: jwan
Dom: kyet
Hafen: brak
wandern: djan
Pflanzen: tsos
Marine: nlen
Maske: mrok
Bleistift: pses
Gemüse: sroc
ausstellen: hzet
Hose: tlun
Korruption: hrup
Kabinett: nram
Suppe: srup
Chirurg: syon
Freibetrag: tcot
Spion: gyas
leichtsinnig: hlec
Klatsch: gyic
Zeichen: hzon
Zusammenfassung: srok
Donnerstag: cwim
Verkehr: ryaf
Architektur: ryek
knacken: rwaf
Ornament: rwon
umkehren: lwas
amüsieren: mwun
Wiederherstellung: ksus
Pflaster: plut
entscheidend: dyin
Negativ: nraf
Festival: hfec
reduzieren: hrum
Verrat: zyan
Jäger: djin
Schlange: syen
Batterie: bret
Wachs: flam
Detektiv: dlit
Analyse: nlis
Betonung: hzot
schwimmen: twen
Umschlag: lwaf
wer-auch-immer: hgek
Zigarette: jrit
Motor-: mrot
Freiwillige: hwot
Reaktion: ryif
Gepäck: blam
taub: hboc
Saft: hjus
Demut: jlit
Ministerium: mret
sexuell: hjon
Durchmesser: dyam
Axt: blac
Diamant: dlam
wechseln: hlek
Echo: hgus
Zurückhaltung: swon
Identität: hdaf
Bildschirm: krun
faul: lwis
momentane-Aspekt: hmop
kompakt: kfot
Drift: hdif
verschwinden: hgaf
Strahl: ryen
Tinte: mwic
massiv: mraf
Keller: dyac
unvergesslich: nrun
Glanz: klek
Senat: slet
Sarg: tfap
Vergebung: frac
schlucken: nlun
frönen: nlot
Swing: swun
Wiese: gram
Komplex: klos
Rücktritt: hzis
demütigen-Neu-registrieren: nret
Verschwörung: swim
Pfeffer: prip
Pony: pron
Kandidat: hzam
Fuchs: flik
Kamin: tcon
Zuständigkeit: drik
Landwirtschaft: rwic
Genauigkeit: tcuk
ehemalige-Verstorbene: brim
demokratisch: mrek
Knospe: hbos
Decke: bwat
Hagel: hgep
Schwein: srus
geformt: krek
Elfenbein: craf
klassisch: ksok
Beobachter: nwet
Elefant: lwit
Nägel: nwus
Biene: hmif
begraben: dzan
Darsteller: bzat
Schweiß: zwan
polieren: ploc
Illusion: hlus
Unsicherheit: pcet
Sekundär: syif
falten: tsot
ländlich: grun
Stöhnen: nyen
ähneln: slec
Zitat: hzun
Sack: cyek
Ärger: fren
Nadel: hjun
kontrolliert: nroc
Huhn: truk
konsistent: kwot
Fass: bras
gewohnheitsmäßig-Aspekt: hcep
Experte: ksec
beeindrucken: blin
Olive: zlin
Lieferwagen: myen
Hindernis: bwak
nicken: kcec
fördern: plaf
Definition: fyic
Geburtstag: gjin
Hammer: hcof
duftend: hfon
Wiederholung: trun
trivial: twut
Kick: hjik
graben: kwaf
Haustier: plot
Schädel: hcop
Legislative: dlik
Ferse: cruk
Stirnrunzeln: crun
Patent: plet
Billion: blim
Chemikalie: fyik
Pilot: pyot
imitieren: mlot
Rock: kwet
ungewöhnlich: srap
wöchentlich: jwik
technisch: tfip
Vegetation: tset
Krähe: kraf
Sonnenaufgang: sruc
Lebenszeit: glin
beitragen: hyom
Haken: hdok
Tiger: blic
durchdringen: crut
Ärmel: slun
Autobahn: jras
Miliz: mlip
Graben: kroc
Integrität: kret
neunzehn: dzin
organisch: rwik
Theologie: flic
schweben: flut
Hexe: byac
gelangweilt: hwuk
diplomatisch: dyik
Studio: twos
überschreiten: kcok
Champagner: cyen
inspirieren: crif
Banner: hbes
Scheidung: lwon
Bolzen: hbut
Vene: jyan
passiv: psif
Schaum: hgum
Kies: grik
Schürze: tyen
Planet: gren
Regal: claf
Ventilator: flon
tropisch: hjip
Phase: fwas
willkürlich: rwen
aussprechen: kfun
Quecksilber: krok
kriechen: hrem
Selbstmord: tcos
Reporter: prot
berauben: hpok
geschickt: klun
Balkon: blik
Gabel: fras
Mitarbeiter: mlek
Arbeitgeber: myot
Breite: jrak
irritiert: djit
beschuldigen: klot
Pension: pyen
Verb: kres
Affe: mwon
akzeptabel: hwek
Stempel,-Unterschrift: tlim
orthodox: rwos
Ironie: fron
Kindergarten: nrap
Abneigung: jlan
Import: tyot
Fackel: croc
Grammatik: gjak
Anzahlung: gyat
kolonial: plon
Yacht: jyat
Folge: kwec
Kuppel: kwun
Dicke: hfot
stur: cyon
Muskel: hmup
Größe: ryam
reiben: ryos
feige: rwam
Geschirr: gwac
Toast: tros
Maus: myus
Silbe: slim
klopfen: prap
Dialog: dlaf
neutral: nrot
Sorgfalt: dwin
Widerspruch: trot
erreichen: kfic
Ziege: byak
blühen: hfet
auferlegen: mlon
anonym: nwim
formal-Neu-registrieren: frit
Kalb: hbof
Handbuch: mwut
Schmelze: hjec
löschen: flas
Regenschirm: gras
Stiefel: bzut
Mineral: mrim
Waffenstillstand: crus
Ente: hbok
Planung: pfam
Seife: hsuf
Puppe: gwak
Skeleton: klet
Villa: blis
Nähen: jlin
versöhnen: dyak
Kessel: kset
reifen: mruc
Kaninchen: kruc
Leiter: nwot
Abhängigkeit: djat
Spieler: jlic
Insekt: pset
Restaurant: cret
Eule: lwun
Radikale: djik
Einwohner: zwin
Drachen: dron
Hör--beweiskräftig: drot
durstig: kyos
verweilen: dren
Berechnung: glun
Verordnung: ryim
Bürgermeister: mlap
Minderheit: mric
Erwerb: dwon
Veteran: bren
Orchester: ryes
Speck: bjin
Nachteil: zwat
Stoff: frap
Musiker: gzik
geistig: hnep
Verbindung: nyon
unzureichend: nrip
Architekt: tsek
Zitrone: nyim
Husten: kcos
Kopfschmerzen: crek
Mieter: ryet
Fruchtbarkeit: srun
heilen: hfoc
neunzig: nwon
zufällig: hbec
Löffel: kcek
Ballon: blon
Kreide: hfip
folgernd-beweiskräftig: nlet
Herausgeber: pcot
Essig: sruk
Asche: fyec
Kraftausdruck: slek
beleben: nrut
anfällig: kfim
Tunnel: tfun
Puzzle: hpef
Mechanismus: mwim
Mathematik: gzit
verblassen: frun
Leber: jwin
sublative-Fall: bwik
tauchen: dris
Einheit: twim
Monopol: hnop
Spiel: hgup
U-Boot: bzin
Erdbeben: hbem
Labor: brot
Kork: kruk
selbst-steuern: syot
Buddha: hbus
stricken: bjat
Botschaft: blas
am-weitesten: sres
deklarative-Stimmung: drim
Stimulus: tyuc
Schokolade: clot
Zufall: tyon
Handschuh: gwat
knien: hjek
Erdkunde: hjif
Investition: nwes
verbal: mrec
Analogie: nlip
weltlich: srek
Falke: blap
Psychologie: nloc
befestigen: gjan
Schrott: krep
Rolle: cyum
Dosis: hdos
Lachs: slom
Pudding: pwun
magnetisch: gyik
Pumpe: pcom
Sauerstoff: ksip
Zertifikat: tfot
Medaille: hmem
Rhetorik: trok
kratzen: rwap
Ruder: dyas
Fernrohr: trip
Halskette: clek
Rechtschreibung: prif
Whiskey: hwos
Weide: hwof
Kamel: hlum
Amateur: myet
Ausgang: crec
Biografie: brif
Esel: gzac
monatlich: mwis
ignorieren: nruk
Ferien: byit
klicken: lyik
Oval: twon
elastisch: lyet
Wörterbuch: kfon
Schinken: gzam
Regenbogen: rwun
verbrauchen: kcum
spucken: tcup
Panzer: trek
Kollege: clok
Schmetterling: trif
Diagramm: graf
Zwilling: jwat
unabhängig: trem
Bambus: hbum
Händler: jlat
Akkumulation: kles
Inspektor: nyet
Bissen: hyos
Alptraum: hbom
Marmelade: gjam
Museum: mrem
Alphabet: lwam
streuen: zras
Überfall: crip
bekannt-geben: clus
verrotten: fraf
aggressiv: gris
Reibung: mroc
Seebrücke: gyac
Spinne: brik
Kartoffel: trut
Revision: cwon
Gier: jlac
verfrüht: ryot
multiplizieren: gzan
drehen: pcip
Statistiken: tsok
Kalender: klem
Nominierung: nwen
Trillion: tlos
Dachboden: tlok
positiv-Stimmung: rwim
Anwendungen: pfen
nominal: nlon
Unzufriedenheit: sraf
Infektion: hfok
Krug: krot
zucken: cyok
Pionier: gzin
Unterlassung: nlif
Kohl: glic
sportlich: tlet
Trunkenheit: mrut
idiophone: hdof
Hebel: lwek
Senator: syem
Iris: nrif
Ameise: mwam
Fehler: hbop
schwanger: grim
Präzipitat: hjet
Knöchel: tcok
Einstufung: glik
Variable: prim
wickeln: ryap
lockig: krec
Schwefel: hsef
diktieren: dwik
entstehen: brun
Frosch: fram
übertrieben-Fall: twek
Schwamm: hjen
nervig: djon
Eichhörnchen: slip
schleifen: zyin
irrealis-Stimmung: flim
Vulkan: glam
drinnen: gron
verwerten: kloc
geologisch: jlik
Reisepass: psop
unmoralisch: mlet
Keks: hbuk
Zusammenarbeit: kros
Tablette: tlot
Entspannung: kces
Atom: trom
AIDS: hzip
Pyramide: psim
Zyklus: swok
Nickerchen: hnup
ungesetzlich: hjaf
Pfote: pfap
Schüchternheit: crom
Finsternis: klip
Laute: lwap
Besen: srum
Platte: mwen
Astronomie: tcom
Labyrinth: blen
Stipendium: bwit
Schildkröte: kfuc
Berater: dwak
Faser: fwic
Kricket: jrik
Taube: ksom
Anpassung: dyon
Dreieck: tfon
Schatzmeister: tsen
Wasserstoff: jron
zerbrechlich: hfuk
Drucker: pyet
Choke: tcof
chronisch: gzon
zurechtkommen: slaf
Dilemma: dlim
Ingenieurwesen: jyin
Kamera: hkef
entschuldigen: pluc
lecken: lwet
Tänzer: dret
Migration: mres
Tennis: tces
Rücken: clip
braten: zrac
Webstuhl: tfuc
stechen: twuc
Passwort: psaf
Hemisphäre: praf
Strategie: zrit
Quarz: krus
Schere: jris
patrouillieren: proc
Gletscher: lwic
halb: dwam
Memorandum: mwap
Kegel: kwuc
Symmetrie: hzut
Hersteller: zrak
Beklagte: fwik
Moschee: djis
Schach: cres
Maut: htof
Kirsche: tref
weit-verbreitet: kfen
stolpern: tfok
LKW: ryok
Senf: mros
Prozent: pfet
Auktion: jlam
Sieb: srif
unsicher: swoc
Magnet: gjat
saugen: syus
Islam: slum
auf-Zehenspitzen: twip
Membran: mlen
rasieren: clet
Gitarre: gjit
glänzend: bzan
Ulme: hyem
steigen: kcom
Pronomen-Marker: ryec
Klammer: pcus
würzen: zlat
Kaution: jlas
Träger: zyac
Vibration: bron
necken: trus
Pflug: hlom
physiologisch: zlik
Rinne: hgok
Komet: cyet
mittelalterlich: dyic
Spatz: grec
kompensieren: twet
Kunststoff: psuk
Fußnote: cyot
Orbit: rwot
sparsam: twum
Golf: hgof
Zero: zrun
Chip: tcep
unterdrücken: prok
gähnen: gjac
Ungleichheit: gwas
Mole: tloc
Keramik: frik
Hausfrau: hgif
Roggen: rwem
nicht-gehorchen: hyes
tolerant: glon
Embryo: brec
Bergmann: jren
applaudieren: zlac
Hefe: lyim
Prämie: pfim
Pflaume: plem
Konkurs: byas
Bewässerung: rwif
Minze: nyun
Kapitalist: glis
Elastizität: hlef
Hai: gyak
rekrutieren: drut
Lagerung: zren
Realismus: cles
Ingwer: djic
Ambulanz: blus
vergleichbar: kwip
Brieftasche: bjap
Grimasse: glim
Wissenschaftler: gyis
Darm: grot
Gleichmut: hwum
Radio: href
irrelevant: zlit
Bohne: bwam
informell: frim
Enkelin: gyut
Uneinigkeit: dloc
Steak: tfek
Stickstoff-: zron
Rasierer: hjut
kontrastierend: krom
Propaganda: pcoc
Feuerwerk: fris
Pop: pcop
ausziehen: crop
Furche: cruc
schädlich: hzaf
Judentum: hjum
ergänzen: pluk
Linse: lyes
pegative-Fall: pwek
Krebs: kfes
Pfand: pyek
Dozent: zyat
Leck: hzuk
qualifizieren: krif
Dichte: djot
Induktion: dyis
kauen: htuf
gesprächig: bzit
Hummer: hgos
Rabatt: dyut
Taxi: tsuk
Hierarchie: crem
Jade: gyec
Knurren: glaf
Eidechse: lyis
Wasserfall: crof
enttäuschend: djak
Veto: frot
Präsidentschaft: ryip
Käufer: mrif
Gallone: jlen
Moskito: mruk
Abweichung: dwen
ringen: lyut
Mosaik-: myok
Stecker: plok
hocken: pcuk
Lebensmittelgeschäft: ksoc
Kommunist: myos
verblüffen: mwek
prosecutive-Fall: rwuk
Konstellation: nlos
Diktator: dwit
Beschäftigung: tyet
Satellit: tlec
Slipper: hlop
Konsonant: fyon
ungefähr: tsif
arbeitslos: byet
Fan: sros
Lotus: lwot
Salat: sles
Chlorid: lwok
Bakterien: bwic
klebrig: pcek
Komponente: bwon
Kern: klec
vortäuschen: bjak
Byte: bzet
Sekretion: sruf
ausdrücklich: pres
übereinstimmen: mloc
Ballett: blet
Urin: mrus
Knoblauch: lyun
verstrichene: hguc
Wirtschaft: kcem
Mittelklasse: hdom
agil: gjic
Zange: htef
Wäsche: lyoc
Erdbeere: srem
städtisch: pcos
in-Verlegenheit-bringen: mlaf
Notizbuch: tfut
Album: zlam
Baseball: hbep
Schnupfen: sluc
Buffet: hbuf
Partizip: rwip
Garage: grek
Diagnose: djas
Krücke: ksuc
erpressen: srom
Registrierung: psuc
löslich: jlun
Phosphor: psof
strukturell: rwut
kleben: glum
These: twes
Handwerker: clif
Banane: bwas
Axiom: kyom
Rippe: psos
Nickel: nyek
Pi: pyim
Bus: bwos
zensieren: swes
Rakete: mlus
Wurst: slos
Manipulation: nlut
Tomate: tfet
verstärken: kfut
Steckdose: syok
Kalium: tsom
abrufen: prup
virtuell: zwit
Algebra: gjas
Zahnarzt: dzit
optisch: pcok
nachgeben: bzen
Biologie: bwim
Arbeitslosigkeit: byim
Raupe: krum
Solo: slof
Browser: bjac
entfernt-Vergangenheit-Tempus: nyot
historisch-Tempus: crep
Atom-: nluk
Spektrum: pyem
Natrium: syom
Hysterie: syes
Treuhänder: tyos
Geisel: byik
Kürbisflasche: gluk
Falte: kwuk
Transparenz: tfif
Spitze: swip
Priorität: pcif
Fußgänger: dyen
Atheismus: tsem
Monitor: mwot
Wahlkreis: nlec
unkontrolliert: hkof
Sonde: grok
Platin: plip
Dual-Nummer: dlun
Lunge: pcep
Super: syup
Wagen: trop
örtlich: lyot
anregen: gzat
Benzin: plif
Niere: grif
Beute: bzac
Bewertung: dlen
Arsen: syek
Schnecke: nrok
Heuschrecke: tsec
Gleichung: fwen
Sozialist: swos
Filter: flot
sensorisch-beweiskräftig-Stimmung: hxin
erweitern: kyot
emittieren: mwet
Leine: pwet
Mandarin: drun
Jockey: hjok
Lungenentzündung: hnof
Solidarität: gret
Scharnier: cyif
in-Längsrichtung: nruc
Dividende: dwun
Schlittschuh: hkep
Exponent: slop
Behinderung: dlif
Obsession: bwen
Zuteilung: pfun
Fotograf: trof
Delta: dlet
digital: djim
Hündin: brut
Augenlid: hyop
Diagonale: dyun
Unterbewusstsein: byon
Augenbraue: bruc
niesen: pcec
urkomisch: dlis
Hinduismus: nwum
Flüchtling: nyif
pendeln: cwot
Eiweiß: pwot
Müllkippe: hdop
verfeinern: flen
erbrechen: hwom
Gen: gyen
Student-im-ersten Jahr: hdem
Soziologie: syoc
quetschen: kwoc
Fischer: hfuc
regional: jyen
Bewegung-bergauf: hvok
retrospektiv: hxik
Tornado: gyon
Inversion: nwos
Fernseher: twif
Würfel: kfet
Produktivität: pwuk
Karotte: krop
Molekular-: mwuk
Konglomerat: glet
Buchhalter: ksum
Gurke: kyok
Orgie: drok
Lösungsmittel: jlet
Phosphat: psef
Grundierung: gwik
alkalisch: flis
Gymnastik: jyas
Komma: kwom
Bewegung-bergab: hvat
Fehlgeburt: jwac
Schote: tcop
Spender: dzon
Mangan: hzem
Psychologe: syos
Chlor: clos
Tastatur: kyoc
Elite: zyit
Parenthese: pfaf
Rugby: rwoc
Geschwür: jlon
gebeugt: hxit
knabbern: nres
Quant: fwam
Pullover: swek
evolutionär: fwis
Notation: nyoc
prallen: tcuf
Präparation: drec
Cache-Speicher: kcep
linear: lyec
Antimon: trum
superessive-Fall: psek
Tumor: twom
Erosion: cyos
Alpha: flaf
Nabel: nwip
immun: myip
Grippe: flun
Brauerei: bjit
vereinfachen: slef
kürzen: bram
Delle: djen
bestechen: dwim
zwingen: brok
Socke: bzas
Film: fyim
Kosmos: klom
verschmutzen: hpuf
gesellig: gjen
Penis: zyis
Forstwirtschaft: lyif
Aluminium: lwum
Schwingung: zlon
Horoskop: ksop
auswerfen: dlek
Aufnahme: nluc
Nutznießer: byic
Delphin: dlip
Mörder: cyus
Säugetier: myaf
Indikator: swif
Dioxyd: dwis
Doppelpunkt: zlen
Bürokratie: brus
verzerren: jric
Kühlschrank: frip
archäologisch: cluk
nicht-akzeptabel: kwok
Spezifikation: pfis
Broschüre: pfut
Anthropologie: nlom
lecker: kyec
transitiv: txit
kauern: kwus
Sonnenblume: hzuc
Laus: glus
Ion: lyos
Tourismus: tyum
Modem: myom
Beschleunigung: jrun
verfälschen: tsoc
Emission: hmef
entführen: drap
überlappen: hwep
Friseur: pfes
Folklore: floc
kapillar: plek
Nationalismus: nlum
Gesäß: nros
Motiv: hmuf
Sublimat: slem
Frustration: xras
Kobalt: kwos
Hafer: gwam
Bewegung-flussaufwärts: trup
After: gyam
Rinder-: bwun
Flip: flip
Redundanz: dzun
Video: hwop
Boykott: bjik
Quiz: cwif
Eishockey: cwok
Guerilla: grip
Magnesium: hgem
Radar: drek
Schimpanse: hzif
Zuverlässigkeit: kwif
Rechteck: tyec
Seetang: klep
verallgemeinern: jlak
Sperrstunde: kfec
Homosexuelle: mlok
Szenario: srop
Formulierung: flus
Reinkarnation: nrom
entzünden: zlak
Uran: ryum
Fänger: kwes
koordinieren: kyop
Steuerzahler: nwaf
integriert: trep
meinte,: hzap
Gamma: hxam
Safari: fwim
Bewegung-flussabwärts: ht6n
Koeffizient: kfus
Überschrift: zlic
Analytiker: nles
Schachmatt: hzes
Einkaufszentrum: hmof
Wismut: bzim
Postkarte: psok
Konvergenz: bros
abschweifen: djet
Aktionär: ksem
Mikrobe: mrip
genital: jwit
morphologisch: mluk
Beta: byot
Jeans: gjis
Datenbank: tles
Taschenrechner: klus
Röntgenstrahl: ksef
parsen: zram
Umwelt-: zyen
Sigma: zyim
Trennung: hxon
Agenda: gres
Visum: bzis
Infrastruktur: nyuk
Glühwürmchen: gyun
Detektor: tyek
adaptiv: dyip
Biologe: byis
spleißen: pyec
Brom: brom
Palladium: plum
Schluckauf: kfok
Pastell-: psec
Zoo: zwac
Klinik: lyok
Konnotation: nwoc
Yoga: hjoc
Buchhandlung: byun
Therapie: grap
Nationalist: zlis
enthaupten: zlet
Ja: swec
problematisch: byam
Jazz: dzas
Wolfram: tsof
Terrorist: gwis
dribbeln: droc
Stoffwechsel: tlem
Alimente: lyaf
Wochenende: hfom
Chrysantheme: gzim
Impfstoff: byap
Motorrad: tyok
Mantra: dyot
Semester: myes
Heroin: gwon
Mappe: flap
Kathode: kfoc
Ideologie: dlec
Parken: prek
Theta: fret
Enttäuschung: hxis
Selen: clem
Radfahren: blek
Kortex: pros
Gleichwertigkeit: swaf
Strom-Relevanz-Marker: hxak
Flughafen: cwoc
amputieren: gyet
Basketball: bwet
Betrüger: mwip
Kakerlake: tlek
Chrom: hgom
Liter: hl6t
dennoch: nwec
Hormon: cwom
fehlerhaft: tluc
perforieren: prec
Animismus: nyom
Vieleck: cloc
Feminist: hfes
konjugieren: kcop
Euro: dros
Ginseng: hjes
Algorithmus: hlof
Laser-: lwes
Drogerie: dlot
Millimeter: mlem
biegen: flek
Anode: nlok
Nuance: hzus
Teilzeit: prem
Empfindlichkeit: nyec
Vorführer: drom
Helium: clum
zweisprachig: dzic
Akronym: hqim
initialism: nl6m
Gerundium: gros
Plasma: psem
Chromosom: rwom
Ordinal-: rwok
Kilometer: klum
Fax: tfes
Genetik: nwek
Sommersprosse: frek
Schraubendreher: dres
Brokkoli: blok
Präteritum: xrit
Vitamin: tyem
Cadmium: kyem
Bomber: bwoc
grafischen: gjik
Titan: dyim
protzen: clec
Lambda: lwem
Freundin: pcem
kopulieren: kyuk
Sanduhr: tlus
Empathie: mlif
Bor: bres
Hubschrauber: cwet
Tellur: tlum
Frist: jyic
ausrichten: gwic
Zentimeter: hfem
Molybdän: mlom
Lithium: tfim
Multimedia: myum
aktualisieren: dyet
Kalorie: clom
Roboter: ryoc
Hausaufgaben: groc
Logarithmus: grom
Gottesanbeterin: gzas
installieren: nwut
Amino: myoc
Glyphe: glif
aorist: pyos
Ökologie: plec
sophisticate: flok
Marihuana: bjam
Mikro: mrom
Kilogramm: lwom
zu-viel-essen: jrot
berechenbar: dzik
Pizza: zyas
lauschen: zris
Linguistik: bwis
Haarschnitt: braf
Iridium: ryom
Rassismus: gwim
optimal: gyim
Industrialisierung: drif
Hauptsitz: krup
Cer: zrim
kongruent: nrum
partitiv-Fall: pxik
Kassette: ksep
Willenskraft: blot
dimensional: dzen
Parameter: rwet
synchronisieren: nrop
maximieren: dzim
Seminar: mwec
Disko: dyok
Neon-: nyok
Osmium: hzom
Offenbarung: hp6n
plagiieren: lyap
Artefakt: rwek
Reaktor: fyet
Oregano: ryop
Plutonium: pwum
Yttrium: tyom
Unterstützten: hxat
Benutzername: mrum
Doktorand: zrot
rechter-Flügel: dwaf
Argon: jros
Phobie: hxot
sozialisieren: sluk
Globalisierung: bluc
Wellenlänge: hnef
kodieren: kfom
recyceln: psoc
Neustart: nrek
Hepatitis: pyes
Wulst: fros
Chemotherapie: myep
Modulo: mwok
Proton: zwot
Diskette: dwet
Milligramm: mlum
Pixel: psep
Tantal: twem
solute: hjot
Völkermord: nyos
Raubtier: rwes
Gallium: glem
Zirkonium: hzum
Ermittler: txin
nichtlineare: nlem
Schädlingsbekämpfungsmittel: pyif
Beryllium: brem
Neuron: nrus
prädikativ: pxit
Unterhose: tlif
Fakultät: kref
Neutron: zrut
Niob: nwom
Germanium: hjem
Halbmetall: tlop
stellen-auf: dlap
prolative-Fall: hl6k
Biodiversität: jwic
Joystick: jyok
Antibiotikum: twok
Aktinium: gjim
Astronaut: srof
Außerirdische: tyes
spinös: hwup
Marathon-: mrof
Ytterbium: zwim
Autismus: tyif
ionisieren: nlof
Radon: cwos
nerium: nrem
Epidemiologie: pwip
hohes-Alter: lyuc
Camping: kyep
gestreift: drip
Indium: nyum
veridical: hvik
Webseite: bwes
Koran: kwek
Besteck: fwet
n-ter-Wurzel: tfec
Lawrencium: lyem
Bürgerrechte: glip
Mobiltelefon: mlof
gelähmt: twoc
Protaktinium: prum
Strahlung: hd6n
abhängen-auf: pxin
Thorium-Atom: hxim
blau--jean: bjun
Zimmerpflanze: hxas
individuell: dvit
Flussstrom: lwuk
Dreipunkt: ht6t
menschlicher-Körper: hn6n
Physik: bzik
Verkauf-Geschäft: hxan
Cäsium: hs6m
lange-vor: hqan
Kalkulationstabelle: hxet
Einheit-Punkts: hn6m
kompilieren: ml6n
Binär---Wert: vrim
Mensch-Sein: nyus
durch-Mittel-von: hvan
depan-dari: pxat
Praseodym: pyom
Karton: kxat
endlich-Verb: hqik
Versuch-Nummer: hr6n
Profi-Satz: hr6t
Kritiker: hk6k
Verpackung: pxas
Unbeständigkeit: pxan
beim-die-meisten: txas
Descriptor: drop
Neodym: nyem
Freundschaft: hvit
lesen-nur: xyak
gründet: xwan
gnomic-Stimmung: kxin
Phonem: hxom
Rationalität: xlit
phonologisch: xlin
Speise--Zimmer: hxac
Leben-Zimmer: hxic
zentrisch-Fall: zrik
vor-hodiernal: hx6n
geduldig-Fall: hqak
schräg-Fall: bwok
ländlich-Bereich: hqat
recurse: hr6s
Mitte-Stimme: dyos
meitnerium: hm6m
Briefträger: hvak
unverbindlich: kxit
Stock-Markt: xrak
identifizierbar: hxap
Tor-auslösen: krof
eine-Sekunde: hxen
geberischen-Fall: dvak
Ration: hr6c
nicht-Mensch: hg6n
Leben-Ding: hvic
auch-wenig: hxut
Kino: hvin
hassium: xyim
abschwäche: ty6t
multal-Nummer: ml6m
milchig-Weg: txam
Neptunium: nwem
Ghostwriter: txik
trans-Ziffer: ts6s
narren-um: hqun
Americium: myem
Morgen--Ruhm: txan
Feuerwehrmann: xran
berkelium: blem
Galaxis-Geschlecht: kxan
nobelium: blum
Tschüss: hvac
Buddhismus: hfum
fermium: frem
cyan: xyan
Soja: syof
Verteiler: qrit
Streikbrecher: txak
Prozessor: ples
Abessiv-Fall: bvak
Adessiv-Fall: dvik
zu-Fall: kxak
Agens-Fall: dvek
rutherfordium: hr6m
Antikörper: txip
wie-viel-wie: hjos
Agent-auslösen: hg6t
Darsteller-Rolle: xram
Ethidium-: txim
verbreitet-Geschlecht: hk6n
Begleiter: kl6n
Distel: kxam
francium: fyam
Erbium: ry6m
passiv-Stimme: xyis
Astat: hqit
Kauen-Gummi: hqam
Star-Geschlecht: hqin
Zitat-bilden: ht6m
Curium: jrim
Comic: kxis
farbenblind: hqon
Eulersche---Nummer: hl6m
guckt-mal-beim: kxas
Fußgängerübergang: pwok
Schlachtfeld: txat
Autofahrer: vrit
Kurzschluss: txok
verbal-Substantiv: hvis
Schrei-aus: hk6t
statistisch: xyit
Joghurt: txot
Xenon: hs6n
hypnotisieren: hxif
nehmen-aus: hxaf
Klausel--tail: hxok
direkt-Objekt: dwot
Lebensmittelgeschäft-Geschäft: kxun
bestehen-von: hm6t
ergative-Fall: gvik
in---Sprache: txic
aus-erster-Hand: pxam
Lokativ-Fall: hqok
Pool: slup
adverbial-Fall: vlak
besichtigen: hqas
Fernsehen-Set: ht6s
Finale-Teilchen: xlik
evitative-Fall: hvek
Rehabilitation: xlat
Regression: xris
Block-von-wohnungen: kxot
aufwachen-oben: hxup
Polizei-Offizier: ps6s
schwören---in: vran
Interviewer: qrat
Rhenium: ryem
Sprühdose: xres
besitzergreifend-Fall: kxik
Substantivierung: mlec
besessen-Fall: dzak
überladen: pxak
Hilfs--Verb: xyik
primär-Objekt: mlut
Computer-Virus: prus
Geschäftsperson: hqis
ein-Menschen: hqen
antessive-Fall: ts6k
Premierminister: pxis
Lutetium: lyum
Europium: rwum
emote: xrot
Volksmusik: zyik
Dichter: vwit
Post: pxot
angeblich: hvas
animieren-Geschlecht: hven
subessive-Fall: bvik
Gaspedal: glep
Polarität: pr6t
Fahrzeug-Geschlecht: vlin
Mineral-Geschlecht: xrin
Verb---Endung: hvif
leidenschaftlich: pc6n
Samarium: sr6m
Moderator: hs6t
imaginären-Einheit: xyin
Lichtgeschwindigkeit: kxac
Luftwaffe: hxes
einfühlsam-Freude: pfec
kritischer-Punkt: qyit
Vollzeit: hxem
Hafnium: xyam
Hemmung: hn6s
Veränderung-von-Event: qrin
Holmium: xlim
anders-Event: hf6t
Universum-Geschlecht: hvip
Gegend-Geschlecht: kxen
virtuell-Maschine: hvim
Forschung-Geschlecht: txen
künstlerisch-Geschlecht: ts6n
crastinal-Tempus: sl6t
abstrakt-Geschlecht: srep
exocentric-Fall: zrek
transitiv-Verb: txif
Morphem: tfom
Chauvinist: dvis
Vergangenheit-perfektiv: xrat
beruflich: hy6n
indirekt-Rede: tyoc
zweite-Sprache: draf
zu-Sein: txis
Friedhof-Verschiebung: vrak
Kollektiv-Substantiv: hxos
absolutive-Fall: bvuk
geduldig-auslösen: tr6t
selbst-Vertrauen: hs6s
Kot: hzos
reflexiv-Stimme: hf6s
unpersönlich-Verb: hxek
seaborgium: br6m
white-space: hxep
modal-Fall: dlok
unbelebt-Geschlecht: hj6n
kausativ: qran
propositive-Stimmung: psom
elektrisch-Strom: tr6n
assoziativ-Fall: nwok
Superlativ-Fall: tluk
auch-viel: xyut
Planeten--Geschlecht: pxen
lebhaft-Karikatur: nwuk
reziprok-Stimme: vrik
Gesetze-erlassen: hqaf
beim-am-wenigsten: vlas
grammatisch--Fall: qrak
Benutzer: pxut
Ader-benefactive: kfef
Torwart: hgop
:-except-for: kcef
Nenner: dvan
else-if: lyek
seitwärts: hx6s
gegenseitig: dles
aufeinanderfolgende-Klausel: lyuk
abnutzen: hxun
Shorts: ht6k
Dysprosium: prom
bald-Zukunft-Tempus: rwec
si-Einheiten: vyin
Krypton: kxon
mendelevium: dlem
applicative-Stimme: hp6s
Antipassiv-Stimme: tsef
weiter-Aspekt: ht6p
Strahlungskrankheit: hr6k
necessitative-Stimmung: hn6t
Single-Aktion-Verb: hqek
Triebwagen: xlak
Superlativ-Grad: tlup
Existenz-Klausel: hs6k
Californium: kf6n
Geschenk-Partizip: vrat
leuchtend-Intensität: hc6t
singulative-Nummer: slus
grammatisch--Objekt: hy6t
passiv-Partizip: vris
übertrieben-Dauer: kxic
kritischem-Fluid: sr6t
Menge-von-Substanz: ks6t
postpositional-Fall: pxok
Wahl--Quantor: lwif
Gadolinium: dl6n
epenthetic-Morphem: hp6m
negatory-Quantor: nwif
einsteinium: ny6n
künstlich-Sprache: txac
verbindend-Teilchen: qrik
entfernt-Zukunft-Tempus: twec
frequentative-Aspekt: hfep
distributive-Pronomen: bvin
Ansprache-Zustimmung: hk6m
kahl: blos
Vorort: syum
Universal--Quantor: vlit
Computer-Programmierung: mr6m
Fernsehen-Programm: tr6m
Floating-Point---Zahl: hvun
existentielle-Quantor: tl6t
das-Tag-nach Morgen: dwek
Alternative-Quantor: lw6t
schlecht-gelaunt: hdup
Vergangenheit-passiv-Partizip: hp6t
das-Tag-Vor gestern: txet
Lokativ-Richtungs--Fall: tc6k
kontra-bedingt: ht6c
