αντίο: Αντίο, Χαίρετε, Π, αποχαιρετισμός
ο: 
του: μεταξύ, για, του
να: Έλα, πρέπει
σε: 
:-first-Persians: 
εγώ: μου
:-third-Persians: 
ότι: το, ο-οποίος
του: του, ίδιος
αυτός: το
με: 
για: για, προς
ως: ο-οποίος, παράδειγμα, πως
:-Seconde-Persians: 
είναι: 
αυτήν: του
επί: κλήση, για
στο: άλογο
με: πέρασμα, και, για
έχω: αρκούδα
ή: ούτε
από: 
αυτό: το
αυτόν: του
αυτή: αυτοί, το
μου: ορυχείο, μου
τους: του, αυτοί
έτσι: έτσι, σύντομα
ένα: 
τους: αυτοί, εσείς
εμείς: μας, μου
Ποιος: οποιοσδήποτε, ο-οποίος
θα: νομίζω, φέρω
θα: δύναμη-της-θέλησης
κανένα: δεν
αν: αν, υπό-την-προϋπόθεση
επάνω: πάνω-από, αύξηση, έξω, χειρότερος
σε: ένας
κάθε: δηλαδή, ο-οποίος, όλοι, κάθε
σας: δικό-σου
τι: ούτε, ο-οποίος, πράγμα
ενδεικτικός-διάθεση: διευθυντικός-διάθεση
άνδρας: πρόσωπο, σύζυγος, αρσενικός
από: περισσότερο, για, πως
μας: άνοιξη, μας
μερικοί: κάπως
επάνω-σε: μετά, πάνω-από, έξω
Μάιος: ικανός
τώρα: παρόν
αρέσει: πως, αγάπη, Κρατήστε
κουτί: ικανός, θα-μπορούσε-να, κουτί
πρέπει: πρέπει
έκανε: κάνω, γεγονός
τέτοιος: έτσι
ένα: ένας
αυτοί: αυτοί, το
υπερ: πάνω-από, περισσότερο
πολύ: πολύ, τόμος
κύριος: Κύριε, κύριος
καλός: όμορφος, εξαιρετική, είδος
πλέον: περισσότερο, μεγάλα, πλειοψηφία, πολύ
θα: πρέπει
εκείνοι: αυτοί, του
ίδιος: ίδιος, ίδιο, εαυτούς
ΖΩΗ: ζω, Διάρκεια-Ζωής, φωνήεν, μέση
χωρίς: 
μάρκα: κάνω, δημιουργώ
Λοιπόν: άνετος, δικαίωμα
ομιλία-σημάδι: 
διά-μέσου: πέρασμα, διαπερνώ
θα-μπορούσε: εξουσία, ίσως, θα-μπορούσε-να
πολύ: πολύ, ακόμη-και
πάλι: έπειτα, πίσω, μια-φορά
πολοί: πλειοψηφία
κάθε: κάθε, ο-οποίος
άνθρωποι: πρόσωπο, κοινότητα, ένα-άνθρωποι
σκέψη: ιδεολογία, ιδέα, νομίζω
κάτω-από: κάτω
ακόμη: περισσότερο
θέση: σημείο, θέση, που
ενώ: ενώ, φορά, προσωρινός
μόλις: μόνο, απλός
επίσης: ακόμη-και, επίσης, περισσότερο
ακόμη: αλλά, ούτε, παρ-'όλα-αυτά, περισσότερο
εναντίον: προς, πριν
παίρνω: συναντώ, παίρνω, αντλώ
πάντα: αιώνιος, ποτέ, πάντοτε
μακριά-από: κλειστός, μακριά, έξω, σκεπαστός
πρόσωπο: επιφάνεια, εκατό, πρόσωπο
άλλος: τελευταίος, άλλα
αριστερά: μακριά
νέος: Νέο, μυθιστόρημα, φρέσκο, εννέα, νέος
κυρία: 
βάζω: σειρά, τελευταίος, δίνω
λέγω: λέγω
μυαλό: διανοούμενος, νομίζω
λίγοι: ζευγάρι, λίγο
ποιόν: ο-οποίος, οποιοσδήποτε
μακριά: μακριά, μακρινός, πολύ
που-ονομάζεται: νομίζω
ολόκληρο: γεμάτος, όλοι
και-οι-δύο: δυο
εύρημα: θεμελιώ, έρευνα
ματιά: βλέπω, έλεγχος, ματιά
αφήνω: λεωφορείο, εκπέμπουν, δίνω, καθιστώ-ικανό
άρχοντας: κύριος, Κύριε, βασιλιάς
σπίτι: σπίτι
κάτι: τίποτα, κάπως
στιγμή: φορά
πατέρας: μπαμπάς
αναμεταξύ: μεταξύ
γυναικών: θηλυκός
μητέρα: μαμά
τέλος: πεπερασμένος, τελευταίος, αργά
μικρό: λίγο, μικρο
σύ: εσείς
θέλω: πρέπει
ωστόσο: αλλά, παρ-'όλα-αυτά, αν-και
αρκετά: εντελώς, κάπως, πολύ, αρκετά
τίνος: ο-οποίος
καλύτερος: καλύτερα
εγώ-ο-ίδιος: μου, εαυτούς
μέχρι: ακόμη-και, πριν, Αντίο
από: έπειτα, πρώτα, επειδή
μεταχειρισμένος: παλιός, ανακυκλώνω
μάλλον: αντί, κάπως, περισσότερο
μείον: μικρός, κάτω, ελάχιστα
εντός: εσωτερικός, βαθύς, εντός-κτίριου
μαζί: σειρά
μεγάλο: εξαιρετική, ογκώδης
ύλη: πράγμα, θέμα, ερώτηση
βέβαιος: αποφασισμένος, δικαίωμα
εαυτήν: εαυτούς
ήμισυ: στα-μέσα-του δρόμου, αλέθω, πλευρά
αληθής: όντως, γεγονός, δικαίωμα
οτιδήποτε: οτιδήποτε, κάπως, τίποτα
διατήρηση: Κρατήστε, σειρά, διατηρώ
γυναίκα: θηλυκός
μέσα: τρόπος
κοντά: πέρασμα, σχεδόν
κατάσταση: κατάσταση, εισάγω, χώρα, κυβέρνηση
μόνος: μοναχικός, μονοφωνία, ένας
περίπτωση: πτώση, παράδειγμα, κοστούμι, περιστατικό, επειδή
σε: εσείς
ψηλά: πάνω-από, πάτωμα
κορίτσι: κόρη, θηλυκός, φιλενάδα
σίγουρος: διαβεβαιώνω, δικαίωμα, όντως
πράγματι: όντως, γεγονός
εαυτό: εαυτούς, ίδιος, αν
κατά-μήκος: σχετίζονται, μακρύς, μήκος
γη: χώρα
απόδοση: οπισθοδρόμηση, πίσω, επιστροφή-χρημάτων
άδεια: αναχώρηση, διακοπές, εγκαταλειμμένος, μακριά, άδεια
είτε: ακόμη-και
νόμος: δικαίωμα, νομικός, κανόνας
λαϊκός: σειρά, κοσμικός, βοήθεια
σημείο: σημείο, δράση, μόνο, παράγραφος
παιδί: παιδιά
επιθυμία: ελπίδα, επιθυμία
μιλώ: λέγω, ομιλία
κατά-την-διάρκεια: φορά, ενώ
διάφοροι: ντουζίνα, ζευγάρι, περισσότερο
επιχείρηση: εμπόριο, κατάστημα, εταιρεία, δουλειά, εμπορικός, κίνηση
τρόπος: τρόπος, προσέγγιση
δεύτερος: άλλα
γενικός: κοινός, γενικά, δημόσιο
πίσω: πίσω
γίνομαι: Έλα
νεκρός: καλούπι, θάνατος
γη: χώρα
αγόρι: υιός
αφή: συναίσθημα, ακούω
πνεύμα: ψυχή
αλήθεια: γεγονός
έδαφος: πάτωμα, χώρα, σημείο
πραγματικά: όντως, πολύ, γεγονός
υπόλοιπο: άλλα, άνεση, αποσύρω, λείψανα, διακοπές
διαφορετικός: διάφορος, διαφορά, άλλα
δυνατόν: ίσως
ανθρώπινος: πρόσωπο, ανθρωπότητα
πόλη: πόλη
εξής: επόμενος, ακολουθώ, μετά
ανάγκη: απαραίτητος, πρέπει
αιτία: λόγος, προκαλέσει, επειδή
απόγευμα: νύχτα, απόγευμα
πέντε: πέμπτος, έτος
ισχυρός: εξουσία, ικανός, βίαιος
κυρία: θηλυκός
γύρω: περιβάλλων, σχεδόν, για, μάτι
σειρά: πλευρά, σειρά, παραγγελία
έννοια: μέσο, συναίσθημα, έννοια
κοντά: κλειστός, σχεδόν
χαρακτήρας: χαρακτηριστικός, προσωπικότητα, σημάδι, φύση
είδος: ταξινόμηση, είδος
θέαμα: όραμα, προς-τα-εμπρός, σκηνή, βλέπω, ματιά
κόμμα: γιορτή, κόμμα, χώρα
πρόστιμο: εξαιρετική, λεπτός
έτοιμος: προετοιμάζω, ήδη, ακροποδητί, πεπερασμένος
λογαριασμός: λόγος, νομοσχέδιο, λογαριασμός, κόμης
γραπτός: γράφω
ηλικία: παλιός, αιώνας
αλλού: άλλα, τελευταίος, αλλού, περισσότερο
δύναμη: εξουσία, αναγκάζω, επιβάλλω
απέναντι: πάνω-από, απέναντι
νωρίς: πρόωρος, αρχή, πρωτόγονος, σύντομα
ήλιος: 
αργότερα: μελλοντικός, έπειτα, μετά, επόμενος
πάντα: όλοι
το-παρελθόν: παρέλθει, αναδρομικός, τελευταίος, μετά
πράξη: νομοσχέδιο, ρήμα, δράση, δουλειά, κίνηση
περαιτέρω: προς-τα-εμπρός, περισσότερο, επιπλέον
πέρα: περισσότερο, έξω
ούτε: ούτε, ο-οποίος
θέα: αποφάνθηκε, ματιά, βλέπω, όραμα, σκηνή, ημερολόγιο
ήχος: φωνή
κανένας: τίποτα, νικέλιο
σαφής: ανοιχτό, καταφανής, εκπληκτικός, ελαφρης
δρόμος: αυτοκινητόδρομος, τρόπος
πραγματικός: πραγματικός, γεγονός, βασιλικός
σχεδόν: σχεδόν, για
γνώση: πληροφορίες
προς: προς
κακός: χειρότερος, κακό, φτωχός
ζωή: ζω, μέση, Διάρκεια-Ζωής
ειρήνη: δωμάτιο
χαμηλός: μικρός, φτηνός, αποτυχία
βόρειος: απάντηση, βόρειος, μεσάνυχτα
φυσικός: φύση
αρκετά: όμορφος, πολύ, αρκετά
έκθεση: δικαίωμα, έκθεση, δέκα
υπηρεσία: σερβίρισμα, φροντίδα
παρακάτω: κάτω
ευχαρίστηση: ευτυχισμένος
ιστορία: ιστορία, ημερομηνία, ιστορικός
Σημείωση: θυμάμαι, σημειογραφία
αν-και: αν-και
εμπρός: απέναντι, προς-τα-εμπρός, πριν
μεγάλος: εξαιρετική, ογκώδης
σίγουρα: αυστηρά, πορεία, όντως
άνεμος: αέρας, σοφίτα
λαμβάνω: παραλαβή, παίρνω, αντλώ
Προσοχή: φροντίδα, προτεραιότητα, εστία, σχέση, έμφαση
δύναμη: εξουσία
πιθανώς: ίσως
χαρούμενος: ευτυχισμένος, εύθυμος, ικανοποιημένοι
σπουδαίος: απαραίτητος, επακόλουθος
σύ-ο-ίδιος: ίδιος, εαυτούς
σύντροφος: συνάδελφος, φίλος
γνώμη: αποφάνθηκε, ιδέα
πίστη: πιστεύω, πίστη
πριν: Ανατολή, έπειτα, πριν, προς-τα-εμπρός, πίσω
χρέωση: διόδια, δαπάνη, παίρνω
μπράτσο: χέρι, φτωχός, μανίκι, όπλα, ώμος
τελευταίος: τελευταίος
αντικείμενο: σκοπός, τίποτα, θέμα
κύριος: αρσενικός, Κύριε, κύριος
ιδιαίτερος: ειδικά, δηλαδή
μόλις: δεν, σχεδόν, σπάνιος
αρχηγός: διευθυντής, κεφάλι
ευκαιρία: σύμπτωση, θέση, ευκαιρία, πιθανότητα
συμφωνία: σχέδιο, κατάστημα, συμφωνία
σκέψη: νομίζω
βαρύς: επανάληψη, βάρος, σοβαρά, σκληρά
πεδιάδα: ανοιχτό, απλός, κοίλος
αμέσως: μια-φορά, σύντομα
στόμα: πρόσωπο
φοβισμένος: έντρομος, φόβος, ανήσυχος
μονόκλινο: ένας, μοναχικός
χαρά: ευτυχισμένος, έξαψη
σπασμένος: θείο, τομή
εκτός: εκτός
μεταφέρω: αρκούδα, φορούν, φέρω, καθιστώ-ικανό
επιρροή: αποτέλεσμα, γρίπη
εμφανίζομαι: αναδύομαι, φαίνομαι
εκτός: έξω, εκτός
παρακαλώ: ευγενώς, παρακαλώ
εμφάνιση: αναδύομαι, φαίνομαι
αργά: σταδιακά, αργά
περίοδος: φάση, φορά
αδελφή: αδελφός
μάχη: πάλη, πόλεμος
πρώην: παλιός
νεολαία: νέος
απλώς: μόνο, απλός, μοναχικός
έκταση: προσέγγιση, κατορθώνω, Έλα
σύστημα: παραγγελία, ιεραρχία, οργάνωση
βραδινό: νύχτα, μεσημεριανό
κατόπιν: μελλοντικός, μετά
βόλτα: πάτημα, πάω, πάτωμα, πόδι
αναρωτιέμαι: θαύμα, παράξενος, έκπληκτος
συνήθης: γενικά, κοινός, πάντοτε
εικόνα: ψηφιακό, στατιστική, σχηματισμένος, αριθμός, διόδια, εικόνα
αρχαίος: παλιός, ντεμοντέ
σεβασμός: σχέση, τιμή, κίνδυνος, προς
τρίτος: τρία, Τρίτη
μένω: διαμονή
κοινωνία: κοινωνικός, κοινότητα, εταιρεία
αποτέλεσμα: σύναψη, αποτέλεσμα
εντολή: παραγγελία
μόνο: μόνο, απλός
δίπλα: πέρασμα, επόμενος, εκτός
σιωπηλός: ησυχία
τέλειος: κατάλληλος, εξαιρετική
δρόμος: τρόπος
γράψιμο: γράφω, επιστολή
ξύλο: ξύλινος, δέντρο, ραβδί
γρήγορα: σύντομα
ανακοίνωση: βλέπω, διαφήμιση, προειδοποίηση
ευφυής: αιχμηρός, ελαφρης, λαμπερός, εκπληκτικός
σκάφος: πλοίο, φλοτέρ, θαλαμηγός
ευγενής: εξαιρετική, ένδοξος
αιφνίδιος: ξαφνικά
αξία: αξία, τάξη, σπουδαιότητα
οφειλόμενος: επειδή
ανάγνωση: ανάγνωση, ερώτηση
συμφωνώ: συμφωνία
Περιμένετε: αναμένω, Κρατήστε, διαμονή
κομμάτι: τσιπ, μέρος, τέντωμα
πρώην: παλιός
συνομιλία: ομιλία, διάλογος
ευκαιρία: ευκαιρία, θέση
κόστος: δαπάνη, πληρωμή
σημαντικός: εξαιρετική, επακόλουθος, εκπληκτικός
καθίζω: διαμονή
κορυφή: άριστος, κορυφογραμμή, πάνω-από, κορυφή
γάμος: παντρεμένος
βήμα: δράση, πάτημα, φάση
αρχίζω: αρχή
ανά: κάθε, προς
άτομο: πρόσωπο, μεμονωμένα, άτομο
δύσκολος: σκληρά
κομμάτι: μέρος, λίγο, ψείρα, κομματάκι
ομιλία: ομιλία
εξουσία: δικαιοδοσία, εξουσία
ευτυχία: ευτυχισμένος
προμηθεύω: υπό-την-προϋπόθεση, δίνω, διαβεβαιώνω
μελέτη: μαθαίνω, ανάλυση, στούντιο
προσωπικός: ιδιωτικός, μεμονωμένα, προσωπικό
παρακολουθώ: έλεγχος, μηνυτής, βλέπω
ευχαριστημένος: ικανοποιημένοι, ευτυχισμένος
καυτό: ζεστός, φωτιά
προσπάθεια: δοκιμή, ένταση
έτοιμος: προετοιμάζω, ήδη
απόπειρα: δοκιμή, κουίζ, μαχαιριά
γρήγορα: σύντομα, ευκίνητος
κάτω-από: κάτω, μετά
προορίζονται: σκοπεύω, εστία, σκοπός
ευθεία: κατευθείαν, απλός
πιθανός: εύκολα, πιθανότητα, ίσως, τάχα
δικαιοσύνη: δικαίωμα
απλά: μόνο, απλός
εμπιστοσύνη: πιστεύω, πίστη
πέρασμα: μέρος, διάβαση, στήλη, πέρασμα, τέντωμα
κλειστό: κλειστός, αργαλειός, σκεπαστός
εμάς: εαυτούς
πέρασμα: πέρασμα, παρέλθει, διάβαση
μέσον: δευτερεύων, μέσο
κατοχή: ιδιοκτησία
ευχάριστος: άνετος, είδος
τέλεια: εντελώς, όντως
συνήθως: κοινός, γενικά, τείνω
τάφος: σκληρά
σταθερός: διορθώνω, αν-και, πρότυπο, μόνιμος
στρατεύματα: στρατός
συνάντηση: συνεδρία, συνέλευση, συναντώ
στρατόπεδο: κατασκήνωση, πεδίο
έθνος: χώρα, εθνικός
ύπαρξη: παρουσία
απάντηση: απάντηση, επιστροφή-χρημάτων
ουρανός: ατμόσφαιρα, ουρανός
ίσος: ίδιο, βαθμός
τύχη: μοίρα, κατάσταση, ιδιοκτησία
πεδίο-ορισμού: πεδίο
κατάσταση: θέση, κατάσταση
μέσο: μέσο, στα-μέσα-του δρόμου, μέση
χειμώνας: κρύο
επιτρέπω: άδεια, καθιστώ-ικανό
χλωμός: κίτρινος, χρώμα, λιποθυμία, παστέλ, ανοιχτό, ελαφρης
τρέξιμο: αγώνας, τρέξιμο
θρησκευτικός: θρησκεία, χημειοθεραπεία
μόλυβδος: προκαλέσει, φέρω
κίνηση: πάτημα, επιχείρημα, κινούμαι, κίνηση, δράση
στάση: διακοπή, στάση
ομιλούμενος: λέγω, προφορικός, ομιλία
επιτροπή: αύξηση, πίνακας, συμβουλή, άκρη, επιτροπή
μάταιος: δωρεάν, αδειάζω
απώλεια: μειονέκτημα, χαμένος, διαρροή
προσφορά: υπό-την-προϋπόθεση, προτείνω, δίνω, έκθεμα, σερβίρισμα, προνόμιο
τάξη: είδος, τροχιά, τάξη
πλήρης: γεμάτος
πρόσβαση: επίσκεψη, προσέγγιση, απόκτηση
πάθος: ενθουσιασμός, συναίσθημα
φυσικός: φυσική, σώμα
παράδειγμα: παράδειγμα
αρχή: αρχή
πείσμα: θυμός
σοβαρός: εξαιρετική, σοβαρά, άκρο
ασήμι: χρήματα, Παρασκευή
επαρκής: αρκετά
κύριος: κεφάλι, κύριος, κλειδί, πρωτότυπο, κύριο-προϊόν
θαυμάσιος: παράξενος, βίαιος, εξαιρετική
μονοπάτι: τρόπος
έννοια: έννοια, μέσο, σπουδαιότητα, θέμα
κατάλληλος: κοστούμι, κατάλληλος
παρτίδα: μάζα, πολύ, μοίρα
κάθισμα: καρέκλα, πολιορκία, έδρα
παιχνίδι: χαρτοπαίγνιο, παιχνίδι
δήλωση: έκφραση, έκθεση
όνειρο: εφιάλτης, ύπνος
βράχος: γκρεμός, φούστα, πέτρα
ειδικός: ειδικά, ιδιωτικός, ειδικός
αμοιβή: δαπάνη, διόδια, πληρωμή
μερίδιο: μέρος, στοίχημα, ρόλος, διανέμω
διάδοση: λεπτομέρεια, εκτενής, σκορπίζω, λόγος
δόξα: τιμή, έπαινος
χώρος: θέση, αίθουσα, πεδίο, αστροναύτης
συνήθης: κοινός, απλός
σκεφτείτε: νομίζω, σχέση
σε-μεγάλο-βαθμό: πολύ, μεγάλα
αξιωματικός: επίσημος-ανώτερος-υπάλληλος
τιμή: πρότυπο, τιμή, πορεία
σημείο: σημειογραφία, χειρονομία, σημάδι, σημείο
ντόπιος: φύση, πρωτότυπο, κάτοικος
εργαζόμενος: υπάλληλος, δουλειά
παντρεύω: παντρεμένος
έκταση: όριο, τόμος, βαθμός
μέθοδος: τρόπος, μια-φορά, προσέγγιση
έξοχος: καλύτερα, εξαιρετική
εμπιστοσύνη: πιστεύω
ακριβώς: όντως, ειδικά, γεμάτος, εντελώς
απέραντος: εξαιρετική
φαντασία: φαντασία, όμορφος
γρήγορα: σύντομα, ευκίνητος
Ναί: ναι, έτσι
ελευθερία: δωρεάν, ανεξαρτησία
ενδιαφέρων: ισοπαλία, περίεργος
κατά-μέρος: διαχωρίζεται, πλαγίως, εκτός
καθαρός: φρέσκο, φιλαληθής
σχετικά-με: πάνω-από, για, σχέση
αποδεικτικός: απόδειξη, καταφανής
μακρινός: μακριά, μακρινός
παρόμοιος: μοιάζω, ίδιο, σύμφωνος, συγκρίσιμος
στενός: λεπτός, μικρός
εντελώς: εντελώς
σελίδα: πλευρά, αυλή
λεπτομερώς: ειδικά
βουνό: λόφος
υπερήφανος: υπερηφάνεια
σαφώς: ρητώς, ανοιχτό, καταφανής
τιμή: τιμή
άρρωστος: άρρωστος
κρίση: απόφαση, ποινή, κανόνας, δικαστής, δικαιοδοσία, κρίση
αποδέχομαι: δεκτός, ομολογώ, παίρνω
είδος: είδος
ζητώ: έρευνα
τιμή: τιμή
αυτί: άδεια
κάτω-μέρος: κάτω, πάτωμα, βάση
βοήθεια: βοηθήματα, βοήθεια, υποστήριξη
πλήρως: γεμάτος, εντελώς
απόλαυση: ευτυχισμένος, δυσάρεστος
ποσό: ποσοστό, τόμος, πλήθος, αριθμός
αποκτώ: απόκτηση, αντλώ, παίρνω
φόρος: ενοίκιο, γραμμή
σταυρός: διάβαση, πέρασμα, υπερβαίνω
ξένος: επισκέπτης, παράξενος, αλλοδαπός, άγνωστος
τολμώ: θάρρος
καλλιεργώ: αύξηση
ψευδής: ψέμα, λανθασμένος, άρρωστος, ελαττωματική
ψηλός: μακρύς, πάτωμα
πύλη: θύρα
ελευθερώς: ανεξαρτησία, δωρεάν, ανεξάρτητα, χύμα
πλήγμα: σοκ, κτύπημα, βολή, λάκτισμα
μόδα: προσέγγιση, Έλα
καθημερινά: ημέρα
διανομή: διανέμω
πλούτος: χρήματα, ιδιοκτησία
ελευθερία: δωρεάν, ανεξαρτησία
προκαταβολή: πρόοδος
ευγενής: μαλακός, γλυκός
ασφαλώς: πορεία, όντως
ασφαλής: ασφαλής, προστατεύω, διαβεβαιώνω
κατειλημμένος: αρπάζω, χαλάζι, αρραβωνιασμένος
στάδιο: πλατφόρμα, δράση, φάση, κατάσταση, σκηνή
μερίδα: μέρος, σιτηρέσιο
γλώσσα: γλώσσα, σούβλα
θυμωμένος: θυμός
μεταφορά: τρένο, καροτσάκι, σαΐτα
καιρός: κλίμα, αέρας, φορά
ανάγκη: σπουδαιότητα
πρακτική: άσκηση, δράση, έθιμο
αξίωση: αίτηση, κοστούμι
πρίγκιπας: δούκας
ομάδα: σειρά, συσφαιρώνω, σμήνος, ζώνη, πίνακας
παντού: παντού
προσθέτω: ευρύνω, επιπλέον, αυξάνω
προσεύχομαι: παρακαλώ
κύριος: επακόλουθος, κύριος
γκρί: καστανός, φλαμουριά
συχνά: συχνά, αλλεπάλληλος, μόνιμος
περίφημος: δημοφιλής, πασίγνωστος, φωνήεν
ισχυρός: εξουσία, ικανός
ζωντανός: ζω
αδύναμος: λιποθυμία, φτωχός
υλικό: περιεχόμενο, θέμα
ειλικρινής: τίμιος, αξίωμα
θερμότητα: καλοκαίρι, ζεστός
φρουρά: προστατεύω, φροντίδα
εξίσου: ισορροπία, ίδιο, επίσης
φυσικά: φύση
αξιοσημείωτος: παράξενος, ασυνήθιστα, εξαιρετική
φεγγάρι: μήνας
μικρός: λίγο, εύκολα, ελαφρης, λεπτός, μικρός
στυλ: ελαφρης
αιχμηρός: ημισφαίριο, αιχμηρός
αρχή: θεωρία, αξίωμα, αρχή
άμεσος: σύντομα, κατευθείαν
πρόθυμος: ήδη, ακροποδητί, μίλι
συνέπεια: επακόλουθος, αποτέλεσμα, σύναψη
προσφορά: μαλακός, συμφωνία, αγώνας
ενδιαφερόμενος: σκοπεύω, ενδιαφέρον
συνοικία: πόδι
προχωρημένος: πάνω-από, προς-τα-εμπρός
προφανώς: ρητώς, τάχα, φαίνομαι
ενεργός: δουλειά, δράση
ενήμερος: επίτηδες, ξέρω
επικίνδυνος: κίνδυνος, επιβλαβής, απειλή
ηρεμία: ησυχία
ιερός: θεϊκός, άγιος
βασίλειο: βασιλικός
ολόκληρος: εντελώς, όλοι, γεμάτος
όμορφη: όμορφος
συνήθεια: χαρακτηριστικός, τρόπος, έθιμο
απευθείας: καταφανής, κατευθείαν, από-προσωπική-πείρα
πράγματι: όντως, γεγονός
ακρόαση: ακούω
περίπατος: πάτημα, πόδι, πεζός
βολή: εκπέμπουν, εκμαγείο, βολή
σοφία: διανοούμενος
οδηγώ: οδήγηση, χορωδία, εκστρατεία, Σπρώξτε, τρέξιμο, δίσκος
σφάλμα: ευθύνη, λανθασμένος
υπόθεση: πράγμα, θέμα, συγγένειες
επαφή: αλληλογραφία, επαφή
σταθμός: στάση, κέντρο, εποχή
ακούω: ακούω, παρακαλώ, υπακούω
πλήγμα: βλάβη, πόνος, τραυματίας
εξπρές: έκφραση, εξηγώ
εύνοια: πλευρά, χάρη, θετός
ύψος: μήκος
μέγεθος: διαστατικός, μέγεθος, γεμάτος
έργο: δράση, δουλειά, δασμός
συμπάθεια: εμπάθεια, κρίμα
ντυμένος: φόρεμα
μακρύτερα: προς-τα-εμπρός
σκάφος: όργανο, πλοίο
αγάπη: αγάπη
ταλαιπωρία: βασανιστήριο, μιζέρια, πικρός, ταλαιπωρία
σάρκα: κρέας, σώμα
μεγαλειώδης: ογκώδης, εξαιρετική
θέση: τάξη, ταχυδρομείο, μετά, στέλνω, θέση
συλλογή: συσσώρευση, σειρά, στοά, σύναψη
φαντάζομαι: φαντασία, νομίζω
άφιξη: Έλα
μεγαλόφωνος: επιμένω, εξαιρετική, σκληρά
ωραίος: όμορφος, ένδοξος
έκτακτος: παράξενος, ασυνήθιστα
συμβαίνω: ούτε
πρωινό: πρωί, μεσημεριανό
πληθυσμός: πλήθος
σειρά: αλυσίδα, σειρά
ανακούφιση: βοηθήματα, άνεση, γλύφω
εντύπωση: αποτέλεσμα, συναίσθημα, εντυπωσιάζω, αποτύπωμα
ικανοποίηση: ικανοποιημένοι
σχήμα: διαστατικός, μορφή, σχηματισμένος
γέννηση: γεννημένος
θεώρηση: ιδέα, σχέση
τακτικός: περιοδικός, αλλεπάλληλος, τακτικός
κίνηση: κινούμαι, κίνηση
απασχολημένος: αρραβωνιασμένος
ποιότητα: μάζα, βαθμός
ανακαλύπτω: θεμελιώ, έρευνα, αποκαλύπτω
μέσα: εσωτερικός, βαθύς, εντός-κτίριου
έδαφος: λάσπη, πάτωμα, μονοφωνία, χώρα
εντελώς: εντελώς
μήνυμα: πληροφορίες, νέα
φράση: έκφραση, ποινή
αναφέρω: αρσενικός
ζεύγος: δικαίωμα, ζευγάρι
τίτλος: επικεφαλίδα, κεφάλι, θέμα
κατανόηση: καταλαβαίνω, εμπάθεια
Κυριακή: εβδομάδα
τρελός: εκκεντρικός, ανόητος
απολύτως: εντελώς, αυστηρά
αργός: ησυχία
έλεος: κρίμα, χάρη
περιέχω: συμπεριλαμβανομένου, περιεχόμενο
θλίψη: λύπη, πόνος
στρατιώτης: στρατός, πιόνι
προηγούμενος: Ανατολή
εξήγηση: εξηγώ, πληροφορίες
προσευχή: αίτηση
πίστη: πιστεύω, πίστη
συνεχής: αλλεπάλληλος, πρότυπο, διορθώνω, μόνιμος
τελικός: τελευταίος, τελικά
βόλτα: ιππασία, σαφάρι, αύξηση, οδήγηση
πολιτική: πολιτικός
σχέδιο: εικόνα, ισοπαλία, σχέδιο
βαφή: θάνατος, καλούπι
ζήτηση: αίτηση, ερώτηση
ανώτερος: πάνω-από
ποσό: και, γιόγκα, αριθμός
κίνηση: κίνηση, προτείνω
βοήθεια: υποστήριξη, βοήθεια
αξιοπρέπεια: τιμή
σύλληψη: Κρατήστε, παίρνω, σύλληψη
μεταξύ: μεταξύ
ρεύμα: παρόν, ρεύμα
πιθανώς: πιθανότητα, ίσως, θα-μπορούσε-να
ξεχωριστός: διαχωρίζεται, διαφορά, μονοφωνία
χειριστός: χειρότερος, φτωχός
τρόμος: φόβος, τρομοκράτης
έλεγχος: κανονισμός, ελεγχόμενη, έλεγχος, διαχειρίζομαι
ικανός: καθιστώ-ικανό, ικανός, έμπειρος, επιδεξιότητα
εταιρεία: εταιρεία, αν-και
ανώτερος: καλύτερα
πνευματικός: διανοητικά, ηθικός, διανοούμενος
απόδειξη: αποδεικνύω, απόδειξη
σχέση: συγγένειες, έκθεση, σχέση
ενδιαφερόμενος: φροντίδα, ανήσυχος, σχετίζονται
βαθιά: βαθύς, λεπτομέρεια
τραγουδώ: ανάγνωση
φιλικός: σύμφωνος, ευγενώς, φιλία, είδος
είσοδος: θύρα, παραλαβή
προμήθεια: πλάτος, υπό-την-προϋπόθεση
καθαρός: φρέσκο, πετυχημένος
χρήσιμος: απαραίτητος, αποτελεσματικός
λεπτός: εύθραυστος, λεπτός, κομψός
αφαιρώ: απαλλάσσω, διαγράφω, ισοπαλία
επιλογή: επιλέγω, εκλογή, έλεγχος
τεράστιος: ογκώδης, εξαιρετική
ανίκανος: δεν-μπορώ, δεν, αποτυγχάνω
κάλυμμα: παλτό, συμπερίληψη, κουβέρτα, κάλυμμα, πεζοδρόμιο
διπλό: δίδυμο, δυο-φορές, ζευγάρι
νίκη: επιτυχία
συνεχώς: συχνά, αλλεπάλληλος, πάντοτε, συνεχίζω
επίπεδο: πρότυπο, κατάσταση, επιφάνεια
ελευθέρωση: εκπλήρωση, δημοσίευση, δωρεάν
τραχύς: χειρότερος, ευέξαπτο, αγενής
εμπρός: προς-τα-εμπρός, πάνω-από
συνδεδεμένος: όριο, επισυνάπτεται, σχετίζονται, κλίνω
κέρδος: απόκτηση, πλεονέκτημα
πρόσθεση: επιπλέον, συμπλήρωμα
θάλαμος: δωμάτιο, αίθουσα, κάμερα
γνωριμία: οικείος, αλφαβητάρι
λάθος: λανθασμένος
με-βάση: βάση, όροι
αυτοκίνητο: τρένο
κανείς: κάποιος, τίποτα
ενέργεια: εξουσία
γυμνός: ανοιχτό, μπαρ, ντροπή, κοίλος, φαλακρός
εν-μέρει: στα-μέσα-του δρόμου, μέρος, κάπως
χρώμα: χρώμα
ασφάλεια: ασφαλής, σωτηρία, φροντίδα
περιγραφή: περιγράφω, πληροφορίες, Περιγραφέας, ορισμός
κοιμισμένος: ύπνος
πτώση: βουτιά, πτώση, διαρροή
λαμπρός: ένδοξος, λαμπερός, εξαιρετική
σύντομος: ακρώνυμο, μικρός
γκρί: καστανός, φλαμουριά
υψηλά: πολύ
ερεθισμένος: έξαψη, ενοχλημένος
απελπισία: ματαίωση, λιποθυμία
ευκολία: άνεση, περιορίζω
σύνολο: ακαθάριστο, όλοι
καλοσύνη: αρετή, χάρη
κύκλος: κύκλος, διαμέρισμα, γύρος, τροχός
αμβλύς: οπή
πρόθεση: σκοπεύω, σκοπός
όρος: όροι, ακαδημαϊκό-εξάμηνο, διορία
πλήρως: άνετος, εντελώς
εφαρμόζω: χρήση
εργασία: δουλειά
νοημοσύνη: διανοούμενος
απεργία: επίθεση, εκπληκτικός
αρκετά: εντελώς, αρκετά, πολύ
συμμορφώνομαι: συναντώ, υπακούω, περιεχόμενο
συμβάν: περιστατικό, ευκαιρία, προβολή
μαλακά: μαλακός, ευγενώς
σύνδεση: σύνδεση, προσάρτημα, κλήση
προστασία: προστατεύω, καταφύγιο, φροντίδα
συνειδητός: άγρυπνος, επίτηδες, συναίσθημα
έκδοση: δαπάνη, αποτύπωμα, δημοσίευση, άδεια
πτήση: πουλί, μύγα, πτήση
ποικιλία: είδος, διάφορος
χώρια: διαχωρίζεται, μακριά, εκτός, ανεξάρτητα
απαίσιος: τρομερός, κρίμα
όλοι: όλοι, κάποιος
εργασία: δουλειά
εραστής: αγαπητός, φιλενάδα
τραγούδι: τραγούδι
πρόθυμος: επιθυμία, ανυπόμονος, περίεργος, ανήσυχος
απαιτώ: παρακαλώ, αίτηση, επιμένω
οποτεδήποτε: πότε
επιτυχής: επιτυχία
αύξηση: ευρύνω, ανελκυστήρας, αυξάνω, αύξηση
ανάπτυξη: πρόοδος
δροσερός: κρύο, όμορφος
δίκη: καθετήρας, διαδικασία, δικαστήριο
στο-εξωτερικό: αλλοδαπός, εξορία
αφιερωμένος: πίστη, πιστός
λογοτεχνικός: βιβλιογραφία
συγγραφέας: συγγραφέας
στοκ: ραβδί, ρόλος, δράση
τύπος: είδος, γράφω, τύπος
αφθονία: πλούσιος, πλεονασμός, αρκετά
αποφύγει: αποτρέψει
εύνοια: πλευρά, χάρη, θετός
διανοητικός: διανοούμενος, διανοητικά, εσωτερικός
στάση: ματιά, στάση, χειρονομία, προσέγγιση, εξάρτηση, παράγραφος
θαυμασμός: έπαινος
ανησυχία: ανήσυχος, φόβος, έγνοια, έξαψη
διδάσκω: ξέρω, μαθαίνω
ορατός: ξέρω
οδηγός: εγχειρίδιο, απόδειξη, οδήγηση
πραγματικός: πραγματικός, γεγονός, βασιλικός
άθλιος: ανεπαρκής, λυπημένος, δυστυχής, μιζέρια, ανήμπορος
βλάβη: κακό, επιβλαβής, βλάβη, κρίμα
Συγγνώμη: συγχωρώ, Συγνώμη, απολογούμαι, χάρη
σπάνια: μερικές-φορές
ρεκόρ: εγγραφή, δίσκος, αποθηκεύσετε
λίπος: έλαιο, πυκνός
διαμέρισμα: διαμέρισμα, επιφυλακτικός, σχέδιο
δώρο: ανταμοιβή, παρόν
ναός: σπίτι, καθεδρικός-ναός
άδεια: άδεια
συγκατάθεση: έγκριση, άδεια
επαρκώς: γεμάτος, αρκετά
πληγή: βλάβη, τραυματίας, έλκος
τολμηρός: θάρρος, γενναίος
οπουδήποτε: κάπου, παντού
μάρτυρας: απόδειξη
ανόητος: αμαθής, ανόητος
οποιοσδήποτε: κάποιος, οποιοσδήποτε
εαυτός: ιδιωτικός, εαυτούς, ίδιος
επακρώς: πολύ, ασυνήθιστα
θεραπεία: θεραπεία, φροντίδα
λαιμός: λαιμός, πτήση, αγγούρι
ασθενής: άρρωστος
ανάπτυξη: αυξάνω
ποσότητα: ποσοστό, μάζα, πλήθος, δόση, αριθμός, μέγεθος
αυστηρός: αυστηρά, βίαιος, σκληρά
δικαιολογία: συγχωρώ, λόγος, μεταβατικός, Συγνώμη
προέλευση: πρωτότυπο, φύση
ακροατήριο: παθητικός, δημόσιο
παραμένων: λείψανα
νίκη: επιτυχία
υπηρέτρια: υπηρέτης
απαλά: μαλακός, ησυχία
πραγματικότητα: γεγονός
τοποθεσία: σκηνή, δικτυακός-τόπος, σημείο
ιστίο: πλοίο, πέπλο
κατάστημα: κατάστημα, αποθήκευση, αποθηκεύσετε
παρατήρηση: αποφάνθηκε, σχέση
παύση: διακοπή
πολύτιμος: αξία
όθεν: έτσι, επομένως
φυτό: αύξηση, δέντρο, μύλος
πάγος: χιόνι
απόλυτος: γεμάτος, εντελώς
πρόθυμα: εύκολα, σύντομα
άγριος: αιχμηρός, βίαιος, σκληρά, σκληρός, αρπακτικό, άγριος
οργή: θυμός
ανακάλυψη: θεμελιώ, έρευνα, εφεύρεση, άνοιγμα
συγγενεύων: σχετίζονται
τιμωρία: ποινή
ελαφρώς: λίγο, εύκολα, κάπως
μυστηριώδης: μυστικό, ασαφής, αόρατος
σκιά: σκιά, τόνος, απόχρωση
δολοφονία: σκοτώνω
συγκίνηση: συναίσθημα, παθιασμένος
καταστροφή: καταστροφή, καταστρέφω
φρίκη: φόβος
τοπικός: σε-τοπικό-επίπεδο, εσωτερικός, σημείο
σειρά: διάφορος, απόσταση, σειρά
πλήθος: στρατός, επισκέπτης, πλήθος
υγρός: βροχή, υγρασία
μυστήριο: μυστικό
κατέχω: ίδιος, αρκούδα
συνείδηση: λογική, συναίσθημα, συνείδηση
προηγουμένως: πριν
παραγωγή: παράγω
κατάστρωμα: γέφυρα
περιουσία: ιδιοκτησία
βασιλεία: βασιλιάς, βασιλεία
συμμόρφωση: ακολουθώ, προσαρμογή
δικός-της: του
ατυχής: δυστυχώς, σύμπτωση, δυστυχής, κρίμα, ανεπαρκής
λουλούδι: ξοδεύω, ενδιαφέρον, λάσπη
ευχαριστώ: ευχαριστώ
ανήκω: ιδιοκτησία, συμπεριλαμβανομένου
αγορά: αγορά
καπάκι: καπέλο, φελλός
ευχαριστημένος: ευτυχισμένος
νοικοκυριό: οικογένεια, σπίτι
στόλος: πλοίο, ναυτικό, φλοτέρ
μωρό: παιδιά, κούκλα
περιοχή: πεδίο
ακριβής: αλεύρι, κατάλληλος, γεμάτος, προσεκτικός
εικόνα: εικόνα
υποψία: αμφιβολία, ύποπτος
απορρίμματα: αρνούμαι, βέτο, απόβλητα
ευθύνη: δασμός, ευθύνη
ντροπιασμένος: ντροπή
γεύμα: τροφή, φάω, αλεύρι
κατάσταση: θέση, κατάσταση
υποδεικνύω: εισάγω, προβολή
ποίημα: ποίηση, τραγούδι
σηκώνομαι: αναδύομαι, αύξηση
ταξίδι-στη-θάλασσα: σαφάρι, εκστρατεία
παραβρίσκομαι: ενώνω
διαθέτω: αγορά, δίνω, αρκούδα
προσφέρω: συμβάλλει, δίνω
δουλειά: δουλειά
προχωρώ: συνεχίζω, αυξάνω, πρόοδος, πέρασμα
μετανιώνω: Συγνώμη
κίνδυνος: κίνδυνος
ταχύς: σύντομα, ευκίνητος
σαφής: διαχωρίζεται, διαφορά
δεόντως: κατάλληλος, άνετος
φήμη: έπαινος
ενικός: ενωμένος, μονάδα
σφάλμα: λανθασμένος
φήμη: έπαινος
έφεση: ισοπαλία, κλήση
έλλειψη: τομή, ελαττωματική, απουσία
βία: βίαιος
καθιστώ: κάνω, παρουσιάζω, δίνω
καριέρα: επάγγελμα, δουλειά
σχέδιο: σύλληψη, σχέδιο
πρόταση: ποινή, προτείνω
αρθρώνω: προφέρω, γεμάτος
ανάλυση: απόφαση, σύναψη, ανάλυση, ευρύνω
εφεδρικός: εναλλασσόμενος, επιπλέον, αντικαθιστώ, δόρυ
οικιακός: εμφύλιος, εσωτερικός, κάτοικος, εθνικός
αναφορά: αναφορικός, μνήμη
υπάρχω: παρουσία, παρόν
θέμα: προβληματικός, όροι, ταλαιπωρία, θέμα, ερώτηση, εκπομπή
χορήγηση: υπό-την-προϋπόθεση, δίνω
φλόγα: φωτιά
άγνοια: αμαθής, αγνοώ
ενίοτε: μερικές-φορές, αλλεπάλληλος
πέταγμα: μύγα
πανί: ύφασμα, ρούχα
κέρδος: πλεονέκτημα
τέταρτος: τέσσερα, Τετάρτη, δωμάτιο
κουδούνι: τρομάζω, ώρα
όφελος: πλεονέκτημα
κεφάλαιο: θύρα, μέρος, κεφάλι, εποχή, κεφάλαιο, εαυτούς
τρύπα: οπή, λάκκος
λογικός: κατάλληλος, σοφός, λογικός
ζάχαρη: μέθη, τρόπος
αντικατάσταση: αντικαθιστώ, αντί, επίδομα, εναλλασσόμενος, ανταλλαγή
ώθηση: επιμένω, πλέκω, πληρωμή, Σπρώξτε, ώθηση
πλαίσιο: κλίμακα, νομικός, βολή
ουσία: θέμα
e-mail: στέλνω
διαίρεση: μέρος
σκλαβιά: δούλος
στίχος: ποίηση, παράγραφος
πιθανός: ίσως
επώδυνος: πικρός, πόνος
πάντα: πάντοτε, αιώνιος
ωκεανός: θάλασσα
όπισθεν: μετά, πίσω, αντίστροφο
ηγέτης: κεφάλι, διευθυντής, αγωγός, εγχειρίδιο
οξύς: σκοπεύω, ανήσυχος, αιχμηρός
τύχη: μοίρα
φαινόμενος: καταφανής, αξίωμα
βιασύνη: σύντομα, μοσχάρι
σχέδιο: σχέδιο, ριγέ, διάγραμμα
άχρηστος: απόβλητα
ωστόσο: αν-και, παρ-'όλα-αυτά
λείος: μαλακός
στερεός: εκδηλωτικός, καθιερωμένος, αν-και, συμπαγής
αναγκαίως: πρέπει, απαραίτητος
οικοδομώ: δημιουργώ, κτίριο, διατύπωση
απόπειρα: δοκιμή, μαχαιριά
ισοδύναμος: ίδιο
πρόσφατος: πρόσφατα, σύγχρονος, τελευταίος
ταξίδι: επίσκεψη, τουρισμός
μεσημέρι: απόγευμα, νότος
που-βρίσκεται: πτώση
ανακοίνωση: διαφήμιση
παύω: αποτρέψει
περίσταση: κατάσταση, φάκελος
σκηνή: καμπίνα, σκηνή
συχνάζω: αλλεπάλληλος, συχνά
μεγαλόφωνως: φωνή
ανεξάρτητος: ανεξαρτησία, χύμα, ανεξάρτητα
ουσιώδης: απαραίτητος, κύριο-προϊόν
παρατήρηση: παρατηρώ
ευγνωμοσύνη: ευχαριστώ
διατηρώ: διατηρώ, αποθήκευση, προστατεύω
άποψη: στοιχείο, πλευρά
φόβος: φόβος, φοβία, έντρομος
έξυπνος: έμπειρος, σοφός
περιοχή: ζω
αποτυχία: αποτυγχάνω, λανθασμένος, πτώχευση, αποτυχία
σεντ: σεντ, τοις-εκατό, εκατό
συναίσθημα: συναίσθημα
μέσο: μέσο
απελπισμένος: λιποθυμία
ένωση: ΣΥΜΜΑΧΙΑ, ενωμένος
χορήγηση: ομολογώ
επιτυχία: πολλαπλασιάζω, λάκτισμα, επιτυχία
τεράστιος: εξαιρετική, ογκώδης
καταδίκη: ποινή
πυρετός: φωτιά, γρίπη
κέρασμα: θεραπεία, διαδικασία, θεραπεύω
δικός-μας: άνοιξη, μας
εσφαλμένος: λανθασμένος, κατάχρηση, ελαττωματική
ιδανικό: καλύτερα
βιασύνη: πλήθος, κτύπημα
σωστός: κατάλληλος, δικαίωμα, πιστός, διορθώνω
εκτελώ: προβολή, κάνω
κάπως: κάπως
έννοια: σύλληψη, έννοια, ιδέα
συζήτηση: συζητώ, επιχείρημα
σταθερά: καθιερωμένος, αν-και
σταθερός: πρότυπο, διορθώνω, συνεπής, μόνιμος
αυτοκρατορία: βασιλικός
στυλό: μολύβι, κεφάλι
άδεια: άδεια
διατηρώ: Κρατήστε, προστατεύω, διατηρώ
συνωστισμένος: πλήθος, πυκνότητα
περιορισμός: όριο, συγκράτηση
φρικτός: τρομερός
λιμάνι: λιμάνι, θύρα
έμπειρος: εμπειρία, έμπειρος, ειδικός
αντίθετος: αντιπολίτευση, απέναντι, προς, αντίθετος
συνθήκη: υπόμνημα, συμφωνία
συμβούν: Έλα
αναζητούν: ικετεύω, έρευνα
πρακτικά: σχεδόν, όντως, πρακτικός
ίχνος: σημάδι, βέτο
χαρούμενος: ευτυχισμένος, εύθυμος
συμφωνία: παραγγελία, διάθεση, οργανωμένος, συμφωνία
δυτικός: Δύση
πίεση: έμφαση, αποτύπωμα, Σπρώξτε, βάρος
πολιτική: πολιτικός
επιστημονικός: επιστήμη, επιστήμονας
αξία: έπαινος, έχω-τα-προσόντα, αξία
συνέντευξη: επίσκεψη, ερευνητή
έδαφος: πεδίο
φύλο: πέος, σεξουαλικός, έξι
δημιουργία: δημιουργώ, διατύπωση, καθιερωμένος
μονοπάτι: σημάδι, εκλογή, τρόπος
προοπτική: ελπίδα, πιθανότητα, όραμα, σκηνή
λειτουργία: τάση, διαδικασία, δράση, χειρουργός
βαθύς: βαθύς
αγώνας: χαρτοπαίγνιο, συμπίπτω, σύμπτωση, αγώνας
στολή: φόρεμα
χρέος: ευθύνη, θρησκεία, δασμός, πίστωση
τόλμημα: περιπέτεια, επένδυση, εταιρεία
εκτέλεση: δράση
διάθεση: συναίσθημα, χιούμορ, διάθεση
πλήρωμα: προσωπικό
αντιλαμβάνομαι: καταλαβαίνω, σύλληψη, βλέπω
δηλώνω: εξηγώ
έκδοση: αντίγραφο, κύτταρο
περιττός: παράξενος, ασυνήθιστα
ευγνώμων: ευχαριστώ
άπειρος: αιώνιος, απαρέμφατο
ασφάλεια: ασφαλής, φροντίδα
λογικός: σοφός, λογικός, ευαίσθητος
εξοχικό-σπίτι: καλύβα, καμπίνα
χωρητικότητα: ικανός, επιδεξιότητα, τόμος
εγκαθιστώ: διαμονή
εμπλεγμένος: αρραβωνιασμένος, ενώνω
συμβούλιο: συμβουλή
εξέταση: καθετήρας, έλεγχος, επιλέγω
ατσάλι: σίδερο
δοκιμή: έλεγχος, δοκιμή
φιλανθρωπία: αγάπη
υπόστεγο: χύνω, εκμαγείο
ανακοίνωση: αλληλογραφία, συγγένειες
κάποιος: οποιοσδήποτε, πρόσωπο, κάποιος
σειρά: γραμμή, τακτικός, σειρά, κυβέρνηση, παραγγελία
φτώχεια: φτωχός
έντονος: άκρη, άκρο, βίαιος
φιλονικία: πάλη
διαθέσιμος: υπό-την-προϋπόθεση, παρόν
αντίσταση: αντιπολίτευση
ασυνήθης: ασυνήθιστα, κοινός
έρημη: εγκαταλειμμένος, έρημος
ψήφος: επιλέγω, φωνή
υποφέρω: αρκούδα, υποστηρικτής, τελευταίος, υποφέρω
πετυχαίνω: επιτυχία
πόδι: πόδι, οστό
προσφορά: προτείνω, αίτηση
εσωτερικό: εσωτερικός
αβασάνιστα: εύκολα, ελαφρης
απεικόνιση: προβολή, έκθεμα, οθόνη, σκηνή, απόδειξη
περιορισμένος: περιωρισμένος, μόνο
σκοπός: σκοπός, εστία
κρίσιμος: απαραίτητος, κριτικός
τσάντα: τσέπη, σάκος, καλάθι
επαναλαμβάνω: επανάληψη, πίσω, αλλεπάλληλος
πίστα: μηνυτής, τραγούδι, τρόπος, ακολουθώ
κατοικία: καταφύγιο
διασκέδαση: ευτυχισμένος, εύθυμος, ψυχαγωγία
υπερασπίζω: προστατεύω
βαριά: βάρος, σοβαρά
υλικό: περιεχόμενο, εμπορεύματα, πράγμα
τμήμα: μέρος, ανατομή
επίλυση: συμφωνία, καταφύγιο, κανονισμός
πλάκα: πίνακας, δίσκος, ντίσκο
καταβάλλω: αντιμετωπίζω, υπερβαίνω, ρυθμός
λόγους: λόγος, όροι, μοτίβο
μάρμαρο: πέτρα
ικανότητα: ικανός, επιδεξιότητα, ταλέντο
κύμα: παλίρροια, ασαφής
παραδοσιακός: ένα-άνθρωποι, δημοφιλής
δυνατότητα: πιθανότητα, ικανός
βούτυρο: έλαιο
έχθρα: περιφρόνηση, μισώ
επιδίωξη: έρευνα
Τραβήξτε: ισοπαλία, ψαλίδι
σύνθημα: χειρονομία, σημάδι, σύνθημα
ασφάλεια: ασφαλής
έγκαυμα: κάηκε, καπνός
μάθημα: εκπαίδευση, θέμα, πορεία
ετήσιος: έτος
κάρτα: χαρτόνι, χάρτης, μικρός, χαρτί
εφαρμογή: χρήση, λογισμικό, αίτηση
έξυπνος: διανοούμενος, σοφός
κομητεία: μποϋκοτάζ, περιφερειακός, πόλη, χώρα
μορφή: μορφή, εκμαγείο
ροή: ρεύμα
βλάβη: καταστροφή, βλάβη, κρίμα
εξάλλου: επιπλέον, ακόμη-και, περισσότερο
εμπόριο: εμπόριο
νότιος: νότος
εξωτερικός: έξω
μέσος: δευτερεύων, μέσο
γυμνός: ντροπή
φανερός: καταφανής, ανοιχτό, αξίωμα
θεμέλιο: βάση, πλατφόρμα
ανησυχία: φροντίδα, ανήσυχος, σχετίζονται, ενδιαφέρον, έγνοια
μαγεία: γοητεία
εκστρατεία: κίνηση, εκστρατεία
φιλελεύθερος: γενναιόδωρος
συνήθως: κοινός, συχνά, γενικά
κυνήγι: κυνήγι
δάσκαλος: συγγραφέας
σύντομα: σύντομα, μικρός, σχεδόν
ευλογία: ευλογώ
μικροσκοπικός: λίγο, μικρο
απότομα: ταχύτητα, αιχμηρός, σοβαρά
στήθος: στήθος
βάθος: βαθύς
εκτέλεση: προβολή, παραγωγικότητα
ευημερία: κόσμημα, επιτυχία, ευημερία
υπάλληλος: υπάλληλος, επίσημος-ανώτερος-υπάλληλος
αποφασίζω: απόφαση, αποφασισμένος, αποφασιστικός, διαλυτό
θύμα: κυνήγι, θυσία, διόδια
κίνητρο: σκοπεύω, μοτίβο, μοτέρ, σκοπός, κίνητρο
σαφής: αποφασισμένος, καταφανής
τάση: χαρακτηριστικός, μίλι, διάθεση, τάση
φινίρισμα: πεπερασμένος, χρώμα
σημαία: σημαία, ξέρω
διαχείριση: κανόνας, διαχειρίζομαι
σπανίως: σπάνιος
γνήσιος: πραγματικός, πρωτότυπο
εκπαίδευση: εκπαίδευση, διδασκαλία
άσχημα: λανθασμένος, πολύ, χειρότερος, κακό, άρρωστος
τροφή: φάω, θετός, τροφή
κεντρικός: κέντρο, ομοσπονδιακός
αντίθεση: αντίθετος, αντιπολίτευση, σύγκρουση
δομή: κτίριο, κατασκευαστικός, οργάνωση
πληρωμή: πληρωμή
βήμα: ταχύτητα
έρευνα: καθετήρας, αίτηση, έρευνα
οπουδήποτε: που
οφείλω: ένοχος, δασμός
λαβή: διαδικασία, διαχειρίζομαι, αντιμετωπίζω, χειρισμός
ταξίδι: επίσκεψη, σαφάρι, sightsee, εκστρατεία
βλαστός: βολή, εξορία, εκπέμπουν
εργασία: άνεργος, έγνοια, δουλειά
τομή: τομή
αντιστέκομαι: αντιπολίτευση
καθορίζω: determiner, αποφασισμένος, αποφασιστικός, επιβάλλω, διορθώνω
έμπορος: έμπορος, επιχειρηματίας, εμπόριο
ζωηρός: ζω
αεράκι: αέρας
σχετικός: εξάδελφος
εκ-τούτου: έτσι
πρόβλεψη: παρουσιάζω, υπό-την-προϋπόθεση, ευημερία, κατανομή, διάθεση
όσο-αφορά: για, σχέση
διαλέγω: επιλέγω, παίρνω
ξεπεσμένος: καταστρέφω
παραδίδω: δίνω, παρουσιάζω
απροσδόκητος: έκπληξη
γραφείο: τραπέζι, γραφείο
μονοπάτι: γραμμή, ζώνη
εκπροσωπώ: εκπρόσωπος, παράδειγμα
αξιοσέβαστος: τιμή
ευθύνη: δασμός, ευθύνη
απογοητευμένος: φιλοδοξία, απογοητευτικά
κατάλληλος: συμπίπτω, κατάλληλος
εξαρτώμαι: εξάρτηση, όριο
γίγαντας: εξαιρετική, Τέρας
πιάσιμο: καταλαβαίνω, αρπάζω
φθάνω: Έλα, κατορθώνω
απλότητα: απλός, ταπεινότητα
φθινόπωρο: πτώση
απών: απουσία, μακριά
κατήφεια: σκοτάδι
ύποπτος: εικασία, αμφιβολία, ύποπτος
αποφασιστικότητα: αποφασισμένος, απόφαση, έκθεση, ορισμός
βάση: βάση, όροι
εξετάζω: παρατηρώ, έλεγχος, ανάλυση
βραβείο: ανταμοιβή, ασφάλιστρο
αγορά: αγορά
κάποιος: πρόσωπο, κάποιος, αν-και
αντιλαμβάνομαι: κατορθώνω, καταλαβαίνω
ήττα: ρυθμός, κολιέ, αποτυγχάνω
εγκληματίας: αίμα
ανόητος: ανόητος, αμαθής
ανάκληση: θυμάμαι
κατοχή: επιδρομή, επάγγελμα, επαγγελματικός, επιθετικός
ομιλία: σύγχρονος, ομιλία
βοηθώ: βοήθεια, υποστήριξη, συνεργασία
πώληση: δημοπρασία, πωλώ, έκπτωση
πρόσκληση: καλώ, κλήση
κατώτερος: ανεπαρκής, κάτω, χειρότερος
αναγνωρίζω: ομολογώ, διάγνωση
πορτρέτο: εικόνα
προτείνω: προτείνω, υποθέτω
απογοήτευση: ματαίωση, φιλοδοξία, απότομη-πτώση, απογοητευτικά, κόμης
κατασκευή: κτίριο
ζήλος: ενθουσιασμός, επιμέλεια
υπεύθυνος: δασμός
θεραπεία: θεραπεία, θεραπεύω, φροντίδα
συμπεριλαμβάνω: συμπεριλαμβανομένου, εισάγω, συμπερίληψη, καταλαβαίνω, περιεχόμενο
ικανοποιώ: συναντώ, ικανοποιημένοι, περιεχόμενο, ικανοποιώ
αγωνία: πικρός
ηλίθιος: εκκεντρικός, αμαθής, ανόητος
απόλαυση: απολαμβάνω
απόκρυψη: κρύβω
ακριβώς: κατάλληλος, γεμάτος
υποθέτω: ικετεύω, υποθέτω, σχέση
εκτίμηση: εκτίμηση, εικασία
διαδρομή: τρόπος
επισκέπτης: ταξιδιώτης, επισκέπτης, παρατηρητής
μη: δεν
σύρμα: γραμμή
κυρίως: ειδικά, μεγάλα
αναίσθητος: λιποθυμία
αμοιβαίος: κάθε---άλλο, κοινός
εξωτερικός: έξω, αλλοδαπός
σύμπαν: σύμπαν, κόσμος
ρολόι: ώρα
εντολή: διδασκαλία, κατεύθυνση, εγχειρίδιο
πληγή: έλκος, άρρωστος, πόνος
πειθαρχία: θέμα
εισαγωγή: παρουσιάζω, υπό-την-προϋπόθεση, προαγωγή, αλφαβητάρι, εισαγωγή
ερημιά: έρημος
ταραγμένος: νευρικός, ματαίωση
γάμος: παντρεμένος
χάρη: εκπρόσωπος, πλευρά, χάρη, μέρος
υπολογίζω: πιστεύω, λογαριασμός, κόμης
αβέβαιος: αβεβαιότητα, ασταθής, ασαφής
σύμπλεξη: αρραβωνιασμένος, υποψηφιότητα
βρώμικος: εκπομπή, ακαθάριστο
γιατρός: γιατρός
κάλυμμα: σκεπαστός, συμπερίληψη, στέγη, κάλυμμα
ειλικρινής: τίμιος, όντως, φιλαληθής
αίσθηση: συναίσθημα
ειδικός: ειδικά, ιδιωτικός, ειδικός
πανδοχείο: ξενοδοχείο
δύσκαμπτος: σκληρά
συνοδεύω: ακολουθώ
σκορ: σημάδι, έκθεση
παρθένα: κόρη
πείνα: πεινασμένος
ευνοούμενος: ευνοούμενος
τελωνείο: παράδοση, ίντσα, δασμός, έθιμο
εντυπωσιασμένος: συναίσθημα
λεία: κυνήγι, λάφυρο, θυσία
μιούζικαλ: μουσική, μουσικός
ικανοποιητικός: ασθένεια
γελοίος: αμαθής, εύθυμος
σεντόνι: χαρτί, φύλλο, φυλλάδιο
ντροπή: ντροπή
αρχικά: πρωτότυπο
μισθοί: πληρωμή
εκτενής: εκτενής, βαθύς
ελεύθερος-χρόνος: ψυχαγωγία, αδειάζω, αποσύρω, χαλάρωση
πηγούνι: γενειάδα
λάμψη: αντηλιά, ελαφρης, ακτινοβολία, λάμψη
ζήλια: ζηλιάρης
σιδηροδρομικός: σιδηρόδρομος, τρένο
λίβρα: βιβλίο
ανατολικός: Ανατολή
πολίτης: εμφύλιος
παραλία: ακτή
χαρακτηριστικό: στοιχείο, χαρακτηριστικός, ιδιοκτησία
απόθεμα: διατηρώ, βιβλίο
βρυχηθμός: θόρυβος
παραδοξώς: παράξενος
φλοιός: φλοιός, δέρμα
ρεσεψιόν: καλωσόρισμα, παραλαβή
ευχάριστος: δυσάρεστος, είδος
ίχνη: άγρυπνος
έρευνα: ανάλυση, έρευνα
μονάρχης: αυτοκράτορας, βασιλιάς
ενδύματα: ύφασμα, φόρεμα, ρούχα
ασθένεια: ασθένεια, άρρωστος
αστείο: αστείο, ειρωνεία, γέλιο
σχόλιο: εξηγώ
μέταλλο: σίδερο, ορυκτό
λύση: διορθώνω, απόφαση, απάντηση
καπνός: τσιγάρο, καπνός
οντότητα: όργανο, μονάδα, παρουσία, οργάνωση, εταιρεία, πρόσωπο
παρεκκλίνω: αναχώρηση, εκτρέπομαι, ρωγμή, πάω
διαιτητή: πικρός
ειρηνικός: ησυχία
ανησυχεί: ανήσυχος
τέχνασμα: νεοσύλλεκτος, πάτημα, ανόητος, χειρισμός, πονηριά
οικονομικός: χρήματα, οικονομικός
παρασκευή: προετοιμάζω
κέλυφος: φλούδα, φλοιός, δέρμα
φωλιά: ζω, υποδοχή
συλλαμβάνω: σύλληψη, καταλαβαίνω, νομίζω
ραντεβού: υποψηφιότητα, υπόσχεση
φέρω: φέρω, ανακτώ, παίρνω
κερί: ελαφρης, κερί
αδίκημα: επίθεση, έγκλημα, μάζα
μίγμα: μικτός
μοντέλο: παράδειγμα
ελάττωμα: ευθύνη, ρυτίδα, αναπηρία
ένσταση: διαφωνία, αντιπολίτευση, αντίφαση
σκάφος: τέχνη, επαγγελματικός, επιδεξιότητα
παραμέληση: αγνοώ, εγκαταλειμμένος, παράλειψη, μποϋκοτάζ
δεδομένα: πληροφορίες
όπλο: όπλα, όπλο
ροζ: τριαντάφυλλο
μεταχειριζόμενος: για, δικαιούχος
παππούς: πρόγονος, παππούς-και-γιαγιά
μηδενικό: μηδέν, αδειάζω
σθεναρός: βίαιος
αστραπή: ηλεκτρονικός, μπουλόνι, λάμψη
άθλημα: κίνηση, άσκηση
σκόνη: αλεύρι, σκόνη
ζωγραφική: εικόνα, πίνακας
κραυγή: θόρυβος, μαχαίρι, κραυγή
απρόσεκτος: ριψοκίνδυνος, αδιαφορία
παραγωγό: αντλώ
άνοιγμα-της-πόρτας: θύρα
βολικός: απλός, πρακτικός, άνετος, εύκολα, κατάλληλος
ταχυδρομείο: ταχυδρομείο, επιστολή
χρώμα: χρώμα
παράδοση: παράδοση
ιδρύω: παρουσιάζω, καθιερωμένος, διορθώνω
ήπιος: μαλακός, ελαφρης
ταχέως: μια-φορά, κατάλληλος
τμήμα: μέρος
αξίζω: αξία, έχω-τα-προσόντα
εγκαταλείπω: εγκαταλειμμένος, αναδύομαι, ρωγμή, εκμαγείο
διαβεβαίωση: διαβεβαιώνω, εγγύηση
καθρέπτης: ποτήρι
οικόπεδο: συνωμοσία, σχέδιο, ιστορία
προς-τα-άνω: περισσότερο
δυστυχώς: λυπημένος, δυστυχώς
μετριόφρων: κοινός, απλός, ταπεινότητα, ολιγαρκής
πιάτο: δικαστήριο, τροφή, φάω
καθαρά: ιστός, φιλαληθής, άγιος
ζεστασιά: ενθουσιασμός, ζεστός
ανήσυχος: ανήσυχος
πείραμα: πιλότος, εμπειρία, δοκιμή
σήμερα: ημέρα
καταπληκτικός: τρομερός, εξαιρετική, ογκώδης, πολύ
βελτίωση: μεταρρύθμιση, επισκευή, πρόοδος, ανάκτηση, θεραπεύω
διαμάχη: διαφωνία, επιχείρημα
πρόταση: προτείνω, ποινή
ίσως: ίσως, θα-μπορούσε-να
τουφέκι: όπλο
ασπίδα: προστατεύω
χρησιμοποιώ: ενοίκιο, χρήση
διαφορετικός: διάφορος
ανακτώ: αποθηκεύσετε, ανακτώ, ανάκτηση
σύντροφος: σούβλα, συνάδελφος, φίλος
κανονίζω: παραγγελία, νομοθετώ, οργανωμένος
επιτροπή: πίνακας, επιτροπή
ηλικιωμένος: παλιός
φάντασμα: ψυχή
αποκάλυψη: έκφραση
αναγνώριση: ομολογώ, ομολογία
πηλός: λάσπη, τυφλοπόντικας
κορμός: φυλή, αποσκευές, μπότα
διαχείριση: διαχειρίζομαι, οδήγηση
επαναφέρω: διατηρώ, πίσω, ανάκτηση, ανακτώ
διαμαρτυρία: αντιπολίτευση, Μάρτιος
σωρός: σκουπιδότοπος, στοίχημα, πλήθος
μέτριος: δευτερεύων, μέσο
σημαίνω: γοητεία, ορθογραφία
έκταση: πεδίο, περιφερειακός, επιφάνεια
επίσημος: επίσημος-ανώτερος-υπάλληλος
συντάκτης: συγγραφέας, εκδότης
αναγνωρίζω: ομολογία, ομολογώ
θεραπεία: φάρμακο, θεραπεία, διορθώνω
επιδιώκω: ικανοποιώ, μηνυτής, ξοδεύω, ακολουθώ
Πόλος: Συγνώμη, στήλη, άκρο, ομφαλός
ζωτικός: απαραίτητος, αποφασιστικός, κλειδί
πρόεδρος: κεφάλι
πτέρυγα: πτέρυγα, περιφερειακός, μέρος
κυρία: 
ευθυμία: καρδιά, ενθουσιασμός
δικαιολογείται: λογικός, δικαίωμα, δικαιολογώ
θαυμάζω: έπαινος
φανερά: ρητώς, ανοιχτό, άνοιγμα
τροποποίηση: αλλαγή, προσαρμογή
δραματικός: δράμα, εκδηλωτικός
επάνω: πάνω-από, χειρότερος
ποικίλος: διάφορος
κατάβαση: φύση
ζηλεύω: ζηλιάρης
φορτίο: βάρος, ένταση, μπαρ, φυλή
προσποιούμαι: προσποιούμαι, δράμα
εσωτερικός: εσωτερικός
κουρτίνα: πέπλο, οθόνη
υγιής: υγεία
σκοτεινός: ασαφής, έκλειψη
κέντρο: κέντρο
διαγωνισμός: αγώνας
αλλάζω: μετατρέπω, αλλαγή, αντικαθιστώ
ματιά: ματιά, όραμα
σύμβαση: υπόμνημα, παραγγελία, Κρατήστε, συμφωνία
οικονομία: αποθηκεύσετε, αποθήκευση, οικονομολογία
σειρά: σκοινί, αλυσίδα, σειρά
συνδυασμός: σύμπτωση, μικτός, σειρά, κλήση
σύλληψη: στερεώνω, σύλληψη
θερμοκρασία: ζεστός
αυστηρός: αυστηρά, αιχμηρός, σκληρά
επαγγελματίας: επάγγελμα, επαγγελματικός
τραυματίας: τραυματίας, βλάβη
γειτονιά: περιβάλλων, ζω, περιβαλλοντικές
κάπνισμα: καπνός, τσιγάρο
ιατρικός: γιατρός
πληροφορώ: εφημερίδα
διακεκριμένος: δημοφιλής, αξιομνημόνευτος, επακόλουθος, κλειδί, πασίγνωστος
ίδρυμα: οργανωμένος, εταιρεία, οργάνωση
πακέτο: κάλυμμα, κλειστός, συσκευασία
αγωνία: πικρός, μιζέρια, πόνος, λύπη
προφανώς: καταφανής, ανοιχτό, ρητώς
σύλληψη: σαγηνεύω, παίρνω, σύλληψη
επαρκής: αρκετά, ανεπαρκής
υπνοδωμάτιο: δωμάτιο
καθαρώς: μόνο, εντελώς, άγιος
άρθρωση: κοινός, μικτός, κλήση
αναφέρομαι: αναφορικός, συμβουλεύομαι
αναγνωρίζω: ταυτότητα, αναγνωρίσιμα, διορθώνω
παγκάκι: τράπεζα
διάσωση: ανάκτηση, αποθηκεύσετε
όριο: όριο, μειώνω
προσδοκία: αναμένω
πρόγραμμα: σχέδιο, ημερήσια-διάταξη
ηλεκτρικός: ηλεκτρονικός
διάστημα: προσωρινός, διακοπή
κυνηγητό: κυνήγι
ασχολούμαι: παίρνω, αρπάζω
φόρεμα: παλτό, φόρεμα, κοστούμι
κλειδαριά: κάστρο
πρόταση: προτείνω, ποινή, σχέδιο, σύναψη
ευτυχώς: ευτυχισμένος
μεταγενέστερος: επόμενος
ανήσυχος: ασταθής, δυσάρεστος, ανήσυχος, σκληρά
λάμψη: αντηλιά, λάμψη
μηχανήματα: μηχανικός, μηχανή, μηχανισμός
ελκυστικός: μαγνητικός, ισοπαλία, επιθυμητός
προϊόν: εμπορεύματα
ασθένεια: ασθένεια
μηχανή: μοτέρ, μηχανή
δικός-τους: αυτοί
δέρμα: δέρμα
λεπτός: μικρο, λεπτός
κλίση: μίλι, βουτιά, κλίση
ανησυχία: ανήσυχος, έγνοια
βιαίως: σκληρά
καθορίζονται: αποφασισμένος
ξυλεία: ξύλινος, ραβδί, δέντρο
υπολογίζω: λογαριασμός, κόμης
φόνος: σκοτώνω
αστείος: παράξενος, εύθυμος
προσβολή: περιφρόνηση, ντροπή
ανίκανος: ικανός
γευματίζω: φάω
ευαίσθητος: ευαίσθητος, κλειδί
όρεξη: επιθυμία
ευγένεια: ευγενικός, τιμή
σφαίρα: πεδίο, μπάλα, περιφερειακός
τιμητικός: τιμή
ενοχή: ένοχος, έγκλημα, ευθύνη, αμαρτία
νόστιμο: γευστικός, γεύση
σιτάρι: λαογραφία, σιτηρά, καλαμπόκι
χιούμορ: χιούμορ
συνάντηση: αντιμετωπίζω, συναντώ, ημερομηνία
λυκόφως: αυγή
πάρκο: κήπος
οικονομία: οικονομικός, οικονομολογία
κυβερνώ: διαχειρίζομαι, κανόνας, κύριος
σχηματισμός: εκπαίδευση, διατύπωση
άπαχος: μίλι, λεπτός
χτύπημα: διστάζω, ελαφρό-κτύπημα, ρυθμός
ενότητα: ενωμένος, μονάδα, αλληλεγγύη
μείζων: πρωτοπόρος, κλειδί, μητρική-εταιρεία, εξαιρετική, κύριο-προϊόν
προκαταρκτικός: άνοιγμα, πρωτότυπο
σύνορο: όριο, άκρη
αναπνέω: αναπνοή
εξαιρώ: δωρεάν, απαλλάσσω, συγχωρώ
πλούσιος: πλούσιος
έμπνευση: ώθηση, εμπνέω
καθένας: όλοι
άφθονος: πλούσιος
ζωγράφος: καλλιτέχνης
γυαλιά: ποτήρι
κυνήγι: βολή, κυνήγι
κάρο: τρένο, καροτσάκι
δανείζω: δίνω, πίστωση, παραθέτω
αναλαμβάνω: αρχή, κάνω
σφραγίδα: δαχτυλίδι
κλήρος: παπάς
βουνό: εγκαταστήσουν, αυξάνω, λόφος
παράταξη: στήλη, σειρά, παραγγελία
περιοδικό: τύπος
δριμύς: σκληρά, αυστηρά
παρά: αν-και
σφιχτός: αυστηρά
τοπίο: σενάριο, περιβαλλοντικές, όραμα
εγκαταλείπω: εγκαταλειμμένος
καλλιτεχνικός: τέχνη
κυρίως: ειδικά, μεγάλα
πιστός: πίστη, τίμιος, πιστός
κατάλληλο: σύμφωνος, συμπίπτω, κατάλληλος
συμβουλεύω: συμβουλή, σύμβουλος
σταθερός: καθιερωμένος, αποφασισμένος, πρότυπο
ανώτατο-όριο: αυξάνω-στον-ανώτατο βαθμό, άκρο
διαπράττω: υπόσχεση, κάνω
επηρεάζω: αποτέλεσμα, εντυπωσιάζω
χωρικός: γεωργός
πολύ: πολύ, επακόλουθος
επεκτείνω: λεπτομέρεια, ευρύνω, τέντωμα
προσωπικά: μεμονωμένα, ιδιωτικός, ίδιος
ηθική: ηθικός
επανάσταση: επαναστάτης, επανάσταση
νήμα: γραμμή, γνέθω
χαλκός: ορείχαλκος
απάντηση: αντίδραση, απάντηση
αυτοκρατορικός: βασιλικός
κενό: αδειάζω, κοίλος, άσπρο
ανήλικος: δευτερεύων, λίγο, μεταλλωρύχος
παζάρι: εμπόριο, ευκαιρία
κούραση: κουρασμένος, ένταση
αντιπάθεια: περιφρόνηση, μισώ, απροθυμία
κανονικός: κοινός
σκίτσο: περίγραμμα, σχέδιο
ενάρετος: αρετή
οπωσδήποτε: παρ-'όλα-αυτά, ήδη
οδηγός: αυτοκινητιστής, οδήγηση, αγωγός
δήλωση: διαφήμιση
υπέρβαση: επιπλέον, πλεονασμός
χωρισμός: διαχώριση, απόσταση, διαχωρίζεται
αηδία: περιφρόνηση, φοβία, μισώ
ορθά: ίδιο, κατάλληλος
όχλος: πλήθος, μάζα
περιττός: απόβλητα, πρέπει
γούνα: δέρμα, παλτό
ενθαρρύνω: εμπνέω, Σπρώξτε
φόρος: ενοίκιο
ανακουφίζω: περιορίζω, απαλλάσσω, συγχωρώ
νομοθεσία: νομοθετώ, κανόνας, νομοθετικό-σώμα
σχέδιο: σχέδιο
νεράιδα: άγγελος, μπλε, βίλα
καταλήγω: Κρατήστε, σύναψη
τυχερός: ευτυχισμένος
ποδιά: γόνατο, ποδιά, γύρος
λεία: λάφυρο, καταστροφή, πονηρεύω
υπεύθυνος: εύκολα, τείνω, ευαίσθητος
προσεκτικός: προσεκτικός, ανήσυχος, σοφός
ευνοϊκός: σύμφωνος, καλώδιο, επιθυμητός
κασσίτερος: τράπεζα
εξαρτώμενος: εξάρτηση, επισυνάπτεται, υπάλληλος
ένταλμα: διαβεβαιώνω, δικαιολογώ, υπόμνημα
καταγγελία: άσπρο
σύμβαση: υπόμνημα, συμφωνία
γωνία: γωνία, πολύγωνο
ευρέως: εκτενής, πολύ, γενικά, μεγάλα
αγελάδα: βοοειδή
προκατάληψη: μισώ
βεράντα: αίθουσα, μπαλκόνι
εκπληκτικός: παράξενος, καταπλήσσω, έκπληξη, εκπληκτικός
κρήνη: πηγή
κατάλληλος: κατάλληλος, κοστούμι, συνεπής
βέβαιος: θάρρος, ασφαλής, πιστεύω
όργανο: όργανο, μέλος, στοιχείο, σώμα
επιλογή: επιλέγω, υποψηφιότητα, εκλογή
δέος: φοβία, φόβος
συγκρίνω: σύγκριση
αναφέρω: στερεώνω, άγκιστρο, συγγένειες, σχετίζονται
υποθέτω: πιστεύω, εικασία, υποθέτω, σχέση
απών: χαμένος
μόδας: σύγχρονος, κομψός
θετικώς: θετικός
αιτιολογία: ιδέα, επιχείρημα
ενοχλώ: νευρικός, επιθετικός, επεμβαίνω, ενοχλητικός
εταίρος: φιλενάδα, κοινός, μέτοχος
σχέση: σύνδεση, σχέση
ανηψιά: ανιψιός, εγγονή
σωματικά: φυσιολογικός, σώμα
σχολή: κολλέγιο, παραγοντικό
κανόνι: μπάλα, πυροβολικό, όπλο
απόπλους: πλοίο, πέπλο
έξυπνος: σοφός
μικροπρεπής: δαχτυλίδι, ασήμαντος, λίγο
Προσοχή: προειδοποίηση, φροντίδα
χειρόγραφο: νομοσχέδιο
πολεμιστής: ήρωας
υγρό: νερό
έννοια: σύλληψη, έννοια
ειδικώς: ειδικά
άλμα: μύγα, χορός, φτέρνα, πήδημα
απρόθυμος: σκοπεύω
επιπλέον: επιπλέον
πίσσα: πεζοδρόμιο, τόνος, δεν
αδέξιος: ανεπαρκής, παράξενος
εκτιμώ: χειροκροτώ, απολαμβάνω
επιζώ: ζω, διαμονή
εν-ολίγοις: ακρώνυμο, μικρός
ρύζι: ορείχαλκος
άνθρωπος: πρόσωπο
συμπεριφορά: χαρακτηριστικός, συμπεριφορά
ενστερνίζομαι: υποθέτω, παίρνω
τακτικά: συχνά, αλλεπάλληλος, μόνιμος, κατάλληλος
έρευνα: καθετήρας, έρευνα
συνταγματικός: σύνταγμα
αργότερο: τελευταίος
μαθητής: φοιτητής
εντελώς: εντελώς
στριμμένα: κλίση
διαφέρω: διαχωρίζεται, διαφορά, διάφορος
καταστροφή: καταστροφή
στοίχημα: στοίχημα, κατάσταση, βέτο
ακατέργαστος: ζω, πηγή, ακαθάριστο, πράσινος
κούτσουρο: εισάγω, εγγραφή, λέσχη
φιλοξενία: γενναιόδωρος
καροτσάκι: τρένο, καροτσάκι
ρόμπα: φόρεμα
αρραβωνιάζω: επισυνάπτεται, χρήση, ενοίκιο, διατηρώ
αγέλη: σμήνος
συλλέγω: μαζεύω
τηγάνι: δοχείο
προσβολή: επίθεση, επιδρομή
εξαπατώ: ανόητος, προδίδω
πένθος: λύπη
αποσύρω: απαλλάσσω, ισοπαλία, αποσύρω
αρμονία: τραγούδι, αρμονία
συμπόνια: εμπάθεια, κρίμα
μεταμφίεση: κρύβω
μεταγραφή: αντίγραφο
έγγραφο: αρχείο
γείτονας: περιβάλλων
φραγμός: αποτρέψει, τόμος
υποχρέωση: δασμός
πτώση: αρνούμαι, πτώση
φιλόδοξος: φιλοδοξία
αργία: διακοπές, γιορτή
γροθιά: πρώτα
αετός: γεράκι, γραβάτα
αξιότιμος: τιμή
σημαντικός: απαραίτητος, επακόλουθος, εκπληκτικός
πυκνός: συμπαγής, πυκνός
μυθιστόρημα: μυθιστόρημα, φαντασία, ιστορία
συνιστώ: προτείνω, παρουσιάζω, συμβουλή
εκπαιδευτικός: εκπαίδευση
προς-τα-πάνω: περισσότερο, πάνω-από
κέρατο: καλαμπόκι
κεφάλαιο: κουτί, κεφάλαιο
οίκημα: καλύβα, αρχείο, καμπίνα
ενδυμασία: φόρεμα, κοστούμι, έθιμο
ναύλος: ενοίκιο, πάω, χάρτης
χειροκροτήματα: χειροκροτώ, έγκριση
υπενθυμίζω: θυμάμαι, μοιάζω
μαξιλάρι: ποτάμι
πουθενά: σημείο
πτώμα: σώμα
ουσία: κύτταρο, πλάσμα
ανύψωση: απότομος
βασίλειο: πεδίο, κόσμος
σκάλα: σκάλες, κλίμακα
συμφωνία: υπόμνημα, συμπαγής, κοστούμι, συμπίπτω, συμφωνία
δαντέλα: ακίδα, εισόδημα
λόγιος: φοιτητής, επιστήμονας
κυβερνήτης: δούκας, κυβερνήτης
τρελός: εκκεντρικός, ανόητος
διασκεδάζω: καλωσόρισμα, διασκεδάζω, ψυχαγωγία
χαιρετισμός: καλωσόρισμα, καρτ-ποστάλ
θηλυκός: θηλυκός
τερατώδης: Τέρας, τρομερός
ευκολία: εξοπλισμός
ληστεύω: κλέβω, λάφυρο
σκάλα: σκάλες, αγωγός, κλίμακα, σχολείο
κατάληξη: τελευταίος
χώρισμα: διαφορά, διανέμω
απίστευτος: παράξενος, ασυνήθιστα
αψίδα: τόξο
εκλεκτός: εκλογή, επιλέγω
ντροπαλός: συστολή, ντροπή
ομίχλη: ομίχλη
έγχρωμος: χρώμα
προειδοποιώ: προειδοποίηση, προκαλέσει
αβαθής: βαθύς
ενθάρρυνση: κίνητρο, άνεση
ακανόνιστος: κοινός, ασυνήθιστα
πιστά: πίστη, πιστός, κατάλληλος
μεταφορά: μετάφραση
θεμελιώδης: βάση, κύριο-προϊόν
δέσμη: κλειστός, ίνα
τραγικός: τρομερός
κριτική: αναθεώρηση, κριτική
τρομερά: τρομερός, πολύ, χειρότερος
μαγείρεμα: μάγειρας, κουζίνα
επανάσταση: επαναστάτης, επανάσταση
βελτιώ: διορθώνω, θεραπεύω
ναυάγιο: καταστρέφω
πείθω: πείθω, διαβεβαιώνω
γαβάθα: φλιτζάνι
εικόνα: παράδειγμα, εικόνα
νεύρο: φλέβα, θάρρος, νευρικός
ατενίζω: διορθώνω
διαπιστώνω: ξέρω, διαβεβαιώνω, αποφασισμένος, έλεγχος, διορθώνω
ενέχυρο: διαβεβαιώνω, υπόσχεση, όμηρος, εγγύηση, πιόνι
κερδίζω: σερβίρισμα
επιλέγω: επιλέγω
βιομηχανικός: εκβιομηχάνιση, βιομηχανία
ερμηνεία: μετάφραση
πρόκληση: κλήση
απαγορεύω: αποτρέψει, αρνούμαι
θέμα: μοτίβο, θέμα
είσοδος: παραλαβή
πισίνα: πισίνα, λάκκος
διάσκεψη: συνεδρία, συνέλευση
ισότητα: αναλογία, ισορροπία, ισοροππία, εξίσωση
πρόσφατα: Νέο, πρόσφατα, μυθιστόρημα
περίχωρα: περιβαλλοντικές, περιβάλλων
εισβολή: επίθεση, επιδρομή
πρότυπο: παράδειγμα, μια-φορά, πρότυπο, μορφή
αποκαλύπτω: αποκαλύπτω, προδίδω
αποφασίζω: χύμα, διορθώνω
κηρύττω: κήρυγμα
γιαγιά: νύμφη, παππούς-και-γιαγιά
μαλλί: βαμβάκι
επικοινωνώ: διάλογος, καθιστώ-κοινωνικόν, συγγένειες
κατ-'ουσίαν,: όροι
εναντιώνομαι: αντιπολίτευση
δείγμα: παράδειγμα
σέρνω: ισοπαλία, ψαλίδι
καλλιέργεια: σπάρτα, συγκομιδή, τομή
ακριβής: κατάλληλος, αλεύρι, προσεκτικός
θέρετρο: παίρνω, καταφύγιο, διακοπή
άρνηση: αρνούμαι, απόβλητα
δεσμός: κλειδί, εγγύηση, συνδετικό-ρήμα
συμπονετικός: κρίμα
μισθός: πληρωμή
συνεχής: συνεχίζω
διεγείρω: προκαλέσει, ερεθίζω
άγρια: άγριος, βίαιος
θλίψη: λύπη, τραγωδία
σύμμαχος: ενωμένος, σχετίζονται
οροφή: κουβέρτα, στέγη
στόχος: εστία, σκοπός
μετρητά: χρήματα
κενός: ανοιχτό, δωρεάν, αδειάζω, χύμα, ασαφής
περιφρονώ: περιφρόνηση
γκαζόν: γρασίδι, λιβάδι
Τουρκία: 
γείτονας: περιβάλλων
τελικός: τελευταίος, άκρο, τελικά, κύριο-προϊόν
υποβολή: υπακούω, στέλνω
είσοδος: εισάγω
πλήρης: βαθύς, γεμάτος
συναρπαστικός: ισοπαλία, περίεργος
επιτυχής: επιτυχία
συντηρητικός: ορθόδοξος, κυβερνήτης
ενθουσιώδης: ενθουσιασμός, ανήσυχος
κάτω-πάτωμα: κάτω
βρασμός: μάγειρας, έλκος
όμορφα: ομορφιά, όμορφος
αύριο: εχθές
άβολος: ανήσυχος, δυσάρεστος
συσκευή: εξοπλισμός
διεκδικώ: επιμένω
έκφραση: προφέρω, έκφραση
κάγκελο: σιδηρόδρομος, τρένο
ατελής: γεμάτος, αναπηρία, ελαττωματική
αποκτώ: απόκτηση, αντλώ, αγορά
επιθετικός: επιδρομή, επίθεση, επιθετικός
ψυχρά: κρύο
διάλεξη: πορεία
διά-του-οποίου: που
αντίληψη: συναίσθημα, ματιά, σύλληψη
αναπτύσσω: επεξεργάζομαι
λειτουργία: τελετή, δουλειά, δραστηριότητα
σφαίρα: δισκίο, βολή, μπάλα
δένω: στερεώνω, όριο
απαράλλακτος: ίδιο
ουσιώδης: εκδηλωτικός, εξαιρετική, επακόλουθος, εκπληκτικός
όγκος: μάζα, μέγεθος, τόμος, όγκος
παρατεταμένος: μακρύς, αργοπορώ
ενοχλημένος: ενοχλημένος, δυσάρεστος
αναστατωμένος: νευρικός, λυπημένος
δέσμη: συνδετικό-ρήμα, ζώνη
σανός: γρασίδι, άχυρο
δημόσια-συζήτηση: διαφωνία, επιχείρημα
ηρεμία: σιωπή
μερικός: εξαίρεση, μέρος
βοδινό-κρέας: κρέας
ενώνω: αλληλεγγύη, ιπποσκευή, συμφιλίωση, ενώνω
λεπίδα: φύλλο, σπαθί, μαχαίρι
εργοστάσιο: μύλος
μηδενικό: μηδέν, αδειάζω
εφημερίδα: εφημερίδα, τύπος
τίμια: πίστη, τίμιος
νόμιμος: νομικός
προφορά: προφέρω, έμφαση, εστία
ειλικρινά: σοβαρά
σύνδεσμος: ΣΥΜΜΑΧΙΑ
εγκρίνω: έγκριση
άκρο: μέλος, άκρο
οικονόμος: διευθυντής, υπηρέτης
εξέλιξη: μεταρρύθμιση, εξελικτική
επισκόπηση: έλεγχος, έρευνα
σύγχρονος: σύγχρονος
σκάνδαλο: διαφθορά
σκόπιμος: επίτηδες
σύμβολο: σημειογραφία, χειρονομία
πλύσιμο: πλύση, πλυντήριο
ακριβής: κατάλληλος, αλεύρι, προσεκτικός
περιστατικό: περιστατικό, ευκαιρία
στέλεχος: χαντάκι, ώμος, δέντρο
στέλεχος: ξηρός, φυλή, ρίζα
εταιρεία: εταιρεία, οργάνωση
προτίμηση: προνόμιο, προτιμώ, πλεονέκτημα, επιλέγω
παροτρύνω: προκαλέσει, ώθηση, επιθυμία
μετακίνηση: απόσταση
ισχυρισμός: έγκριση, έμφαση
προσιτός: επίσκεψη, θεμελιώ
κωμωδία: χιούμορ
έξαψη: χρώμα, έξαψη
κώδικας: αυλή, κωδικοποιούν
επαρκής: αρκετά, κατάλληλος
σπλιτ: διανέμω
ιστοριογράφος: ιστορικός
ένταση: πυκνότητα, ένταση
δημοκρατία: δημοκρατία
θρήσκευμα: ομολογία
έλξη: γοητεία, βαρύτητα
συναυλία: φεστιβάλ
προς-τα-κάτω: κάτω
κανάλι: κανάλι, σωλήνας
προτροπή: σύντομα, αίτηση, ευκίνητος
μπρούντζος: ορείχαλκος, καστανός
ένδυμα: ρούχα
τύψη-συνειδήσεως: λυπημένος, κρίμα
αποκλειστικός: μονοπώλιο, ιδιωτικός
porter: φορούν, φορέας
παύλα: γραμμή
λωρίδα: ζώνη
Σε-τελική-ανάλυση: τελικά
ομάδα: χορωδία
ακριβός: αγαπητός
αρχηγείο: έδρα, κέντρο
οξύς: αιχμηρός
αμήχανος: νευρικός, ντροπή
απόγονος: παιδιά
δίκτυο: ιστός
επίπεδο: πουλί, επιφάνεια, μηχανή
μερικώς: μέρος
με-καμάρι: υπερηφάνεια
ταράτσα: μπαλκόνι, στέγη
λαβή: Κρατήστε, παγίδα
έκρηξη: έκρηξη
ομάδα: στρατός, στρατιωτικός
σφικτά: αυστηρά
ποινή: κρίμα, ποινή
βρωμιά: υγρασία, περιττώματα, λάσπη
εποχή: εποχή
πρεσβευτής: αγγελιαφόρος
ράτσα: πολλαπλασιάζω, αγώνας
παρέμβαση: επεμβαίνω, ενόχληση, αταξία
συνίσταμαι: πέρασμα, περιεχόμενο
αποδοχή: δεκτός, έγκριση, παραλαβή
μηχανικός: μηχανικός
παύση: πόδι
εναλλακτική-λύση: εναλλασσόμενος, αντικαθιστώ
σφραγίδα: δαχτυλίδι
μετρητής: δίσκος, αντιπολίτευση, απέναντι
Αφροδίτη: Παρασκευή
φανταστικός: φαντασία
ορειβασία: αύξηση, ανατριχιάζω
προσελκύω: ισοπαλία, εντυπωσιάζω
εκπληκτικός: έκπληξη, εκπληκτικός
ανταγωνισμός: αντίπαλος
κρύσταλλο: ποτήρι
ντους: λούτρο, βροχή
φιλοσοφικός: φιλόσοφος, φιλοσοφία
θορυβώδης: θόρυβος
συσκευή: εξοπλισμός
μεταφορά: κυκλοφορία, σαΐτα
τελικά: τελικά
φοβερά: πολύ, τρομερός
ενατένιση: κατοπτρίζω, αντανάκλαση
κατασκευή: βιομηχανία, παράγω
αναπαυτικά: άνετος
έκθεση: έκθεμα, έκθεση
γεωργικός: γεωργία, αγρόκτημα
αναζήτηση: έρευνα
επέκταση: λεπτομέρεια, ευρύνω
αμφισβήτηση: αντίφαση, επιχείρημα
βάναυσως: σχεδόν
πάνω-από-το κεφάλι: πάνω-από
αναχαιτίζω: αναχαίτηση, αποτρέψει, συγκράτηση, διατηρώ
διατήρηση: αποθηκεύσετε, φροντίδα, διατηρώ
καπηλειό: μπαρ
λεκάνη: κοιλάδα, πισίνα, νεροχύτης
μελωδία: τόνος
ενοικίαση: ενοίκιο
ανήσυχος: ανήσυχος, νευρικός
ηλικιωμένος: παλιά-εποχή, παλιός
πανεπιστήμιο: κολλέγιο
προσεκτικός: προσεκτικός
πριν: Ανατολή, πριν
περίπλοκος: συγκρότημα, σκληρά, επεξεργάζομαι
απολογία: απολογούμαι, Συγνώμη
φοβισμένη: έντρομος, φόβος
υποκατάστατο: εναλλασσόμενος, επίδομα, αντικαθιστώ
χρήση: χρήση
αποκατάσταση: επισκευή, ανάκτηση, ανακτώ
φράχτης: φράκτης
πρωταρχικός: κύριος, βάση, πρωτότυπο, κύριο-προϊόν
δέσμη: ακτίνα
περιοδεία: επίσκεψη, εκστρατεία
εξωγκωμένος: άλας
αρμόδιος: καθιστώ-ικανό, ικανός
επείγων: σύντομα, ίζημα
συναγερμός: προειδοποίηση, τρομάζω, άγρυπνος
φούρνος: σόμπα
στρογγυλεμένες: γύρος
συμβατικός: κοινός
συνηγορώ: ικετεύω, δικαιολογώ
κορδόνι: σκοινί
κατά-μήκος-της πλευράς: παράλληλο, επόμενος, σύνδεση
εκχύλισμα: παραθέτω, χυμός
αναπτήρας: ελαφρης
πίντα: μπύρα
σωλήνας: σωλήνας
λεωφόρος: ευκαιρία
αποτελεσματικός: έμπειρος, αποτελεσματικός, αποτέλεσμα
μείγμα: μικτός, ταραχή
διατάραξη: αταξία, ενόχληση
εκτελεστικός: διευθυντής
δέκατος: δέκα
συγκριτικός: σύγκριση
π.μ.: πρωί, λαμπερός
κλουβί: κάστρο, κύτταρο
φυλακή: φυλακή, αλυσίδα
ικανός: έμπειρος, πονηριά, ικανός
κραυγή: κραυγή
συμβιβασμός: συμφωνία, αρμονία
πυρομαχικά: βολή
βοηθός: υποστηρικτής, βοήθεια
μπαστούνι: ραβδί
συζητώ: συζητώ, επιμένω
λογική: επιχείρημα, λογικός, λογική
πανικός: φόβος
κυκλοφορία: ποδηλασία, κύκλος, κυκλοφορία, sightsee
στρες: ένταση
κατανάλωση: χρήση, καταναλώνω, φάω
υποστηρίζω: υποστήριξη, διατηρώ, Κρατήστε, υποφέρω
σύγκρουση: πτώση, σύγκρουση
λείπει: ανεπαρκής, τομή, ελαττωματική
βαθμιαίος: σταδιακά
συντριβή: καταστρέφω, βαρύτητα, σκουός
φαινόμενο: περιστατικό, πράγμα
εκτελώ: τρέξιμο, δράση
χαιρετώ: υγεία, καλωσόρισμα, χαλάζι
μοναρχία: βασιλικός, ιδιοκτησία
συμπεριφέρομαι: ζω
εμπόδιο: εμπόδιο, κατώφλι
καμπύλη: τόξο
βασίζομαι: κόμης
ευκολία: εύκολα, άνεση
αρνάκι: πρόβατα, ανατριχιάζω
λογικός: λογικός
διατροφή: τροφή
δικαστικός: δικαστήριο, νομικός
δυσπιστία: αμφιβολία, πίστη
φτερό: άνοιξη, κρίμα
εθελοντικός: εθελοντής
σακάκι: παλτό, ζακέτα
κολύμπι: ζάλη
εντυπωσιακός: εκπληκτικός
κάτω-από: κάτω, μετά
επαρχιακός: αγροτικός, επαρχία
αποζημίωση: αποζημιώνω, επίδομα
σερβιτόρος: υπηρέτης
προάγω: επιτάχυνση, προαγωγή, θετός, Σπρώξτε, συμβάλλει
αφιερώνω: σκοπεύω
εχθρότητα: εχθρικός
φυτεία: αγρόκτημα, φυτώριο
εκθέσει: περίγραμμα, αποκαλύπτω, ανοιχτό
κηλίδα: σημείο, προσάρτημα
διακοπή: διακοπή, ενόχληση
αντίχειρας: ίντσα
επαναστατικός: επανάσταση
καταπληκτικός: παράξενος, καταπλήσσω
άκρο: ημισφαίριο, ακίδα, άκρο, γενειάδα, κορυφή, συμβουλή
απειλή: απειλή, κίνδυνος
ζούγκλα: δάσος
τυπικός: κοινός, χαρακτηριστικός
καύσιμα: έλαιο
γαλήνιος: ησυχία
προορισμός: επανάληψη, σκοπός, μοίρα
καρφίτσα: μυστικό, βελόνα
Άρης: Μάρτιος
σύντροφος: σχετίζονται, συνάδελφος, σύνδεση, κοινός, παράλληλο, επισυνάπτεται
φαύλος: ανήθικος, κακό
συμπόσιο: γιορτή
λεπτομερής: επεξεργάζομαι, βαθύς, μεντεσές, λεπτομέρεια, προσεκτικός
ντουλάπι: υπουργικό-συμβούλιο
νομοθετικό: νομοθετώ, νομοθετικό-σώμα
περιθώριο: άκρη, πεδίο
πρωταθλητής: ήρωας
σφυγμός: ώθηση
φεύγω: τρέξιμο, διαφυγή
ρήτρα: ρεύμα, παράγραφος
χημική-ένωση: σύνδεση, συγκρότημα
κόμπος: Κρατήστε, πλέκω
σχέση: συγγένειες, έκθεση, σχέση
πρακτορείο: οργάνωση, εταιρεία, γραφείο
γκριμάτσα: χαμόγελο, γκριμάτσα
επίδειξη: προβολή, Μάρτιος
κατάθλιψη: λύπη
όχημα: μηχανή
δανείζομαι: πίστωση, παραθέτω
πρήξιμο: φούσκωμα
θέμα: μοτίβο, θέμα, επικεφαλίδα
ετυμηγορία: απόφαση, κανόνας
σάββατο: Σάββατο
αναγνώριση: αναγνωρίσιμα, ταυτότητα, ορισμός
φωτογραφία: εικόνα, βολή
σύμμαχος: φίλος, φιλία, ενωμένος
έκταση: τρόπος, τέντωμα, επιχείρημα
ταινία: ζώνη, ταινία
συν: περισσότερο
διαφανής: διαφάνεια, καταφανής
άρωμα: μυρωδιά
ενόχληση: ταλαιπωρία, επεμβαίνω, ενοχλητικός, ενόχληση
αρμόδιος: ικανός, έχω-τα-προσόντα, έμπειρος
έκθεση: άρθρο, έκθεση
καβαλάρης: ιππότης, ιππασία
μοναξιά: μοναχικός
καρπός-χεριού: χέρι
λεπτή: μαλακός, λεπτός, τελικά
μηδενικό: μηδέν, αδειάζω
καταδικάζω: ποινή
σαγόνι: πεύκο
μοναδικός: ενωμένος
αναπόφευκτα: αναπόφευκτος
τύμπανο: χορός, αδειάζω
αποθήκη: κουτί, καλάθι
διάρκεια: προσωρινός, μόνιμος, φορά, μήκος
ζυγίζω: μέτρο, βάρος
μοναστήρι: μονή
δημοσιεύω: δημοσίευση, διανέμω, αποκαλύπτω
διορατικότητα: όραμα
οπωσδηποτε: καταφανής, αυστηρά, πορεία, όντως, ρητώς
αλλαγή: αλλαγή
απόψε: ημέρα
παράγοντας: λόγος, υπάλληλος, συντελεστής
χάος: επιθετικός, αταξία, σύγχυση
πρακτική: άσκηση, δράση
ιερό: βωμός
μαζεύω: ακρώνυμο, μαζεύω
δαπάνη: δαπάνη, χρήση, ξοδεύω
ενθαρρυντικά: καρδιά, εμπνέω
έκθεση: έκφραση, έκθεμα, έκθεση, αποτέλεσμα
ακατέργαστος: ακαθάριστο, πράσινος
εισιτήριο: σημαία, χάρτης
προς-τα-πίσω: πίσω
παπούτσι: παπούτσια, μπότα
απάτη: ψευδαίσθηση
έκρηξη: έκρηξη
τζάκι: καμινάδα
δοχείο: ποτήρι, μπουκάλι, στάμνα, δοχείο
σάλτσα: σάλτσα
σάπιος: τεμπέλης, ανήθικος, φτωχός
συμπεριφορά: χαρακτηριστικός, συμπεριφορά
δάνειο: πίστωση, παραθέτω
παράλογος: λογικός, ανοησίες
λαγνεία: φιλοδοξία
ετησίως: έτος
υγρό: νερό
παιδί: παιδιά
παράφρων: εκκεντρικός, ανόητος
ανατροπή: χύνω
κατόρθωμα: επιτυχία, τάξη, εκμεταλλεύομαι
υπόθεση: υποθέτω, φαντασία, τάχα
κωμικός: χιούμορ, εύθυμος
έκσταση: ενθουσιασμός
συνταξιοδότηση: αποσύρω, παραίτηση, σύνταξη
κοινοβούλιο: νομοθετικό-σώμα, γερουσία
επείγον: ανήσυχος, κρίση
δέμα: κάλυμμα, μέρος, κλειστός
συρτάρι: κουτί, σκάλες
συνεισφορά: συμβάλλει, στοίχημα
σύνδεσμος: προσάρτημα
κόβω: θάρρος, αποσπώ
εκτύπωση: δημοσίευση, αποτύπωμα, τύπος
συνήγορος: δικηγόρος, δικαιολογώ, εναγόμενος
περιβάλλο: ατμόσφαιρα, περιβαλλοντικές
επιβεβαιώνω: αποδεικνύω, διαβεβαιώνω, ενισχύω
αναγγέλλω: αποκαλύπτω, δημοσίευση
παραιτούμαι: παραίτηση, αποσύρω
απορρίπτω: αρνούμαι, βέτο
σκληρός: σκληρά, σκληρός
θραύσμα: τσιπ, κομματάκι, ξύσμα, τέντωμα
στοχασμός: φροντίδα, κατοπτρίζω
λεκές: σημείο
ταφή: κηδεία, θάβω
υπόθεση: υποθέτω
υποθετικός-διάθεση: κερδοσκοπικός-διάθεση, assumptive-διάθεση, υποθετικός-διάθεση
συναλλαγή: δραστηριότητα, εμπόριο
προσβολή: θυμός, περιφρόνηση, ντροπή
ποικίλλω: μεταβλητός, διάφορος, αντικαθιστώ
δικηγόρος: δικηγόρος, εκπρόσωπος
προσβάλλω: ένοχος
πακέτο: κάλυμμα, τσέπη, κλειστός
κλασσικός: κλασσικός
ράντσο: αγρόκτημα
πίτα: κέικ, Π
ακρίβεια: δικαίωμα, ακρίβεια, αυστηρά
ρίψιμο: εκμαγείο
θαλάσσια: ναυτικό, θάλασσα
τραγουδιστής: αναγνώστης
ηλεκτρισμός: ηλεκτρονικός, ρεύμα
εξωγήινο: αλλοδαπός, επισκέπτης, εξωγήινο
ραγισμένος: έκρηξη, ρωγμή
μελαγχολικός: λυπημένος, λύπη
πυκνά: πυκνός
λογικώς: λόγος, λογικός
καλώδιο: κοίλος, καλώδιο
εικονογραφώ: εξηγώ, κατοπτρίζω
υιοθέτηση: έγκριση, παραλαβή
διαβόητος: πασίγνωστος
βλάπτω: βλάβη
σωστά: ακρίβεια, κατάλληλος, δικαίωμα
βοσκή: ιτιά, λιβάδι
σκουλήκι: μάσκα, βαθύς
εκτίμηση: εκτίμηση, εικασία
εξοπλισμός: οργάνωση, ρούχα, εξοπλισμός, φόρεμα
άτυχος: δυστυχής, δυστυχώς
όγδοο: οκτώ
χαλαρή: άνεση, χαλάρωση, ησυχία
γειτονικός: σχεδόν, περιβάλλων
αρχαιότερος: βετεράνος, μητρική-εταιρεία, κεφάλι
τρομάζω: τρομάζω
παιδαγωγός: πούλμαν
ληστεία: λάφυρο, κλέβω
εμπορία: εμπόριο, εμπορικός
εξαφανισμένος: εξαφανίζομαι
μάζα: μάζα, βάση-στήλης, βαθούλωμα
τυχαίος: τυχαίος, προσωρινός, σύμπτωση, έκπληξη
κτίριο: σπίτι, σημείο, κτίριο, εντός-κτίριου
διανομή: παρουσιάζω
κυρτός: κλίση, καλώδιο
παραγωγικός: κατασκευαστής, παράγω
πρησμένος: φούσκωμα
καλλιεργώ: θετός, αγρόκτημα
παραλλαγή: αλλαγή, διαφορά
αντίπαλος: αντίπαλος, αντιπολίτευση
εγγονός: εγγονή, ανιψιός
καρφί: καρφιά, ακίδα, μπουλόνι
καλοσύνη: γενναιόδωρος, ευημερία, αρετή, χάρη
ακρίβεια: ακρίβεια
ένδειξη: σημάδι
μείωση: περιορίζω, τομή
κοιλιά: στομάχι, ομφαλός
αηδιάζων: μισώ
συνθέτω: γράφω, δημιουργώ
επιβάτης: ταξιδιώτης
τσίμπημα: μαχαιριά, πικρός, δάγκωμα
ταυτοχρόνως: Εν-τω-μεταξύ,
επεισόδιο: επακόλουθος, μέρος
επίμονος: συνεπής, συνεχίζω, μόνιμος
λιμοκτονώ: πεινασμένος
διαβούλευση: συμβουλεύομαι, συμβουλή
θυμώνω: οξύ
υπογραμμίζω: επιμένω, έμφαση
παρέλαση: Μάρτιος
κράνος: καπέλο
προκηρύσσω: προπαγάνδα, δημοσίευση
κατάλυμα: ξενοδοχείο
σπρέι: φάρμακο
επίσημα: επίσημος-ανώτερος-υπάλληλος
ανησυχητικό: νευρικός, επεμβαίνω, ανήσυχος, ενοχλητικός
πρόβλεψη: αναμένεται, αναμένω
βαθμός: γέφυρα, συντελεστής, τάξη, εκτίμηση, βαθμός
σκαμνί: περιττώματα, καρέκλα
αιτιολόγηση: δικαιολογώ
ξένος: αλλοδαπός, επισκέπτης
μεταφορά: κυκλοφορία, σαΐτα
κατανόηση: καταλαβαίνω
διευθυντής: διευθυντής, κεφάλι
χρονικός: προσωρινός, φορά
όμορφα: όμορφος
επιβάλλω: επιβάλλω, αναγκάζω, καθιστώ-ικανό, αστυνομία
περιεκτικός: βαθύς, γεμάτος
απειλώ: απειλή
προοδευτικός: πρόοδος, ριζικό
πόρος: πηγή
περιορίζω: περιωρισμένος, αρπάζω, μειώνω, περιορίζω
συγχαιρώ: έπαινος
ασφάλιση: ασφαλής
διορίζω: μάτι
διακοπή: εμπόδιο, τομή, επεμβαίνω, ακρωτηριάζω, διακοπή
καταστέλλω: καταπιέζω, αποτρέψει
στρώμα: στήλη
ένδειξη: απόδειξη, κλειδί
δόντι: δόντια, οδοντίατρος, βαθούλωμα
εγγύηση: διαβεβαιώνω, εγγύηση
διαδικασία: διαδικασία, μηχανισμός, δράση, προσέγγιση
σύσταση: συμβουλή
χάσμα: διακοπή, άνοιγμα
συνεπάγονται: μέσο
συνδέω: επισυνάπτεται, συνδέω, στερεώνω
στάση: χειρονομία, δείκτης, θέση, στάση
σουίτα: πτέρυγα, σειρά, διαμέρισμα
κόσμημα: θησαυρός, κόσμημα
ευαίσθητος: συναίσθημα, παθιασμένος, ευαίσθητος
σκυρόδεμα: εκδηλωτικός, συνεπής
συνδυασμός: ΣΥΜΜΑΧΙΑ, σύνδεση
κορυφή: κορυφή
νόμισμα: χρήματα, κέρμα
σκοπός: σκοπός, εστία
μνημείο: μνήμη, προειδοποίηση
χωριστά: διαχωρίζεται, διαφορά, μεμονωμένα, μοναχικός
δίσκος: δίσκος
οριζόντιος: ισορροπία
ναύλωση: σύνταγμα, χαρτί, ενοίκιο
είδος: εμπορεύματα, άρθρο, στοιχείο, φωνή, είδος, θέση
επέκταση: λεπτομέρεια, ευρύνω
συστροφή: μπουλόνι, γνέθω, ειρωνεία
παραδοσιακός: παράδοση, κλασσικός
εμπλέκω: συμπεριλαμβανομένου, συμπερίληψη, περιεχόμενο
ρουτίνα: κοινός, μηχανισμός
λύσει: άροτρο, χύμα, διορθώνω
πειράζω: πειράζω, προκαλέσει
ανεπιτυχής: αποτυγχάνω
πολιτευτής: πολιτικός
καπάκι: στέγη
παράβαση: βλάβη
διασταύρωση: τακτικός, διάβαση
αφεντικό: ιδιοκτήτης, διευθυντής, εργοδότης, κεφάλι, κλέφτης
σκεύη: εξοπλισμός
νήμα: ακτή, ζώνη
χείλος: άκρη, γκρεμός, χείλος
εμπορεύματα: εμπόριο, εμπορεύματα
σε-απόσταση: διαχωρίζεται, μακριά, μακρινός
άσυλο: νοσοκομείο, καταφύγιο
βεβαιώνω: αποδεικνύω, διαβεβαιώνω
πρόγραμμα: τραπέζι, ημερολόγιο, διάγραμμα, διάθεση
χαράκωμα: χαντάκι
δημοτικός: πόλη
ταραχή: ταραχή
καταθέτω: αποδεικνύω
μητρικός: έγκυος, μαμά
γλυπτική: άγαλμα
γεύση: γεύση
μάρκα: εγχειρίδιο, σημάδι
αποσκευές: αποσκευές
σκουπίδια: ανοησίες, ξύσμα, σκουπιδότοπος
εργαλείο: όργανο
χάος: αταξία, σύγχυση
δίωξη: κοστούμι
σε-υπερένταση: νευρικός, φορά
κότα: κοτόπουλο
τακτοποίηση: στολίδι, περιορίζω, τομή
διακριτικός: σοφός
θρηνώ: κραυγή
διάλεκτος: στίλβωση
στοιχειώδης: βάση
φορτίο: αποσκευές, μπαρ, φορτηγό
σκουπίζω: σκούπισμα
άρνηση: αρνούμαι
υπόγειος: μυστικό
ενδιάμεσος: έλεγχος
τύπος: εξίσωση, τύπος
απάτη: ανόητος, χειρισμός
στέκι: διστάζω, φοβία
μητρώο: λίστα, εγγραφή
αόριστος: ασαφής, αόριστος
πλεόνασμα: επιπλέον
ρίγος: τρέμω
ιστός: οργάνωση, ιστός, ύφασμα
προσχέδιο: περίγραμμα
παιχνίδι: κούκλα, παιχνίδι, χαρτοπαίγνιο
σκαλί: σκάλες, κλίμακα
μετάβαση: μόλυνση, αλλαγή, μεταβατικός, διάβαση
κουμπί: κλειδί
αφιλοφρών: αγενής
πρόγραμμα: σχέδιο, ημερήσια-διάταξη
βιομηχανοποίηση: εκβιομηχάνιση, μύλος, παράγω
ζώνη: πεδίο, περιφερειακός, ζώνη
ένατος: εννέα
αλκοόλ: κρασί
άπληστος: φιλοδοξία, απληστία
διευθύνω: διαχειρίζομαι
με-επιρροή: αποτελεσματικός, διαπερνώ
περιβάλλω: περιλαίμιο, πολιορκία
πνίγω: νεροχύτης, γωνία
ολίσθηση: ολίσθημα
συς: αύξηση, ψωμί, χοίρος
κυρίαρχο: εξαιρετική, επιδρομή
ηγεσία: ιεραρχία, εγχειρίδιο
ημερολόγιο: εφημερίδα, ημερολόγιο
γιορτάζω: πείθω
φασαρία: έξαψη, θόρυβος, ενοχλητικός, σύγχυση
αναπληρωτής: εκπρόσωπος, εναλλασσόμενος
αυτοκινήτων: μοτέρ
τροπολογία: αναθεώρηση, αλλαγή
κατακόρυφος: στάση, γεωγραφικού-μήκους
ανεπαρκής: ανεπαρκής, αρκετά
δεκάρα: λεπτός
συμπέρασμα: εικασία, σύναψη
επαγωγική-διάθεση: επαγωγικός-διάθεση
διαφήμιση: διαφήμιση, εμπορικός, προπαγάνδα
κλοπή: κλέβω, λογοκλοπώ
αυθόρμητος: ένστικτο, αυθαίρετος
χρησιμότητα: οργάνωση, χρήση, όργανο
συνδέω: στερεώνω, άγκιστρο, συνδέω, ενώνω
προς-τα-κάτω: κάτω
παρέμβαση: επεμβαίνω
αναβίωση: ανασταίνω, ανάκτηση
Internet: εμπόριο
φυσικώς: φυσική, σώμα
τελεία: σημείο
συγκλονιστικός: σοκ
αγένεια: αγενής
ισορροπημένη: συνεπής
δείκτης: εκθέτης, λίστα, δείκτης
μεταδίδω: στέλνω, διανέμω
επάνω-σε: πάνω-από, έξω, προς-τα-εμπρός
κουβέντα: ομιλία, στατιστική
κεχριμπάρι: κίτρινος
τόνος: τόνος
ομαλά: άνετος
ένταση: ένταση, έξαψη
φάλαινα: εκλογή
δηλητηριώδης: δηλητήριο
παραχώρηση: κινούμαι, προνόμιο, έκπτωση
εργάτης: υπάλληλος
κλίνω: βουτιά, κλίνω
τουαλέτα: υπουργικό-συμβούλιο
αδίκημα: επίθεση, έγκλημα
μνησικακία: μισώ, εκδίκηση
σθένος: υπομονή, θάρρος
προσδοκώ: ελπίδα, αναμένω
ρυθμός: ρυθμός
αρουραίος: ποντίκι
ανταποκρίνομαι: αλληλογραφία, κοστούμι, κατάλληλος, απάντηση
καθυστερώ: αποτρέψει, αρπάζω, διατηρώ
ερμηνεύω: εξηγώ
σαλόνι: αίθουσα
λειτουργώ: χειρισμός, δουλειά, τρέξιμο, δράση
διοχετεύω: υδρορροή, τρέξιμο
μισθός: πληρωμή
δυσάρεστος: μισώ, κακό, δυσάρεστος, απογοητευτικά, άσχημος
νεκροταφείο: κηδεία
γύψος: κιμωλία
παρακέντηση: σωλήνας, γάλα
απολύω: σάκος, αγνοώ, αρνούμαι, βέτο, διακρίνω, πλεονασμός, συγχωρώ
προκαλώ: έξαψη, ενοχλημένος
κατοικώ: διαμονή, ζω
διακόσμηση: στολίδι
δάχτυλο-του-ποδιού: ακροποδητί, πόδι, δάχτυλο, πόδι-ζώου
αδυναμία: αναπηρία, αδυναμία
εφευρίσκω: εφεύρεση
καθορίζω: determiner, επεξεργάζομαι, περιγράφω
περιορισμένος: περιωρισμένος, όριο
ντουλάπι: υπουργικό-συμβούλιο, ράφι
ράφι: ράφι
επιστάτης: αγωγός, επιθεωρητής
παρουσίαση: παρουσιάζω, προβολή, έκθεμα, προαγωγή
καουτσούκ: μπάλα, ελαστικό
αποκλείω: στερώ, διαγράφω, διακρίνω
προνομιούχος: προνόμιο
ερημίτης: ασκητής
γρατσουνιά: ξύνω, αρχή
βίδα: μπουλόνι
εξερευνώ: παρατηρώ, εκμεταλλεύομαι
ασφαλίζω: διαβεβαιώνω
κύλινδρος: δίσκος
περίληψη: περίγραμμα, περίληψη
απίθανος: πιθανότητα
σμήνος: σμήνος, υιός
συστηματικός: μηχανισμός
πρακτικώς: όντως, σχεδόν, πρακτικός
πελάτης: έθιμο, επισκέπτης
κατάλογος: λίστα, τραπέζι
χημεία: χημική-ουσία
ψήνω: ψωμί, μάγειρας
διατρυπώ: μαχαιριά, διαπερνώ, οπή, διάτρητος
αρπάζω: σχίσιμο, αρπάζω, απαγωγή
εκτόξευση: εκπέμπουν, εκμαγείο
καλλιέργεια: γεωργία
ηθοποιός: ηθοποιός
θέατρο: θέατρο, αίθουσα
φάρμακο: φάρμακο
δυσμενής: χειρότερος, μειονέκτημα, αντίστροφο, αρνητικός, επιβλαβής
καραμέλα: μέντα, σοκολάτα, γλυκός
πάστα: σειρά, κολιέ
κατάδικος: παγίδα, τιμωρώ, ένοχος
ερευνώ: καθετήρας, παρατηρώ, έλεγχος
πακέτο: κάλυμμα, σειρά, κλειστός
αργή-πορεία: ανατριχιάζω, μαζεύομαι
θραύση: κρότος, κλικ, εικόνα, παλίρροια, σύντομα
λάστιχο: έμβρυο, δαχτυλίδι
αξιοπρόσεχτος: εκπληκτικός, καταφανής
πυρήνας: βάση
προκάτοχος: πρόγονος
ομοίως: επίσης, ίδιο
φράγμα: σκόνη
ολισθηρός: ολίσθημα
μετασχηματισμός: αλλαγή
κροσσός: άκρη
τοποθεσία: θέση, σημείο
σύμπλεγμα: συσφαιρώνω, μάζα, ζώνη
προσφορά: παραθέτω
επιμέλεια: επιμέλεια, φροντίδα
εύλογος: δεκτός
τινάσσω: εκμαγείο
σκαλί: πάτημα
συγκέντρωση: συσσώρευση, εστία
εύχρηστος: πρακτικός, άνετος
δόλωμα: γεύση, αλφαβητάρι
ποικίλος: διάφορος
φέτα: τσιπ, δίσκος, κομματάκι
τρυπάνι: οπή, σκάβω
απαντώ: αντίδραση, επιστροφή-χρημάτων, απάντηση
θνησιμότητα: θάνατος
αγριόχορτο: γρασίδι
σχετικά: τόμος
μαθηματικός: μαθηματικά, αθλητικός
ηθικά: ηθικός
ασθμαίνω: στεναγμός, αναπνοή
ιπποδρομίες: αγώνας
απομόνωση: διαχώριση, διαχωρίζεται
κάποτε: μερικές-φορές
ενήλικας: ώριμος
ταλαιπωρία: πικρός, μιζέρια, ταλαιπωρία, ενόχληση
φήμη: κουτσομπολεύω, φωνή
αντέχω: διατηρώ, αρκούδα, τελευταίος
κατώτερος: νέος
πλέξιμο: πλέκω
έμμεσος: κατευθείαν
προηγούμενο: παράδειγμα
διάδρομος: ακτίνα, αίθουσα, διάβαση
διαψεύδω: αντίφαση, αρνούμαι
εξαργυρώνω: αποθηκεύσετε, αποζημιώνω
μονοπάτι: τρόπος, διάβαση-πεζών
γρανάζι: εξοπλισμός, δόντια, σχηματίζω-πλευρές, τρέξιμο
εορτασμός: γιορτή
αναπαυτικός: ζεστός, άνετος
εκδόσεων: δημοσίευση, διανέμω
πελάτης: επισκέπτης, αγοραστής
χαλί: χαλί, πάτωμα, κουβέρτα
χώρισμα: κόμης
άποψη: ματιά, όραμα
αισθητικός: ομορφιά
φέρω-βαρέως: μισώ
στάση: προτείνω, προκαλέσει, στάση
ικανοποίηση: ικανοποιημένοι
οργανισμός: πλάσμα
ακατάληπτος: καταλαβαίνω
εμφατικός: έμφαση
μεσημέρι: απόγευμα, νότος
κρίνος: ανάγνωση
ουσιαστικό: ονομαστικοποίησης, όνομα
πτυσσόμενος: πτυχή, κλίση
χρήσιμος: βοήθεια
επιμένω: επιμένω, συνεχίζω, τελευταίος
έξοδος: έξοδος, υποδοχή, αναχώρηση
κληρονομώ: κληρονόμος
ταχύτητα: ταχύτητα, ίζημα
προσβλητικός: προφορικός
έλλειψη: ανεπαρκής, τομή, παράλειψη, ελαττωματική
εξασφαλίζω: διαβεβαιώνω
αθέμιτος: δικαίωμα
υπο: αντικαθιστώ
κάδος: βαρέλι, κουτάλι
οργάνωση: οργάνωση
πρωτίστως: ειδικά
τελετουργία: τελετή, λατρεία
μήρος: ζαμπόν, πόδι
γκαρνταρόμπα: ρούχα, υπουργικό-συμβούλιο
υφή: οργάνωση
ταραχώδης: βίαιος
έλος: τέλμα
απληροφόρητος: αμαθής
αρχικός: άνοιγμα, πρωτότυπο, αρχή, πρώτα, πρωτόγονος
ελάχιστο: ελάχιστα
διόρθωση: μεταρρύθμιση, αναθεώρηση, επισκευή
παραβλέπω: αγνοώ, ξεχνώ
ομόφωνος: ενωμένος
άνθρακας: άνθρακας
σπείρα: αρχείο, ρολό, κατσαρός
τραγανός: εύθραυστος, αιχμηρός
λεξιλόγιο: λεξικό
βόλτα: περιπλανιέμαι
καταλληλότητα: άσκηση, γυμναστική, κατάσταση
ιθαγένεια: εθνικισμός, εθνικός
γεύση: γεύση
ασήμαντος: απαραίτητος, ασήμαντος, άσχετος
γροθιά: ρυθμός
δρασκελιά: πρόοδος, πάτημα
άξονας: ώμος, αποτύπωμα
ικανοποιητική: ασθένεια, ικανοποιημένοι
αξιόπιστος: πιστός
αηδιαστικός: μισώ, άσχημος
ηθικός: ηθικός
κατάρρευση: πτώση
μαξιλάρι: ποτάμι
κατατροπώνω: νοθεύω, καταστρέφω, καταπλήσσω, αποτυγχάνω, στενοχωρώ
μύθος: ιστορία, θρύλος
ιδιοκτησία: ιδιοκτησία
φόβος: έντρομος, τρομερός, φόβος
φρένο: διακοπή
παξιμάδι: φασόλι, σπόρος
μεγεθύνω: φούσκωμα, αυξάνω
ηλιακός: λιακάδα
ράμφος: χείλος, μονάδα
μίσθωση: λουρί, ενοίκιο
αναλογία: συγγένειες, σύγκριση, κλίμακα, έκθεση, αναλογία
χτένα: βούρτσα, ώμος, κορυφογραμμή
μεταφράζω: μετάφραση, αναρρίπτω
αναψυχή: ψυχαγωγία, διακοπές, χαλάρωση
ιδιοτροπία: χρώμα
δείγμα: παράδειγμα, δοκιμή
πληθυντικός: μάζα
πρωτοβουλία: σχέδιο, δοκιμή
πηκτή: μαρμελάδα, γάλα
αναρχία: αταξία
προφίλ: περίγραμμα, αρχείο, δικτυακός-τόπος
οικονομικά: χρήματα
βασικός: βάση, κύριο-προϊόν
εξορίζω: σκουπιδότοπος, επιδρομή
ηλεκτρικός: ηλεκτρονικός
βότανο: γρασίδι
ευημερώ: κόσμημα
ομοιότητα: αναλογία, μοιάζω, αλληλεγγύη
μυστικότητα: ιδιωτικός
κονίστρα: πεδίο
ταξιδιώτης: ταξιδιώτης
σωματίδιο: άτομο, σπόρος
έμφυτος: πρωτότυπο
κάτοικος: κάτοικος
φλάουτο: σφύριγμα
αναπαραγωγή: γονιμότητα
σπιθαμή: μήκος
σαλάτα: μαρούλι, εξουσία
βαφή: χρώμα
επιδεικνύω: αποδεικνύω
ηθική: ηθικός
επίσημα: επίσημος-ανώτερος-υπάλληλος
ενοχλώ: επεμβαίνω, ενοχλητικός, πειράζω, ερεθίζω, οπή
γλιστρώ: ολίσθημα
χαρακτηριστικό: χαρακτηριστικός, ιδιοκτησία, τέντωμα
συνθέτης: μουσικός
ποδόσφαιρο: λάκτισμα
συνεταιρισμός: συνεργασία, ΣΥΜΜΑΧΙΑ, συμβάλλει
συνέχιση: συνεχίζω
ανώμαλος: ασυνήθιστα, εκκεντρικός
αλληλουχία: αλυσίδα
σφίξιμο: Σπρώξτε
ανυψωτήρ: αρπάζω, αντιμετωπίζω, εξοπλισμός
χαλιναγώγηση: αναχαίτηση, πεζοδρόμιο, συγκράτηση
διαφήμιση: διαφήμιση, προπαγάνδα
απόσυρση: οπισθοδρόμηση, υποδοχή, σύναψη
στεγαστικών-δανείων: όμηρος, πίστωση, πιόνι
ανοχή: υπομονή, αρκούδα
καταστέλλω: αποτρέψει, καταπιέζω
σύζυγος: σύζυγος
έγκυρος: αποτελεσματικός
βαλβίδα: βαν
κατασκευάζω: δημιουργώ, κτίριο, διατύπωση, φάση
ατμός: ατμός, ζευγάρι
ρόπαλο: ραβδί, λέσχη, προς-τα-εμπρός
αντιφατικός: αντίφαση, άσχετος, αντίθετος
αυτόματο: κατευθείαν
σαφής: ανοιχτό, διαφάνεια, αξίωμα
αποτελεσματικά: αποτελεσματικός, αποτέλεσμα
εξάρτηση: εξάρτηση
επιθεωρώ: παρατηρώ, έλεγχος, sightsee, ανάλυση
παράδοξα: παράξενος, ασυνήθιστα
τραβώ: ισοπαλία, λάφυρο
στενόχωρος: ντροπή, στενοχωρώ
ανάπηρος: αναπηρία, παθητικός
αλαζονικός: υπερηφάνεια
μπούκλα: κατσαρός, δαχτυλίδι
κόσμημα: πέτρα, κόσμημα
επέτειος: γενέθλια
κύρος: πίστωση
αμέλεια: παράλειψη, περιφρόνηση, αδιαφορία
εαυτός-: ιδιωτικός
διάκριση: εξαίρεση, διακρίνω
ευρωπαϊκός: ήπειρος
στόχος: σκοπός
αναβάλλω: κατάστημα, στάση
επενδύω: επένδυση
κρουαζιέρα: πλοίο
συλλαλητήριο: αλληλεγγύη, δράση
φήμη: κουτσομπολεύω, φωνή
δραστήρια: σοβαρά
έλεγχος: έλεγχος
διαμέρισμα: διαμέρισμα
ειδικά: ειδικά
πάταγος: κρότος, έκρηξη, βολή
σύνολο: ακαθάριστο, κοινός
κλάσμα: μέρος, στοίχημα
παράνομος: παράνομος, άγριος
διαλύω: διαγράφω, διαλυτός, διαλυτικό-μέσο
ισορροπία: ισορροπία
εξερεύνηση: καθετήρας, ανάλυση
κρεμμύδι: τόξο
συγγένεια: αναλογία, αλληλεγγύη, εξάρτηση
ανέντιμος: πιστός
σύγκρουση: σύγκρουση, σοκ, επεμβαίνω
πολυθρόνα: καρέκλα, καναπές
ζύμη: αλεύρι, μάζα, ζύμη, κέικ
επιβιβάζομαι: ενώνω
έκσταση: όραμα
απόρριψη: αρνούμαι, απόβλητα
διακύμανση: διαφορά, κατάλληλος, αντίφαση
απορρόφηση: δέρμα
συλλογικός: μάζα
έγκαιρος: φορά
εισβαλλει: επίθεση
απόλυση: σάκος, πλεονασμός
σημαντικά: μεγάλα
πειραματικός: πιλότος
ταινία: ταινία, τηλεόραση, εικόνα
δημοσιότητα: προπαγάνδα, προαγωγή, διαφήμιση
διαστέλλω: ευρύνω, λεπτομέρεια
κατρακύλισμα: παραπάτημα, πτώση, βουτιά, ρούχα
σιδηρουργείο: δημιουργώ, νοθεύω
απολίθωμα: έλαιο, αρχαιολογικός
περιορισμός: εμπόδιο, κανονισμός, συγκράτηση
ζέση: ενθουσιασμός, μπαχαρικό, εμπειρία, γεύση, δέρμα
σχολαστικός: ενοχλητικός
χωριουδάκι: προάστιο, χωριό
κεραία: κόσμημα, πήδημα, έκρηξη
αναπαράγω: αντίγραφο, μιμούμαι
συνέδριο: συνέλευση
σταφύλι: κρασί
συνεργείο: στούντιο, σεμινάριο
μείωση: περιορίζω, τομή, πτώση
προφορά: προφέρω
κρίση: απόφαση, ποινή, κανόνας, δικαστής, δικαιοδοσία, κρίση
συγκεντρώνομαι: προσεκτικός, εστία
ξεκάνω: αποκαλύπτω, πίσω
πορθμείο: θαλαμηγός, πλοίο
ειλικρινής: απλός, κατευθείαν, εύκολα, διαφάνεια, γραμμικός
υψόμετρο: μήκος
σημαίνω: προβολή, μέσο
εξαγωγή: έξοδος
παραβάτης: κομήτης, ένοχος
αποδοκιμασία: αντιπολίτευση, βέτο
par: ζευγάρι, ισορροπία
καταργώ: διαγράφω
προσαρμόζω: αναθεώρηση, διορθώνω, προσαρμογή
ιδιότητα-του-μέλους: μέλος
μετρητής: μέτρο, κλίμακα, μέγεθος, λεπτός, δείκτης
ανέχομαι: συγχωρώ
ισχίο: οπίσθια, μέση
εμμένω: ακολουθώ, ενώνω, ραβδί, διατηρώ
αποκρούω: αποτρέψει
αναταραχή: αταξία
αγνότητα: ακρίβεια, καθαρότητα
χαλαρότητα: χαλάρωση, χύμα
συστολή: συστολή
δημοσιογράφος: δημοσιογράφος
σύμπτωμα: έκθεμα
ποδήλατο: ποδηλασία, κύκλος
πίσσα: πεζοδρόμιο
σπειροειδής: γνέθω
σχόλια: εμβόλιο, ορισμός
μετάδοση: μόλυνση
ψηφοφορία: φωνή, εκλογή
δυνητικός: ικανός
εκλέξιμος: ικανός, δικαίωμα, έχω-τα-προσόντα, κατάλληλος
βρόχος: ποδηλασία, μεντεσές, δαχτυλίδι
εργάτης: υπάλληλος
καταδιώκω: ευθύνη
άδεια: άδεια
παραιτούμαι: εκπλήρωση
εγώ: εαυτούς, αναπνοή
πίδακας: εκβάλλω, πουλί, ρεύμα
παραβιάζω: απειθώ, τομή
εθισμένος: εξάρτηση
επιβίωση: Διάρκεια-Ζωής, φωνήεν
πάγωμα: παγωμένος
ύφανση: πλέκω
αξιωματούχος: καθιερωμένος, δικαιούχος
απάθεια: αδιαφορία
οργανώνω: οργάνωση, προετοιμάζω, νομοθετώ, οργανωμένος
πιθανώς: ίσως, τάχα
χορδή: συμφωνία
αιμορραγώ: αίμα, αιματηρός
ανίχνευση: θεμελιώ, έρευνα, αποκαλύπτω
σπάσιμο: καταστρέφω, διακοπή
διευκολύνω: επιτάχυνση, θετός, συμβάλλει
συχνότητα: κύκλος, διστάζω
βελονιά: ράψιμο
τηλεφωνικός-κατάλογος: απόδειξη
μπριζόλα: δάγκωμα, τομή, μπριζόλα
θέρμανση: ζεστός
καταθλιπτικό: απογοητευτικά, λυπημένος
πραξικόπημα: επανάσταση, βολή, κτύπημα
συμπονετικός: κρίμα
στοχαστής: διανοούμενος
προϋπολογισμός: ισορροπία
αστικός: εμφύλιος, αστικός
εισάγω: εισάγω, αυξάνω
σκέπτομαι: κατοπτρίζω, νομίζω
εύκαμπτος: απλός, καλώδιο, ελαστικό
πλάκα: πίνακας, δισκίο, σόμπα
προσόν: ταλέντο, έχω-τα-προσόντα
διακόπτης: αντίστροφο, μετατρέπω, κλειδί
πετσέτα: ύφασμα
δεκαετία: δέκα, Κρατήστε
πολλαπλούς: διάφορος, περισσότερο
επίδεσμος: σάλτσα, στερεώνω
τακτοποιημένος: πετυχημένος
χειροκρότημα: ελαφρό-κτύπημα, χειροκροτώ
σφεντάμι: παλάμη
τσουγκράνα: σκούπισμα
κενότητα: αδειάζω
μεδούλι: έλαιο, εγκέφαλος, νεροκολόκυθο
θήκη: παλτό, φάκελος, φλούδα
απορροφώ: εκμεταλλεύομαι, ρουφώ, εναγκαλισμός
προφητεία: αναμενόμενος, εικασία
εκπαιδεύω: εκπαίδευση, τρένο, διδασκαλία
έρευνα: καθετήρας, αίτηση, έρευνα
κυριαρχία: κανόνας
γονικός: μητρική-εταιρεία
συμμετέχω: δέλτα, ενώνω, αρραβωνιασμένος
ανελκυστήρας: ανελκυστήρας
πλευρικός: πλευρά
αναβάλλω: καθυστέρηση
σιχαμάρα: περιφρόνηση, μισώ
πυρήνας: πυρηνικός, κύτταρο, έμβρυο
μεταφορά: παράδειγμα
υποκοριστικό: λίγο, μικρο
βόμβα: αντλία
κρισίμως: βαθύς, κριτικός
σκωρία: πέρασμα
κράτηση: διατηρώ, αρπάζω
ράβω: ράψιμο
φαρμακοποιός: χημική-ουσία
σαλόνι: διακοπή, αίθουσα
επίθεση: αρχή, επιδρομή, επίθεση
κατάδυση: βουτιά
δυσμενής: εχθρικός
απογραφή: λογαριασμός
καταγγέλω: κατηγορώ, ποινή
λινάρι: λινό
αναστέλλω: αποτρέψει
σφαλιάρα: ρυθμός
Χαλαρώστε: χαλάρωση
ερωτοτροπία: αυλή
εμπόρευμα: εμπορεύματα
συνέχεια: σύνδεση
αμοιβαίος: ανταλλαγή, αναστροφή
συνταγή: φάρμακο, αντίγραφο
φυσαλλίδα: αφρός
φτυάρι: λαβίδα, κουπί
χρησιμοποιώ: εκμεταλλεύομαι, χρήση, ξοδεύω, ιπποσκευή, καταναλώνω
διαρκής: μακρύς
καταγωγή: οικείος
ψευδάργυρος: νεροχύτης
οποιοδήποτε: οτιδήποτε, ο-οποίος
πεπερασμένος: περιωρισμένος, τελικά, πεπερασμένος
βοηθητικός: υποστηρικτής, βοηθήματα
σκαρφάλωμα: διαστροφέας, πάλη, κτύπημα
ακαδημαϊκός: εκπαίδευση
λάστιχο: έμβρυο, δαχτυλίδι
καταναλωτής: χρήση
κύρος: αξία, πίστωση
περίπου: σχεδόν, κατά-προσέγγιση
πλεκτά: πλέκω
μικροσκόπιο: τηλεσκόπιο
πολίτης: εμφύλιος
λουρί: λουρί, σκοινί
συμβολικός: χειρονομία, ταυτότητα
προσαρμόζω: προσαρμογή, αντιμετωπίζω, αντιγράφω
πιθανότητα: πιθανότητα, ικανός
υποκειμενικός: διανοητικά
αντωνυμία: συνείδηση
λανθασμένα: λανθασμένος, κατάχρηση
αποθαρρύνω: στενοχωρώ, φιλοδοξία
νεοφερμένος: επισκέπτης
άπειρο: απαρέμφατο
γραφικός: διάγραμμα
σύκο: σχηματισμένος, εικόνα
κόγχη: συνεπής, κλειδί
απογοητεύω: απογοητευτικά, προδίδω, αποτυγχάνω
προβολή: σχέδιο, προβολή
απελευθέρωση: εκπλήρωση, σωτηρία
συνταγή: κίνητρο
προνόμιο: προνόμιο
ανάρμοστος: ανοησίες, άσχετος, ανεπαρκής
περιστροφή: κύκλος, επανάσταση, γνέθω
λαβή: μπουμπούκι
μέτρο: μέτρο
περιορισμός: όριο, συγκράτηση, κανονισμός
κατηγορία: κοινότητα, τάξη
φυλετικός: αγώνας, ρατσισμός
υποκατάσταση: αντί, αντικαθιστώ, αλλαγή
καινοτομία: εφεύρεση
αντιμετωπίζω: αντιμετωπίζω
απαγόρευση: αρνούμαι
διακοσμητικός: στολίδι
αίθουσα: προκαλέσει, αίθουσα
ρίχνω: εκμαγείο, κατσαρός
πάπυρος: βιβλίο, ρολό, κατσαρός
μηχανικός: μηχανικός, τεχνίτης
επίθεση: επίθεση, επιθετικός, υπερβαίνω
hey: Χαίρετε, καλωσόρισμα
μέτρηση: μέτρο
συναγωνίζομαι: παλαίω, αντίπαλος
ακαδημία: κολλέγιο
αρχάριος: νεοσύλλεκτος, φρέσκο
διαζευγμένος: διαζύγιο
γαλακτοκομείο: γάλα
δεξαμενή: δεξαμενή
ψώνια: κατάστημα, εμπόριο
σιωπηρή: συνεπής
στρατηγικό: στρατηγική
μούχλα: modulo, μορφή, αποτύπωμα, εκμαγείο
πρόβα: άσκηση, επανάληψη
επιμονή: επιμένω
προηγούμαι: πριν
στα-μέσα: μεσαιονικός, στα-μέσα-του δρόμου, μέση
τουρίστας: ταξιδιώτης, τουρισμός
ποτό: ποτό
προσεκτικός: προσεκτικός
διατυπώσει: εξηγώ, έκφραση
σχετικά-με-: έπειτα, πίσω
τροποποιώ: αναθεώρηση, αλλαγή, αντικαθιστώ, συνδέω, μεταρρύθμιση
διάγραμμα: διάγραμμα, χάρτης
επαγωγικός-διάθεση: επαγωγικός-διάθεση
κατακλύζω: καταπιέζω
κινητός: τηλέφωνο, κύτταρο
ανυψώνω: προαγωγή, ανελκυστήρας
παράδοξο: αντίφαση
υπερβάλλω: άλας, αυξάνω-στον-ανώτατο βαθμό
ξανθιά: κίτρινος
σύνθημα: σημάδι, σύνθημα, ραβδί
δρομέας: αίθουσα
διαπραγματεύομαι: ομιλία, συζητώ
καθεστώς: κανόνας
ανοχή: ανεκτικός, αρκούδα
επιλογή: εναλλασσόμενος, αγγούρι
σταυροφορία: κίνηση
επιδημία: τραγωδία, μετάφραση
τεχνική: τεχνικός, προσέγγιση, μηχανική, εξοπλισμός
τερματικό: τελικά
αποφοιτώ: πέρασμα
παραγωγή: δαπάνη, σύναψη, δημοσίευση, αναχώρηση, παραγωγικότητα, έξοδος
εγκατάσταση: σημείο
αθέτηση: παράλειψη, πρότυπο
συμφραζόμενα: περιβαλλοντικές, σκηνή, έννοια
συνασπισμός: ΣΥΜΜΑΧΙΑ
ελάττωμα: ευθύνη, λανθασμένος, αναπηρία, μειονέκτημα
παραδέχομαι: ομολογώ
αναμετάδοση: δημοσίευση, στέλνω
καντράν: επιλέγω, δαχτυλίδι, μαζεύω
επικράτηση: δημοφιλής
όλο-και-περισσότερο: όλοι
μετασχηματίζω: αλλαγή, μετατρέπω
χαρταετός: δράκων
ασαφής: ασαφής, αντίφαση
καφενείο: καφές, μπαρ
βραβείο: ανταμοιβή, ασφάλιστρο, ομολογώ
επιγραφή: στούντιο, σημάδι
την-έγκριση: έγκριση, ομολογώ
συγγένεια: αναλογία, σοσιαλιστής
ρεαλιστικός: όντως
έρπων: φίδι
υπαίθριος: έξω, ανοιχτό
πολιτικά: πολιτικός
υπόλειμμα: λείψανα, απόβλητα
ταινία: κασέτα, ζώνη, ταινία
ήπιος: μαλακός, γλυκός
του-στόματος: προφορικός, χείλος
σκέπτομαι: εικασία
αποβάλλω: εκβάλλω, εκπλήρωση
ψεγάδι: σημείο, αναπηρία
παραλείπω: χορός, ξοδεύω
κούπα: φλιτζάνι, γκριμάτσα
σφήνα: ακίδα, στοίχημα, γωνία
απαλλαγή: έκπτωση, εξαίρεση, πλεονασμός
φορητός: λίγο
τύλιγμα: συσκευασία, κάλυμμα
λαμπρότητα: ταλέντο, ομορφιά, αντηλιά
πτερύγιο: κουπί, μπαλέτο
μουρμούρισμα: ψίθυρος
μούρο: κόλπος
μετανάστευση: μετανάστευση
σκαπάνη: άροτρο
χειρουργική: χειρουργός
συσσωρεύω: συσσώρευση, κατάθεση, μαζεύω
πρύμνη: περιττώματα, σωλήνας
κοιλιά: στομάχι
υπαινιγμός: έννοια, συμπερίληψη, σύναψη
κίνητρο: κίνητρο
κλειδί: κατσαβίδι, κλειδί
εξοχή: αγροτικός, προάστιο, πεδίο, χωριό
υποβιβάζω: καταστρέφω, περιορίζω
εγχώριος: φύση, πρωτότυπο, κάτοικος
σωρός: σκουπιδότοπος, κορυφογραμμή, καμινάδα
δίσκος: δίσκος
τάση: συμπεριφορά, κατεύθυνση, κλίση, διάθεση, τάση
εταιρικός: εταιρεία, κοινός
αθωώνω: απαλλάσσω
ασταθής: ασταθής, παροδικότητα
σύμφωνος: συνεπής, παράλληλο, σύμφωνος
τηλέφωνο: τηλέφωνο
κενό: αδειάζω
αρπάζω: μαχαιριά, παίρνω, αρπάζω
σπασμός: σεισμός, έκρηξη
ανιαρός: βαριόμουνος, οπή, ενοχλητικός
χαρτοφυλάκιο: σειρά, πορτοφόλι
ρωγμή: ρωγμή
επιπλοκή: προβληματικός, διόδια
παρεμβαίνω: επεμβαίνω
πολικός: πόλωση, άκρο
αντιπρόσωπος: εκπρόσωπος, αγγελιαφόρος
θέληση: δύναμη-της-θέλησης, επιθυμία
προλέγω: αναμενόμενος, εικασία
αισιοδοξία: ελπίδα, πιστεύω
φλούδα: δέρμα, φλούδα, φλοιός
κόβω: δάγκωμα
φτερουγίζω: φλοτέρ, πτήση, διστάζω
τομέας: πεδίο, βιομηχανία, περιφερειακός, μέρος
επώνυμο: όνομα, αυτοί
ινστιτούτο: οργανωμένος, εταιρεία, οργάνωση
επείγον: ανήσυχος
απολαυστικός: είδος
αποτρέπω: αποτρέψει
άρνηση: αρνούμαι
νικητής: επιτυχία
σύνθετος: μικτός
σύγκρουση: αποτέλεσμα, σύγκρουση
ίνα: ίνα
γουλιά: καταπιεί
οπτικός: οπτικός, σκηνή
δαγκάνα: πόδι-ζώου
ενάγων: ηθοποιός, φορέας, λόγος
θρηνώ: κρίμα
παραπλανώ: διαστροφέας, καταπλήσσω, ανόητος
απαγορεύω: αναχαίτηση, αποτρέψει, αρνούμαι
εκτελεστής: ηθοποιός, καλλιτέχνης, παίχτης
τουρνουά: αγώνας
απαίτηση: αίτηση, κατάσταση
πλην: ελάχιστα
ακατάστατος: ριψοκίνδυνος
μολυσματικός: μόλυνση
τονίζω: επιμένω, έμφαση
παντελόνι: παντελόνι
συγχέω: παζλ, καταπλήσσω, στενοχωρώ
αφιερώνω: εθελοντής, σκοπεύω
χειρουργικός: χειρουργός
φιλαλήθεια: γεγονός, ακρίβεια
εκατοστός: εκατό
κλίση: απότομος, βουτιά, κλίση
πλησίον: σχεδόν, σύντομα, περιβάλλων
κανονικά: κοινός, συχνά, γενικά, τείνω
σύγχυση: αντίφαση, παζλ, σύγχυση
αναλογικά: συγκρίσιμος, ισορροπία
διαφωνώ: διαφωνία
εκνευρίζω: θυμός, επεμβαίνω, πειράζω, ενοχλημένος
εκκρεμής: καλύτερα, εκπληκτικός
μύηση: αρχή
κατακρήμνιση: ίζημα
τρομάζω: τρομάζω
χόμπι: ψυχαγωγία
γραματικός: γραμματική
αριθμητικός: αριθμός, ψηφιακό
κριτήριο: πρότυπο
πρόβλεψη: αναμενόμενος, εικασία
αποδοκιμάζω: αρνούμαι
εξωτικός: αλλοδαπός, παράξενος
βολβός: λυχνία
επαυξάνω: ευρύνω, αυξάνω, αυξάνω-στον-ανώτατο βαθμό, θεραπεύω
συγχώνευση: τήκω, κλήση
ψηφοφορία: εκλογή
ταλαντούχος: ταλέντο, έμπειρος
τήξη: τήκω
ισιώνω: τέντωμα, διορθώνω
διακοσμώ: στολίδι
προεδρικός: προεδρία
χτύπημα: πρόωρος, πολλαπλασιάζω, λάκτισμα, βαθούλωμα, όγκος
συγχαρητήριο: έπαινος
σάρωση: σκούπισμα
δίνω-δικαίωμα: καθιστώ-ικανό, δικαίωμα
στοιχημάτων: κατάσταση
τεχνικά: τεχνικός, μηχανική
εμπειρικός: εμπειρία
κατακυριεύω: κύριος
διαφημίζω: διαφήμιση, προπαγάνδα
διάχυση: διανέμω, δημοσίευση
αμυχή: ξύνω
εργαλειοθήκη: εξοπλισμός, κουτί, σειρά
επαγγελματίας: γιατρός, πούλμαν
μουλιάζω: ρουφώ, βουτιά
διατήρηση: προστατεύω, αποθηκεύσετε, φροντίδα
λάσπη: λάσπη, πεζοδρόμιο, τρίπλα
προκλητική: σκληρά
ρύπανση: ρυπαίνω, διαφθορά
χημικές-ουσίες: χημική-ουσία
σύνολο-παραγωγής: σμήνος, ώθηση, τόμος
μαμά: μαμά
τρομαχτικός: τρομερός, απειλή
ειδικός: ειδικός
λαχταρώ: επιθυμία
τουαλέτα: λούτρο
τζόγος: χαρτοπαίγνιο, παιχνίδι, περιπέτεια
αναπόσπαστο: απαραίτητος, ολοκληρωμένος
εξαλείφω: απαλλάσσω, διαγράφω
μπιζέλι: φασόλι
παράρτημα: προσάρτημα, επιπλέον, επίδομα
κυκλοφορώ: διανέμω
περιεκτικός: ενωμένος
πωλητής: έμπορος
ενοχλώ: νευρικός, επεμβαίνω, έμμονη-ιδέα
εκρηγνύω: έκρηξη
εξετάζω: περιέργεια, μοχλός
διαρροή: διαρροή, χύνω
δωρεάν: δωρεάν
συστατικό: στοιχείο
έλλειμμα: ανοιχτό
ανησυχητικός: νευρικός, ενοχλητικός, δυσάρεστος, λυπημένος, αταξία
στέγαση: σπίτι
φωτογραφικός: φάση, εικόνα, φωτογράφος
λοιμός: έντομο
χάπι: δισκίο
επί-του-παρόντος: παρόν
μέσα-ενημέρωσης: τύπος
καταστροφή: καταστροφή
σώμα: σώμα, σειρά
μενού: λίστα
κάταγμα: ρωγμή
δικαστήριο: πλατφόρμα, οπή, δικαστήριο
ορμή: ταχύτητα, ώθηση
κλίση: λαούτο, κλίση
πλακάκι: τούβλο
βιβλιοθήκη: βιβλιοθήκη, βιβλιοπωλείο
υπολογισμός: λογαριασμός
παραγωγός: κατασκευαστής
νομισματικός: χρήματα
περιγράφω: περιγράφω, κατοπτρίζω, παρουσιάζω
πληθωρισμός: φούσκωμα
οριακός: άκρη
φαντασία: φαντασία
υπονομεύω: καταστρέφω
συναφής: αυστηρά, σύνδεση, συνεπής
ριζικά: όροι
εκ-προθέσεως: επίτηδες
επιζών: οικογένεια
ροή: ποτάμι, ρεύμα
ανταγωνιστικός: αντίπαλος
κοσμήματα: στολίδι
αλκοολικός: μεθυσμένος, κρασί
ξεχωρίζω: διακρίνω
μαχητικός: ριζικό, τρομοκράτης, στρατιωτικός
αφοπλίζω: όπλα
κρίσιμος: απαραίτητος, αποφασιστικός
εκχώρηση: δουλειά, άσκηση, δασμός, κατανομή
ποσοστό: προνόμιο, κατανομή, ποσοστό
ανασκαφή: λάκκος, σκάβω
ασβέστιο: λάκτισμα
εορτάζω-την-μνήμη: πείθω
ιστορικά: ιστορικός
γεια: Χαίρετε, καλωσόρισμα, σωτηρία
εξάλειψη: απαλλάσσω, παράλειψη, διαγράφω
τεταμένος: πετυχημένος
χαλαρωτικό: άνεση, άνετος, χαλάρωση
αποτελεσματικότητα: αποτελεσματικός, αποτέλεσμα, επιδεξιότητα
τρωτός: ευαίσθητος
αθλητής: αθλητικός
ταινία: ριγέ, γραμμή, ζώνη, ταινία
πρόσοψη: μάσκα, όραμα
συνδετήρας: κύριο-προϊόν, λαβίδα
πρωτότυπο: παράδειγμα, πρωτότυπο
όφσετ: αντιμετωπίζω, αποζημιώνω, παρέκκλιση
μηδενικό: μηδέν, αδειάζω
περιορίζω: αποτρέψει, μειώνω, περιορίζω
τσιμπούρι: σημάδι, ψείρα
δεξαμενή: δεξαμενή
βιασμός: υπερβαίνω
μηδενικό: μηδέν, αδειάζω
υποθετικός: επισυνάπτεται
πολιτιστικός: κουλτούρα
τεχνολογία: τεχνικός, εξοπλισμός
εμπορία: εμπόριο
γραβάτα: γραβάτα
οικονομικά: οικονομικός
διαχειριστής: διευθυντής, θεματοφύλακας
απεικονίζω: περιγράφω, παρουσιάζω
εγγόνι: εγγονή, ανιψιός
διπλός: δυο, ζευγάρι, δίδυμο
σύνθεση: πρωτότυπο, εγκαταστήσουν, σειρά
ειδικότητα: επαγγελματικός, χαρακτηριστικός
παράξενος: παράξενος
αιτών: υποψήφιος
γλωσσικός: γλώσσα, γλωσσολογία
μανιτάρι: φελλός, σφουγγάρι
κολοκύθι: σκουός, νεροκολόκυθο
ανύψωση: ανελκυστήρας, αύξηση, πρόοδος
φαινομενικός: ασυνήθιστα, μονοφωνία, σούπερ
δυναμικός: εξουσία
υβρίζω: αναθεώρηση, διορθώνω, έλεγχος
ανάλυση: διαχώριση, πτώση, ανάλυση
κουραστικός: κουρασμένος
πανεπιστημιούπολη: κολλέγιο, σχολείο
διατριβή: διατριβή
στατιστικός: στατιστική, στατιστικώς
διατυπώ: προετοιμάζω, διατύπωση
σάντουιτς: ψωμί
μηδενικό: μηδέν, αδειάζω
διέγερση: επιτάχυνση, έξαψη, ενοχλημένος
λογοκρισία: λογοκριτής, κανονισμός
εξοπλίζω: συμπλήρωμα
προτείνω: υποψηφιότητα, προτείνω
ματαίωση: διαγράφω, ξύσμα, ματαίωση
μέτρο: μέτρο
καταπιέζω: καταπιέζω
κύριος: Κύριε, κύριος
επανακτίζω: επισκευή, ανάκτηση
διαιτητής: κανόνας, δικαστής
ατομικός: άτομο, πυρηνικός
αμφιλεγόμενος: αντίφαση
εκλεπτυσμένο: συγκρότημα, σύγχρονος
τράβηγμα: σήκωμα-των-ώμων
ακατάλληλος: άσχετος, ανεπαρκής
ίζημα: ίζημα
αποπαίρνω: περιφρόνηση, ευθύνη
παραλαγή: διάφορος
κριτικάρω: κριτική
ανία: βαριόμουνος, ενόχληση, μιζέρια
συνεργάζεται: συνεργασία, σύνδεση
αναλύει: ανάλυση, αναλυτής
βροχόπτωση: βροχή
βλαστάρι: μπουμπούκι
αεροσκάφος: πουλί
αρωματώδης: αιχμηρός
ευκαμψία: ελαστικότητα
ρόκα: βλήμα
επίρρημα: φάκελος
αστάθεια: ασταθής
στέρηση: στερώ, μειονέκτημα
ζαρώνω: κοντόχονδρος
παράγω: παράγω, δημιουργώ
προσέγγιση: κατά-προσέγγιση, προσέγγιση, σύγκλιση
φρόνυμα: άγρυπνος, ηθικός, διανοητικά
αισιόδοξος: ελπίδα, πιστεύω
κατατάσσω: ταξινόμηση, διανέμω
διδακτέα-ύλη: πορεία, ημερήσια-διάταξη
ύπαιθρο: έξω
αντιδρώ: αντίδραση, ρήμα
γραφή: σενάριο, γραμμή, γραφή
εκβιασμός: αποσπώ
δώρο: ανταμοιβή, ασφάλιστρο
κεφάλαιο: ιδιοκτησία, παρουσία, πλεονέκτημα, κεφάλαιο
μεταβλητότητα: διαφορά
ασάφεια: ασαφής, αντίφαση, αβεβαιότητα
μηδενικό: μηδέν, αδειάζω
ουδέτερος: ουδέτερος
μειονέκτημα: στενοχωρώ, εμπόδιο, αναπηρία, μειονέκτημα
φωτογραφία: εικόνα
έλλειψη: τομή, απουσία
μετατόπιση: αντικαθιστώ
μύκητας: βακτήρια, σφουγγάρι, φελλός
διατύπωση: διατύπωση, κείμενο
διπλωμάτης: διπλωματικός, αγγελιαφόρος
μυημένος: παρουσιάζω
συγχώνευση: ιπποσκευή
θρυμματίζω: διακοπή
εισπνέω: εμπνέω
τροχαλία: ρόλος
κοκαλιάρης: λεπτός
ψηφοφόρος: εκλογική-περιφέρεια
ομοσπονδία: ομοσπονδιακός
κινητικότητα: κίνηση
ξεφορτώνω: εκπλήρωση
βιότοπο: καταφύγιο
προκαλώ: ταραχή, προκαλέσει
αραιωμένος: λεπτός
Αντίο: Αντίο, αποχαιρετισμός
κατεδαφίζω: καταστρέφω
σύνταξη: σύνταξη
πέταλο: άλογο
παραμόρφωση: παρέκκλιση, διαστροφέας
χτύπημα: ρυθμός
σχετικό: συνεπής, κατάλληλος, σχετίζονται
λειτουργικός: πρακτικός, δουλειά
εκτοπίζω: αντικαθιστώ, εκβάλλω, κινούμαι
αυτονομία: ανεξαρτησία
βρώμα: μυρωδιά
διάκριση: διακρίνω
διαθεσιμότητα: απόκτηση
φοιτητής: φοιτητής
γραφική-παράσταση: διάγραμμα, χάρτης
θέλγω: σαγηνεύω, πειράζω
χαριτωμένος: όμορφος, γλυκός
κοιλιακός: στομάχι
γνώση-γραφής: εκπαίδευση
συνθετικός: τεχνητός
προπονητής: πούλμαν
συντηρώ: αποθήκευση, αποθηκεύσετε, προστατεύω, διατηρώ
σκουπίδια: ξύσμα, σκουπιδότοπος, απόβλητα
φωτογραφία: εικόνα, βολή
βιβλίο: εγχειρίδιο, βιβλίο
παγιώνω: ενισχύω
αναγκάζω: αναγκάζω, περιωρισμένος, αποσπώ
οικονομολόγος: οικονομικός
αθλητισμός: αθλητικός, άσκηση
στριφογυρίζω: γκριμάτσα
ιώδιο: ορυκτό
μολύνω: μόλυνση, ρυπαίνω
σχεδιαστής: αποφασισμένος
εκκρίνω: έκκριση, κρύβω, εκβάλλω, μυστικό, διακρίνω
σπανάκι: θετός, μαρούλι
εντατικός: άκρο, βίαιος
πειστικός: εκδηλωτικός
ντεμπούτο: πρώτα, αρχή
χιλιοστός: χίλια
εσωτερικός: εσωτερικός, βαθύς, εντός-κτίριου, σκεπαστός
ανακαλώ: στερώ
εύρος: μέγεθος
διάσταση: κατεύθυνση, μετά, διαστατικός, επόμενος
βίβλος: γραφή
αφίσα: σημαία, ιστός
επιταχύνω: ίζημα
εντείνω: ενισχύω, ενισχυτή
άμβλωση: αποτυχία
τυπικά: γενικά, κοινός, συχνά, τείνω
δέσμευση: υπόσχεση
ουρά: ουρά, παραγγελία
υποστήριγμα: κύριο-προϊόν, αγκώνα, άγκιστρο, υποστηρικτής, υποστήριξη
πρώην-: παλιός
αντίστροφος: αντίστροφο, αναστροφή
εξατμίζομαι: τήκω, χασμουρητό
αεροπορία: ατμόσφαιρα, αέρας, μύγα
συσχέτιση: σύγκριση
εθνικός: εθνικιστής, εθνικός
εγκοπή: τομή, περιορίζω
πονηρός: πονηριά, επεξεργάζομαι, συγκρότημα, σκληρά
χαρακτηρισμός: περιγράφω, χαρακτηριστικός
πρόσφυμα: συνδέω, παράλληλο
μόριο: μοριακός
διαμόρφωση: διάθεση, κατασκευαστικός, συνέλευση
ΑΛΛΗΛΕΠΙΔΡΑΣΗ: ομιλία, επικάλυψη
ποσοτικός: τόμος
ενδοσκόπηση: αναδρομικός
Ανατολή: Ανατολή
σπέρμα: σπόρος
εγκρίνω: υποστήριξη, ομολογώ, έγκριση
μη-: ούτε, δεν
αξιοπιστία: πίστη, αξιοπιστία, πίστωση
ανατροπή: καταστροφή
εκτροπή: τάση, παρέκκλιση
ένεση: βελόνα
σανδάλι: παντόφλα, παπούτσια
μεγάλο-κομμάτι: τσιπ, παράγραφος, τέντωμα
τηλεόραση: τηλεόραση
δημητριακό: σιτηρά, φασόλι
δοχείο: όργανο, δεξαμενή, δοχείο
μεταναστεύω: μετανάστευση, περιπλανιέμαι
ορολογία: όροι
εκλογικό-σώμα: εκλογική-περιφέρεια
εξάλειψη: διαγράφω, καταστρέφω
μεσιτεύω: συμφιλίωση
καπιταλισμός: καπιταλιστής
σκι: πατινάζ
εκτελωνισμός: χαρτοπαίγνιο, άδεια
εκλεκτικός: επιλέγω
στατικός: πρότυπο
συγκλίνω: συναντώ, σύγκλιση, εστία
αλφαβητικός: αλφάβητο
καθολικός: διεθνής, κόσμος
ατύχημα: θυσία
Εντάξει: ίδιο, διορθώνω, πολύ
πρακτικός: πρακτικός
διαιτητής: κανόνας, δικαστής
διαφορικός: διαφορά
αποπνέω: εκπέμπουν, αναπνοή
κοιλάς-μεταξύ-ποταμών: νερό
αναπόσπαστο-εξάρτημα: προσαρμογή, εξοπλισμός
εγκαθιστώ: εγκαταστήσουν, καθιερωμένος, κλειστός
απήχηση: δόνηση
παραδοσιακά: παράδοση
αίθουσα-διδασκαλίας: τροχιά
πρωτόκολλο: συμφωνία
λογισμός: λογαριασμός, νομοσχέδιο
γραμμάριο: ζεστός, γρασίδι
βενζίνη: βενζίνη
γαλαξίας: σχηματισμού
έφηβος: νέος
ζυμώνω: ταλαιπωρία
ράδιο: ραδιόφωνο
rarefied: λεπτός
αεροπλάνο: πουλί
πετάλι: πάτημα
περίπου: σχεδόν, για
φακός: φακός
βαλίτσα: κουτί, αποσκευές
ανταλαγή: ανταλλαγή
προαιρετικός: έθιμο
μήτρα: στομάχι
ζωγράφηση: ώμος, εικόνα
πριν: Ανατολή, πριν, λιβάδι
προσέχω: διαφήμιση
ζάλισμα: καταπλήσσω
επίπτωση: περιστατικό, βουτιά
ανατρέπω: χύνω, καρδιά
αισθητήριος: συναίσθημα, παθιασμένος
ομοφωνία: συμφωνία
επιβλέπω: διαχειρίζομαι, μηνυτής, αστυνομία
μεταμόσχευση: εναλλασσόμενος
αλουμίνιο: αλουμίνιο
διακύμανση: ταλάντωση
προσποιούμαι: μιμούμαι, προσποιούμαι
περιπλέκω: συγκρότημα
μέντορας: σύμβουλος, πούλμαν
σχισμή: άνοιγμα
κορώνη: κοράκι, πύργος, κάστρο, όπλο
χειρίζομαι: χειρισμός, ταραχή
χορτοφάγος: λαχανικό
κανόνας: προσδιορισμός, πρότυπο, κανόνας
μετρό: σήραγγα
αναπνευστικός: αναπνοή
προσομοίωση: μιμούμαι
σύριγγα: βελόνα
μετάλλαξη: αλλαγή, μετατρέπω
εσώρουχα: σώβρακο, λινό
κόλπος: κόλπος
διαφοροποιούν: διακρίνω, διαφορά
εποχής: εποχή
χωρικός: αγροτικός
σουσάμι: τυφλοπόντικας
κώμα: κόμμα
αντιστρέφω: αναστροφή, αντίστροφο
επόπτης: παρατηρητής, εγχειρίδιο
εκβάλλω: εκβάλλω
έλεγχος: έλεγχος, αναθεώρηση
πεζοπορώ: πτήση, περιπλανιέμαι, ανελκυστήρας
τόπος: σημείο
ύφεση: οικονομολογία
λεηλασία: λάφυρο
σύνθημα: σύνθημα
έμβρυο: έμβρυο
ενσωμάτωση: συνεργασία, συμπερίληψη
πορφύρα-βαφή: μωβ, κυανό
σμικροποιώ: ελάχιστα, περιορίζω
κατοικητικός: καταφύγιο
αριθμός: ψηφιακό, αριθμός
αλμυρός: άλας
μηδενικό: μηδέν, αδειάζω
θεωρητικός: θεωρία
ενυδρείο: ψάρι
έλξη: βέτο
αλεξίπτωτο: ομπρέλα
σημαντικό: απαραίτητος
ολικός: γενικά, όλοι, κοινός
χειροτερεύω: σαπίλα
μηδενικό: μηδέν, αδειάζω
σεξουαλικότητα: σεξουαλικός
πηνίο: τόμος, κάλυμμα
κατά-κύριο-λόγο: μεγάλα
ιξώδης: κολλώδης
έντερο: έντερο
αρχαιολογία: αρχαιολογικός
αράπικο-φιστίκι: φασόλι
παράθεση: επίδομα
κουζίνα: σόμπα, κουζίνα
παντελονιού: παντελόνι
κριτήρια: πρότυπο, δείκτης
επισκόπηση: περίγραμμα
ποιοτικός: χαρακτηριστικός
γυαλιά: ποτήρι
γενετική: μορφολογικός, γενεσιολογία, γονίδιο
συμμέτοχος: ενώνω, ρόλος, μετοχή
ρεπερτόριο: ταλέντο, λογισμικό
γυρίζω: κύκλος, γνέθω
διάταξη: οργάνωση, σχέδιο, διάθεση
εγγυητής: βύσμα, παραλαβή
θεώρημα: ποινή, θεωρία, αξίωμα
γνωστική: διάγνωση
διευκρινίζω: επεξεργάζομαι, εξηγώ
τοξικός: δηλητήριο
τόνισε: έμφαση
κονδύλι: βελόνα
κατάπτωση: κρίση
προμηθεύω: σερβίρισμα, υπό-την-προϋπόθεση, διαβεβαιώνω
αντι-: αντιπολίτευση
ανθεκτικός: χρόνιος, αντιπολίτευση, απρόσβλητος
πρόχειρο-φαγητό: τοστ
σινεμά: ταινία, κινηματογράφος
βρύση: σωλήνας
σημάδι: σημάδι
περιφερειακός: περιβάλλων, περιφερειακός
κατηγορηματικός: αποφασισμένος, κατηγορηματικός, επιθετικός, αποφασιστικός, πεισματάρης
κόμβος: πλέκω
παχύσαρκος: πυκνός
αφαιρώ: εκβάλλω, περιορίζω, ισοπαλία, στερώ
αμετάβατος: απαραίτητος
έλιξ: σαλιγκάρι, κατσαρός
κουλουράκι: μπισκότο, κέικ
φουσκώνω: φούσκωμα
ηλεκτρονική: ηλεκτρονικός
ξαναγράφω: αντιγράφω
εργαστήριο: εργαστήριο
επαγγελματικός: επάγγελμα, εμπορικός, επαγγελματικός, δουλειά
βαθμίδα: μίλι, βουτιά
γραφικός: χρώμα
κάλυψη: σκεπαστός, εμβόλιο, φροντίδα, κουβέρτα, στέγη, σχέση, τόμος
περιπλοκή: ενώνω, συμπερίληψη
προσανατολισμός: κατεύθυνση
κατασκευάζω: δημιουργώ, παράγω
θερμικός: έλαιο
στερεοτυπία: εξαίρεση
tech: τεχνικός
υπόλοιπο: λείψανα, πλεονασμός
είδος-φορτηγού-κάρρου: φορτηγό
στάδιο: πεδίο
συντονισμός: συντεταγμένη
βακτηριακός: βακτήρια
διεπαφή: προσέγγιση
πυρίτιο: Π
απομνημονεύω: μνήμη, αποθηκεύσετε, θυμάμαι
διαγνωστικός: διάγνωση
περίληψη: περίληψη
μεταβίβαση: γραμμή, απαγωγή
εκατομμυριοστός: εκατομμύριο
έμπορος-λιανικής: έμπορος
βάριο: μπαρ
επικρατούσα-τάση: κλειδί, δευτερεύων
βαρυσήμαντος: μέσο, επακόλουθος
ήχου: φωνή
σχετικός-με-την σύλληψη ή αντίληψη: σύλληψη
πλέγμα: ιστός
διαστημικός: ατμόσφαιρα, διαστατικός
εξέταση: κουίζ
στα-μέσα-: δευτερεύων, μέση
μακιγιάζ: αποζημιώνω
διακεκριμένος: διαχωρίζεται, μονοφωνία
αναστέλλω: αναχαίτηση, αποτρέψει
πολυ: διάφορος, περισσότερο, πολύ
αποπνικτικός: υγρασία, ζεστός
μορφολογία: μορφολογικός
διαγιγνώσκω: διάγνωση
γρίπη: γρίπη
γραφικών: διάγραμμα
στεφανιαίος: ασθένεια
γλουτός: οπίσθια, ζαμπόν
αρχείο: αρχείο
αντιμετώπιση: πάλη, σύγκρουση, σύγκριση
φορτηγό-πλοίο: φορτηγό
βέλτιστος: άριστος, εξαιρετική
βασικά: όροι
κίνητρο: κίνητρο
όρχις: αυγό
θείο: θείο
επιχειρήσεων: χειρισμός, δράση
τροχιά: τροχιά, τρόπος
συνάφεια: σχετίζονται, σπουδαιότητα, συγγένειες
ποδήλατο: ποδηλασία, κύκλος, τροχός
διευθυντικός: εκδηλωτικός
αερογραμμή: πουλί, αέρας
λίτρο: λίτρο
οπισθοδρόμηση: ματαίωση, σοκ, οπισθοδρόμηση, αποτυγχάνω, εμπόδιο
ενοποιώ: ιπποσκευή, συμφιλίωση
στάση: στάση, θέση, παράγραφος
ελάχιστος: ελάχιστα
κυκλικός: ποδηλασία, περιοδικός
υπόστρωμα: μοριακός
υποβρύχιος: υποβρύχιο
πραγματογνωμοσύνη: εμπειρία, επιδεξιότητα
μηδενικό: μηδέν, αδειάζω
ηλεκτρόνιο: ηλεκτρονικός
διαδραστικό: επικάλυψη
αρχικά: πρωτότυπο
σαμποτάζ: καταστρέφω
αλληλεπιδρώ: ομιλία, καθιστώ-κοινωνικόν
μαθηματικά: μαθηματικά
εμβρυακός: έμβρυο
εκμοντερνίζω: σύγχρονος, εκσυγχρονίζω
εξτρεμιστής: ριζικό, άκρο
ουρώ: ούρο
χώνομαι: εναγκαλισμός
εντάξει: διορθώνω, πολύ
σουφρώνω: κλέβω
σκόπιμος: επίτηδες
ημι: στα-μέσα-του δρόμου, πωλώ, αλέθω, πλάτος
νευρικός: νευρικός
αντι: αντιπολίτευση
φακή: φακός
εγγύτατος: σχεδόν
θρεπτικός: ορυκτό, τροφή
ασαφής: ασαφής, καταφανής
τραύμα: σοκ, βλάβη, έλκος
ανταλαγή: ανταλλαγή
διάνυσμα: φορέας
τακτική: προσέγγιση
αξιολογώ: εκτίμηση
μηδενικό: μηδέν, αδειάζω
κλώνος: αντίγραφο
βιώσιμος: πλεονέκτημα, αποτελεσματικός
αντιγραφής: αντίγραφο
αντιδραστικός: αντίδραση
χρονοδιάγραμμα: ημερολόγιο, φορά, διάθεση
συντακτικός: μοίρα
σταθεροποιώ: ησυχία
διαφωνών: αντίπαλος
ανατροφοδότηση: αντίδραση
ερωτηματολόγιο: κουίζ
οξειδώνω: κλήση
χιλιοστόμετρο: χιλιοστόμετρο
ψυχιατρικός: διανοούμενος
σύνδρομο: ασθένεια
παράδειγμα: παράδειγμα
θέτω-εις-ενέργειαν: καθιστώ-ικανό, κάνω, δράση
τυχαία: τυχαίος, σύμπτωση, να-περίπτωση
εξοστρακιστεί: διαχωρίζεται, μποϋκοτάζ
υποσύνολο: μέρος
μεθοδολογία: τρόπος, προσέγγιση, μια-φορά
έργα-τέχνης: δουλειά
ακολουθητικός: συνεπής, τακτικός
εγκλείω: Κρατήστε, αρπάζω, κλειστός
χιλιόμετρο: χιλιόμετρο
πολυεθνικός: διεθνής
σχεδιαστής: ενοικιαστής, ριγέ, σχέδιο
εκθετικός: εκθέτης
βάζω-κατά-λάθος: χάνω
ερευνητής: επιστήμονας
σουπερμάρκετ: εμπορικό-κέντρο
διανέμω: κατανομή, διακρίνω, διανέμω, ανατομή
μηδενικό: μηδέν, αδειάζω
ποδόσφαιρο: λάκτισμα
δικαιώματος: δικαίωμα, κατάλληλος
αποφάγια: λείψανα, απόβλητα
ανεκτός: πρότυπο
διαστημόπλοιο: σαΐτα
βιωματική: εμπειρία
σημασιολογικός: έννοια, θέμα
γνώστης: εσωτερικός, μέλος
τόνο: τόνος
μονάδα-μέτρησης: modulo, μονάδα, τόμος
ένζυμο: ζύμη
τρόπου-ζωής: Διάρκεια-Ζωής
ζυμαρικά: μάζα
dorm: καταφύγιο
νεαρός: νέος
αποκορύφωμα: σημάδι
αρνούμαι: αρνούμαι, καταστρέφω
φίλος: φιλενάδα, φίλος
συμπεριφοράς: συμπεριφορά
ευχαριστώ: ευχαριστώ
εγκέφαλος: εγκέφαλος, ψυχή
οικολογικός: οικολογία, περιβαλλοντικές
μετανάστης: πρόσφυγας
ενθέτω: συμπερίληψη, βουτιά, θάβω
φωτοτυπία: αντίγραφο, εικόνα
ακτιβιστής: δράση
κοντομάνικη-μπλούζα: πουκάμισο
θεραπευτής: γιατρός, θεραπεία
μεγιστάνας: βασιλιάς
εξέγερση: έξαψη
συγχρονισμό: συγχρονίζω
όξινο: οξύ
λεξιλογικός: λεξικό, λέξη
διάρρηξη: διακοπή
ταξινομητής: ταξινόμηση
avant--garde: πρωτοπόρος
πρόεδρος: κεφάλι
ελεημοσύνη: φυλλάδιο
χαρισματικός: γοητεία
σκάνδιο: τελλούριο
κατευθυντήρια-γραμμή: εγχειρίδιο
υποθέτω: υποθέτω, τάχα
ψυγείο: ψυγείο
επανεκκίνηση: επανεκκίνηση
έμπνευση: σέικ, ιδέα
αναπαράγουν: αντίγραφο, μιμούμαι, επανάληψη
αγωνία: φόβος
κατάπαυση-του-πυρός: εκεχειρία
γκάφα: παράλειψη, λανθασμένος
βιομηχανοποιώ: εκβιομηχάνιση, βιομηχανία
αμφιθαλής-αδελφός: αδελφός
εκπρόσωπος: ομιλητής, εκπρόσωπος
εκβιάζω: απαγωγή, άροτρο
μη-μεταλλικών: μεταλοειδές
ρευστός: γρίπη, υγρασία, τρέξιμο
όψη: κατεύθυνση, σχηματισμένος, πλευρά
από-περίπτωση: 
καλοσύνη: αρετή, πλεονέκτημα
χαλαρά: χύμα, δωρεάν
αργότερα: μελλοντικός, έπειτα, μετά
δυσκολία: ταλαιπωρία
ομάδα: ζώνη
γενικά: πλάτος, ευρύνω, γενικά
συσχετίζω: σχετίζονται, άγκιστρο
σύμφωνα-με: πίσω
μηδενικό: μηδέν, αδειάζω
δελτίο: φυλλάδιο, πληροφορίες
αποδοκιμάζοντας: έγκριση, απαράδεκτος
μπανιέρα: λούτρο
διασκεδαστικός: ψυχαγωγία, διασκεδάζω, εύθυμος
εκτός-από: εκτός
εμφάνιση: αναδύομαι, έξοδος, αύξηση
μηδενικό: μηδέν, αδειάζω
μάγουλο: παιχνίδι
πρέπει: πρέπει, δασμός
τοις-εκατό: τοις-εκατό
δίκη: κοστούμι
μηδενικό: μηδέν, αδειάζω
μέσω: πέρασμα, πάνω-από
σοπράνο: παιδαριώδης
διασκεδαστικός: εύθυμος
Μμ.: απόγευμα, νύχτα
ασπράδι-αυγού: πρωτεΐνη
αιματοχυσία: αιματηρός
θούλιο-άτομο: θόριο-άτομο
στροφή: κλίση, καλώδιο
συνδετήρα: σύνδεση
exhortative: παραινετικός
τέρβιο-άτομο: θόριο-άτομο
ενοικιάζονται: ενοίκιο
μακιγιάζ: αποζημιώνω
καλαμπούρι: αστείο
config: κατασκευαστικός
ο-το-παρελθόν: τελευταίος
να-διαιρέσει: διακρίνω, διανέμω
καθηγητής: κύριος
ρόδιο-άτομο: θόριο-άτομο
κατάσταση-σημάδι: 
χώρος-σημάδι: 
γραφειοκρατικός: γραφειοκρατία
ζώνη: ζώνη, ιπποσκευή
μηδενικό: μηδέν, αδειάζω
πωλητής: έμπορος
μηδενικό: μηδέν, αδειάζω
λανθάνιο: τελλούριο
θέμα-περίπτωση: θέμα-περίπτωση
εποικοδομητικός: δημιουργώ, διατύπωση, κατασκευαστής
μηδενικό: μηδέν, αδειάζω
θηλυκός: θηλυκός
ελεγκτής: επιθεωρητής, λογιστής
μικρόφωνο: μικρο
έξω-από: έξω, εκτός
εγγραφή: συμπερίληψη, εγγραφή
δείκτης: δείκτης
αιγίδα: υποτροφία, φροντίδα
αμαθής: αμαθής
μηδενικό: μηδέν, αδειάζω
τυποποιώ: προσδιορισμός, πρότυπο
ώρα: σημείο, ώρα
σπιτονοικοκύρης: ιδιοκτήτης
ανακριτής: determiner, επιστήμονας, ντεντεκτίβ
φούντωσε: κάηκε
μηδενικό: μηδέν, αδειάζω
εξουσιοδοτώ: καθιστώ-ικανό
άμυνα: φροντίδα
διάδρομος: αίθουσα
διαπραγμάτευση: ομιλία
ξεκούραστος: φρέσκο, εκσυγχρονίζω
οφιοειδή: κλίση
εμπρός: πρώτα, επόμενος, προς-τα-εμπρός
αναπνοή: απρόσβλητος, αναπνοή
μηδενικό: μηδέν, αδειάζω
προχώρηση: πρόοδος
αμετάβατος: απαραίτητος
ευφορία: ενθουσιασμός
ευρύς: ευρύνω, πλάτος, εκτενής
αμετάβατος: απαραίτητος
αντιπαράθεσης: αντίθετος, αντιμετωπίζω
έκθαμβος: έκπληκτος
παραπομπή: παρουσιάζω
απόγονος: οικείος, εγγονή, γενιά
παγωτό: κρέμα
ακτίνα: ακτίνα
εναλλακτικά: αλλιώς
γειτονιά: περιβάλλων, ζω, περιβαλλοντικές
που-χρησιμοποιούνται-στη: έθιμο
αμηχανία: ντροπή, αταξία
ουσιαστικά: μεγάλα
πρόσφατα: φρέσκο, πρόσφατα, ρίζα
χορός: παιχνίδι, χορός
μηδενικό: μηδέν, αδειάζω
ποσό-σημάδι: 
κοινωνικός-σημάδι: 
κριτική: κριτική
ρουβίνιο-άτομο: θόριο-άτομο
πάλη: πάλη, σύγκρουση, πόλεμος
παραπονούμαι: για
μηδενικό: μηδέν, αδειάζω
βανάδιο-άτομο: θόριο-άτομο
ουδέτερος-γένος: αρρενωπός-γένος
φθόριο-άτομο: θόριο-άτομο
ταξίδι: επίσκεψη, σαφάρι, εκστρατεία
αρρενωπός: αρσενικός
μηδενικό: μηδέν, αδειάζω
αναπτυξιακές: εξελικτική, πρόοδος
εφαρμοσμένος: πρακτικός
να-κλείσω: κλειστός
καυχιέμαι: φιγούρα
οπισθοδρομικός: πίσω
ο-παρόν: παρόν
μηδενικό: μηδέν, αδειάζω
τυχαίο: τυχαίος
συνεργατική: συνάδελφος
συνταξιούχος: αποσύρω
μηδενικό: μηδέν, αδειάζω
διασκεδάζει: ευτυχισμένος, εύθυμος, διασκεδάζω
κατά-προσέγγιση: κατά-προσέγγιση
δυαδική: δυάδικος
συμπληρωματικός: συμπλήρωμα, επιπλέον
ομιλητικός: αλληλογραφία, ομιλητικός
μηδενικό: μηδέν, αδειάζω
στο-περίπτωση: να-περίπτωση
πολώνιο-άτομο: θόριο-άτομο
ανάλυση: διαχώριση, ανάλυση
μαύρισμα-από-ήλιο: καστανός
πρόβλημα: προβληματικός, ταλαιπωρία
μεταφράζω: μετάφραση, αναρρίπτω
μηδενικό: μηδέν, αδειάζω
θάλλιο-άτομο: θόριο-άτομο
κλίκα: συσφαιρώνω, κλικ
εύκολος: εύκολα, απλός
μεσολαβητής: διευκόλυνσης, διευθυντής
κοινωνικά: κοινωνικός
αντιστοίχιση: κοστούμι, συμπίπτω
ατύχημα: περιστατικό
αυτό-το-οποίο: ο-οποίος
με-ενδιαφέρο: ισοπαλία
άνω-κάτω: αντίστροφο
ζιζανιοκτόνο: δηλητήριο
μηδενικό: μηδέν, αδειάζω
εισερχόμενος: μετοχή
για-παράδειγμα: παράδειγμα
όγκος: όγκος
φθορά: σαπίλα
μηδενικό: μηδέν, αδειάζω
δικτυακός-τόπος: δικτυακός-τόπος
πάρα-πολύ: ογκώδης, πολύ, σούπερ
θα-είναι: 
σχετικός-περίπτωση: σχετικός-περίπτωση
σκοπός-περίπτωση: προορισμός-περίπτωση
ανταμείβω: αποζημιώνω, πληρωμή
κακομεταχειρίζομαι: λανθασμένος
πλέκω: κορυφογραμμή, πλέκω
αντί: αντί
αρχαιολογία: αρχαιολογικός
υποδοχή: συνδετικό-ρήμα, βύσμα, προσάρτημα, υποδοχή
μηδενικό: μηδέν, αδειάζω
γενίκευση: γενικεύω
στρόντιο-άτομο: θόριο-άτομο
ρουθήνιο-άτομο: θόριο-άτομο
Εξαιρουμένων: εκτός
μηδενικό: μηδέν, αδειάζω
υποχώρηση: εκτρέπομαι, οπισθοδρόμηση, αποσύρω
συνταξιούχος: αποσύρω
ο-ενας-τον ΑΛΛΟΝ: κάθε---άλλο, άλλα
ευρύς: εκτενής
χρήση-υπολογιστή: λογαριασμός, ηλεκτρονικός-υπολογιστής, αριθμομηχανή
επιχείρηση-πρόσωπο: επιχειρηματίας
λουκάνικο: λουκάνικο
επικράτηση: αποτέλεσμα, εξουσία, πλεονέκτημα
κλείω-την-παραπομπή εις τα εισαγωγικά: παραθέτω
κτητικός-περίπτωση: γενική-περίπτωση, κτητικός-περίπτωση
γενεσιολογικά: γονίδιο, γενεσιολογία
ενδοτικός: κινούμαι, μαλακός
έμμεσος-αντικείμενο: απευθείας-αντικείμενο
απαγορευτικός-διάθεση: απαγορευτικός-διάθεση
προπόνηση: άσκηση, δουλειά, επεξεργάζομαι
οριοθετημένο: περιωρισμένος, διαχωρίζεται
αντίθετος: αντίστροφο, αντιπολίτευση, απέναντι, αναστροφή, αντίθετος
αναρρίχηση: αύξηση
απίστευτα: ασυνήθιστα, σούπερ
μηδενικό: μηδέν, αδειάζω
κλείσιμο: κλειστός, αργαλειός
φτηνά: φτηνός
καμβάς: ύφασμα, ιστός
μορφωμένος: εκπαίδευση, ευγενικός
άγρια-​​ζωή: φύση, άγριος
αντιτιθέμενες: αντιπολίτευση, απέναντι, προς
μηδενικό: μηδέν, αδειάζω
εκσκάπτω: σκάβω
μολυνθεί: μόλυνση
μηδενικό: μηδέν, αδειάζω
ένοπλος: όπλα
δηλαδή: δηλαδή
κανένας: τίποτα
ορκωμοσία: ορκίζομαι, βλαστήμια
κωνικό: λεπτός, κώνος
καλλιτέχνης: ψυχαγωγία, καλλιτέχνης
και-τα-λοιπά.: 
εκτός---από: εκτός
περίγραμμα: περίγραμμα, περιβαλλοντικές, μορφή
κινητό-τηλέφωνο: κινητό-τηλέφωνο, κύτταρο
δεσποινίδα: τομή, χάνω, ξοδεύω
ανησυχητικός: τρομερός, ανήσυχος
ο-μελλοντικός: μελλοντικός
υποτακτική-διάθεση: υποθετικός-διάθεση, ευκτικός-διάθεση
θα-έπρεπε: πρέπει
μοτοποδηλάτων: μοτοσυκλέτα, μοτέρ
πιστωτική-κάρτα: πίστωση
μηδενικό: μηδέν, αδειάζω
ο-δημόσιο: δημόσιο
κινητό-τηλέφωνο: κινητό-τηλέφωνο, κύτταρο
μηδενικό: μηδέν, αδειάζω
έντερα: έντερο
παρατάσσω: διανέμω, σκορπίζω, καταναλώνω
απελαύνω: εκβάλλω
ποσοστό: στοίχημα, μέρος, ποσοστό
αρμοδιότητα: επιδεξιότητα, δικαιοδοσία
κτηματίας: άγγελος
εμπρόθετος-περίπτωση: 
κατανομή: κατανομή, μέρισμα, επίδομα
ανησυχητική: ανήσυχος
εντάξει: ίδιο, πολύ
επιβολή: αναγκάζω
pro-φράση: pro-πρόταση
αισθητήριο-νεύρο: συλλέκτης
κάνω-ένεση: παρουσιάζω
εκπληκτική: καταπλήσσω, εκπληκτικός
βήχας: βήχας
δίπλα-στο: επόμενος
