απαρέμφατο: hnit
ονομαστική-πτώση-περίπτωση: hnak
αιτιατική-περίπτωση: hkak
θέμα-περίπτωση: htak
μητρική-εταιρεία: hmat
μπαμπάς: hpap
μαμά: hmam
Χαίρετε: hnat
πρόγονος: htat
παππούς-και-γιαγιά: hyat
πεινασμένος: hcac
γενική-περίπτωση: hnik
επίθετο: hcit
και: hwan
μου: hmic
εσείς: hnan
μας: hnam
το: hyic
προορισμός-περίπτωση: htas
δοτική-πτώση-περίπτωση: htik
εσωτερικό-συμφραζόμενα: htis
πρόσωπο-συμφραζόμενα: hpak
εξαρτώμενος-ρήτρα: htan
τελειοποιητικός-άποψη: htap
το-παρελθόν-σε υπερένταση: hkat
αρρενωπός-γένος: hsan
comitative-περίπτωση: hmik
παρόν-σε-υπερένταση: hyan
benefactive-περίπτωση: hpik
essive-περίπτωση: swik
δεν: hnic
του: hsis
επιφάνεια-συμφραζόμενα: hsak
adpositional-περίπτωση: hpan
τοποθεσία-περίπτωση: hwak
χώρος-συμφραζόμενα: hnos
τρόπος-περίπτωση: hrak
ενόργανος-περίπτωση: hsik
ο-οποίος: hkan
ερωτηματικός-διάθεση: hnim
και-ή: htam
αποκλειστικού-ή: hkit
πηγή-περίπτωση: hsok
αφαιρετική-πτώση-περίπτωση: hlak
εκδηλωτικός: hdit
αλλά: hlan
όλοι: hsut
θηλυκός-γένος: hnin
αυτοί: hwin
πληθυντικός-αριθμός: hlun
ένας: hyik
μελλοντικός-σε-υπερένταση: hwet
κοινωνικός-συμφραζόμενα: hson
πότε: hkap
ατελή-άποψη: hmap
εκεί: hkac
υποθετικός-διάθεση: hcan
περισσότερο: hdoc
έξω: htac
σχετικός-περίπτωση: hrik
illative-περίπτωση: hlik
κάνω: hkas
διευθυντικός-διάθεση: hden
δεοντικό-διάθεση: hdim
ερώτηση-λέξη: hwac
συνδετικό-ρήμα: hkok
πρόσωπο: hpon
αρσενικός: hman
θα-μπορούσε-να: kwat
άλλα: hcon
αριθμός: hnoc
πολύ: tcac
φορά: htim
χρόνος-συμφραζόμενα: htos
χρονικός-περίπτωση: hmak
για: hkam
επιστημονικές-διάθεση: hsim
μόνο: htun
λίγο: hcak
έπειτα: pcan
παραινετικός-διάθεση: hton
αναδρομικός-άποψη: hrip
εξαιρετική: hcat
θελητικός-διάθεση: hlim
πριν: hsec
πρέπει: pcic
δυο: htut
βλέπω: tcan
ξέρω: hsat
κάτω: hcin
μετά: hcas
πρώτα: hpas
ίδιος: hpun
απαλλοτριώσιμος-κατοχή: hlic
ποτέ: hnac
αναπαλλοτρίωτος-κατοχή: hkic
παλιός: hwat
συμβουλευτικός-διάθεση: hcim
ημέρα: htin
που: hnap
Έλα: hlat
τρόπος: hyas
δουλειά: hkaf
φωνήεν: hwaf
πάω: hkun
perlative-περίπτωση: pwik
προοδευτικός-άποψη: hpip
μακρύς: hlac
λέγω: hsac
πως: hkin
ακόμη-και: hpit
πίσω: hwap
εδώ: hcic
νομίζω: hcik
ίδιο: hsam
τελευταίος: kcac
μακριά: twan
κάτω-από-συμφραζόμενα: hnas
παίρνω: htit
θεμελιώ: hfan
χέρι: cyat
νέος: hyac
αν-και: hyap
δίνω: hkik
θεός: hmac
delative-περίπτωση: lwak
τίποτα: hmin
δικαίωμα: hyit
μια-φορά: hyam
semelfactive-άποψη: fwip
μέρος: hpat
είδε: htic
σπίτι: hfas
κόσμος: tcat
κεφάλι: hcaf
τρία: tyin
Νέο: hnon
εστία: hcok
αγάπη: hpac
πάντοτε: hsit
νύχτα: hwit
κάθε: hmit
βασιλιάς: hyak
μεταξύ: hsin
καρδιά: cyin
paucal-αριθμός: plom
επειδή: hyok
αιτιώδης-συνάφεια-περίπτωση: ksak
πράγμα: hkis
σειρά: swat
όνομα: hnem
κατάλληλος-ουσιαστικό: hran
παραινετικός: hrat
χώρα: hlit
ερωτηθείς: hput
ορατός-αποδεικτικός: crit
καλύτερα: pcac
πλευρά: psac
πορεία: hkus
θηλυκός: hfin
αρκετά: kyat
σύντομα: hpuc
γεμάτος: hcun
δωμάτιο: hfac
σχεδόν: hlap
δεν-μπορώ: nyat
νερό: hwik
desiderative-διάθεση: hdin
ελαφρης: lyak
ούτε: hnun
λέξη: slat
θύρα: tyan
χρήση: hpus
πρωί: hsap
ληκτικός-περίπτωση: twik
εξουσία: hkuk
εαυτούς: hmis
παρόν: hyin
φωνή: hwas
άσπρο: hpis
χρήματα: tlan
επόμενος: kyak
φτωχός: hyis
θάνατος: hmut
μορφή: hfam
inessive-περίπτωση: nwik
είδος: tyac
συχνά: tsan
έτος: nwan
φίλος: myat
παραγγελία: hyut
επιτακτικός-διάθεση: hpim
γύρος: hcut
πιστεύω: hban
δημόσιο: hpin
κατάσταση-συμφραζόμενα: hsas
υιός: psat
εκατό: hmas
παιδιά: hcis
έτσι: tyak
ελπίδα: hcap
πάνω-από: hyip
αγαπητός: pyin
ανάγνωση: pyac
πόλη: hsic
ήδη: hpic
γεγονός: hfat
Factive-αποδεικτικός: hfit
ακούω: hsun
ελάχιστα: hmim
ίσως: pyat
ανοιχτό: kcat
σώμα: tcic
αέρας: cwac
φύση: nyit
βοήθεια: mlat
επιστολή: lyat
τέσσερα: ksat
ευκτικός-διάθεση: hpam
φωτιά: hfak
επομένως: hyif
ώρα: hcam
δωρεάν: tyit
πόλεμος: syat
αν: hsaf
λόγος: kyan
ενωμένος: hnut
κλήση: hkuc
Γιατί: hwam
χαμένος: hkut
χίλια: tsas
οικογένεια: hfic
ψυχή: twam
ερώτηση: swac
φροντίδα: kcan
REALIS-διάθεση: hlin
μέσο: mwit
δυνητικός-διάθεση: hten
προς: cyan
allative-περίπτωση: lwik
ανθρωπική-γένος: hrin
μικρός: kyut
ικανός: hyuk
ζω: hkip
θέμα: hsek
ίδιο-θέμα-σημάδι: hcek
διαφορετικός-θέμα: hfek
απάντηση: tsat
θάλασσα: mwat
φόβος: hcoc
καταλαβαίνω: pcat
σκληρά: kyin
όροι: tyut
αμφιβολία: hdac
dubitative-διάθεση: twin
παρακαλώ: psan
όπλα: tcas
μαύρος: clis
φέρω: tyat
όμορφος: ksis
σκοτάδι: tcak
Κρατήστε: psak
δέκα: htaf
προβολή: pyan
ιστορία: hkif
κοινός: kwan
βιβλίο: hkup
ηλεκτρονικός: lyin
ομιλία: plak
σημάδι: myac
ενδιαφέρον: nyis
γράφω: kcit
κρεβάτι: pwat
απαραίτητος: syis
ιδέα: hwis
τέχνη: klat
vialis-περίπτωση: hlas
αδελφός: pyak
μερικές-φορές: ksas
γραμμή: lyan
τραπέζι: tlas
ποτάμι: nwit
μάτι: kyac
πληροφορίες: fyin
ξαφνικά: tfan
παράξενος: hgan
βαθύς: ksan
αλλαγή: hrit
συναίσθημα: nwac
συναντώ: mlit
σκοπός: htuc
ευτυχισμένος: hcuc
φαίνομαι: syit
αίμα: cyac
τριαντάφυλλο: kwas
νότος: swan
κρύο: tlat
προς-τα-εμπρός: myik
θέση: psis
αργά: tyam
στάση: syan
υποθέτω: nlas
κόρη: pyit
ορυχείο: myan
τομή: hkim
αντίγραφο: hfap
σύζυγος: hgat
έξι: hlis
θυμάμαι: twat
αποτέλεσμα: hyaf
πτώση: htuk
εκτός: hsip
μαλλιά: hpaf
πέρασμα: pyas
πνευματική-ιδιοκτησία: pcit
στρατός: cyit
τρέξιμο: kcak
άλογο: kcas
μελλοντικός: hwic
Δύση: pcak
πληρωμή: plit
κόκκινος: hyun
χρυσός: tcun
επιθυμία: hdan
παιχνίδι: plin
κύριος: mwas
γραφείο: hfus
κυβέρνηση: syak
εκκλησία: kyas
μήκος: hlen
εταιρεία: ksin
χαρτί: kyis
πιθανότητα: hbin
ειδικά: cyas
αρκούδα: pcas
παράθυρο: cyak
συμφωνία: hgac
ομορφιά: syac
δασμός: tfac
στέλνω: fyan
απόσταση: htif
σιωπή: slan
πόδι: fyat
άγριος: kyik
καλούπι: myam
αποθηκεύσετε: pfan
πράσινος: kcin
ταλαιπωρία: mlan
χαμόγελο: myak
λανθασμένος: clat
διάφορος: pcin
ύπνος: slit
quotative-περίπτωση: kwik
αρχή: cwan
δράση: kfan
επίσκεψη: fwat
ακολουθώ: nlan
δοκιμή: tcis
παρουσία: psit
γλυκός: tlit
πλούσιος: tcin
εχθρός: tcam
πλοίο: hcip
κατάσταση: kyit
συμπεριλαμβανομένου: hkum
περιεκτικός-πρόσωπο: hlon
μυστικό: kwit
precative-διάθεση: pwim
ευγενικός-μητρώο: hbit
κακό: pwac
Μάρτιος: myas
οτιδήποτε: kwac
διαμονή: hlam
αντί: plat
μπλε: plan
αδύνατος: psap
σχολείο: hsuk
ευκαιρία: ksac
παντρεμένος: nwat
τροφή: hcuk
είκοσι: tsis
ησυχία: tcit
εύκολα: hnis
υποψήφιος-άποψη: hrap
γλώσσα: lyac
έκφραση: syas
εβδομάδα: hsus
αίθουσα: hcum
κίνδυνος: kcic
ιδιοκτησία: myit
γεννημένος: nyan
δικαστήριο: kcut
γενικά: tyap
gnomic-άποψη: hmip
αξία: tyas
απλός: syap
δέντρο: pyic
πάλη: pyap
τείχος: twit
ουρανός: cwak
εναρκτικός-άποψη: htip
jussive-διάθεση: hjin
τόνος: twun
σχέση: klan
αναμένεται: pcik
μήνας: hmaf
εμπειρία: nyap
εντελώς: nyac
φρέσκο: tsac
δούκας: hnuk
σκεπαστός: kwak
όριο: hyim
Ανατολή: tyuk
πέτρα: pwan
κάπως: kfat
κατεύθυνση: tlac
καρέκλα: kwis
υποστήριξη: syut
ημερομηνία: tyic
χωριό: klac
πεδίο: clit
άδεια: nwin
επιτρεπτικός-διάθεση: hmom
επιτυχία: slak
κατάλληλος: hric
λόφος: clin
μουσική: ksik
άπω-εκδηλωτικός: hdat
απόγευμα: htup
κραυγή: hyuc
τιμή: hnaf
επτά: swit
ιδιωτικός: pfat
νέα: nwas
σκηνή: slac
κήπος: cyam
αγώνας: htus
διανεμητικές-περίπτωση: twak
μαθαίνω: clan
πολιτικός: syik
ψέμα: kcun
εκμαγείο: tsak
φάω: kcam
πάτωμα: hlaf
άρρωστος: pwin
πρωτότυπο: mlin
καλοκαίρι: kyam
θρησκεία: tlam
εικόνα: ksit
διαφυγή: plap
συγγραφέας: hlut
καστανός: pyun
αποφασισμένος: htem
πόνος: hdon
άνοιξη: psin
αιώνας: syic
μαλακός: mwan
γωνία: kyun
παράγω: psas
γέλιο: cyaf
ξεχνώ: flat
Ευρώπη: hyup
οκτώ: lwat
φόρεμα: lwac
τρομερός: cyap
αναπνοή: syaf
σοφός: hbas
κτητικός-σημάδι: srak
μνήμη: myin
σύγχρονος: fwan
σημείο: tcap
αύξηση: hyus
διακοπή: pyik
πενήντα: hfis
νησί: tlap
επαφή: hsuc
υπόσχεση: pcam
commissive-διάθεση: mwin
βαθμός: tfat
σχέδιο: plac
συμπεριφορά: nyak
έκπληξη: cran
λεπτό: hmun
βολή: hwut
χειρότερος: pcap
ποτήρι: klak
παράδειγμα: tlin
ασφαλής: hsif
γιατρός: tsit
completive-άποψη: hmep
αλλεπάλληλος: tyun
στρατιωτικός: slin
ζεστός: nyam
ποτό: pfin
ερωτήσεις: pcaf
θυμός: nran
κατευθείαν: tyik
καπέλο: hcup
σκύλος: kwap
υπηρέτης: hnuc
υπερηφάνεια: hram
πλήθος: tcuc
τρένο: nyin
ηθικός: myut
σχετίζονται: kyim
εισάγω: fyak
κανόνας: nyas
σπαθί: cwat
επίθεση: kfak
υγεία: clac
παράγραφος: pyaf
κοινωνικός: hsum
επιστροφή-χρημάτων: tfit
Συγνώμη: hpec
θάρρος: krac
χάρη: hnen
επίσημος-ανώτερος-υπάλληλος: hfaf
υπό-την-προϋπόθεση: tsik
αίτηση: pwit
ματιά: klas
κίνηση: hyon
αναμένω: cwit
απέναντι: psam
δώδεκα: tyaf
αρραβωνιασμένος: nyut
κρασί: hwun
γεύση: swut
σίδερο: fyac
διανέμω: syin
εμπόριο: myap
πλεονέκτημα: twac
ρούχα: kfip
δικαστής: fwak
διαφορά: tfaf
ανήσυχος: kcis
καπετάνιος: kwin
πεπερασμένος: nlat
παύση-άποψη: hsep
περίεργος: kyic
αλλοδαπός: kwic
ενισχυτή: hnif
σπουδαιότητα: myun
τελικά: hfim
νομοσχέδιο: fwin
αποδεικνύω: hpuk
αποτρέψει: flan
λαιμός: cyun
νομικός: hfik
ξηρός: swak
σερβίρισμα: syam
χάνω: pcut
απόδειξη: pyut
αποδεικτικός-περίπτωση: hdak
πρόοδος: pyis
κτίριο: klit
έρευνα: syuc
λυπημένος: hrac
αμαρτία: psip
τριάντα: tfis
τίμιος: tsin
κλειστός: kyap
τράπεζα: pcun
μοίρα: cyik
δάσος: hfun
μέτρο: mlac
αλλιώς: htoc
ρεύμα: lyam
ψωμί: hpup
επιπλέον: tfak
επιλέγω: twas
ζώο: nwam
ζωικός-γένος: hzin
eventive-διάθεση: hwim
ίδιο-συμβάν-σημάδι: hcom
πολλαπλασιαστική-περίπτωση: tlak
πυκνός: hmus
πλάσμα: hyum
βροχή: myic
επιφάνεια: pfas
άγιος: swis
Ιούλιος: clim
έκθεση: hfut
ακτή: pwas
αρχείο: hfif
ώμος: cwut
έκπληκτος: kran
βασιλικός: klik
τραγούδι: hkuf
άνεση: kfaf
κάποιος: nyic
γρασίδι: kcap
ισοπαλία: cwik
άνοιγμα: cyic
Ιούνιος: cwun
ψάρι: mlic
κεφάλαιο: klin
στήθος: cyut
χιόνι: hcif
εκπαίδευση: tlik
αιχμηρός: tcaf
κρίμα: hdam
δαπάνη: fyas
δικό-σου: hmuc
εκατομμύριο: mlun
κουρασμένος: tcik
σκοτώνω: ksam
σκιά: cwap
βάρος: plas
μάζα: mlas
καθιερωμένος: tlip
γενναίος: pyam
λεπτός: plic
ικανοποιημένοι: srat
έλεγχος: kcik
αρετή: hdet
εθνικός: nyaf
θεϊκός: swin
κοιλάδα: clak
εικασία: kwam
κερδοσκοπικός-διάθεση: hken
κίτρινος: clas
λείψανα: mwac
κλίση: nlac
κουτί: pwak
εποχή: tsim
επιστήμη: slas
οπή: kcuc
θείος: hmuk
λίστα: lyit
Αύγουστος: ksut
δημοφιλής: hlup
άγνωστος: fyit
οικείος: flak
οικείος-μητρώο: krit
αναγνώστης: tsut
προσέγγιση: pcuc
δυο-φορές: tsap
διανοούμενος: tfik
όντως: tsam
παπάς: pcis
τραυματίας: fran
λύπη: hpom
παλάτι: kfas
ρυθμός: clap
ε;: hnec
ανόητος: myuk
άκρη: pfac
εννέα: nwun
έκρηξη: psut
υποφέρω: tfas
θόρυβος: hcus
βιβλιογραφία: lyic
συμβουλή: swas
αδειάζω: kcuk
τάξη: psik
καταιγίδα: tcut
τσέπη: kyip
φαντασία: nlin
ποινή: cwas
Νοέμβριος: nwap
Δεκέμβριος: tsip
απουσία: psic
ευχαριστώ: ryak
διεύθυνση: tyis
πουλί: pyuc
ιδιοκτήτης: mlik
παλτό: kwut
προετοιμάζω: tyip
συγγένειες: lwan
καπνός: htum
Ιανουάριος: nwak
μηχανή: clic
περιεχόμενο: nyik
δόντια: tlis
ντροπή: hcet
κόλπος: kcaf
εγκέφαλος: pyuk
δαχτυλίδι: klic
φράση-σημάδι: frak
πλατεία: ksap
καρπός: fyut
τσάι: tsic
εξηγώ: slam
καλωσόρισμα: cwam
ποίηση: pwis
αγορά: klam
πιστός: hdic
έξαψη: hcen
σαράντα: klis
Απρίλιος: pyip
ευγενώς: kfit
Οκτώβριος: kfap
πικρός: kyuc
δούλος: tlaf
χύμα: hluk
κείμενο: tsus
πίστωση: cyip
δεκαπέντε: pfit
σκληρός: kcim
ενώνω: cluc
διαδικασία: hpif
έγκλημα: kyaf
σκόνη: tsuc
πρακτικός: plik
χρώμα: nlak
καταστρέφω: nyuc
αυξάνω: lyas
μύτη: hnus
ομολογώ: tyim
εχθές: kfac
hesternal-σε-υπερένταση: tlen
αποτυγχάνω: slap
συνεχίζω: tcim
φορούν: pwam
τυφλός: nlit
ντουζίνα: tsun
μύγα: fyap
έπαινος: cwin
διάβολος: cwaf
σταδιακά: twic
θυσία: kyif
άσκηση: cyis
συνείδηση: tfin
θεωρία: tlic
υπουργός: myis
μισώ: hnet
λίμνη: cwic
κέντρο: syun
λιποθυμία: pfic
λογικός-γένος: hron
προσεκτικός: fwac
απολαμβάνω: nlam
λατρεία: pwap
εμπορεύματα: twap
δέρμα: twaf
στέγη: tlut
στέμμα: gyan
κάστρο: klap
θρόνος: tcus
επισυνάπτεται: nlaf
μίλι: mlim
άκρο: krim
φυλακή: fyis
φλιτζάνι: kcip
μέλος: mlam
εμφύλιος: syim
παντού: tsaf
καταφανής: tfic
ζευγάρι: pwaf
τόμος: clam
έθιμο: ksaf
τόξο: ksun
κοστούμι: slut
κρέας: mwak
γάλα: hluc
φυτικός-γένος: hwen
όραμα: slic
σπάνιος: nlap
εξάδελφος: ksic
γέφυρα: pwut
προστατεύω: pfak
άλας: swam
αθώος: hwus
βασίλισσα: kwim
κόμης: kcus
περιέργεια: hras
χορός: tyus
ξενοδοχείο: clut
γέμισμα: flin
φυλακισμένος: psun
κατάστημα: hjan
σκάλες: sric
ικετεύω: hmen
άμμος: sran
βίαιος: hgit
Σεπτέμβριος: hsem
αναχώρηση: prac
καταστροφή: crin
επιδεξιότητα: krin
βοοειδή: hwec
εξοπλισμός: hwip
κουζίνα: hkon
πωλώ: hbak
ταχύτητα: hsot
σύναψη: clon
ηλεκτρονικός-υπολογιστής: hkot
αιώνιος: hsen
περιωρισμένος: mrit
βιβλιοθήκη: hbek
βάση: hbac
σύγχυση: hrun
ένδοξος: cris
επίσης: hjic
έντρομος: hbic
δυστυχής: prin
άρθρο: hrek
μάγειρας: kfin
ζώνη: hbat
έρημος: hget
φιλί: hbun
μπάλα: hbot
ραβδί: hpot
επιχείρημα: hrut
παρατηρώ: nrak
ευλογία-διάθεση: hbim
εκπληκτικός: hrim
ένοχος: hdis
όπλο: hgin
αστυνομία: plis
κρύβω: hzan
εκστρατεία: srin
αμαθής: nrin
γενναιόδωρος: drac
σύννεφο: blan
απόβλητα: htek
Φεβρουάριος: frif
ασθένεια: hren
ξοδεύω: bwan
πηγή: sron
πρωτοβουλία-περίπτωση: hnok
θεία: hbam
καθυστέρηση: dlic
καθυστέρηση-επιτακτικός: hlip
αναφερθεί-αποδεικτικός: prat
μεσάνυχτα: dyit
ήρωας: nrac
φιλοσοφία: hfof
δάχτυλο: hjit
άνετος: hzat
κάπου: hmoc
τύπος: bran
προσωπικό: hraf
ανταμοιβή: rwan
ευθύνη: dlac
μιζέρια: krat
μέτωπο: htec
διαφήμιση: glan
άγγελος: htet
ενικός-αριθμός: hgam
αυγή: hbon
εμπορικός: krak
συγχωρώ: pran
πρόβατα: hcec
υπομονή: hpen
αγρόκτημα: crac
αναφορικός: hrec
καλαμπόκι: mran
κλειδί: kcif
πλειοψηφία: hmot
αδυναμία: hdut
ατμόσφαιρα: traf
στεναγμός: tcoc
ανθρωπότητα: mlis
αντιπολίτευση: pric
δίσκος: hdik
μοναχικός: hket
καλλιτέχνης: nrat
ιππότης: cwis
γοητεία: tran
απόφαση: drin
κυβερνήτης: gran
υποκατάστημα: rwac
διάθεση: hsoc
ενθουσιασμός: tsum
επαγωγικός-διάθεση: hdum
κοινότητα: hmum
έλαιο: hyen
σωλήνας: hbap
αποτύπωμα: trat
oh: dyoc
ομιλία-συμφραζόμενα: hros
κλητική-πτώση-περίπτωση: hwok
καμπίνα: ksen
τρομάζω: plam
νευρικός: hnes
μόνιμος: hset
μαχαίρι: ksuk
μετάξι: slik
περιφρόνηση: grin
κόλαση: nrik
διαχωρίζεται: plen
σοβαρά: mrat
μικτός: mrik
ξύλινος: mrak
προτιμώ: hpet
προειδοποίηση: trin
νουθεσία-διάθεση: htom
ώθηση: hmos
φιλοδοξία: mrac
αρνούμαι: hnek
σύνταγμα: swic
όργανο: srit
συνεχής-άποψη: hnip
παλίρροια: hgas
κολλέγιο: klen
ουρά: hkek
γενιά: nric
Γάτα: blat
απευθείας-αποδεικτικός: hret
εγκαταλειμμένος: trac
έντεκα: hyec
ένστικτο: nlik
χαρακτηριστικός: trit
φυλή: hgik
φοβισμένος-διάθεση: pcim
καταφύγιο: crat
αγενής: hruc
ιππασία: hris
σέικ: hmon
βιομηχανία: hdot
επάγγελμα: hres
λυχνία: hdap
καφές: kfif
υπακούω: htot
βόρειος: nrit
νοσοκόμα: nris
διαβεβαιώνω: hjat
αλυσίδα: ryin
διδασκαλία: cric
παπούτσια: hgut
αυλή: mram
ασαφής: hmec
αλλού: hlet
διαμέρισμα: pret
δραστηριότητα: twot
Σάββατο: cram
λιακάδα: hduc
χήρα: hwuc
στοιχείο: hlem
αντανάκλαση: hfen
οργάνωση: hgis
αστέρι: tram
περιστατικό: hgon
επισκέπτης: hgip
μπαρ: brap
μπουκάλι: hbet
ευλογώ: blak
ταραχή: crak
εσωτερικός: trik
διορθώνω: krik
αντλώ: prit
κοίλος: hcot
επαρχία: hpos
πολιτισμός: srac
κρεμώ: hgak
σοκ: crok
εξαίρεση: swap
ένταση: tren
πρότυπο: ryan
οδήγηση: dran
απαλλάσσω: hruk
ορκίζομαι: kses
θησαυρός: zran
σπόρος: hbis
πύργος: tras
ευνοούμενος: fwit
πρόσφατα: hcem
πρόσφατος-το-παρελθόν σε υπερένταση: hrot
άγρυπνος: srik
έπιπλα: mrin
σκοινί: hkos
περιπέτεια: hdas
βασιλεία: ryit
γιορτή: dyat
περιγράφω: dras
εξήντα: hses
κλίμακα: hkem
τελετή: srec
κυνήγι: clik
ψίθυρος: psus
μεγάλα: ryat
χριστιανισμός: ksim
δικηγόρος: hwif
λεπτομέρεια: drit
πριγκίπισσα: hrus
βωμός: dlat
ιστός: hwes
μωβ: brin
μαζεύω: hkoc
εκλογή: hben
σύλληψη: kren
μεθυσμένος: crik
χύνω: brac
ανελκυστήρας: hlif
χειρονομία: hjis
διαχειρίζομαι: rwin
ανταλλαγή: tcen
σαφής-άρθρο: hdek
αυτοκράτορας: mras
μακρινός: hroc
άσχημος: clup
αβλαβής: cras
ρολό: hrof
ίντσα: nlic
εφημερίδα: grat
γενειάδα: dric
σχίσιμο: srim
επιτροπή: kson
ενώ: grak
διάβαση: kcoc
ανεξαρτησία: htes
μυρωδιά: hwon
δεκαοχτώ: hdec
ιστορικός: tris
ακαθάριστο: krut
ρίζα: hrok
λάσπη: hbik
νύμφη: dlan
πέπλο: pras
θέατρο: tret
σύγκριση: kras
αντίπαλος: rwis
ισορροπία: slen
πούλμαν: kron
χιούμορ: hnum
μυθιστόρημα: rwas
εκδίκηση: hbaf
ζηλιάρης: ryut
τροχός: hlok
κάηκε: glat
λάμψη: flac
δημιουργώ: hkec
σύγκρουση: hnot
κατάρα: hlos
imprecatory-διάθεση: pram
ανήμπορος: hces
θετικός: hzit
λέσχη: klup
πλημμύρα: nras
σιτηρά: gwan
αδιαφορία: hdun
ορίζοντας: crim
assumptive-διάθεση: hsom
απότομος: htop
αρμονία: mron
βροντή: hgot
παιδική-ηλικία: htok
γόνατο: hgun
λογισμικό: pwen
βλάβη: kram
παραλαβή: ryis
καθιστώ-ικανό: nlim
PROTASIS: hpoc
ολίσθημα: slok
επανάσταση: hrif
γεωργός: hjim
κτύπημα: trak
πλατφόρμα: hpof
αγγελιαφόρος: hmes
προνόμιο: hpek
οργανωμένος: hyot
φοιτητής: clen
σπήλαιο: hgec
παράδοση: rwat
τραγωδία: tses
αποχαιρετισμός: hjap
κριτική: ryik
βαμβάκι: krap
νοσοκομείο: slot
ενοίκιο: kris
αέριο: hges
αναπόφευκτος: pwic
θανάσιμα: hgim
φύλλο: glit
δημοσίευση: plun
εχθρικός: tsup
μετάφραση: dwan
κηδεία: jran
αλεύρι: mrun
αλληλογραφία: ryon
ρομαντικός: hrom
καλύβα: clun
προτείνω: psot
μιμητικός: hmet
δολάριο: dlon
φως-ημέρας: hjac
δεκαέξι: hsos
συνέλευση: hzac
αποικία: klon
πτέρυγα: gyin
λιοντάρι: hles
κουλτούρα: klut
στήλη: hkom
πονηριά: glak
δράμα: dram
αστείο: hjuc
ομίχλη: hdus
φάρμακο: dwas
δεκατέσσερα: hkes
οξύ: sram
δηλαδή: hyet
εισόδημα: hmok
επίσκοπος: hbip
πορτοκάλι: tron
λούτρο: byan
πρωτόγονος: rwit
καλάθι: ksek
γραμματέας: sris
άχυρο: prak
ανυπόμονος: pfif
σωτηρία: slon
hodiernal-σε-υπερένταση: dlin
σκοπεύω: zrin
ατμός: tcip
δηλητήριο: hwoc
ταλέντο: tlon
κλίμα: lwim
αποτελεσματικός: fric
διακρίνω: tcif
πλύση: dwac
ομολογία: kfis
ανοησίες: hjas
άνθρακας: kyon
κανό: kwon
προσωρινός: tric
delimitative-άποψη: hdip
οστό: hcos
Δευτέρα: nwic
Τρίτη: glac
Τετάρτη: bwac
ομοσπονδιακός: frin
επιθυμητός: hzic
εκπρόσωπος: ryic
λινό: lwin
νεροχύτης: swuk
ανιψιός: bwin
αιματηρός: kric
πολιορκία: cren
στομάχι: hpem
ορείχαλκος: pcon
κορυφή: hzik
πέμπτος: pfik
φτηνός: brat
αποκλειστικός-πρόσωπο: kwen
αρπάζω: zrat
φράκτης: hzas
άγαλμα: tfam
πυροβολικό: tlep
εναγκαλισμός: mrap
περιβάλλων: sren
αυστηρά: srot
ελάφι: hluf
θάμνος: hbuc
σιδηρόδρομος: hrep
εκπλήρωση: hduk
κληρονόμος: mris
δρυς: blun
δυσάρεστος: pren
εφεύρεση: hgic
πιάνο: pyon
πείθω: swen
αόρατος: gric
πασίγνωστος: ryun
σκληρότητα: kluk
πειρασμός: hyoc
telic-άποψη: hlep
οικονομικός: kfik
διεθνής: troc
επεμβαίνω: tcek
φιλόσοφος: flif
κομψός: gyit
ευημερία: kyen
αλιεία: mlak
κλέβω: truc
χείλος: hloc
αποσύρω: ryac
τέντωμα: sras
στοά: glen
παράλληλο: zlan
atelic-άποψη: htep
ήπειρος: trap
απαγορευτικός-διάθεση: nrim
γραβάτα: dwat
κύτταρο: slep
αυγό: dyan
τεχνητός: jrat
Εν-τω-μεταξύ,: nwis
κρίση: ksot
ευγενικός: sloc
μεσημεριανό: lyon
πεύκο: pwon
Σπρώξτε: hcef
ΣΥΜΜΑΧΙΑ: lyen
μέση: hkop
θαύμα: hmek
ναύτης: slis
καθαρότητα: prut
δημοκρατία: hguk
τηλέφωνο: tfen
μαστίγιο: krip
πουκάμισο: cyim
παρουσιάζω: ryas
καναπές: hsof
σκούπισμα: hsup
κλέφτης: ksif
διατηρώ: nrec
κανάλι: kcen
προσωπικότητα: klim
μεταρρύθμιση: kfam
απειλή: hzim
παλάμη: plim
ομιλητής: hzak
κατώφλι: dwic
προκαλέσει: pris
δόρυ: bzak
πετυχημένος: syec
συνεδρία: cwen
βασανιστήριο: crot
υγρασία: tcum
κορυφογραμμή: grit
ταξιδιώτης: hyek
μύλος: mwik
χάρτης: jrac
περιλαίμιο: klok
αντικαθιστώ: klif
επίτηδες: drat
μπύρα: hbif
βελούδο: hwem
βαρύτητα: gwit
κήρυγμα: hpum
κατάχρηση: glas
σμήνος: hgen
δεκατρείς: tres
δικαιολογώ: jyit
Παρασκευή: crum
βούρτσα: broc
κατεβάσετε: dlas
κρέμα: krem
γκρεμός: klaf
ένορκοι: jrin
Τέρας: ksos
παγωμένος: hgoc
δοχείο: pfot
σεντ: psen
επιμένω: srut
μήλο: hpep
συζητώ: drak
φόντο: prun
αντιγράφω: trim
περιοδικός: prik
ψυχαγωγία: nren
ιός: bris
παιδαριώδης: blit
κατοπτρίζω: flit
μετατρέπω: kcet
περίγραμμα: kluc
όπερα: hpop
έγκριση: nron
προδίδω: rwak
τιμωρώ: hzen
αγκώνα: kcon
προσάρτημα: tcet
επισκευή: hrop
ύποπτος: cyec
εβδομήντα: swet
γραφή: srip
λάκκος: grac
αταξία: dlak
δυάδικος: byin
μονή: bjan
βέλος: tcec
τείνω: trec
επεξεργάζομαι: frat
πίστη: hlot
κέρμα: syip
τρέμω: tcem
εξορία: gwin
μηχανικός: myim
παγίδα: crap
κέικ: kyek
Κύριε: cyes
διστάζω: sret
δεκαεπτά: syet
μέλι: myon
στοίχημα: dzat
πάτημα: hjam
τούβλο: brit
ογδόντα: hpes
δυστυχώς: pcen
συμβουλεύομαι: kcot
θρύλος: lwen
συγκομιδή: hfos
προαγωγή: pfon
σόμπα: hsop
επαναστάτης: bric
ντεμοντέ: hnom
φούσκωμα: cron
τέλμα: swot
σάλτσα: hdes
ασκητής: pces
διευθυντής: mren
χορωδία: cros
λογικός: tson
επεξεργασία: pson
λύκος: blaf
χαλί: hgap
αρχαιότητα: hjak
εύφορος: frut
σφύριγμα: slif
τυρί: twis
δάγκωμα: byat
καλώ: jwan
καθεδρικός-ναός: kyet
λιμάνι: brak
περιπλανιέμαι: djan
σπάρτα: tsos
ναυτικό: nlen
μάσκα: mrok
μολύβι: pses
λαχανικό: sroc
έκθεμα: hzet
παντελόνι: tlun
διαφθορά: hrup
υπουργικό-συμβούλιο: nram
σούπα: srup
χειρουργός: syon
επίδομα: tcot
κατάσκοπος: gyas
ριψοκίνδυνος: hlec
κουτσομπολεύω: gyic
ένδειξη: hzon
περίληψη: srok
Πέμπτη: cwim
κυκλοφορία: ryaf
αρχιτεκτονική: ryek
ρωγμή: rwaf
στολίδι: rwon
αντίστροφο: lwas
διασκεδάζω: mwun
ανάκτηση: ksus
πεζοδρόμιο: plut
αποφασιστικός: dyin
αρνητικός: nraf
φεστιβάλ: hfec
περιορίζω: hrum
προδοσία: zyan
κυνηγός: djin
φίδι: syen
μπαταρία: bret
κερί: flam
ντεντεκτίβ: dlit
ανάλυση: nlis
έμφαση: hzot
ζάλη: twen
φάκελος: lwaf
οποιοσδήποτε: hgek
τσιγάρο: jrit
μοτέρ: mrot
εθελοντής: hwot
αντίδραση: ryif
αποσκευές: blam
κουφός: hboc
χυμός: hjus
ταπεινότητα: jlit
υπουργείο: mret
σεξουαλικός: hjon
διάμετρος: dyam
τσεκούρι: blac
διαμάντι: dlam
εναλλασσόμενος: hlek
ηχώ: hgus
συγκράτηση: swon
ταυτότητα: hdaf
οθόνη: krun
τεμπέλης: lwis
momentane-άποψη: hmop
συμπαγής: kfot
τάση: hdif
εξαφανίζομαι: hgaf
ακτίνα: ryen
μελάνι: mwic
ογκώδης: mraf
κελάρι: dyac
αξιομνημόνευτος: nrun
αντηλιά: klek
γερουσία: slet
φέρετρο: tfap
συγχώρεση: frac
καταπιεί: nlun
ικανοποιώ: nlot
κούνια: swun
λιβάδι: gram
συγκρότημα: klos
παραίτηση: hzis
ταπεινός-μητρώο: nret
συνωμοσία: swim
πιπέρι: prip
πόνυ: pron
υποψήφιος: hzam
αλεπού: flik
καμινάδα: tcon
δικαιοδοσία: drik
γεωργία: rwic
ακρίβεια: tcuk
πρώην-μακαρίτης: brim
δημοκρατικός: mrek
μπουμπούκι: hbos
κουβέρτα: bwat
χαλάζι: hgep
χοίρος: srus
σχηματισμένος: krek
ελεφαντόδοντο: craf
κλασσικός: ksok
παρατηρητής: nwet
ελέφαντας: lwit
καρφιά: nwus
μέλισσα: hmif
θάβω: dzan
ηθοποιός: bzat
ιδρώτας: zwan
στίλβωση: ploc
ψευδαίσθηση: hlus
αβεβαιότητα: pcet
δευτερεύων: syif
πτυχή: tsot
αγροτικός: grun
βογγητό: nyen
μοιάζω: slec
παραθέτω: hzun
σάκος: cyek
ενόχληση: fren
βελόνα: hjun
ελεγχόμενη: nroc
κοτόπουλο: truk
συνεπής: kwot
βαρέλι: bras
συνήθης-άποψη: hcep
ειδικός: ksec
εντυπωσιάζω: blin
ελιά: zlin
βαν: myen
εμπόδιο: bwak
νεύμα: kcec
θετός: plaf
ορισμός: fyic
γενέθλια: gjin
σφυρί: hcof
ευώδης: hfon
επανάληψη: trun
ασήμαντος: twut
λάκτισμα: hjik
σκάβω: kwaf
κατοικίδιο-ζώο: plot
κρανίο: hcop
νομοθετικό-σώμα: dlik
φτέρνα: cruk
συνοφρυώνομαι: crun
ευρεσιτεχνία: plet
δισεκατομμύριο: blim
χημική-ουσία: fyik
πιλότος: pyot
μιμούμαι: mlot
φούστα: kwet
ασυνήθιστα: srap
εβδομαδιαίος: jwik
τεχνικός: tfip
βλάστηση: tset
κοράκι: kraf
ανατολή-ηλίου: sruc
Διάρκεια-Ζωής: glin
συμβάλλει: hyom
άγκιστρο: hdok
τίγρη: blic
διαπερνώ: crut
μανίκι: slun
αυτοκινητόδρομος: jras
πολιτοφυλακή: mlip
χαντάκι: kroc
ακεραιότητα: kret
δεκαεννέα: dzin
οργανικός: rwik
θεολογία: flic
φλοτέρ: flut
μάγισσα: byac
βαριόμουνος: hwuk
διπλωματικός: dyik
στούντιο: twos
υπερβαίνω: kcok
σαμπάνια: cyen
εμπνέω: crif
σημαία: hbes
διαζύγιο: lwon
μπουλόνι: hbut
φλέβα: jyan
παθητικός: psif
αφρός: hgum
χαλίκι: grik
ποδιά: tyen
πλανήτης: gren
ράφι: claf
ανεμιστήρας: flon
τροπικός: hjip
φάση: fwas
αυθαίρετος: rwen
προφέρω: kfun
υδράργυρος: krok
ανατριχιάζω: hrem
αυτοκτονία: tcos
δημοσιογράφος: prot
στερώ: hpok
έμπειρος: klun
μπαλκόνι: blik
πιρούνι: fras
υπάλληλος: mlek
εργοδότης: myot
πλάτος: jrak
ενοχλημένος: djit
κατηγορώ: klot
σύνταξη: pyen
ρήμα: kres
μαϊμού: mwon
δεκτός: hwek
υπογραφή: tlim
ορθόδοξος: rwos
ειρωνεία: fron
φυτώριο: nrap
απροθυμία: jlan
εισαγωγή: tyot
δάδα: croc
γραμματική: gjak
κατάθεση: gyat
αποικιακός: plon
θαλαμηγός: jyat
επακόλουθος: kwec
θόλος: kwun
πάχος: hfot
πεισματάρης: cyon
μυς: hmup
μέγεθος: ryam
τρίψιμο: ryos
άνανδρος: rwam
ιπποσκευή: gwac
τοστ: tros
ποντίκι: myus
συλλαβή: slim
ελαφρό-κτύπημα: prap
διάλογος: dlaf
ουδέτερος: nrot
επιμέλεια: dwin
αντίφαση: trot
κατορθώνω: kfic
κατσίκα: byak
κόσμημα: hfet
επιβάλλω: mlon
ανώνυμη: nwim
επίσημος-μητρώο: frit
μοσχάρι: hbof
εγχειρίδιο: mwut
τήκω: hjec
διαγράφω: flas
ομπρέλα: gras
μπότα: bzut
ορυκτό: mrim
εκεχειρία: crus
πάπια: hbok
σχεδίαση: pfam
σαπούνι: hsuf
κούκλα: gwak
σκελετός: klet
βίλα: blis
ράψιμο: jlin
συμφιλίωση: dyak
βραστήρας: kset
ώριμος: mruc
κουνέλι: kruc
αγωγός: nwot
εξάρτηση: djat
παίχτης: jlic
έντομο: pset
εστιατόριο: cret
κουκουβάγια: lwun
ριζικό: djik
κάτοικος: zwin
δράκων: dron
ακουστικός-αποδεικτικός: drot
διψασμένος: kyos
αργοπορώ: dren
λογαριασμός: glun
κανονισμός: ryim
δήμαρχος: mlap
μειονότητα: mric
απόκτηση: dwon
βετεράνος: bren
ορχήστρα: ryes
μπέικον: bjin
μειονέκτημα: zwat
ύφασμα: frap
μουσικός: gzik
διανοητικά: hnep
σύνδεση: nyon
ανεπαρκής: nrip
αρχιτέκτων: tsek
λεμόνι: nyim
βήχας: kcos
πονοκέφαλο: crek
ενοικιαστής: ryet
γονιμότητα: srun
θεραπεύω: hfoc
ενενήντα: nwon
τυχαίος: hbec
κουτάλι: kcek
μπαλόνι: blon
κιμωλία: hfip
επαγωγική-αποδεικτικός: nlet
εκδότης: pcot
ξύδι: sruk
φλαμουριά: fyec
βλαστήμια: slek
ανασταίνω: nrut
ευαίσθητος: kfim
σήραγγα: tfun
παζλ: hpef
μηχανισμός: mwim
μαθηματικά: gzit
ξεθωριάζει: frun
συκώτι: jwin
sublative-περίπτωση: bwik
βουτιά: dris
μονάδα: twim
μονοπώλιο: hnop
χαρτοπαίγνιο: hgup
υποβρύχιο: bzin
σεισμός: hbem
εργαστήριο: brot
φελλός: kruk
εαυτός-έλεγχος: syot
Βούδας: hbus
πλέκω: bjat
πρεσβεία: blas
απώτατος: sres
δηλωτικός-διάθεση: drim
κίνητρο: tyuc
σοκολάτα: clot
σύμπτωση: tyon
γάντι: gwat
γονατίζω: hjek
γεωγραφία: hjif
επένδυση: nwes
προφορικός: mrec
αναλογία: nlip
κοσμικός: srek
γεράκι: blap
ψυχολογία: nloc
στερεώνω: gjan
ξύσμα: krep
ρόλος: cyum
δόση: hdos
σολομός: slom
πουτίγκα: pwun
μαγνητικός: gyik
αντλία: pcom
οξυγόνο: ksip
πιστοποιητικό: tfot
μετάλλιο: hmem
ρητορική: trok
ξύνω: rwap
κουπί: dyas
τηλεσκόπιο: trip
κολιέ: clek
ορθογραφία: prif
ουίσκι: hwos
ιτιά: hwof
καμήλα: hlum
ερασιτέχνης: myet
έξοδος: crec
βιογραφία: brif
γάιδαρος: gzac
μηνιαίος: mwis
αγνοώ: nruk
διακοπές: byit
κλικ: lyik
ωοειδής: twon
ελαστικό: lyet
λεξικό: kfon
ζαμπόν: gzam
ουράνιο-τόξο: rwun
καταναλώνω: kcum
σούβλα: tcup
δεξαμενή: trek
συνάδελφος: clok
πεταλούδα: trif
διάγραμμα: graf
δίδυμο: jwat
ανεξάρτητα: trem
μπαμπού: hbum
έμπορος: jlat
συσσώρευση: kles
επιθεωρητής: nyet
κομματάκι: hyos
εφιάλτης: hbom
μαρμελάδα: gjam
μουσείο: mrem
αλφάβητο: lwam
σκορπίζω: zras
επιδρομή: crip
αποκαλύπτω: clus
σαπίλα: fraf
επιθετικός: gris
τριβή: mroc
αποβάθρα: gyac
αράχνη: brik
πατάτα: trut
αναθεώρηση: cwon
απληστία: jlac
πρόωρος: ryot
πολλαπλασιάζω: gzan
γνέθω: pcip
στατιστική: tsok
ημερολόγιο: klem
υποψηφιότητα: nwen
τρισεκατομμύριο: tlos
σοφίτα: tlok
καταφατικός-διάθεση: rwim
εφαρμογές: pfen
ονομαστικός: nlon
δυσαρέσκεια: sraf
μόλυνση: hfok
στάμνα: krot
σήκωμα-των-ώμων: cyok
πρωτοπόρος: gzin
παράλειψη: nlif
λάχανο: glic
αθλητικός: tlet
μέθη: mrut
ιδιόφωνο: hdof
μοχλός: lwek
γερουσιαστής: syem
Ίρις: nrif
μυρμήγκι: mwam
έντομο: hbop
έγκυος: grim
ίζημα: hjet
αστράγαλος: tcok
ταξινόμηση: glik
μεταβλητός: prim
κάλυμμα: ryap
κατσαρός: krec
θείο: hsef
υπαγόρευση: dwik
αναδύομαι: brun
βάτραχος: fram
υπερβολικό-περίπτωση: twek
σφουγγάρι: hjen
ενοχλητικός: djon
σκίουρος: slip
αλέθω: zyin
irrealis-διάθεση: flim
ηφαίστειο: glam
εντός-κτίριου: gron
εκμεταλλεύομαι: kloc
γεωλογικός: jlik
διαβατήριο: psop
ανήθικος: mlet
μπισκότο: hbuk
συνεργασία: kros
δισκίο: tlot
χαλάρωση: kces
άτομο: trom
βοηθήματα: hzip
πυραμίδα: psim
κύκλος: swok
υπνάκο: hnup
παράνομος: hjaf
πόδι-ζώου: pfap
συστολή: crom
έκλειψη: klip
λαούτο: lwap
σκούπα: srum
πίνακας: mwen
αστρονομία: tcom
λαβύρινθος: blen
υποτροφία: bwit
χελώνα: kfuc
σύμβουλος: dwak
ίνα: fwic
κρίκετ: jrik
περιστέρι: ksom
προσαρμογή: dyon
τρίγωνο: tfon
ταμίας: tsen
υδρογόνο: jron
εύθραυστος: hfuk
εκτυπωτής: pyet
εμφράκτης: tcof
χρόνιος: gzon
αντιμετωπίζω: slaf
δίλημμα: dlim
μηχανική: jyin
κάμερα: hkef
απολογούμαι: pluc
γλείψιμο: lwet
χορεύτρια: dret
μετανάστευση: mres
τένις: tces
σπονδυλική-στήλη: clip
μαρίδα: zrac
αργαλειός: tfuc
μαχαιριά: twuc
σύνθημα: psaf
ημισφαίριο: praf
στρατηγική: zrit
χαλαζίας: krus
ψαλίδι: jris
περιπολία: proc
παγετώνας: lwic
στα-μέσα-του δρόμου: dwam
υπόμνημα: mwap
κώνος: kwuc
συμμετρία: hzut
κατασκευαστής: zrak
εναγόμενος: fwik
τζαμί: djis
σκάκι: cres
διόδια: htof
κεράσι: tref
εκτενής: kfen
παραπάτημα: tfok
φορτηγό: ryok
μουστάρδα: mros
τοις-εκατό: pfet
δημοπρασία: jlam
κόσκινο: srif
ασταθής: swoc
μαγνήτης: gjat
ρουφώ: syus
Ισλάμ: slum
ακροποδητί: twip
μεμβράνη: mlen
ξύρισμα: clet
κιθάρα: gjit
λαμπερός: bzan
φτελιά: hyem
πτήση: kcom
αντωνυμία-σημάδι: ryec
κύριο-προϊόν: pcus
μπαχαρικό: zlat
εγγύηση: jlas
φορέας: zyac
δόνηση: bron
πειράζω: trus
άροτρο: hlom
φυσιολογικός: zlik
υδρορροή: hgok
κομήτης: cyet
μεσαιονικός: dyic
σπουργίτης: grec
αποζημιώνω: twet
πλαστική-ύλη: psuk
υποσημείωση: cyot
τροχιά: rwot
ολιγαρκής: twum
γκολφ: hgof
μηδέν: zrun
τσιπ: tcep
καταπιέζω: prok
χασμουρητό: gjac
ανισότητα: gwas
τυφλοπόντικας: tloc
κεραμικά: frik
νοικοκυρά: hgif
σίκαλη: rwem
απειθώ: hyes
ανεκτικός: glon
έμβρυο: brec
μεταλλωρύχος: jren
χειροκροτώ: zlac
ζύμη: lyim
ασφάλιστρο: pfim
δαμάσκηνο: plem
πτώχευση: byas
άρδευση: rwif
μέντα: nyun
καπιταλιστής: glis
ελαστικότητα: hlef
καρχαρίας: gyak
νεοσύλλεκτος: drut
αποθήκευση: zren
ρεαλισμός: cles
τζίντζερ: djic
ασθενοφόρο: blus
συγκρίσιμος: kwip
πορτοφόλι: bjap
γκριμάτσα: glim
επιστήμονας: gyis
έντερο: grot
γαλήνη: hwum
ραδιόφωνο: href
άσχετος: zlit
φασόλι: bwam
άτυπος: frim
εγγονή: gyut
διαφωνία: dloc
μπριζόλα: tfek
άζωτο: zron
ξυράφι: hjut
αντίθετος: krom
προπαγάνδα: pcoc
πυροτεχνήματα: fris
κρότος: pcop
γδύνομαι: crop
αυλάκι: cruc
επιβλαβής: hzaf
ιουδαϊσμός: hjum
συμπλήρωμα: pluk
φακός: lyes
pegative-περίπτωση: pwek
Καρκίνος: kfes
πιόνι: pyek
λέκτορας: zyat
διαρροή: hzuk
έχω-τα-προσόντα: krif
πυκνότητα: djot
επαγωγή: dyis
μάσημα: htuf
ομιλητικός: bzit
αστακός: hgos
έκπτωση: dyut
ταξί: tsuk
ιεραρχία: crem
νεφρίτης: gyec
γρύλισμα: glaf
σαύρα: lyis
υδατόπτωση: crof
απογοητευτικά: djak
βέτο: frot
προεδρία: ryip
αγοραστής: mrif
γαλόνι: jlen
κουνούπι: mruk
παρέκκλιση: dwen
παλαίω: lyut
μωσαϊκό: myok
βύσμα: plok
κοντόχονδρος: pcuk
παντοπωλείο: ksoc
κομμουνιστικός: myos
καταπλήσσω: mwek
διωκτικών-περίπτωση: rwuk
σχηματισμού: nlos
δικτάτορας: dwit
έγνοια: tyet
δορυφόρος: tlec
παντόφλα: hlop
σύμφωνο: fyon
κατά-προσέγγιση: tsif
άνεργος: byet
υποστηρικτής: sros
λωτός: lwot
μαρούλι: sles
χλωριούχο: lwok
βακτήρια: bwic
κολλώδης: pcek
συστατικό: bwon
πυρήνας: klec
προσποιούμαι: bjak
ψηφιόλεξη: bzet
έκκριση: sruf
ρητώς: pres
συμπίπτω: mloc
μπαλέτο: blet
ούρο: mrus
σκόρδο: lyun
παρέλθει: hguc
οικονομολογία: kcem
μεσαία-τάξη: hdom
ευκίνητος: gjic
λαβίδα: htef
πλυντήριο: lyoc
φράουλα: srem
αστικός: pcos
στενοχωρώ: mlaf
σημειωματάριο: tfut
άλμπουμ: zlam
μπέιζμπολ: hbep
όσφρηση: sluc
μπουφές: hbuf
μετοχή: rwip
γκαράζ: grek
διάγνωση: djas
δεκανίκι: ksuc
αποσπώ: srom
εγγραφή: psuc
διαλυτός: jlun
φώσφορος: psof
κατασκευαστικός: rwut
κόλλα: glum
διατριβή: twes
τεχνίτης: clif
μπανάνα: bwas
αξίωμα: kyom
σχηματίζω-πλευρές: psos
νικέλιο: nyek
Π: pyim
λεωφορείο: bwos
λογοκριτής: swes
βλήμα: mlus
λουκάνικο: slos
χειρισμός: nlut
ντομάτα: tfet
ενισχύω: kfut
υποδοχή: syok
κάλιο: tsom
ανακτώ: prup
πραγματικός: zwit
άλγεβρα: gjas
οδοντίατρος: dzit
οπτικός: pcok
κινούμαι: bzen
βιολογία: bwim
ανεργία: byim
κάμπια: krum
μονοφωνία: slof
πρόγραμμα-περιήγησης: bjac
μακρινός-το-παρελθόν σε υπερένταση: nyot
ιστορικός-σε-υπερένταση: crep
πυρηνικός: nluk
φάσμα: pyem
νάτριο: syom
υστερία: syes
θεματοφύλακας: tyos
όμηρος: byik
νεροκολόκυθο: gluk
ρυτίδα: kwuk
διαφάνεια: tfif
ακίδα: swip
προτεραιότητα: pcif
πεζός: dyen
αθεϊσμός: tsem
μηνυτής: mwot
εκλογική-περιφέρεια: nlec
ανεξέλεγκτος: hkof
καθετήρας: grok
πλατίνα: plip
διπλός-αριθμός: dlun
πνεύμονας: pcep
σούπερ: syup
καροτσάκι: trop
σε-τοπικό-επίπεδο: lyot
ερεθίζω: gzat
βενζίνη: plif
νεφρό: grif
λάφυρο: bzac
εκτίμηση: dlen
αρσενικό: syek
σαλιγκάρι: nrok
ακρίδα: tsec
εξίσωση: fwen
σοσιαλιστής: swos
φίλτρο: flot
αισθητήριος-αποδεικτικός-διάθεση: hxin
ευρύνω: kyot
εκπέμπουν: mwet
λουρί: pwet
μανταρίνι: drun
αναβάτης: hjok
πνευμονία: hnof
αλληλεγγύη: gret
μεντεσές: cyif
γεωγραφικού-μήκους: nruc
μέρισμα: dwun
πατινάζ: hkep
εκθέτης: slop
αναπηρία: dlif
έμμονη-ιδέα: bwen
κατανομή: pfun
φωτογράφος: trof
δέλτα: dlet
ψηφιακό: djim
σκύλα: brut
βλέφαρο: hyop
διαγώνιος: dyun
υποσυνείδητο: byon
φρύδι: bruc
φτάρνισμα: pcec
εύθυμος: dlis
ινδουϊσμός: nwum
πρόσφυγας: nyif
σαΐτα: cwot
πρωτεΐνη: pwot
σκουπιδότοπος: hdop
εκκαθαρίζω: flen
κάνω-εμετό: hwom
γονίδιο: gyen
πρωτοετής: hdem
κοινωνιολογία: syoc
σκουός: kwoc
ψαράς: hfuc
περιφερειακός: jyen
κίνηση-ανηφορικός: hvok
αναδρομικός: hxik
ανεμοστρόβιλος: gyon
αναστροφή: nwos
τηλεόραση: twif
κύβος: kfet
παραγωγικότητα: pwuk
καρότο: krop
μοριακός: mwuk
συσφαιρώνω: glet
λογιστής: ksum
αγγούρι: kyok
όργιο: drok
διαλυτικό-μέσο: jlet
φωσφορικό-άλας: psef
αλφαβητάρι: gwik
αλκαλική: flis
γυμναστική: jyas
κόμμα: kwom
κίνηση-κατηφορικός: hvat
αποτυχία: jwac
φλούδα: tcop
δότης: dzon
μαγγάνιο: hzem
ψυχολόγος: syos
χλώριο: clos
πληκτρολόγιο: kyoc
αφρόκρεμα: zyit
παρένθεση: pfaf
ράγκμπι: rwoc
έλκος: jlon
κλιτές: hxit
ροκανίζω: nres
ποσοστό: fwam
ζακέτα: swek
εξελικτική: fwis
σημειογραφία: nyoc
πήδημα: tcuf
ανατομή: drec
κρύπτη: kcep
γραμμικός: lyec
αντιμόνιο: trum
superessive-περίπτωση: psek
όγκος: twom
διάβρωση: cyos
άλφα: flaf
ομφαλός: nwip
απρόσβλητος: myip
γρίπη: flun
ζυθοποιείο: bjit
απλοποιώ: slef
μειώνω: bram
βαθούλωμα: djen
σαγηνεύω: dwim
αναγκάζω: brok
κάλτσα: bzas
ταινία: fyim
σύμπαν: klom
ρυπαίνω: hpuf
αγελαίος: gjen
πέος: zyis
δασοκομία: lyif
αλουμίνιο: lwum
ταλάντωση: zlon
ωροσκόπιο: ksop
εκβάλλω: dlek
συμπερίληψη: nluc
δικαιούχος: byic
δελφίνι: dlip
φονιάς: cyus
θηλαστικό-ζώο: myaf
δείκτης: swif
διοξίδιο: dwis
άνω-κάτω-τελεία: zlen
γραφειοκρατία: brus
διαστροφέας: jric
ψυγείο: frip
αρχαιολογικός: cluk
απαράδεκτος: kwok
προσδιορισμός: pfis
φυλλάδιο: pfut
ανθρωπολογία: nlom
γευστικός: kyec
μεταβατικός: txit
μαζεύομαι: kwus
ηλιοτρόπιο: hzuc
ψείρα: glus
ιόν: lyos
τουρισμός: tyum
μοντέμ: myom
επιτάχυνση: jrun
νοθεύω: tsoc
εκπομπή: hmef
απαγωγή: drap
επικάλυψη: hwep
κομμωτής: pfes
λαογραφία: floc
τριχοειδής: plek
εθνικισμός: nlum
οπίσθια: nros
μοτίβο: hmuf
εξάχνωση: slem
ματαίωση: xras
κοβάλτιο: kwos
βρόμη: gwam
κίνηση-ποτάμι: trup
πρωκτός: gyam
βοδινός: bwun
αναρρίπτω: flip
πλεονασμός: dzun
βίντεο: hwop
μποϋκοτάζ: bjik
κουίζ: cwif
χακί: cwok
ανταρτοπόλεμος: grip
μαγνήσιο: hgem
ραντάρ: drek
χιμπατζής: hzif
αξιοπιστία: kwif
ορθογώνιο-παραλληλόγραμμο: tyec
φαιοφύκη: klep
γενικεύω: jlak
απαγόρευση-της-κυκλοφορίας: kfec
ομοφυλόφιλος: mlok
σενάριο: srop
διατύπωση: flus
μετενσάρκωση: nrom
ανάβω: zlak
ουράνιο: ryum
συλλέκτης: kwes
συντεταγμένη: kyop
φορολογούμενος: nwaf
ολοκληρωμένος: trep
αποφάνθηκε: hzap
γάμμα: hxam
σαφάρι: fwim
κίνηση-κατάντη: ht6n
συντελεστής: kfus
επικεφαλίδα: zlic
αναλυτής: nles
ματ: hzes
εμπορικό-κέντρο: hmof
βισμούθιο: bzim
καρτ-ποστάλ: psok
σύγκλιση: bros
εκτρέπομαι: djet
μέτοχος: ksem
μικρόβιο: mrip
γεννητικός: jwit
μορφολογικός: mluk
βήτα: byot
τζην: gjis
βάση-δεδομένων: tles
αριθμομηχανή: klus
ακτινογραφία: ksef
αναλύω-πρόταση: zram
περιβαλλοντικές: zyen
σίγμα: zyim
διαχώριση: hxon
ημερήσια-διάταξη: gres
Visa: bzis
υποδομή: nyuk
πυγολαμπίδα: gyun
ανιχνευτής: tyek
προσαρμοστική: dyip
βιολόγος: byis
συνδέω: pyec
βρώμιο: brom
παλλάδιο: plum
λόξυγγας: kfok
παστέλ: psec
ζωολογικός-κήπος: zwac
κλινική: lyok
έννοια: nwoc
γιόγκα: hjoc
βιβλιοπωλείο: byun
θεραπεία: grap
εθνικιστής: zlis
καρατομώ: zlet
ναι: swec
προβληματικός: byam
τζαζ: dzas
βολφράμιο: tsof
τρομοκράτης: gwis
τρίπλα: droc
μεταβολισμός: tlem
επίδομα-διατροφής: lyaf
σαββατοκύριακο: hfom
χρυσάνθεμο: gzim
εμβόλιο: byap
μοτοσυκλέτα: tyok
μάντρα: dyot
ακαδημαϊκό-εξάμηνο: myes
ηρωίνη: gwon
ντοσιέ: flap
κάθοδος: kfoc
ιδεολογία: dlec
στάθμευση: prek
θήτα: fret
απότομη-πτώση: hxis
σελήνιο: clem
ποδηλασία: blek
φλοιός: pros
ισοροππία: swaf
ρεύμα-συνάφεια-σημάδι: hxak
αεροδρόμιο: cwoc
ακρωτηριάζω: gyet
μπάσκετ: bwet
απατεώνα: mwip
κατσαρίδα: tlek
χρώμιο: hgom
λίτρο: hl6t
παρ-'όλα-αυτά: nwec
ορμόνη: cwom
ελαττωματική: tluc
διάτρητος: prec
ανιμισμός: nyom
πολύγωνο: cloc
φεμινιστής: hfes
κλίνω: kcop
ευρώ: dros
ginseng: hjes
αλγόριθμος: hlof
λέιζερ: lwes
φαρμακείο: dlot
χιλιοστόμετρο: mlem
καλώδιο: flek
άνοδος: nlok
απόχρωση: hzus
μερικής-απασχόλησης: prem
ευαισθησία: nyec
διαδηλωτής: drom
ήλιο: clum
δίγλωσσος: dzic
ακρώνυμο: hqim
αρκτικόλεξο: nl6m
γερούνδιο: gros
πλάσμα-αίματος: psem
χρωμόσωμα: rwom
τακτικός: rwok
χιλιόμετρο: klum
φαξ: tfes
γενεσιολογία: nwek
φακίδα: frek
κατσαβίδι: dres
μπρόκολο: blok
preterite: xrit
βιταμίνη: tyem
κάδμιο: kyem
βομβαρδιστικό: bwoc
γραφικός: gjik
τιτάνιο: dyim
φιγούρα: clec
λάμδα: lwem
φιλενάδα: pcem
συνουσιάζομαι: kyuk
κλεψύδρα: tlus
εμπάθεια: mlif
βόριο: bres
ελικόπτερο: cwet
τελλούριο: tlum
διορία: jyic
ευθυγραμμίζω: gwic
εκατοστόμετρο: hfem
μολυβδαίνιο: mlom
λίθιο: tfim
πολυμέσων: myum
εκσυγχρονίζω: dyet
θερμίδα: clom
ρομπότ: ryoc
δουλεια-για-το ΣΠΙΤΙ: groc
λογάριθμος: grom
αλογάκι-της-παναγίας: gzas
εγκαταστήσουν: nwut
αμινοξέα: myoc
γλύφω: glif
αόριστος: pyos
οικολογία: plec
πονηρεύω: flok
μαριχουάνα: bjam
μικρο: mrom
χιλιόγραμμο: lwom
παρατρώω: jrot
αναμενόμενος: dzik
πίτσα: zyas
αφουγκράζομαι: zris
γλωσσολογία: bwis
κούρεμα: braf
ιρίδιο: ryom
ρατσισμός: gwim
άριστος: gyim
εκβιομηχάνιση: drif
έδρα: krup
δημήτριο: zrim
σύμφωνος: nrum
μεριστικός-περίπτωση: pxik
κασέτα: ksep
δύναμη-της-θέλησης: blot
διαστατικός: dzen
παράμετρος: rwet
συγχρονίζω: nrop
αυξάνω-στον-ανώτατο βαθμό: dzim
σεμινάριο: mwec
ντίσκο: dyok
νέο: nyok
ωσμίο: hzom
θεοφάνεια: hp6n
λογοκλοπώ: lyap
τεχνούργημα: rwek
αντιδραστήρας: fyet
ρίγανη: ryop
πλουτώνιο: pwum
ύττριο: tyom
αυξητικός: hxat
όνομα-χρήστη: mrum
μεταπτυχιακός: zrot
δεξιά-πτέρυγα: dwaf
αργόν: jros
φοβία: hxot
καθιστώ-κοινωνικόν: sluk
παγκοσμιοποίηση: bluc
μήκος-κύματος: hnef
κωδικοποιούν: kfom
ανακυκλώνω: psoc
επανεκκίνηση: nrek
ηπατίτιδα: pyes
βάση-στήλης: fros
χημειοθεραπεία: myep
modulo: mwok
πρωτόνιο: zwot
δισκέτα: dwet
χιλιοστόγραμμο: mlum
εικονοκύτταρο: psep
ταντάλιο: twem
διαλυτό: hjot
γενοκτονία: nyos
αρπακτικό: rwes
γάλλιο: glem
ζιρκόνιο: hzum
determiner: txin
μη-γραμμική: nlem
φυτοφάρμακο: pyif
βηρύλλιο: brem
νευρώνας: nrus
κατηγορηματικός: pxit
σώβρακο: tlif
παραγοντικό: kref
νετρόνιο: zrut
νιόβιο: nwom
γερμάνιο: hjem
μεταλοειδές: tlop
βάζω-επί: dlap
prolative-περίπτωση: hl6k
βιοποικιλότητα: jwic
χειριστήριο: jyok
αντιβιοτικό: twok
ακτίνιο: gjim
αστροναύτης: srof
εξωγήινο: tyes
εκκεντρικός: hwup
μαραθώνας: mrof
υττερβίο: zwim
αυτισμό: tyif
ιονίζω: nlof
ραδόνιο: cwos
Nerium: nrem
επιδημιολογία: pwip
παλιά-εποχή: lyuc
κατασκήνωση: kyep
ριγέ: drip
ινδίο: nyum
φιλαληθής: hvik
δικτυακός-τόπος: bwes
Κοράνι: kwek
μαχαιροπήρουνα: fwet
νύοστη-ρίζα: tfec
λωρένσιο: lyem
πολιτικά-δικαιώματα: glip
κινητό-τηλέφωνο: mlof
παράλυτος: twoc
πρωτακτίνιο: prum
ακτινοβολία: hd6n
εξαρτώμαι-επί: pxin
θόριο-άτομο: hxim
blue--jean: bjun
φυτό-σπιτιού: hxas
μεμονωμένα: dvit
ροή-ρεύματος: lwuk
τριπλό-σημείο: ht6t
ανθρώπινο-σώμα: hn6n
φυσική: bzik
λιανεμποριο-κατάστημα: hxan
καίσιο: hs6m
μακρύς-πριν: hqan
υπολογιστικό-φύλλο: hxet
ανά-μονάδα-μάζας: hn6m
συντάσσω: ml6n
δυαδική-τιμή: vrim
ανθρώπινος-ύπαρξη: nyus
με-μέσα-του: hvan
sikap-peduli-Choiz sil off: pxat
πρασεοδύμιο: pyom
χαρτόνι: kxat
πεπερασμένος-ρήμα: hqik
δίκη-αριθμός: hr6n
pro-πρόταση: hr6t
κριτικός: hk6k
συσκευασία: pxas
παροδικότητα: pxan
στο-πλέον: txas
Περιγραφέας: drop
νεοδύμιο: nyem
φιλία: hvit
διαβάζω-μόνο: xyak
ιδρύει: xwan
gnomic-διάθεση: kxin
φωνήμα: hxom
λογική: xlit
φωνολογικός: xlin
τραπεζαρία-δωμάτιο: hxac
ζωή-δωμάτιο: hxic
κεντρικός-περίπτωση: zrik
προ-hodiernal: hx6n
ασθενής-περίπτωση: hqak
λοξός-περίπτωση: bwok
αγροτικός-περιοχή: hqat
recurse: hr6s
μέσο-φωνή: dyos
μαϊτνέριο: hm6m
μεταφορέας-μηνυμάτων: hvak
επιφυλακτικός: kxit
στοκ-αγορά: xrak
αναγνωρίσιμα: hxap
στόχος-σκανδάλη: krof
ένα-δευτερόλεπτο: hxen
τική-περίπτωση: dvak
σιτηρέσιο: hr6c
μη-ανθρώπινος: hg6n
ζωή-πράγμα: hvic
πολύ-λίγο: hxut
κινηματογράφος: hvin
χάσιο: xyim
attenuative: ty6t
multal-αριθμός: ml6m
γαλακτώδης-τρόπος: txam
ποσειδώνιο: nwem
συγγραφέας-φάντασμα: txik
trans-αριθμός: ts6s
παίζω: hqun
αμερίκιο: myem
πρωί-δόξα: txan
πυροσβέστης: xran
μπερκέλιο: blem
γαλαξίας-γένος: kxan
Νομπέλιο: blum
Αντίο: hvac
βουδισμός: hfum
Φέρμιο: frem
κυανό: xyan
σόγια: syof
διανομέας: qrit
απεργοσπάστης: txak
επεξεργαστή: ples
abessive-περίπτωση: bvak
adessive-περίπτωση: dvik
να-περίπτωση: kxak
agentive-περίπτωση: dvek
ραδερφόρντιο: hr6m
αντίσωμα: txip
ως-πολύ-ως: hjos
μέσο-σκανδάλη: hg6t
ηθοποιός-ρόλος: xram
αιθιδίου: txim
κοινός-γένος: hk6n
συνοδός: kl6n
κνήκου: kxam
φράγκιο: fyam
έρβιο: ry6m
παθητικός-φωνή: xyis
αστατίου: hqit
μάσημα-κόμμι: hqam
αστέρι-γένος: hqin
παραπομπή-μορφή: ht6m
κούριο: jrim
κόμικς: kxis
αχρωματοψία: hqon
euler's-αριθμός: hl6m
ματιά-στο: kxas
διάβαση-πεζών: pwok
πεδίο-μάχης: txat
αυτοκινητιστής: vrit
βραχυκύκλωμα: txok
προφορικός-ουσιαστικό: hvis
κραυγή-έξω: hk6t
στατιστικώς: xyit
γιαούρτι: txot
ξένο: hs6n
υπνωτίζω: hxif
παίρνω-μακριά-από: hxaf
Ρήτρα---ουρά: hxok
απευθείας-αντικείμενο: dwot
παντοπωλείο-κατάστημα: kxun
συνίσταμαι-του: hm6t
ergative-περίπτωση: gvik
στη-γλώσσα: txic
από-προσωπική-πείρα: pxam
τοπική-πτώση-περίπτωση: hqok
πισίνα: slup
επιρρηματικός-περίπτωση: vlak
sightsee: hqas
τηλεόραση-σειρά: ht6s
τελικός-σωματίδιο: xlik
evitative-περίπτωση: hvek
αναμόρφωση: xlat
οπισθοδρόμηση: xris
φραγμός-του-διαμερίσματα: kxot
ίχνη-επάνω: hxup
αστυνομία-αξιωματικός: ps6s
Ορκίζομαι-στο: vran
ερευνητή: qrat
ρήνιο: ryem
αεροζόλ: xres
κτητικός-περίπτωση: kxik
ονομαστικοποίησης: mlec
κατεχόμενος-περίπτωση: dzak
υπερφόρτιση: pxak
βοηθητικός-ρήμα: xyik
πρωταρχικός-αντικείμενο: mlut
υπολογιστή--virus: prus
επιχειρηματίας: hqis
ένα-άνθρωποι: hqen
antessive-περίπτωση: ts6k
πρωθυπουργός: pxis
λουτήτιο: lyum
ευρώπιο: rwum
emote: xrot
παραδοσιακή-μουσική: zyik
ποιητής: vwit
ταχυδρομείο: pxot
τάχα: hvas
έμψυχος-γένος: hven
subessive-περίπτωση: bvik
γκάζι: glep
πόλωση: pr6t
όχημα-γένος: vlin
ορυκτό-γένος: xrin
ρήμα---κατάληξη: hvif
παθιασμένος: pc6n
σαμάριο: sr6m
διευκόλυνσης: hs6t
φανταστική-μονάδα: xyin
ταχύτητα-του-φωτός: kxac
πολεμική-αεροπορία: hxes
κατανόηση-χαρά: pfec
κρίσιμο-σημείο: qyit
ΠΛΗΡΗΣ-ΑΠΑΣΧΟΛΗΣΗ: hxem
άφνιο: xyam
αναχαίτηση: hn6s
αλλαγή-του-συμβάν: qrin
όλμιο: xlim
διαφορετικός-συμβάν: hf6t
σύμπαν-γένος: hvip
τοποθεσία-γένος: kxen
πραγματικός-μηχανή: hvim
έρευνα-γένος: txen
καλλιτεχνικός-γένος: ts6n
crastinal-σε-υπερένταση: sl6t
περίληψη-γένος: srep
exocentric-περίπτωση: zrek
μεταβατικός-ρήμα: txif
μόρφημα: tfom
σωβινιστής: dvis
το-παρελθόν-τελειοποιητικός: xrat
επαγγελματικός: hy6n
έμμεσος-ομιλία: tyoc
δεύτερος-γλώσσα: draf
να-είναι: txis
νεκροταφείο-βάρδια: vrak
συλλογικός-ουσιαστικό: hxos
absolutive-περίπτωση: bvuk
ασθενής-σκανδάλη: tr6t
εαυτός-εμπιστοσύνη: hs6s
περιττώματα: hzos
αυτοπαθής-φωνή: hf6s
απρόσωπος-ρήμα: hxek
σιμπόργκιο: br6m
λευκό-κενό: hxep
τροπικός-περίπτωση: dlok
άψυχος-γένος: hj6n
αιτιολογικός: qran
propositive-διάθεση: psom
ηλεκτρικός-ρεύμα: tr6n
συνειρμική-περίπτωση: nwok
υπερθετικός-περίπτωση: tluk
πολύ-πολύ: xyut
πλανητικός-γένος: pxen
κινουμένων-σχεδίων-κινούμενα σχέδια: nwuk
αμοιβαίος-φωνή: vrik
νομοθετώ: hqaf
στο-ελάχιστα: vlas
γραμματικές-περίπτωση: qrak
μεταχειριζόμενος: pxut
πυρήνας-benefactive: kfef
τερματοφύλακας: hgop
:-exkept-Four: kcef
παρονομαστής: dvan
else-if: lyek
πλαγίως: hx6s
κάθε---άλλο: dles
διαδοχικός-ρήτρα: lyuk
φθορά--out: hxun
σορτς: ht6k
δυσπρόσιο: prom
σύντομα-μελλοντικός-σε υπερένταση: rwec
σι-μονάδες: vyin
κρυπτόν: kxon
μεντελέβιο: dlem
applicative-φωνή: hp6s
antipassive-φωνή: tsef
continuative-άποψη: ht6p
ακτινοβολία-ασθενείας: hr6k
necessitative-διάθεση: hn6t
μονόκλινο-δράση-ρήμα: hqek
αυτοκινηταμαξών: xlak
υπερθετικός-βαθμός: tlup
υπαρξιακός-ρήτρα: hs6k
καλιφόρνιο: kf6n
παρόν-μετοχή: vrat
φωτεινός-ένταση: hc6t
singulative-αριθμός: slus
γραμματικές--αντικείμενο: hy6t
παθητικός-μετοχή: vris
υπερβολικό-διάρκεια: kxic
υπερκρίσιμο-ρευστό: sr6t
ποσό-του-ουσία: ks6t
postpositional-περίπτωση: pxok
αιρετός-quantifier: lwif
γαδολίνιο: dl6n
epenthetic-μόρφημα: hp6m
άνευ-αντικειμένου-με quantifier: nwif
αϊνστάνιο: ny6n
τεχνητός-γλώσσα: txac
συνδετικός-σωματίδιο: qrik
μακρινός-μελλοντικός-σε υπερένταση: twec
frequentative-άποψη: hfep
διανεμητικές-αντωνυμία: bvin
Ο-μιλία-συμφωνία: hk6m
φαλακρός: blos
προάστιο: syum
παγκόσμιος-quantifier: vlit
ηλεκτρονικός-υπολογιστής-προγραμματισμός: mr6m
τηλεόραση-πρόγραμμα: tr6m
floating-point---αριθμός: hvun
υπαρξιακός-quantifier: tl6t
ο-ημέρα-μετά αύριο: dwek
εναλλακτική-λύση-quantifier: lw6t
ευέξαπτο: hdup
το-παρελθόν-παθητικός μετοχή: hp6t
ο-ημέρα-πριν εχθές: txet
τοπική-πτώση-κατευθυντήριος περίπτωση: tc6k
αντιπαραδειγμάτων-υποθετικός: ht6c
