infinitive: hnit
nominative-case: hnak
accusative-case: hkak
topic-case: htak
parent: hmat
dad: hpap
mom: hmam
hello: hnat
ancestor: htat
grandparent: hyat
hungry: hcac
genitive-case: hnik
adjective: hcit
and: hwan
me: hmic
you: hnan
us: hnam
it: hyic
destination-case: htas
dative-case: htik
interior-context: htis
person-context: hpak
dependent-clause: htan
perfective-aspect: htap
past-tense: hkat
masculine-gender: hsan
comitative-case: hmik
present-tense: hyan
benefactive-case: hpik
essive-case: swik
not: hnic
its: hsis
surface-context: hsak
adpositional-case: hpan
location-case: hwak
space-context: hnos
way-case: hrak
instrumental-case: hsik
which: hkan
interrogative-mood: hnim
and-or: htam
exclusive-or: hkit
source-case: hsok
ablative-case: hlak
demonstrative: hdit
but: hlan
all: hsut
feminine-gender: hnin
they: hwin
plural-number: hlun
one: hyik
future-tense: hwet
social-context: hson
when: hkap
imperfective-aspect: hmap
there: hkac
conditional-mood: hcan
more: hdoc
out: htac
elative-case: hrik
illative-case: hlik
do: hkas
directive-mood: hden
deontic-mood: hdim
question-word: hwac
copula: hkok
person: hpon
male: hman
could: kwat
other: hcon
number: hnoc
very: tcac
time: htim
time-context: htos
temporal-case: hmak
about: hkam
epistemic-mood: hsim
only: htun
little: hcak
then: pcan
hortative-mood: hton
retrospective-aspect: hrip
great: hcat
volitive-mood: hlim
before: hsec
must: pcic
two: htut
see: tcan
know: hsat
down: hcin
after: hcas
first: hpas
own: hpun
alienable-possession: hlic
never: hnac
inalienable-possession: hkic
old: hwat
deliberative-mood: hcim
day: htin
where: hnap
come: hlat
way: hyas
work: hkaf
vowel: hwaf
go: hkun
perlative-case: pwik
progressive-aspect: hpip
long: hlac
say: hsac
how: hkin
even: hpit
back: hwap
here: hcic
think: hcik
same: hsam
last: kcac
away: twan
under-context: hnas
take: htit
found: hfan
hand: cyat
young: hyac
though: hyap
give: hkik
god: hmac
delative-case: lwak
nothing: hmin
right: hyit
once: hyam
semelfactive-aspect: fwip
part: hpat
saw: htic
house: hfas
world: tcat
head: hcaf
three: tyin
neo: hnon
focus: hcok
love: hpac
always: hsit
night: hwit
each: hmit
king: hyak
between: hsin
heart: cyin
paucal-number: plom
because: hyok
causal-case: ksak
thing: hkis
set: swat
name: hnem
proper-noun: hran
hortative: hrat
country: hlit
asked: hput
visible-evidential: crit
better: pcac
side: psac
course: hkus
female: hfin
enough: kyat
soon: hpuc
full: hcun
room: hfac
almost: hlap
cannot: nyat
water: hwik
desiderative-mood: hdin
light: lyak
nor: hnun
word: slat
door: tyan
use: hpus
morning: hsap
terminative-case: twik
power: hkuk
themselves: hmis
present: hyin
voice: hwas
white: hpis
money: tlan
next: kyak
poor: hyis
death: hmut
form: hfam
inessive-case: nwik
kind: tyac
often: tsan
year: nwan
friend: myat
order: hyut
imperative-mood: hpim
round: hcut
believe: hban
public: hpin
state-context: hsas
son: psat
hundred: hmas
children: hcis
thus: tyak
hope: hcap
above: hyip
dear: pyin
read: pyac
city: hsic
already: hpic
fact: hfat
factive-evidential: hfit
hear: hsun
least: hmim
perhaps: pyat
open: kcat
body: tcic
air: cwac
nature: nyit
help: mlat
letter: lyat
four: ksat
optative-mood: hpam
fire: hfak
therefore: hyif
hour: hcam
free: tyit
war: syat
whether: hsaf
reason: kyan
united: hnut
call: hkuc
why: hwam
lost: hkut
thousand: tsas
family: hfic
soul: twam
question: swac
care: kcan
realis-mood: hlin
mean: mwit
potential-mood: hten
towards: cyan
allative-case: lwik
anthropic-gender: hrin
short: kyut
able: hyuk
live: hkip
subject: hsek
same-subject-marker: hcek
different-subject: hfek
answer: tsat
sea: mwat
fear: hcoc
understand: pcat
hard: kyin
terms: tyut
doubt: hdac
dubitative-mood: twin
ask: psan
arms: tcas
black: clis
bring: tyat
beautiful: ksis
dark: tcak
hold: psak
ten: htaf
show: pyan
story: hkif
common: kwan
book: hkup
electronic: lyin
talk: plak
mark: myac
interest: nyis
write: kcit
bed: pwat
necessary: syis
idea: hwis
art: klat
vialis-case: hlas
brother: pyak
sometimes: ksas
line: lyan
table: tlas
river: nwit
eye: kyac
information: fyin
suddenly: tfan
strange: hgan
deep: ksan
change: hrit
feeling: nwac
meet: mlit
purpose: htuc
happy: hcuc
seem: syit
blood: cyac
rose: kwas
south: swan
cold: tlat
forward: myik
position: psis
late: tyam
stand: syan
suppose: nlas
daughter: pyit
mine: myan
cut: hkim
copy: hfap
husband: hgat
six: hlis
remember: twat
effect: hyaf
fall: htuk
except: hsip
hair: hpaf
pass: pyas
copyright: pcit
army: cyit
run: kcak
horse: kcas
future: hwic
west: pcak
pay: plit
red: hyun
gold: tcun
desire: hdan
play: plin
master: mwas
office: hfus
government: syak
church: kyas
length: hlen
company: ksin
paper: kyis
probability: hbin
especially: cyas
bear: pcas
window: cyak
agreement: hgac
beauty: syac
duty: tfac
send: fyan
distance: htif
silence: slan
foot: fyat
wild: kyik
die: myam
save: pfan
green: kcin
trouble: mlan
smile: myak
wrong: clat
various: pcin
sleep: slit
quotative-case: kwik
beginning: cwan
action: kfan
visit: fwat
follow: nlan
try: tcis
presence: psit
sweet: tlit
rich: tcin
enemy: tcam
ship: hcip
condition: kyit
including: hkum
inclusive-person: hlon
secret: kwit
precative-mood: pwim
polite-register: hbit
evil: pwac
march: myas
whatever: kwac
stay: hlam
instead: plat
blue: plan
impossible: psap
school: hsuk
occasion: ksac
married: nwat
food: hcuk
twenty: tsis
quiet: tcit
easily: hnis
prospective-aspect: hrap
language: lyac
expression: syas
week: hsus
hall: hcum
danger: kcic
property: myit
born: nyan
court: kcut
generally: tyap
gnomic-aspect: hmip
worth: tyas
simple: syap
tree: pyic
fight: pyap
wall: twit
heaven: cwak
inchoative-aspect: htip
jussive-mood: hjin
tone: twun
regard: klan
expected: pcik
month: hmaf
experience: nyap
entirely: nyac
fresh: tsac
duke: hnuk
covered: kwak
bound: hyim
east: tyuk
stone: pwan
somewhat: kfat
direction: tlac
chair: kwis
support: syut
date: tyic
village: klac
field: clit
permission: nwin
permissive-mood: hmom
success: slak
proper: hric
hill: clin
music: ksik
distal-demonstrative: hdat
afternoon: htup
cry: hyuc
honour: hnaf
seven: swit
private: pfat
news: nwas
scene: slac
garden: cyam
race: htus
distributive-case: twak
learn: clan
political: syik
lie: kcun
cast: tsak
eat: kcam
floor: hlaf
ill: pwin
original: mlin
summer: kyam
religion: tlam
picture: ksit
escape: plap
author: hlut
brown: pyun
determined: htem
pain: hdon
spring: psin
century: syic
soft: mwan
corner: kyun
produce: psas
laugh: cyaf
forget: flat
europe: hyup
eight: lwat
dress: lwac
terrible: cyap
breath: syaf
wise: hbas
possessive-marker: srak
memory: myin
modern: fwan
spot: tcap
rise: hyus
break: pyik
fifty: hfis
island: tlap
touch: hsuc
promise: pcam
commissive-mood: mwin
degree: tfat
plan: plac
conduct: nyak
surprise: cran
minute: hmun
shot: hwut
worse: pcap
glass: klak
instance: tlin
safe: hsif
doctor: tsit
completive-aspect: hmep
repeated: tyun
military: slin
warm: nyam
drink: pfin
questions: pcaf
anger: nran
directly: tyik
hat: hcup
dog: kwap
servant: hnuc
pride: hram
crowd: tcuc
train: nyin
moral: myut
associated: kyim
enter: fyak
rule: nyas
sword: cwat
attack: kfak
health: clac
paragraph: pyaf
social: hsum
refund: tfit
sorry: hpec
courage: krac
grace: hnen
official: hfaf
provided: tsik
request: pwit
glance: klas
movement: hyon
expect: cwit
opposite: psam
twelve: tyaf
engaged: nyut
wine: hwun
taste: swut
iron: fyac
distribute: syin
trade: myap
advantage: twac
clothes: kfip
judge: fwak
difference: tfaf
anxious: kcis
captain: kwin
finished: nlat
cessative-aspect: hsep
curious: kyic
foreign: kwic
intensifier: hnif
importance: myun
finally: hfim
bill: fwin
prove: hpuk
prevent: flan
neck: cyun
legal: hfik
dry: swak
serve: syam
lose: pcut
evidence: pyut
evidential-case: hdak
progress: pyis
building: klit
search: syuc
sad: hrac
sin: psip
thirty: tfis
honest: tsin
shut: kyap
bank: pcun
fate: cyik
forest: hfun
measure: mlac
otherwise: htoc
stream: lyam
bread: hpup
additional: tfak
choose: twas
animal: nwam
zoic-gender: hzin
eventive-mood: hwim
same-event-marker: hcom
multiplicative-case: tlak
thick: hmus
creature: hyum
rain: myic
surface: pfas
holy: swis
july: clim
report: hfut
coast: pwas
file: hfif
shoulder: cwut
surprised: kran
royal: klik
song: hkuf
comfort: kfaf
anyone: nyic
grass: kcap
draw: cwik
opening: cyic
june: cwun
fish: mlic
capital: klin
breast: cyut
snow: hcif
education: tlik
sharp: tcaf
pity: hdam
expense: fyas
yours: hmuc
million: mlun
tired: tcik
kill: ksam
shadow: cwap
weight: plas
mass: mlas
established: tlip
brave: pyam
thin: plic
satisfied: srat
check: kcik
virtue: hdet
national: nyaf
divine: swin
valley: clak
guess: kwam
speculative-mood: hken
yellow: clas
remains: mwac
bent: nlac
box: pwak
season: tsim
science: slas
bore: kcuc
uncle: hmuk
list: lyit
august: ksut
popular: hlup
unknown: fyit
familiar: flak
familiar-register: krit
reader: tsut
approach: pcuc
twice: tsap
intellectual: tfik
truly: tsam
priest: pcis
wounded: fran
sorrow: hpom
palace: kfas
beat: clap
eh?: hnec
fool: myuk
edge: pfac
nine: nwun
burst: psut
suffer: tfas
noise: hcus
literature: lyic
advice: swas
empty: kcuk
rank: psik
storm: tcut
pocket: kyip
imagination: nlin
sentence: cwas
november: nwap
december: tsip
absence: psic
thank: ryak
address: tyis
bird: pyuc
owner: mlik
coat: kwut
prepare: tyip
relations: lwan
smoke: htum
january: nwak
machine: clic
content: nyik
teeth: tlis
shame: hcet
bay: kcaf
brain: pyuk
ring: klic
phrase-marker: frak
square: ksap
fruit: fyut
tea: tsic
explain: slam
welcome: cwam
poetry: pwis
buy: klam
faithful: hdic
excitement: hcen
forty: klis
april: pyip
kindly: kfit
october: kfap
bitter: kyuc
slave: tlaf
loose: hluk
text: tsus
credit: cyip
fifteen: pfit
cruel: kcim
join: cluc
process: hpif
crime: kyaf
dust: tsuc
practical: plik
colour: nlak
destroy: nyuc
increase: lyas
nose: hnus
admit: tyim
yesterday: kfac
hesternal-tense: tlen
fail: slap
continue: tcim
wear: pwam
blind: nlit
dozen: tsun
fly: fyap
praise: cwin
devil: cwaf
gradually: twic
sacrifice: kyif
exercise: cyis
conscience: tfin
theory: tlic
minister: myis
hate: hnet
lake: cwic
centre: syun
faint: pfic
rational-gender: hron
careful: fwac
enjoy: nlam
worship: pwap
goods: twap
skin: twaf
roof: tlut
crown: gyan
castle: klap
throne: tcus
attached: nlaf
mile: mlim
extreme: krim
prison: fyis
cup: kcip
member: mlam
civil: syim
everywhere: tsaf
evident: tfic
couple: pwaf
volume: clam
custom: ksaf
bow: ksun
suit: slut
meat: mwak
milk: hluc
vegetal-gender: hwen
vision: slic
rare: nlap
cousin: ksic
bridge: pwut
protect: pfak
salt: swam
innocent: hwus
queen: kwim
count: kcus
curiosity: hras
dance: tyus
hotel: clut
fill: flin
prisoner: psun
shop: hjan
stairs: sric
beg: hmen
sand: sran
violent: hgit
september: hsem
departure: prac
ruin: crin
skill: krin
cattle: hwec
equipment: hwip
kitchen: hkon
sell: hbak
speed: hsot
conclusion: clon
computer: hkot
eternal: hsen
limited: mrit
library: hbek
base: hbac
confusion: hrun
glorious: cris
likewise: hjic
frightened: hbic
unhappy: prin
article: hrek
cook: kfin
band: hbat
desert: hget
kiss: hbun
ball: hbot
stick: hpot
argument: hrut
observe: nrak
benedictive-mood: hbim
striking: hrim
guilty: hdis
gun: hgin
police: plis
hide: hzan
expedition: srin
ignorant: nrin
generous: drac
cloud: blan
waste: htek
february: frif
disease: hren
spend: bwan
source: sron
initiative-case: hnok
aunt: hbam
delay: dlic
delayed-imperative: hlip
reported-evidential: prat
midnight: dyit
hero: nrac
philosophy: hfof
finger: hjit
comfortable: hzat
somewhere: hmoc
press: bran
staff: hraf
reward: rwan
blame: dlac
misery: krat
forehead: htec
ad: glan
angel: htet
singular-number: hgam
dawn: hbon
commercial: krak
forgive: pran
sheep: hcec
patience: hpen
farm: crac
referential: hrec
corn: mran
key: kcif
majority: hmot
weakness: hdut
atmosphere: traf
sigh: tcoc
humanity: mlis
opposition: pric
disk: hdik
lonely: hket
artist: nrat
knight: cwis
charm: tran
decision: drin
governor: gran
branch: rwac
disposition: hsoc
enthusiasm: tsum
inductive-mood: hdum
community: hmum
oil: hyen
pipe: hbap
print: trat
oh: dyoc
discourse-context: hros
vocative-case: hwok
cabin: ksen
alarm: plam
nervous: hnes
permanent: hset
knife: ksuk
silk: slik
contempt: grin
hell: nrik
separated: plen
seriously: mrat
mixed: mrik
wooden: mrak
prefer: hpet
warning: trin
admonitive-mood: htom
impulse: hmos
ambition: mrac
deny: hnek
constitution: swic
instrument: srit
continuous-aspect: hnip
tide: hgas
college: klen
tail: hkek
generation: nric
cat: blat
direct-evidential: hret
abandoned: trac
eleven: hyec
instinct: nlik
characteristic: trit
tribe: hgik
apprehensive-mood: pcim
shelter: crat
rude: hruc
riding: hris
shake: hmon
industry: hdot
profession: hres
lamp: hdap
coffee: kfif
obey: htot
northern: nrit
nurse: nris
assure: hjat
chain: ryin
teaching: cric
shoes: hgut
yard: mram
vague: hmec
elsewhere: hlet
apartment: pret
activity: twot
saturday: cram
sunshine: hduc
widow: hwuc
element: hlem
reflection: hfen
organization: hgis
star: tram
incident: hgon
guest: hgip
bar: brap
bottle: hbet
bless: blak
stir: crak
inner: trik
fix: krik
derive: prit
hollow: hcot
province: hpos
civilization: srac
hang: hgak
shock: crok
exception: swap
strain: tren
standard: ryan
driving: dran
rid: hruk
swear: kses
treasure: zran
seed: hbis
tower: tras
favourite: fwit
recently: hcem
recent-past-tense: hrot
awake: srik
furniture: mrin
rope: hkos
adventure: hdas
royalty: ryit
feast: dyat
describe: dras
sixty: hses
scale: hkem
ceremony: srec
hunting: clik
whisper: psus
largely: ryat
christianity: ksim
lawyer: hwif
detail: drit
princess: hrus
altar: dlat
web: hwes
purple: brin
gather: hkoc
election: hben
conception: kren
drunk: crik
pour: brac
lift: hlif
gesture: hjis
manage: rwin
exchange: tcen
definite-article: hdek
emperor: mras
remote: hroc
ugly: clup
harmless: cras
roll: hrof
inch: nlic
newspaper: grat
beard: dric
tear: srim
commission: kson
whereas: grak
crossing: kcoc
independence: htes
smell: hwon
eighteen: hdec
historical: tris
gross: krut
root: hrok
mud: hbik
bride: dlan
veil: pras
theatre: tret
comparison: kras
rival: rwis
balance: slen
coach: kron
humour: hnum
novel: rwas
revenge: hbaf
jealous: ryut
wheel: hlok
burnt: glat
flash: flac
create: hkec
conflict: hnot
curse: hlos
imprecative-mood: pram
helpless: hces
positive: hzit
club: klup
flood: nras
grain: gwan
indifference: hdun
horizon: crim
assumptive-mood: hsom
steep: htop
harmony: mron
thunder: hgot
childhood: htok
knee: hgun
software: pwen
injury: kram
receipt: ryis
enable: nlim
protasis: hpoc
slip: slok
revolution: hrif
farmer: hjim
stroke: trak
platform: hpof
messenger: hmes
privilege: hpek
organized: hyot
student: clen
cave: hgec
tradition: rwat
tragedy: tses
farewell: hjap
criticism: ryik
cotton: krap
hospital: slot
rent: kris
gas: hges
inevitable: pwic
deadly: hgim
leaf: glit
publication: plun
hostile: tsup
translation: dwan
funeral: jran
flour: mrun
correspondence: ryon
romantic: hrom
hut: clun
propose: psot
mimetic: hmet
dollar: dlon
daylight: hjac
sixteen: hsos
assembly: hzac
colony: klon
wing: gyin
lion: hles
culture: klut
column: hkom
cunning: glak
drama: dram
joke: hjuc
mist: hdus
medicine: dwas
fourteen: hkes
acid: sram
namely: hyet
income: hmok
bishop: hbip
orange: tron
bath: byan
primitive: rwit
basket: ksek
secretary: sris
straw: prak
impatient: pfif
salvation: slon
hodiernal-tense: dlin
intend: zrin
steam: tcip
poison: hwoc
talent: tlon
climate: lwim
effective: fric
distinguish: tcif
wash: dwac
confession: kfis
nonsense: hjas
coal: kyon
canoe: kwon
temporary: tric
delimitative-aspect: hdip
bone: hcos
monday: nwic
tuesday: glac
wednesday: bwac
federal: frin
desirable: hzic
representative: ryic
linen: lwin
sink: swuk
nephew: bwin
bloody: kric
siege: cren
stomach: hpem
brass: pcon
summit: hzik
fifth: pfik
cheap: brat
exclusive-person: kwen
seize: zrat
fence: hzas
statue: tfam
artillery: tlep
embrace: mrap
surrounding: sren
strictly: srot
deer: hluf
bush: hbuc
railroad: hrep
discharge: hduk
heir: mris
oak: blun
unpleasant: pren
invention: hgic
piano: pyon
persuade: swen
invisible: gric
well-known: ryun
cruelty: kluk
temptation: hyoc
telic-aspect: hlep
economic: kfik
international: troc
interfere: tcek
philosopher: flif
elegant: gyit
welfare: kyen
fishing: mlak
steal: truc
lip: hloc
retire: ryac
stretch: sras
gallery: glen
parallel: zlan
atelic-aspect: htep
continent: trap
prohibitive-mood: nrim
tie: dwat
cell: slep
egg: dyan
artificial: jrat
meanwhile: nwis
crisis: ksot
polite: sloc
lunch: lyon
pine: pwon
push: hcef
alliance: lyen
waist: hkop
miracle: hmek
sailor: slis
purity: prut
republic: hguk
telephone: tfen
whip: krip
shirt: cyim
introduce: ryas
sofa: hsof
sweep: hsup
thief: ksif
retain: nrec
channel: kcen
personality: klim
reform: kfam
threatening: hzim
palm: plim
speaker: hzak
threshold: dwic
induce: pris
spear: bzak
neat: syec
session: cwen
torture: crot
damp: tcum
ridge: grit
traveller: hyek
mill: mwik
map: jrac
collar: klok
replace: klif
deliberately: drat
beer: hbif
velvet: hwem
gravity: gwit
sermon: hpum
abuse: glas
flock: hgen
thirteen: tres
justify: jyit
friday: crum
brush: broc
download: dlas
cream: krem
cliff: klaf
jury: jrin
monster: ksos
frozen: hgoc
pot: pfot
penny: psen
insist: srut
apple: hpep
discuss: drak
background: prun
transcribe: trim
periodic: prik
entertainment: nren
virus: bris
childish: blit
reflect: flit
convert: kcet
outline: kluc
opera: hpop
approval: nron
betray: rwak
punish: hzen
elbow: kcon
attachment: tcet
repair: hrop
suspicious: cyec
seventy: swet
scripture: srip
pit: grac
disorder: dlak
binary: byin
abbey: bjan
arrow: tcec
tend: trec
elaborate: frat
loyalty: hlot
coin: syip
tremble: tcem
exile: gwin
mechanical: myim
trap: crap
cake: kyek
sir: cyes
hesitate: sret
seventeen: syet
honey: myon
stake: dzat
tread: hjam
brick: brit
eighty: hpes
unfortunately: pcen
consult: kcot
legend: lwen
harvest: hfos
promotion: pfon
stove: hsop
rebel: bric
old-fashioned: hnom
swell: cron
swamp: swot
dressing: hdes
ascetic: pces
manager: mren
chorus: cros
rational: tson
processing: pson
wolf: blaf
carpet: hgap
antiquity: hjak
fertile: frut
whistle: slif
cheese: twis
bite: byat
invite: jwan
cathedral: kyet
harbor: brak
wander: djan
crops: tsos
navy: nlen
mask: mrok
pencil: pses
vegetable: sroc
exhibit: hzet
trousers: tlun
corruption: hrup
cabinet: nram
soup: srup
surgeon: syon
allowance: tcot
spy: gyas
reckless: hlec
gossip: gyic
token: hzon
abstract: srok
thursday: cwim
traffic: ryaf
architecture: ryek
crack: rwaf
ornament: rwon
reverse: lwas
amuse: mwun
recovery: ksus
pavement: plut
decisive: dyin
negative: nraf
festival: hfec
reduce: hrum
treason: zyan
hunter: djin
snake: syen
battery: bret
wax: flam
detective: dlit
analysis: nlis
emphasis: hzot
swim: twen
envelope: lwaf
whoever: hgek
cigarette: jrit
motor: mrot
volunteer: hwot
reaction: ryif
baggage: blam
deaf: hboc
juice: hjus
humility: jlit
ministry: mret
sexual: hjon
diameter: dyam
axe: blac
diamond: dlam
alternate: hlek
echo: hgus
restraint: swon
identity: hdaf
screen: krun
lazy: lwis
momentane-aspect: hmop
compact: kfot
drift: hdif
disappear: hgaf
ray: ryen
ink: mwic
massive: mraf
cellar: dyac
memorable: nrun
glare: klek
senate: slet
coffin: tfap
forgiveness: frac
swallow: nlun
indulge: nlot
swing: swun
meadow: gram
complex: klos
resignation: hzis
humble-register: nret
conspiracy: swim
pepper: prip
pony: pron
candidate: hzam
fox: flik
chimney: tcon
jurisdiction: drik
agriculture: rwic
accuracy: tcuk
former-deceased: brim
democratic: mrek
bud: hbos
blanket: bwat
hail: hgep
pig: srus
shaped: krek
ivory: craf
classical: ksok
observer: nwet
elephant: lwit
nails: nwus
bee: hmif
bury: dzan
actor: bzat
sweat: zwan
polish: ploc
illusion: hlus
uncertainty: pcet
secondary: syif
fold: tsot
rural: grun
groan: nyen
resemble: slec
quote: hzun
sack: cyek
annoyance: fren
needle: hjun
controlled: nroc
chicken: truk
consistent: kwot
barrel: bras
habitual-aspect: hcep
expert: ksec
impress: blin
olive: zlin
van: myen
obstacle: bwak
nod: kcec
foster: plaf
definition: fyic
birthday: gjin
hammer: hcof
fragrant: hfon
repetition: trun
trivial: twut
kick: hjik
dig: kwaf
pet: plot
skull: hcop
legislature: dlik
heel: cruk
frown: crun
patent: plet
billion: blim
chemical: fyik
pilot: pyot
imitate: mlot
skirt: kwet
unusually: srap
weekly: jwik
technical: tfip
vegetation: tset
crow: kraf
sunrise: sruc
lifetime: glin
contribute: hyom
hook: hdok
tiger: blic
penetrate: crut
sleeve: slun
highway: jras
militia: mlip
ditch: kroc
integrity: kret
nineteen: dzin
organic: rwik
theology: flic
float: flut
witch: byac
bored: hwuk
diplomatic: dyik
studio: twos
exceed: kcok
champagne: cyen
inspire: crif
banner: hbes
divorce: lwon
bolt: hbut
vein: jyan
passive: psif
foam: hgum
gravel: grik
apron: tyen
planet: gren
shelf: claf
fan: flon
tropical: hjip
phase: fwas
arbitrary: rwen
pronounce: kfun
mercury: krok
creep: hrem
suicide: tcos
reporter: prot
deprive: hpok
skilled: klun
balcony: blik
fork: fras
employee: mlek
employer: myot
width: jrak
irritated: djit
accuse: klot
pension: pyen
verb: kres
monkey: mwon
acceptable: hwek
signature: tlim
orthodox: rwos
irony: fron
nursery: nrap
reluctance: jlan
import: tyot
torch: croc
grammar: gjak
deposit: gyat
colonial: plon
yacht: jyat
consequential: kwec
dome: kwun
thickness: hfot
stubborn: cyon
muscle: hmup
magnitude: ryam
rub: ryos
cowardly: rwam
harness: gwac
toast: tros
mouse: myus
syllable: slim
pat: prap
dialogue: dlaf
neutral: nrot
diligence: dwin
contradiction: trot
achieve: kfic
goat: byak
flourish: hfet
impose: mlon
anonymous: nwim
formal-register: frit
calf: hbof
manual: mwut
melt: hjec
delete: flas
umbrella: gras
boot: bzut
mineral: mrim
truce: crus
duck: hbok
planning: pfam
soap: hsuf
doll: gwak
skeleton: klet
villa: blis
sewing: jlin
reconcile: dyak
kettle: kset
mature: mruc
rabbit: kruc
conductor: nwot
dependence: djat
player: jlic
insect: pset
restaurant: cret
owl: lwun
radical: djik
resident: zwin
dragon: dron
auditory-evidential: drot
thirsty: kyos
linger: dren
calculation: glun
regulation: ryim
mayor: mlap
minority: mric
acquisition: dwon
veteran: bren
orchestra: ryes
bacon: bjin
disadvantage: zwat
fabric: frap
musician: gzik
mentally: hnep
conjunction: nyon
inadequate: nrip
architect: tsek
lemon: nyim
cough: kcos
headache: crek
tenant: ryet
fertility: srun
heal: hfoc
ninety: nwon
random: hbec
spoon: kcek
balloon: blon
chalk: hfip
inferential-evidential: nlet
publisher: pcot
vinegar: sruk
ash: fyec
expletive: slek
revive: nrut
susceptible: kfim
tunnel: tfun
puzzle: hpef
mechanism: mwim
mathematics: gzit
fade: frun
liver: jwin
sublative-case: bwik
dip: dris
unit: twim
monopoly: hnop
gambling: hgup
submarine: bzin
earthquake: hbem
laboratory: brot
cork: kruk
self-control: syot
buddha: hbus
knit: bjat
embassy: blas
farthest: sres
declarative-mood: drim
stimulus: tyuc
chocolate: clot
coincidence: tyon
glove: gwat
kneel: hjek
geography: hjif
investment: nwes
verbal: mrec
analogy: nlip
secular: srek
hawk: blap
psychology: nloc
fasten: gjan
scrap: krep
role: cyum
dose: hdos
salmon: slom
pudding: pwun
magnetic: gyik
pump: pcom
oxygen: ksip
certificate: tfot
medal: hmem
rhetoric: trok
scrape: rwap
oar: dyas
telescope: trip
necklace: clek
spelling: prif
whiskey: hwos
willow: hwof
camel: hlum
amateur: myet
exit: crec
biography: brif
donkey: gzac
monthly: mwis
ignore: nruk
vacation: byit
click: lyik
oval: twon
elastic: lyet
dictionary: kfon
ham: gzam
rainbow: rwun
consume: kcum
spit: tcup
tank: trek
colleague: clok
butterfly: trif
chart: graf
twin: jwat
independently: trem
bamboo: hbum
dealer: jlat
accumulation: kles
inspector: nyet
morsel: hyos
nightmare: hbom
jam: gjam
museum: mrem
alphabet: lwam
scatter: zras
raid: crip
disclose: clus
rot: fraf
aggressive: gris
friction: mroc
pier: gyac
spider: brik
potato: trut
revision: cwon
greed: jlac
premature: ryot
multiply: gzan
spin: pcip
statistics: tsok
calendar: klem
nomination: nwen
trillion: tlos
attic: tlok
affirmative-mood: rwim
applications: pfen
nominal: nlon
dissatisfaction: sraf
infection: hfok
pitcher: krot
shrug: cyok
pioneer: gzin
omission: nlif
cabbage: glic
athletic: tlet
drunkenness: mrut
ideophone: hdof
lever: lwek
senator: syem
iris: nrif
ant: mwam
bug: hbop
pregnant: grim
precipitate: hjet
ankle: tcok
classification: glik
variable: prim
wrap: ryap
curly: krec
sulphur: hsef
dictate: dwik
emerge: brun
frog: fram
exessive-case: twek
sponge: hjen
annoying: djon
squirrel: slip
grind: zyin
irrealis-mood: flim
volcano: glam
indoors: gron
exploit: kloc
geological: jlik
passport: psop
immoral: mlet
biscuit: hbuk
cooperation: kros
tablet: tlot
relaxation: kces
atom: trom
aids: hzip
pyramid: psim
cycle: swok
nap: hnup
unlawful: hjaf
paw: pfap
shyness: crom
eclipse: klip
lute: lwap
broom: srum
panel: mwen
astronomy: tcom
maze: blen
scholarship: bwit
turtle: kfuc
adviser: dwak
fibre: fwic
cricket: jrik
pigeon: ksom
adaptation: dyon
triangle: tfon
treasurer: tsen
hydrogen: jron
fragile: hfuk
printer: pyet
choke: tcof
chronic: gzon
cope: slaf
dilemma: dlim
engineering: jyin
camera: hkef
apologize: pluc
lick: lwet
dancer: dret
migration: mres
tennis: tces
spine: clip
fry: zrac
loom: tfuc
stab: twuc
password: psaf
hemisphere: praf
strategy: zrit
quartz: krus
scissors: jris
patrol: proc
glacier: lwic
halfway: dwam
memorandum: mwap
cone: kwuc
symmetry: hzut
manufacturer: zrak
defendant: fwik
mosque: djis
chess: cres
toll: htof
cherry: tref
widespread: kfen
stumble: tfok
truck: ryok
mustard: mros
percent: pfet
auction: jlam
sieve: srif
unsteady: swoc
magnet: gjat
suck: syus
islam: slum
tiptoe: twip
membrane: mlen
shave: clet
guitar: gjit
shiny: bzan
elm: hyem
soar: kcom
pronoun-marker: ryec
staple: pcus
spice: zlat
bail: jlas
carrier: zyac
vibration: bron
tease: trus
plow: hlom
physiological: zlik
gutter: hgok
comet: cyet
medieval: dyic
sparrow: grec
compensate: twet
plastic: psuk
footnote: cyot
orbit: rwot
frugal: twum
golf: hgof
zero: zrun
chip: tcep
oppress: prok
yawn: gjac
inequality: gwas
mole: tloc
pottery: frik
housewife: hgif
rye: rwem
disobey: hyes
tolerant: glon
embryo: brec
miner: jren
applaud: zlac
yeast: lyim
premium: pfim
plum: plem
bankruptcy: byas
irrigation: rwif
mint: nyun
capitalist: glis
elasticity: hlef
shark: gyak
recruit: drut
storage: zren
realism: cles
ginger: djic
ambulance: blus
comparable: kwip
wallet: bjap
grimace: glim
scientist: gyis
gut: grot
equanimity: hwum
radio: href
irrelevant: zlit
bean: bwam
informal: frim
granddaughter: gyut
disagreement: dloc
steak: tfek
nitrogen: zron
razor: hjut
contrasting: krom
propaganda: pcoc
fireworks: fris
pop: pcop
undress: crop
furrow: cruc
harmful: hzaf
judaism: hjum
complement: pluk
lens: lyes
pegative-case: pwek
cancer: kfes
pawn: pyek
lecturer: zyat
leak: hzuk
qualify: krif
density: djot
induction: dyis
chew: htuf
talkative: bzit
lobster: hgos
discount: dyut
taxi: tsuk
hierarchy: crem
jade: gyec
snarl: glaf
lizard: lyis
waterfall: crof
disappointing: djak
veto: frot
presidency: ryip
buyer: mrif
gallon: jlen
mosquito: mruk
deviation: dwen
wrestle: lyut
mosaic: myok
plug: plok
squat: pcuk
grocery: ksoc
communist: myos
amaze: mwek
prosecutive-case: rwuk
constellation: nlos
dictator: dwit
preoccupation: tyet
satellite: tlec
slipper: hlop
consonant: fyon
approximate: tsif
unemployed: byet
supporter: sros
lotus: lwot
lettuce: sles
chloride: lwok
bacteria: bwic
sticky: pcek
component: bwon
kernel: klec
feign: bjak
byte: bzet
secretion: sruf
explicitly: pres
coincide: mloc
ballet: blet
urine: mrus
garlic: lyun
elapse: hguc
economics: kcem
middle-class: hdom
agile: gjic
tongs: htef
laundry: lyoc
strawberry: srem
urban: pcos
embarrass: mlaf
notebook: tfut
album: zlam
baseball: hbep
sniff: sluc
buffet: hbuf
participle: rwip
garage: grek
diagnosis: djas
crutch: ksuc
extort: srom
registration: psuc
soluble: jlun
phosphorus: psof
structural: rwut
glue: glum
thesis: twes
artisan: clif
banana: bwas
axiom: kyom
rib: psos
nickel: nyek
pi: pyim
bus: bwos
censor: swes
missile: mlus
sausage: slos
manipulation: nlut
tomato: tfet
reinforce: kfut
socket: syok
potassium: tsom
retrieve: prup
virtual: zwit
algebra: gjas
dentist: dzit
optical: pcok
budge: bzen
biology: bwim
unemployment: byim
caterpillar: krum
solo: slof
browser: bjac
remote-past-tense: nyot
historic-tense: crep
nuclear: nluk
spectrum: pyem
sodium: syom
hysteria: syes
trustee: tyos
hostage: byik
gourd: gluk
wrinkle: kwuk
transparency: tfif
spike: swip
priority: pcif
pedestrian: dyen
atheism: tsem
monitor: mwot
constituency: nlec
uncontrolled: hkof
probe: grok
platinum: plip
dual-number: dlun
lung: pcep
super: syup
trolley: trop
locally: lyot
incite: gzat
gasoline: plif
kidney: grif
loot: bzac
assessment: dlen
arsenic: syek
snail: nrok
grasshopper: tsec
equation: fwen
socialist: swos
filter: flot
sensory-evidential-mood: hxin
widen: kyot
emit: mwet
leash: pwet
mandarin: drun
jockey: hjok
pneumonia: hnof
solidarity: gret
hinge: cyif
longitudinal: nruc
dividend: dwun
skate: hkep
exponent: slop
disability: dlif
obsession: bwen
allotment: pfun
photographer: trof
delta: dlet
digital: djim
bitch: brut
eyelid: hyop
diagonal: dyun
subconscious: byon
eyebrow: bruc
sneeze: pcec
hilarious: dlis
hinduism: nwum
refugee: nyif
shuttle: cwot
protein: pwot
dump: hdop
refine: flen
vomit: hwom
gene: gyen
freshman: hdem
sociology: syoc
squash: kwoc
fisher: hfuc
regional: jyen
motion-uphill: hvok
retrospective: hxik
tornado: gyon
inversion: nwos
tv: twif
cube: kfet
productivity: pwuk
carrot: krop
molecular: mwuk
conglomerate: glet
accountant: ksum
cucumber: kyok
orgy: drok
solvent: jlet
phosphate: psef
primer: gwik
alkaline: flis
gymnastics: jyas
comma: kwom
motion-downhill: hvat
miscarriage: jwac
pod: tcop
donor: dzon
manganese: hzem
psychologist: syos
chlorine: clos
keyboard: kyoc
elite: zyit
parenthesis: pfaf
rugby: rwoc
ulcer: jlon
inflected: hxit
nibble: nres
quantum: fwam
sweater: swek
evolutionary: fwis
notation: nyoc
bounce: tcuf
dissection: drec
cache: kcep
linear: lyec
antimony: trum
superessive-case: psek
tumor: twom
erosion: cyos
alpha: flaf
navel: nwip
immune: myip
influenza: flun
brewery: bjit
simplify: slef
abridge: bram
dent: djen
captivate: dwim
coerce: brok
sock: bzas
movie: fyim
cosmos: klom
pollute: hpuf
gregarious: gjen
penis: zyis
forestry: lyif
aluminum: lwum
oscillation: zlon
horoscope: ksop
eject: dlek
inclusion: nluc
beneficiary: byic
dolphin: dlip
killer: cyus
mammal: myaf
indicator: swif
dioxide: dwis
colon: zlen
bureaucracy: brus
distort: jric
refrigerator: frip
archaeological: cluk
unacceptable: kwok
specification: pfis
leaflet: pfut
anthropology: nlom
tasty: kyec
transitive: txit
cower: kwus
sunflower: hzuc
louse: glus
ion: lyos
tourism: tyum
modem: myom
acceleration: jrun
falsify: tsoc
emission: hmef
kidnap: drap
overlap: hwep
hairdresser: pfes
folklore: floc
capillary: plek
nationalism: nlum
buttocks: nros
motif: hmuf
sublimate: slem
frustration: xras
cobalt: kwos
oat: gwam
motion-upriver: trup
anus: gyam
bovine: bwun
flip: flip
redundancy: dzun
video: hwop
boycott: bjik
quiz: cwif
hockey: cwok
guerrilla: grip
magnesium: hgem
radar: drek
chimpanzee: hzif
reliability: kwif
rectangle: tyec
kelp: klep
generalize: jlak
curfew: kfec
homosexual: mlok
scenario: srop
formulation: flus
reincarnation: nrom
ignite: zlak
uranium: ryum
catcher: kwes
coordinate: kyop
taxpayer: nwaf
integrated: trep
opine: hzap
gamma: hxam
safari: fwim
motion-downriver: ht6n
coefficient: kfus
headline: zlic
analyst: nles
checkmate: hzes
mall: hmof
bismuth: bzim
postcard: psok
convergence: bros
digress: djet
shareholder: ksem
microbe: mrip
genital: jwit
morphological: mluk
beta: byot
jeans: gjis
database: tles
calculator: klus
x-ray: ksef
parse: zram
environmental: zyen
sigma: zyim
disjunction: hxon
agenda: gres
visa: bzis
infrastructure: nyuk
firefly: gyun
detector: tyek
adaptive: dyip
biologist: byis
splice: pyec
bromine: brom
palladium: plum
hiccup: kfok
pastel: psec
zoo: zwac
clinic: lyok
connotation: nwoc
yoga: hjoc
bookstore: byun
therapy: grap
nationalist: zlis
behead: zlet
yeah: swec
problematic: byam
jazz: dzas
tungsten: tsof
terrorist: gwis
dribble: droc
metabolism: tlem
alimony: lyaf
weekend: hfom
chrysanthemum: gzim
vaccine: byap
motorcycle: tyok
mantra: dyot
semester: myes
heroin: gwon
folder: flap
cathode: kfoc
ideology: dlec
parking: prek
theta: fret
anticlimax: hxis
selenium: clem
cycling: blek
cortex: pros
equivalence: swaf
current-relevance-marker: hxak
airport: cwoc
amputate: gyet
basketball: bwet
imposter: mwip
cockroach: tlek
chromium: hgom
litre: hl6t
nonetheless: nwec
hormone: cwom
flawed: tluc
perforate: prec
animism: nyom
polygon: cloc
feminist: hfes
conjugate: kcop
euro: dros
ginseng: hjes
algorithm: hlof
laser: lwes
drugstore: dlot
millimeter: mlem
flex: flek
anode: nlok
nuance: hzus
part-time: prem
sensitivity: nyec
demonstrator: drom
helium: clum
bilingual: dzic
acronym: hqim
initialism: nl6m
gerund: gros
plasma: psem
chromosome: rwom
ordinal: rwok
kilometre: klum
fax: tfes
genetics: nwek
freckle: frek
screwdriver: dres
broccoli: blok
preterite: xrit
vitamin: tyem
cadmium: kyem
bomber: bwoc
graphical: gjik
titanium: dyim
splurge: clec
lambda: lwem
girlfriend: pcem
copulate: kyuk
hourglass: tlus
empathy: mlif
boron: bres
helicopter: cwet
tellurium: tlum
deadline: jyic
align: gwic
centimetre: hfem
molybdenum: mlom
lithium: tfim
multimedia: myum
update: dyet
calorie: clom
robot: ryoc
homework: groc
logarithm: grom
mantis: gzas
instal: nwut
amino: myoc
glyph: glif
aorist: pyos
ecology: plec
sophisticate: flok
marijuana: bjam
micro: mrom
kilogram: lwom
overeat: jrot
predictable: dzik
pizza: zyas
eavesdrop: zris
linguistics: bwis
haircut: braf
iridium: ryom
racism: gwim
optimal: gyim
industrialization: drif
headquarter: krup
cerium: zrim
congruent: nrum
partitive-case: pxik
cassette: ksep
willpower: blot
dimensional: dzen
parameter: rwet
synchronize: nrop
maximize: dzim
seminar: mwec
disco: dyok
neon: nyok
osmium: hzom
epiphany: hp6n
plagiarize: lyap
artifact: rwek
reactor: fyet
oregano: ryop
plutonium: pwum
yttrium: tyom
augmentative: hxat
username: mrum
postgraduate: zrot
right-wing: dwaf
argon: jros
phobia: hxot
socialize: sluk
globalization: bluc
wavelength: hnef
encode: kfom
recycle: psoc
restart: nrek
hepatitis: pyes
torus: fros
chemotherapy: myep
modulo: mwok
proton: zwot
diskette: dwet
milligram: mlum
pixel: psep
tantalum: twem
solute: hjot
genocide: nyos
predator: rwes
gallium: glem
zirconium: hzum
determiner: txin
nonlinear: nlem
pesticide: pyif
beryllium: brem
neuron: nrus
predicative: pxit
underpants: tlif
factorial: kref
neutron: zrut
niobium: nwom
germanium: hjem
metalloid: tlop
put-on: dlap
prolative-case: hl6k
biodiversity: jwic
joystick: jyok
antibiotic: twok
actinium: gjim
astronaut: srof
extraterrestrial: tyes
crackpot: hwup
marathon: mrof
ytterbium: zwim
autism: tyif
ionize: nlof
radon: cwos
netium: nrem
epidemiology: pwip
old-age: lyuc
camping: kyep
striped: drip
indium: nyum
veridical: hvik
web-site: bwes
koran: kwek
flatware: fwet
nth-root: tfec
lawrencium: lyem
civil-rights: glip
mobile-phone: mlof
paralyzed: twoc
protactinium: prum
radiation: hd6n
depend-on: pxin
thorium-atom: hxim
blue-jean: bjun
houseplant: hxas
individually: dvit
flow-current: lwuk
triple-point: ht6t
human-body: hn6n
physics: bzik
retail-store: hxan
cesium: hs6m
long-ago: hqan
spreadsheet: hxet
unit-of-mass: hn6m
compile: ml6n
binary-value: vrim
human-being: nyus
by-means-of: hvan
in-front-of: pxat
praseodymium: pyom
cardboard: kxat
finite-verb: hqik
trial-number: hr6n
pro-sentence: hr6t
critic: hk6k
packaging: pxas
impermanence: pxan
at-most: txas
descriptor: drop
neodymium: nyem
friendship: hvit
read-only: xyak
founds: xwan
gnomic-mood: kxin
phoneme: hxom
rationality: xlit
phonological: xlin
dining-room: hxac
living-room: hxic
centric-case: zrik
prehodiernal: hx6n
patient-case: hqak
oblique-case: bwok
rural-area: hqat
recurse: hr6s
middle-voice: dyos
meitnerium: hm6m
mail-carrier: hvak
nonremittal: kxit
stock-market: xrak
identifiable: hxap
goal-trigger: krof
one-second: hxen
lative-case: dvak
ration: hr6c
non-human: hg6n
living-thing: hvic
too-little: hxut
movie-theater: hvin
hassium: xyim
attenuative: ty6t
multal-number: ml6m
milky-way: txam
neptunium: nwem
ghostwriter: txik
trans-numeral: ts6s
fool-around: hqun
americium: myem
morning-glory: txan
firefighter: xran
berkelium: blem
galaxy-gender: kxan
nobelium: blum
byebye: hvac
buddhism: hfum
fermium: frem
cyan: xyan
soya: syof
distributor: qrit
strikebreaker: txak
processor: ples
abessive-case: bvak
adessive-case: dvik
to-case: kxak
agentive-case: dvek
rutherfordium: hr6m
antibody: txip
as-much-as: hjos
agent-trigger: hg6t
actor-role: xram
ethium: txim
common-gender: hk6n
accompanier: kl6n
safflower: kxam
francium: fyam
erbium: ry6m
passive-voice: xyis
astatine: hqit
chewing-gum: hqam
star-gender: hqin
citation-form: ht6m
curium: jrim
comic-strip: kxis
color-blind: hqon
eulers-number: hl6m
look-at: kxas
crosswalk: pwok
battlefield: txat
motorist: vrit
short-circuit: txok
verbal-noun: hvis
cry-out: hk6t
statistically: xyit
yogurt: txot
xenon: hs6n
hypnothize: hxif
take-off: hxaf
clause-tail: hxok
direct-object: dwot
grocery-store: kxun
consist-of: hm6t
ergative-case: gvik
in-language: txic
first-hand: pxam
locative-case: hqok
swimming-pool: slup
adverbial-case: vlak
sightsee: hqas
television-set: ht6s
final-particle: xlik
evitative-case: hvek
rehabilitation: xlat
regression: xris
block-of-flats: kxot
wake-up: hxup
police-officer: ps6s
swear-in: vran
interviewer: qrat
rhenium: ryem
aerosol: xres
posessive-case: kxik
nominalization: mlec
possessed-case: dzak
overcharge: pxak
auxiliary-verb: xyik
primary-object: mlut
computer-virus: prus
businessperson: hqis
a-people: hqen
antessive-case: ts6k
prime-minister: pxis
lutetium: lyum
europium: rwum
emote: xrot
folk-music: zyik
poet: vwit
post-office: pxot
supposedly: hvas
animate-gender: hven
subessive-case: bvik
gas-pedal: glep
polarity: pr6t
vehicle-gender: vlin
mineral-gender: xrin
verb-affix: hvif
passionate: pc6n
samarium: sr6m
facilitator: hs6t
imaginary-unit: xyin
speed-of-light: kxac
air-force: hxes
empathetic-joy: pfec
critical-point: qyit
full-time: hxem
hafnium: xyam
inhibition: hn6s
change-of-event: qrin
holmium: xlim
different-event: hf6t
universe-gender: hvip
locality-gender: kxen
virtual-machine: hvim
research-gender: txen
artistic-gender: ts6n
crastinal-tense: sl6t
abstract-gender: srep
exocentric-case: zrek
transitive-verb: txif
morpheme: tfom
chauvinist: dvis
past-perfective: xrat
vocational: hy6n
indirect-speech: tyoc
second-language: draf
to-be: txis
graveyard-shift: vrak
collective-noun: hxos
absolutive-case: bvuk
patient-trigger: tr6t
self-confidence: hs6s
feces: hzos
reflexive-voice: hf6s
impersonal-verb: hxek
seaborgium: br6m
whitespace: hxep
modal-case: dlok
inanimate-gender: hj6n
causative: qran
propositive-mood: psom
electric-current: tr6n
associative-case: nwok
superlative-case: tluk
too-much: xyut
planetary-gender: pxen
animated-cartoon: nwuk
reciprocal-voice: vrik
legislate: hqaf
at-least: vlas
grammatical-case: qrak
user-: pxut
core-benefactive: kfef
goalkeeper: hgop
except-for: kcef
denominator: dvan
else-if: lyek
sideways: hx6s
each-other: dles
successive-clause: lyuk
wear-out: hxun
shorts: ht6k
dysprosium: prom
soon-future-tense: rwec
si-units: vyin
krypton: kxon
mendelevium: dlem
applicative-voice: hp6s
antipassive-voice: tsef
continutive-aspect: ht6p
radiation-sickness: hr6k
necessitative-mood: hn6t
single-action-verb: hqek
railcar: xlak
superlative-degree: tlup
existential-clause: hs6k
californium: kf6n
present-participle: vrat
luminous-intensity: hc6t
singulative-number: slus
grammatical-object: hy6t
passive-participle: vris
excessive-duration: kxic
supercritical-fluid: sr6t
amount-of-substance: ks6t
postpositional-case: pxok
elective-quantifier: lwif
gadolinium: dl6n
epenthetic-morpheme: hp6m
negatory-quantifier: nwif
einsteinium: ny6n
artificial-language: txac
connective-particle: qrik
remote-future-tense: twec
frequentative-aspect: hfep
distributive-pronoun: bvin
allocutive-agreement: hk6m
bald: blos
suburb: syum
universal-quantifier: vlit
computer-programming: mr6m
television-programme: tr6m
floating-point-number: hvun
existential-quantifier: tl6t
the-day-after-tomorrow: dwek
alternative-quantifier: lw6t
bad-tempered: hdup
past-passive-participle: hp6t
the-day-before-yesterday: txet
locative-directional-case: tc6k
counterfactual-conditional: ht6c
