infinitivo: hnit
nominativo-caso: hnak
acusativo-caso: hkak
tema-caso: htak
padre: hmat
padre: hpap
mamá: hmam
Hola: hnat
antepasado: htat
abuelo: hyat
hambriento: hcac
genitivo-caso: hnik
adjetivo: hcit
y: hwan
yo: hmic
usted: hnan
nos: hnam
ello: hyic
destino-caso: htas
dativo-caso: htik
interior-contexto: htis
persona-contexto: hpak
dependiente-cláusula: htan
perfectivo-aspecto: htap
pasado-tiempo: hkat
masculino-género: hsan
comitative-caso: hmik
presente-tiempo: hyan
benefactivo-caso: hpik
essive-caso: swik
no: hnic
sus: hsis
superficie-contexto: hsak
adpositional-caso: hpan
ubicación-caso: hwak
espacio-contexto: hnos
camino-caso: hrak
instrumental-caso: hsik
cual: hkan
interrogativo-estado-animico: hnim
y-o: htam
exclusivo-o: hkit
fuente-caso: hsok
ablativo-caso: hlak
demostrativo: hdit
pero: hlan
todas: hsut
femenino-género: hnin
ellos: hwin
plural-número: hlun
uno: hyik
futuro-tiempo: hwet
social-contexto: hson
cuando: hkap
imperfective-aspecto: hmap
allí: hkac
condicional-estado-animico: hcan
Más: hdoc
fuera: htac
relativo-caso: hrik
ilativo-caso: hlik
hacer: hkas
directiva-estado-animico: hden
deóntica-estado-animico: hdim
pregunta-palabra: hwac
cópula: hkok
la-persona: hpon
masculino: hman
podría: kwat
otro: hcon
número: hnoc
muy: tcac
hora: htim
hora-contexto: htos
temporal-caso: hmak
acerca-de: hkam
epistémica-estado-animico: hsim
sólo: htun
pequeña: hcak
en-ese-caso: pcan
hortative-estado-animico: hton
retrospectivo-aspecto: hrip
estupendo: hcat
volitivo-estado-animico: hlim
antes-de: hsec
debe: pcic
dos: htut
ver: tcan
saber: hsat
abajo: hcin
después: hcas
primero: hpas
propio: hpun
alienable-posesión: hlic
Nunca: hnac
inalienable-posesión: hkic
antiguo: hwat
deliberativo-estado-animico: hcim
día: htin
donde: hnap
ven: hlat
camino: hyas
trabajo: hkaf
vocal: hwaf
ir: hkun
perlative-caso: pwik
progresivo-aspecto: hpip
largo: hlac
decir: hsac
cómo: hkin
incluso: hpit
atrás: hwap
aquí: hcic
pensar: hcik
mismo: hsam
último: kcac
fuera: twan
debajo-contexto: hnas
llevar: htit
encontrado: hfan
mano: cyat
joven: hyac
aunque: hyap
dar: hkik
Dios: hmac
delative-caso: lwak
nada: hmin
correcto: hyit
una-vez: hyam
semelfactive-aspecto: fwip
parte: hpat
Sierra: htic
casa: hfas
mundo: tcat
cabeza: hcaf
Tres: tyin
neo: hnon
atención: hcok
amor: hpac
siempre: hsit
noche: hwit
cada: hmit
Rey: hyak
Entre: hsin
corazón: cyin
paucal-número: plom
porque: hyok
causal-caso: ksak
cosa: hkis
conjunto: swat
nombre: hnem
apropiado-sustantivo: hran
hortative: hrat
país: hlit
preguntó: hput
visible-probatorio: crit
mejor: pcac
lado: psac
curso: hkus
hembra: hfin
suficiente: kyat
En-Poco-Tiempo: hpuc
completo: hcun
cuarto: hfac
casi: hlap
no-poder: nyat
agua: hwik
desiderativo-estado-animico: hdin
luz: lyak
ni: hnun
palabra: slat
puerta: tyan
usar: hpus
Mañana: hsap
terminative-caso: twik
energía: hkuk
sí-mismos: hmis
presente: hyin
voz: hwas
blanco: hpis
dinero: tlan
el-siguiente: kyak
pobre: hyis
muerte: hmut
formar: hfam
inesivo-caso: nwik
amable: tyac
a-menudo: tsan
año: nwan
amigo: myat
orden: hyut
imperativo-estado-animico: hpim
ronda: hcut
creer: hban
público: hpin
estado-contexto: hsas
hijo: psat
cien: hmas
niños: hcis
así: tyak
esperanza: hcap
arriba: hyip
Estimado: pyin
leer: pyac
ciudad: hsic
ya: hpic
hecho: hfat
Factive-probatorio: hfit
escuchar: hsun
menos: hmim
quizás: pyat
abierto: kcat
cuerpo: tcic
aire: cwac
naturaleza: nyit
ayuda: mlat
carta: lyat
cuatro: ksat
optativo-estado-animico: hpam
fuego: hfak
por-lo-tanto: hyif
hora: hcam
gratis: tyit
guerra: syat
si: hsaf
razón: kyan
unido: hnut
llamada: hkuc
por-qué: hwam
perdido: hkut
mil: tsas
familia: hfic
alma: twam
pregunta: swac
cuidado: kcan
realis-estado-animico: hlin
media: mwit
potencial-estado-animico: hten
hacia: cyan
allativo-caso: lwik
antrópico-género: hrin
corto: kyut
capaz: hyuk
vivir: hkip
sujeto: hsek
mismo-tema-marcador: hcek
diferente-tema: hfek
responder: tsat
mar: mwat
miedo: hcoc
comprender: pcat
difícil: kyin
condiciones: tyut
duda: hdac
dubitativo-estado-animico: twin
pedir: psan
brazos: tcas
negro: clis
traer: tyat
hermosa: ksis
oscuro: tcak
mantener: psak
diez: htaf
espectáculo: pyan
cuento: hkif
común: kwan
libro: hkup
electrónico: lyin
hablar: plak
Marcos: myac
interesar: nyis
escribe: kcit
cama: pwat
necesario: syis
idea: hwis
arte: klat
vialis-caso: hlas
hermano: pyak
a-veces: ksas
línea: lyan
mesa: tlas
río: nwit
ojo: kyac
información: fyin
de-golpe: tfan
extraño: hgan
profundo: ksan
cambiar: hrit
sensación: nwac
reunirse: mlit
propósito: htuc
feliz: hcuc
parecer: syit
sangre: cyac
Rosa: kwas
sur: swan
frío: tlat
reenviar: myik
posición: psis
tarde: tyam
estar: syan
suponer: nlas
hija: pyit
mía: myan
Corte: hkim
copia: hfap
esposo: hgat
seis: hlis
recuerda: twat
efecto: hyaf
caer: htuk
excepto: hsip
cabello: hpaf
pasar: pyas
derechos-de-autor: pcit
ejército: cyit
carrera: kcak
caballo: kcas
futuro: hwic
Oeste: pcak
paga: plit
rojo: hyun
oro: tcun
deseo: hdan
jugar: plin
dominar: mwas
oficina: hfus
gobierno: syak
Iglesia: kyas
largo: hlen
compañía: ksin
papel: kyis
probabilidad: hbin
especialmente: cyas
oso: pcas
ventana: cyak
acuerdo: hgac
belleza: syac
deber: tfac
enviar: fyan
distancia: htif
silencio: slan
pie: fyat
salvaje: kyik
morir: myam
ahorrar: pfan
verde: kcin
problema: mlan
sonrisa: myak
incorrecto: clat
varios: pcin
dormir: slit
de-citación-caso: kwik
comenzando: cwan
acción: kfan
visita: fwat
seguir: nlan
probar: tcis
presencia: psit
dulce: tlit
Rico: tcin
enemigo: tcam
enviar: hcip
condición: kyit
incluso: hkum
inclusivo-la-persona: hlon
secreto: kwit
precative-estado-animico: pwim
Cortés-registro: hbit
mal: pwac
marzo: myas
lo-que-sea: kwac
permanecer: hlam
en-lugar: plat
azul: plan
imposible: psap
colegio: hsuk
ocasión: ksac
casado: nwat
comida: hcuk
20: tsis
tranquilo: tcit
fácilmente: hnis
futuro-aspecto: hrap
idioma: lyac
expresión: syas
semana: hsus
pasillo: hcum
Peligro: kcic
propiedad: myit
Nació: nyan
la-Corte: kcut
en-general: tyap
gnomic-aspecto: hmip
valor: tyas
sencillo: syap
árbol: pyic
pelea: pyap
pared: twit
cielo: cwak
incoativo-aspecto: htip
yusivo-estado-animico: hjin
tono: twun
considerar: klan
esperado: pcik
mes: hmaf
experiencia: nyap
enteramente: nyac
fresco: tsac
duque: hnuk
cubierto: kwak
ligado: hyim
este: tyuk
piedra: pwan
algo: kfat
dirección: tlac
silla: kwis
apoyo: syut
fecha: tyic
pueblo: klac
campo: clit
permiso: nwin
permisivo-estado-animico: hmom
éxito: slak
apropiado: hric
colina: clin
música: ksik
distal-demostrativo: hdat
tarde: htup
llorar: hyuc
honor: hnaf
siete: swit
privado: pfat
Noticias: nwas
escena: slac
jardín: cyam
carrera: htus
distributivo-caso: twak
aprender: clan
político: syik
mentira: kcun
elenco: tsak
comer: kcam
planta: hlaf
enfermo: pwin
original: mlin
el-verano: kyam
religión: tlam
cuadro: ksit
escapar: plap
autor: hlut
marrón: pyun
determinado: htem
dolor: hdon
primavera: psin
siglo: syic
suave: mwan
esquina: kyun
Produce: psas
risa: cyaf
olvidar: flat
Europa: hyup
ocho: lwat
vestido: lwac
terrible: cyap
aliento: syaf
sabio: hbas
posesivo-marcador: srak
memoria: myin
moderno: fwan
lugar: tcap
aumento: hyus
descanso: pyik
cincuenta: hfis
isla: tlap
toque: hsuc
promesa: pcam
comisivos-estado-animico: mwin
grado: tfat
plan: plac
conducta: nyak
sorpresa: cran
minuto: hmun
Disparo: hwut
peor: pcap
vaso: klak
ejemplo: tlin
a-salvo: hsif
doctor: tsit
definitivo-aspecto: hmep
repetido: tyun
militar: slin
calentar: nyam
bebida: pfin
preguntas: pcaf
enfado: nran
directamente: tyik
sombrero: hcup
perro: kwap
servidor: hnuc
orgullo: hram
multitud: tcuc
entrenar: nyin
moral: myut
asociado: kyim
entrar: fyak
regla: nyas
espada: cwat
ataque: kfak
salud: clac
párrafo: pyaf
social: hsum
reembolso: tfit
lo-lamento: hpec
valor: krac
gracia: hnen
oficial: hfaf
siempre-que: tsik
petición: pwit
vistazo: klas
movimiento: hyon
esperar: cwit
opuesto: psam
doce: tyaf
comprometido: nyut
Vino: hwun
sabor: swut
hierro: fyac
distribuir: syin
comercio: myap
ventaja: twac
ropa: kfip
juez: fwak
diferencia: tfaf
ansioso: kcis
capitán: kwin
terminado: nlat
cesación-aspecto: hsep
curioso: kyic
exterior: kwic
intensificador: hnif
importancia: myun
finalmente: hfim
cuenta: fwin
probar: hpuk
evitar: flan
cuello: cyun
legal: hfik
seco: swak
servir: syam
perder: pcut
evidencia: pyut
probatorio-caso: hdak
Progreso: pyis
edificio: klit
buscar: syuc
triste: hrac
pecado: psip
treinta: tfis
honesto: tsin
cerrar: kyap
banco: pcun
destino: cyik
bosque: hfun
la-medida: mlac
de-otra-manera: htoc
corriente: lyam
pan-de-molde: hpup
adicional: tfak
elegir: twas
animal: nwam
zoico-género: hzin
eventivo-estado-animico: hwim
mismo-evento-marcador: hcom
multiplicativo-caso: tlak
grueso: hmus
criatura: hyum
lluvia: myic
superficie: pfas
santo: swis
julio: clim
informe: hfut
costa: pwas
archivo: hfif
hombro: cwut
sorprendido: kran
real: klik
canción: hkuf
comodidad: kfaf
nadie: nyic
césped: kcap
dibujar: cwik
apertura: cyic
junio: cwun
pescado: mlic
capital: klin
pecho: cyut
nieve: hcif
educación: tlik
agudo: tcaf
lástima: hdam
gastos: fyas
tuya: hmuc
millón: mlun
cansado: tcik
matar: ksam
sombra: cwap
peso: plas
masa: mlas
establecido: tlip
valiente: pyam
delgada: plic
satisfecho: srat
comprobar: kcik
virtud: hdet
nacional: nyaf
adivinar: swin
Valle: clak
adivinar: kwam
especulativo-estado-animico: hken
amarillo: clas
permanece: mwac
doblado: nlac
encajonar: pwak
temporada: tsim
ciencia: slas
aburrir: kcuc
tío: hmuk
lista: lyit
agosto: ksut
popular: hlup
desconocido: fyit
familiar: flak
familiar-registro: krit
lector: tsut
enfoque: pcuc
dos-veces: tsap
intelectual: tfik
verdaderamente: tsam
sacerdote: pcis
herido: fran
dolor: hpom
palacio: kfas
golpear: clap
¿eh?: hnec
engañar: myuk
borde: pfac
nueve: nwun
ráfaga: psut
sufrir: tfas
ruido: hcus
literatura: lyic
Consejo: swas
vacío: kcuk
rango: psik
tormenta: tcut
bolsillo: kyip
imaginación: nlin
frase: cwas
noviembre: nwap
diciembre: tsip
ausencia: psic
gracias: ryak
dirección: tyis
pájaro: pyuc
propietario: mlik
capa: kwut
preparar: tyip
relaciones: lwan
humo: htum
enero: nwak
la-maquina: clic
contenido: nyik
dientes: tlis
vergüenza: hcet
bahía: kcaf
cerebro: pyuk
anillo: klic
frase-marcador: frak
cuadrado: ksap
Fruta: fyut
té: tsic
explicar: slam
bienvenida: cwam
poesía: pwis
comprar: klam
fiel: hdic
emoción: hcen
cuarenta: klis
abril: pyip
amablemente: kfit
octubre: kfap
amargo: kyuc
esclavo: tlaf
suelto: hluk
texto: tsus
crédito: cyip
quince: pfit
cruel: kcim
unirse: cluc
proceso: hpif
crimen: kyaf
polvo: tsuc
práctico: plik
color: nlak
destruir: nyuc
aumentar: lyas
nariz: hnus
admitir: tyim
ayer: kfac
hesternal-tiempo: tlen
fallar: slap
continuar: tcim
vestir: pwam
ciego: nlit
docena: tsun
mosca: fyap
alabanza: cwin
diablo: cwaf
gradualmente: twic
sacrificio: kyif
ejercicio: cyis
conciencia: tfin
teoría: tlic
ministro: myis
odio: hnet
lago: cwic
centrar: syun
débil: pfic
racional-género: hron
cuidadoso: fwac
disfrutar: nlam
rendir-culto: pwap
bienes: twap
piel: twaf
techo: tlut
corona: gyan
castillo: klap
trono: tcus
adjunto: nlaf
milla: mlim
extremo: krim
prisión: fyis
taza: kcip
miembro: mlam
civil: syim
en-todos-lados: tsaf
evidente: tfic
par: pwaf
volumen: clam
personalizado: ksaf
arco: ksun
traje: slut
carne: mwak
leche: hluc
vegetal-género: hwen
visión: slic
raro: nlap
primo: ksic
puente: pwut
proteger: pfak
sal: swam
inocente: hwus
reina: kwim
contar: kcus
curiosidad: hras
baile: tyus
hotel: clut
llenar: flin
prisionero: psun
Tienda: hjan
escalera: sric
mendigar: hmen
arena: sran
violento: hgit
septiembre: hsem
salida: prac
ruina: crin
habilidad: krin
ganado: hwec
equipo: hwip
cocina: hkon
vender: hbak
velocidad: hsot
conclusión: clon
computadora: hkot
eterno: hsen
limitado: mrit
biblioteca: hbek
base: hbac
confusión: hrun
glorioso: cris
igualmente: hjic
asustado: hbic
infeliz: prin
artículo: hrek
cocinar: kfin
banda: hbat
Desierto: hget
Beso: hbun
bola: hbot
palo: hpot
argumento: hrut
observar: nrak
bendición-estado-animico: hbim
llamativo: hrim
culpable: hdis
pistola: hgin
policía: plis
esconder: hzan
expedición: srin
ignorante: nrin
generoso: drac
nube: blan
residuos: htek
febrero: frif
enfermedad: hren
gastar: bwan
fuente: sron
iniciativa-caso: hnok
tía: hbam
retrasar: dlic
retrasado-imperativo: hlip
reportado-probatorio: prat
doce-de-la noche: dyit
héroe: nrac
filosofía: hfof
dedo: hjit
cómodo: hzat
algun-lado: hmoc
oprima: bran
personal: hraf
recompensa: rwan
culpa: dlac
miseria: krat
frente: htec
anuncio: glan
ángel: htet
singular-número: hgam
amanecer: hbon
comercial: krak
perdonar: pran
oveja: hcec
paciencia: hpen
granja: crac
referencial: hrec
maíz: mran
clave: kcif
mayoría: hmot
debilidad: hdut
atmósfera: traf
suspiro: tcoc
humanidad: mlis
oposición: pric
disco: hdik
solitaria: hket
artista: nrat
caballero: cwis
encanto: tran
decisión: drin
gobernador: gran
rama: rwac
disposición: hsoc
entusiasmo: tsum
inductivo-estado-animico: hdum
comunidad: hmum
aceite: hyen
tubo: hbap
impresión: trat
Oh: dyoc
discurso-contexto: hros
vocativo-caso: hwok
cabina: ksen
alarma: plam
nervioso: hnes
permanente: hset
cuchillo: ksuk
seda: slik
desprecio: grin
infierno: nrik
apartado: plen
seriamente: mrat
mezclado: mrik
de-madera: mrak
preferir: hpet
advertencia: trin
amonestación-estado-animico: htom
impulso: hmos
ambición: mrac
negar: hnek
constitución: swic
instrumento: srit
continuo-aspecto: hnip
marea: hgas
Universidad: klen
cola: hkek
generación: nric
gato: blat
directo-probatorio: hret
abandonado: trac
once: hyec
instinto: nlik
característica: trit
tribu: hgik
aprensivo-estado-animico: pcim
abrigo: crat
grosero: hruc
equitación: hris
sacudir: hmon
industria: hdot
profesión: hres
lámpara: hdap
café: kfif
obedecer: htot
del-Norte: nrit
enfermera: nris
asegurar: hjat
cadena: ryin
enseñanza: cric
Zapatos: hgut
yarda: mram
vago: hmec
en-otra-parte: hlet
apartamento: pret
actividad: twot
sábado: cram
luz-del-sol: hduc
viuda: hwuc
elemento: hlem
reflexión: hfen
organización: hgis
estrella: tram
incidente: hgon
huésped: hgip
bar: brap
botella: hbet
bendecir: blak
remover: crak
interior: trik
fijar: krik
derivar: prit
hueco: hcot
provincia: hpos
civilización: srac
colgar: hgak
choque: crok
excepción: swap
tensión: tren
estándar: ryan
conducción: dran
eliminar: hruk
jurar: kses
tesoro: zran
semilla: hbis
torre: tras
favorito: fwit
hace-poco: hcem
reciente-pasado-tiempo: hrot
despierto: srik
mueble: mrin
cuerda: hkos
aventuras: hdas
realeza: ryit
banquete: dyat
describir: dras
sesenta: hses
escala: hkem
ceremonia: srec
caza: clik
susurro: psus
en-gran-parte: ryat
cristianismo: ksim
abogado: hwif
detalle: drit
princesa: hrus
altar: dlat
web: hwes
morado: brin
reunir: hkoc
elección: hben
concepción: kren
bebido: crik
verter: brac
ascensor: hlif
gesto: hjis
administrar: rwin
intercambiar: tcen
definido-artículo: hdek
emperador: mras
remoto: hroc
feo: clup
inofensivo: cras
rodar: hrof
pulgada: nlic
periódico: grat
barba: dric
lágrima: srim
comisión: kson
mientras: grak
cruce: kcoc
independencia: htes
olor: hwon
Dieciocho: hdec
histórico: tris
bruto: krut
raíz: hrok
barro: hbik
novia: dlan
velo: pras
el-teatro: tret
comparación: kras
rival: rwis
equilibrar: slen
entrenador: kron
humor: hnum
novela: rwas
venganza: hbaf
celoso: ryut
rueda: hlok
quemada: glat
destello: flac
crear: hkec
conflicto: hnot
maldición: hlos
imprecatorio-estado-animico: pram
indefenso: hces
positivo: hzit
club: klup
inundar: nras
grano: gwan
indiferencia: hdun
horizonte: crim
assumptive-estado-animico: hsom
escarpado: htop
armonía: mron
trueno: hgot
infancia: htok
rodilla: hgun
software: pwen
lesión: kram
recepción: ryis
habilitar: nlim
protasis: hpoc
resbalón: slok
revolución: hrif
agricultor: hjim
carrera: trak
plataforma: hpof
mensajero: hmes
privilegio: hpek
organizado: hyot
estudiante: clen
cueva: hgec
tradición: rwat
tragedia: tses
despedida: hjap
crítica: ryik
algodón: krap
hospital: slot
alquiler: kris
gas: hges
inevitable: pwic
mortal: hgim
hoja: glit
publicación: plun
hostil: tsup
traducción: dwan
funeral: jran
harina: mrun
correspondencia: ryon
romántico: hrom
choza: clun
proponer: psot
mimético: hmet
dólar: dlon
luz: hjac
dieciséis: hsos
Asamblea: hzac
colonia: klon
ala: gyin
león: hles
cultura: klut
columna: hkom
astuto: glak
drama: dram
broma: hjuc
niebla: hdus
medicina: dwas
catorce: hkes
ácido: sram
a-saber: hyet
ingresos: hmok
obispo: hbip
naranja: tron
bañera: byan
primitivo: rwit
cesta: ksek
secretario: sris
paja: prak
impaciente: pfif
salvación: slon
hodierno-tiempo: dlin
intentar: zrin
vapor: tcip
veneno: hwoc
talento: tlon
clima: lwim
eficaz: fric
distinguir: tcif
lavar: dwac
confesión: kfis
disparates: hjas
carbón: kyon
canoa: kwon
temporal: tric
delimitative-aspecto: hdip
hueso: hcos
lunes: nwic
martes: glac
miércoles: bwac
federal: frin
deseable: hzic
representante: ryic
lino: lwin
lavabo: swuk
sobrino: bwin
sangriento: kric
cerco: cren
estómago: hpem
latón: pcon
cumbre: hzik
quinto: pfik
barato: brat
exclusivo-la-persona: kwen
aprovechar: zrat
cerca: hzas
estatua: tfam
artillería: tlep
abrazo: mrap
circundante: sren
estrictamente: srot
ciervo: hluf
arbusto: hbuc
ferrocarril: hrep
descarga: hduk
heredero: mris
roble: blun
desagradable: pren
invención: hgic
piano: pyon
persuadir: swen
invisible: gric
bien-conocido: ryun
crueldad: kluk
tentación: hyoc
télica-aspecto: hlep
económico: kfik
internacional: troc
interferir: tcek
filósofo: flif
elegante: gyit
bienestar: kyen
pesca: mlak
robar: truc
labio: hloc
retirarse: ryac
tramo: sras
galería: glen
paralelo: zlan
atelic-aspecto: htep
continente: trap
prohibitivo-estado-animico: nrim
corbata: dwat
celda: slep
huevo: dyan
artificial: jrat
mientras-tanto: nwis
crisis: ksot
Cortés: sloc
almuerzo: lyon
pino: pwon
empujar: hcef
alianza: lyen
cintura: hkop
milagro: hmek
marinero: slis
pureza: prut
república: hguk
teléfono: tfen
látigo: krip
camisa: cyim
introducir: ryas
sofá: hsof
barrer: hsup
ladrón: ksif
conservar: nrec
canal: kcen
personalidad: klim
reforma: kfam
amenazante: hzim
palma: plim
altavoz: hzak
límite: dwic
inducir: pris
lanza: bzak
ordenado: syec
sesión: cwen
tortura: crot
húmedo: tcum
cresta: grit
viajero: hyek
molino: mwik
mapa: jrac
collar: klok
reemplazar: klif
deliberadamente: drat
cerveza: hbif
terciopelo: hwem
gravedad: gwit
sermón: hpum
abuso: glas
rebaño: hgen
trece: tres
justificar: jyit
viernes: crum
cepillo: broc
descargar: dlas
crema: krem
acantilado: klaf
jurado: jrin
monstruo: ksos
congelado: hgoc
maceta: pfot
centavo: psen
insistir: srut
manzana: hpep
discutir: drak
fondo: prun
transcribir: trim
periódico: prik
entretenimiento: nren
virus: bris
infantil: blit
reflejar: flit
convertir: kcet
contorno: kluc
ópera: hpop
aprobación: nron
traicionar: rwak
castigar: hzen
codo: kcon
adjunto-archivo: tcet
reparar: hrop
suspicaz: cyec
setenta: swet
Sagrada-Escritura: srip
pozo: grac
trastorno: dlak
binario: byin
abadía: bjan
flecha: tcec
tender: trec
elaborar: frat
lealtad: hlot
acuñar: syip
temblar: tcem
exilio: gwin
mecánico: myim
trampa: crap
pastel: kyek
señor: cyes
vacilar: sret
diecisiete: syet
la-miel: myon
estaca: dzat
pisada: hjam
ladrillo: brit
ochenta: hpes
Desafortunadamente: pcen
consultar: kcot
leyenda: lwen
cosecha: hfos
promoción: pfon
estufa: hsop
rebelde: bric
pasado-de-moda: hnom
hinchar: cron
pantano: swot
vendaje: hdes
ascético: pces
gerente: mren
coro: cros
racional: tson
tratamiento: pson
lobo: blaf
alfombra: hgap
antigüedad: hjak
fértil: frut
silbar: slif
queso: twis
mordedura: byat
invitación: jwan
catedral: kyet
puerto: brak
vagar: djan
cultivos: tsos
marina-de-guerra: nlen
máscara: mrok
lápiz: pses
vegetal: sroc
exposición: hzet
pantalones: tlun
corrupción: hrup
armario: nram
sopa: srup
cirujano: syon
tolerancia: tcot
espiar: gyas
temerario: hlec
chismes: gyic
simbólico: hzon
abstracto: srok
jueves: cwim
tráfico: ryaf
arquitectura: ryek
grieta: rwaf
ornamento: rwon
marcha-atrás: lwas
divertir: mwun
recuperación: ksus
acera: plut
decisivo: dyin
negativo: nraf
festival: hfec
reducir: hrum
traición: zyan
cazador: djin
serpiente: syen
batería: bret
cera: flam
detective: dlit
análisis: nlis
énfasis: hzot
nadar: twen
sobre: lwaf
quien: hgek
cigarrillo: jrit
motor: mrot
voluntario: hwot
reacción: ryif
equipaje: blam
sordo: hboc
jugo: hjus
humildad: jlit
ministerio: mret
sexual: hjon
diámetro: dyam
hacha: blac
diamante: dlam
alterno: hlek
eco: hgus
restricción: swon
identidad: hdaf
pantalla: krun
perezoso: lwis
momentane-aspecto: hmop
compacto: kfot
deriva: hdif
desaparecer: hgaf
rayo: ryen
tinta: mwic
macizo: mraf
bodega: dyac
memorable: nrun
deslumbramiento: klek
senado: slet
ataúd: tfap
perdón: frac
golondrina: nlun
complacer: nlot
oscilación: swun
prado: gram
complejo: klos
renuncia: hzis
humilde-registro: nret
conspiración: swim
pimienta: prip
poni: pron
candidato: hzam
zorro: flik
tubo-de-lámpara: tcon
jurisdicción: drik
agricultura: rwic
exactitud: tcuk
ex-fallecido: brim
democrático: mrek
brote: hbos
cobija: bwat
granizo: hgep
cerdo: srus
conformado: krek
marfil: craf
clásico: ksok
observador: nwet
elefante: lwit
clavos: nwus
abeja: hmif
enterrar: dzan
actor: bzat
sudor: zwan
polaco: ploc
espejismo: hlus
incertidumbre: pcet
secundario: syif
doblez: tsot
rural: grun
gemido: nyen
parecerse-a: slec
citar: hzun
saco: cyek
molestia: fren
aguja: hjun
revisado: nroc
pollo: truk
consistente: kwot
barril: bras
habitual-aspecto: hcep
experto: ksec
impresionar: blin
aceituna: zlin
camioneta: myen
obstáculo: bwak
asentir: kcec
fomentar: plaf
definición: fyic
cumpleaños: gjin
martillo: hcof
fragante: hfon
repetición: trun
trivial: twut
patada: hjik
cavar: kwaf
mascota: plot
cráneo: hcop
legislatura: dlik
tacón: cruk
fruncir-el-ceño: crun
patentar: plet
millones: blim
químico: fyik
piloto: pyot
imitar: mlot
falda: kwet
extraordinariamente: srap
cada-semana: jwik
técnico: tfip
vegetación: tset
cuervo: kraf
amanecer: sruc
toda-la-vida: glin
contribuir: hyom
gancho: hdok
Tigre: blic
penetrar: crut
manga: slun
autopista: jras
milicia: mlip
zanja: kroc
integridad: kret
diecinueve: dzin
orgánico: rwik
teología: flic
flotador: flut
bruja: byac
aburrida: hwuk
diplomático: dyik
estudio: twos
exceder: kcok
champán: cyen
inspirar: crif
bandera: hbes
divorcio: lwon
tornillo: hbut
vena: jyan
pasivo: psif
espuma: hgum
grava: grik
delantal: tyen
planeta: gren
estante: claf
abanico: flon
tropical: hjip
fase: fwas
arbitrario: rwen
pronunciar: kfun
mercurio: krok
arrastrarse: hrem
suicidio: tcos
reportero: prot
privar: hpok
experto: klun
balcón: blik
tenedor: fras
empleado: mlek
empleador: myot
anchura: jrak
irritado: djit
acusar: klot
pensión: pyen
verbo: kres
mono: mwon
aceptable: hwek
firma: tlim
ortodoxo: rwos
ironía: fron
guardería: nrap
reluctancia: jlan
importar: tyot
antorcha: croc
gramática: gjak
depositar: gyat
colonial: plon
yate: jyat
consecuente: kwec
cúpula: kwun
espesor: hfot
obstinado: cyon
músculo: hmup
magnitud: ryam
frotar: ryos
cobardemente: rwam
aprovechar: gwac
brindis: tros
ratón: myus
sílaba: slim
palmadita: prap
diálogo: dlaf
neutral: nrot
diligencia: dwin
contradicción: trot
lograr: kfic
cabra: byak
florecer: hfet
imponer: mlon
anónimo: nwim
formal-registro: frit
becerro: hbof
manual: mwut
derretir: hjec
borrar: flas
paraguas: gras
bota: bzut
mineral: mrim
tregua: crus
pato: hbok
planificación: pfam
jabón: hsuf
muñeca: gwak
esqueleto: klet
villa: blis
de-coser: jlin
conciliar: dyak
tetera: kset
maduro: mruc
conejo: kruc
conductor: nwot
dependencia: djat
jugador: jlic
insecto: pset
restaurante: cret
búho: lwun
radical: djik
residente: zwin
dragón: dron
auditivo-probatorio: drot
sediento: kyos
persistir: dren
cálculo: glun
regulación: ryim
alcalde: mlap
minoría: mric
adquisición: dwon
veterano: bren
orquesta: ryes
tocino: bjin
desventaja: zwat
tela: frap
músico: gzik
mentalmente: hnep
conjunción: nyon
inadecuado: nrip
arquitecto: tsek
limón: nyim
tos: kcos
dolor-de-cabeza: crek
inquilino: ryet
fertilidad: srun
sanar: hfoc
noventa: nwon
al-azar: hbec
cuchara: kcek
globo: blon
tiza: hfip
inferencial-probatorio: nlet
editor: pcot
vinagre: sruk
ceniza: fyec
expletivo: slek
reanimar: nrut
susceptible: kfim
túnel: tfun
rompecabezas: hpef
mecanismo: mwim
matemáticas: gzit
descolorarse: frun
hígado: jwin
Sublative-caso: bwik
inmersión: dris
unidad: twim
monopolio: hnop
juego: hgup
submarino: bzin
terremoto: hbem
laboratorio: brot
corcho: kruk
yo-controlar: syot
Buda: hbus
tejer: bjat
embajada: blas
más-lejano: sres
declarativo-estado-animico: drim
estímulo: tyuc
chocolate: clot
coincidencia: tyon
guante: gwat
arrodillarse: hjek
geografía: hjif
inversión: nwes
verbal: mrec
analogía: nlip
secular: srek
halcón: blap
psicología: nloc
sujetar: gjan
chatarra: krep
papel: cyum
dosis: hdos
salmón: slom
pudín: pwun
magnético: gyik
bomba: pcom
oxígeno: ksip
certificado: tfot
medalla: hmem
retórica: trok
raspar: rwap
remo: dyas
telescopio: trip
collar: clek
deletreando: prif
whisky: hwos
sauce: hwof
camello: hlum
aficionado: myet
salida: crec
biografía: brif
el-burro: gzac
mensual: mwis
ignorar: nruk
vacaciones: byit
hacer-clic: lyik
oval: twon
elástico: lyet
diccionario: kfon
jamón: gzam
arco-iris: rwun
consumir: kcum
escupir: tcup
tanque: trek
colega: clok
mariposa: trif
gráfico: graf
gemelo: jwat
independientemente: trem
bambú: hbum
comerciante: jlat
acumulación: kles
inspector: nyet
bocado: hyos
pesadilla: hbom
atasco: gjam
museo: mrem
alfabeto: lwam
dispersión: zras
RAID: crip
revelar: clus
putrefacción: fraf
agresivo: gris
fricción: mroc
muelle: gyac
araña: brik
Papa: trut
revisión: cwon
codicia: jlac
prematuro: ryot
multiplicar: gzan
girar: pcip
estadística: tsok
calendario: klem
nominación: nwen
billones: tlos
ático: tlok
afirmativo-estado-animico: rwim
aplicaciones: pfen
nominal: nlon
insatisfacción: sraf
infección: hfok
lanzador: krot
encogimiento-de-hombros: cyok
pionero: gzin
omisión: nlif
repollo: glic
atlético: tlet
embriaguez: mrut
idiophone: hdof
palanca: lwek
senador: syem
iris: nrif
hormiga: mwam
error: hbop
embarazada: grim
precipitado: hjet
tobillo: tcok
clasificación: glik
variable: prim
envolver: ryap
Rizado: krec
azufre: hsef
dictar: dwik
surgir: brun
rana: fram
excesivo-caso: twek
esponja: hjen
molesto: djon
ardilla: slip
moler: zyin
irrealis-estado-animico: flim
volcán: glam
dentro: gron
explotar: kloc
geológico: jlik
pasaporte: psop
inmoral: mlet
galleta: hbuk
cooperación: kros
tableta: tlot
relajación: kces
átomo: trom
SIDA: hzip
pirámide: psim
ciclo: swok
siesta: hnup
ilegal: hjaf
pata: pfap
timidez: crom
eclipse: klip
laúd: lwap
Escoba: srum
panel: mwen
astronomía: tcom
laberinto: blen
beca: bwit
Tortuga: kfuc
asesor: dwak
fibra: fwic
Grillo: jrik
Paloma: ksom
adaptación: dyon
triángulo: tfon
tesorero: tsen
hidrógeno: jron
frágil: hfuk
impresora: pyet
ahogo: tcof
crónico: gzon
capa-pluvial: slaf
dilema: dlim
ingeniería: jyin
camara-fotografica: hkef
disculparse: pluc
lamer: lwet
bailarín: dret
migración: mres
tenis: tces
espina: clip
freír: zrac
telar: tfuc
puñalada: twuc
clave: psaf
hemisferio: praf
estrategia: zrit
cuarzo: krus
tijeras: jris
patrulla: proc
glaciar: lwic
a-medio-camino: dwam
memorándum: mwap
cono: kwuc
simetría: hzut
fabricante: zrak
acusado: fwik
mezquita: djis
ajedrez: cres
Peaje: htof
Cereza: tref
extendido: kfen
tropezón: tfok
camión: ryok
mostaza: mros
por-ciento: pfet
subasta: jlam
tamiz: srif
inestable: swoc
imán: gjat
chupar: syus
islam: slum
punta-del-pie: twip
membrana: mlen
afeitado: clet
guitarra: gjit
brillante: bzan
olmo: hyem
remontarse: kcom
pronombre-marcador: ryec
grapa: pcus
condimentar: zlat
fianza: jlas
portador: zyac
vibración: bron
molestar: trus
arado: hlom
fisiológico: zlik
canal: hgok
cometa: cyet
medieval: dyic
gorrión: grec
compensar: twet
el-plastico: psuk
nota: cyot
órbita: rwot
frugal: twum
golf: hgof
cero: zrun
chip: tcep
oprimir: prok
bostezo: gjac
desigualdad: gwas
Topo: tloc
cerámica: frik
ama-de-casa: hgif
centeno: rwem
desobedecer: hyes
tolerante: glon
embrión: brec
minero: jren
aplaudir: zlac
levadura: lyim
prima: pfim
ciruela: plem
quiebra: byas
irrigación: rwif
menta: nyun
capitalista: glis
elasticidad: hlef
tiburón: gyak
recluta: drut
almacenamiento: zren
realismo: cles
jengibre: djic
ambulancia: blus
comparable: kwip
billetera: bjap
mueca: glim
científico: gyis
intestino: grot
ecuanimidad: hwum
radio: href
irrelevante: zlit
haba: bwam
informal: frim
nieta: gyut
desacuerdo: dloc
bistec: tfek
nitrógeno: zron
maquinilla-de-afeitar: hjut
en-contraste: krom
propaganda: pcoc
fuegos-artificiales: fris
popular: pcop
desnudo: crop
surco: cruc
perjudicial: hzaf
judaísmo: hjum
complemento: pluk
lente: lyes
pegative-caso: pwek
cáncer: kfes
empeñar: pyek
conferencista: zyat
fuga: hzuk
calificar: krif
densidad: djot
inducción: dyis
masticar: htuf
hablador: bzit
langosta: hgos
descuento: dyut
taxi: tsuk
jerarquía: crem
jade: gyec
gruñido: glaf
lagartija: lyis
cascada: crof
decepcionante: djak
veto: frot
presidencia: ryip
comprador: mrif
galón: jlen
mosquito: mruk
desviación: dwen
luchar: lyut
mosaico: myok
enchufe: plok
agacharse: pcuk
tienda-de-comestibles: ksoc
comunista: myos
asombro: mwek
prosecutive-caso: rwuk
constelación: nlos
dictador: dwit
preocupación: tyet
satélite: tlec
zapatilla: hlop
consonante: fyon
aproximado: tsif
desempleados: byet
seguidor: sros
loto: lwot
lechuga: sles
cloruro: lwok
bacterias: bwic
pegajoso: pcek
componente: bwon
núcleo: klec
fingir: bjak
byte: bzet
secreción: sruf
explícitamente: pres
coincidir: mloc
ballet: blet
orina: mrus
ajo: lyun
transcurrido: hguc
ciencias-económicas: kcem
clase-media: hdom
ágil: gjic
tenazas: htef
lavandería: lyoc
fresa: srem
urbano: pcos
avergonzar: mlaf
cuaderno: tfut
álbum: zlam
béisbol: hbep
oler: sluc
bufé: hbuf
participio: rwip
garaje: grek
diagnóstico: djas
muleta: ksuc
extorsionar: srom
registro: psuc
soluble: jlun
fósforo: psof
estructural: rwut
cola: glum
tesis: twes
artesano: clif
plátano: bwas
axioma: kyom
costilla: psos
níquel: nyek
pi: pyim
autobús: bwos
censurar: swes
misil: mlus
salchicha: slos
manipulación: nlut
tomate: tfet
reforzarse: kfut
enchufe: syok
potasio: tsom
recuperar: prup
virtual: zwit
álgebra: gjas
dentista: dzit
óptico: pcok
ceder: bzen
biología: bwim
desempleo: byim
oruga: krum
solo: slof
navegador: bjac
remoto-pasado-tiempo: nyot
histórico-tiempo: crep
nuclear: nluk
espectro: pyem
sodio: syom
histeria: syes
fideicomisario: tyos
rehén: byik
calabaza: gluk
arruga: kwuk
transparencia: tfif
espiga: swip
prioridad: pcif
peatonal: dyen
ateísmo: tsem
monitor: mwot
distrito-electoral: nlec
sin-control: hkof
sonda: grok
platino: plip
dual-número: dlun
pulmón: pcep
súper: syup
carretilla: trop
en-la-zona: lyot
incitar: gzat
gasolina: plif
riñón: grif
botín: bzac
evaluación: dlen
arsénico: syek
caracol: nrok
saltamontes: tsec
ecuación: fwen
socialista: swos
filtrar: flot
sensorial-probatorio-estado animico: hxin
ensanchar: kyot
emitir: mwet
correa: pwet
mandarín: drun
jockey: hjok
neumonía: hnof
solidaridad: gret
bisagra: cyif
longitudinal: nruc
dividendo: dwun
patinar: hkep
exponente: slop
discapacidad: dlif
obsesión: bwen
asignación: pfun
fotógrafo: trof
delta: dlet
digital: djim
perra: brut
párpado: hyop
diagonal: dyun
subconsciente: byon
ceja: bruc
estornudar: pcec
divertidísimo: dlis
hinduismo: nwum
refugiado: nyif
lanzadera: cwot
proteína: pwot
tugurio: hdop
refinar: flen
vomitar: hwom
gene: gyen
estudiante-de-primer año: hdem
sociología: syoc
squash: kwoc
pescador: hfuc
regional: jyen
movimiento-cuesta-arriba: hvok
retrospectivo: hxik
tornado: gyon
inversión: nwos
televisión: twif
cubo: kfet
productividad: pwuk
Zanahoria: krop
molecular: mwuk
conglomerado: glet
contador: ksum
Pepino: kyok
orgía: drok
solvente: jlet
fosfato: psef
cebador: gwik
alcalino: flis
gimnasia: jyas
coma: kwom
movimiento-cuesta-abajo: hvat
aborto-espontáneo: jwac
vaina: tcop
donante: dzon
manganeso: hzem
psicólogo: syos
cloro: clos
teclado: kyoc
élite: zyit
paréntesis: pfaf
rugby: rwoc
úlcera: jlon
declinada: hxit
picar: nres
cuántico: fwam
suéter: swek
evolutivo: fwis
notación: nyoc
bote: tcuf
disección: drec
cache: kcep
lineal: lyec
antimonio: trum
superessive-caso: psek
tumor: twom
erosión: cyos
alfa: flaf
ombligo: nwip
inmune: myip
influenza: flun
cervecería: bjit
simplificar: slef
abreviar: bram
mella: djen
cautivar: dwim
obligar: brok
calcetín: bzas
película: fyim
cosmos: klom
contaminar: hpuf
gregario: gjen
pene: zyis
silvicultura: lyif
aluminio: lwum
oscilación: zlon
horóscopo: ksop
expulsar: dlek
inclusión: nluc
beneficiario: byic
delfín: dlip
asesino: cyus
mamífero: myaf
indicador: swif
dióxido: dwis
colon: zlen
burocracia: brus
distorsionar: jric
refrigerador: frip
arqueológico: cluk
inaceptable: kwok
especificación: pfis
prospecto: pfut
antropología: nlom
sabroso: kyec
transitivo: txit
acobardarse: kwus
girasol: hzuc
piojo: glus
ion: lyos
turismo: tyum
módem: myom
aceleración: jrun
falsificar: tsoc
emisión: hmef
secuestrar: drap
superposición: hwep
peluquero: pfes
folklore: floc
capilar: plek
nacionalismo: nlum
nalgas: nros
motivo: hmuf
sublimado: slem
frustración: xras
cobalto: kwos
avena: gwam
movimiento-río-arriba: trup
ano: gyam
bovino: bwun
dar-la-vuelta: flip
redundancia: dzun
vídeo: hwop
boicotear: bjik
examen: cwif
hockey: cwok
guerrilla: grip
magnesio: hgem
radar: drek
chimpancé: hzif
confiabilidad: kwif
rectángulo: tyec
quelpo: klep
generalizar: jlak
toque-de-queda: kfec
homosexual: mlok
guión: srop
formulación: flus
reencarnación: nrom
encender: zlak
uranio: ryum
colector: kwes
coordinar: kyop
contribuyente: nwaf
integrado: trep
opinado: hzap
gama: hxam
safari: fwim
movimiento-río-abajo: ht6n
coeficiente: kfus
titular: zlic
analista: nles
mate: hzes
centro-commercial: hmof
bismuto: bzim
tarjeta-postal: psok
convergencia: bros
divagar: djet
accionista: ksem
microbio: mrip
genital: jwit
morfológica: mluk
beta: byot
jeans: gjis
base-de-datos: tles
calculadora: klus
radiografía: ksef
analizar-gramaticalmente: zram
ambiental: zyen
sigma: zyim
disyunción: hxon
orden-del-día: gres
visa: bzis
infraestructura: nyuk
luciérnaga: gyun
detector: tyek
adaptado: dyip
biólogo: byis
empalme: pyec
bromo: brom
paladio: plum
hipo: kfok
pastel: psec
Zoo: zwac
clínica: lyok
connotación: nwoc
yoga: hjoc
librería: byun
terapia: grap
nacionalista: zlis
decapitar: zlet
sí: swec
problemático: byam
jazz: dzas
tungsteno: tsof
terrorista: gwis
regatear: droc
metabolismo: tlem
pensión-alimenticia: lyaf
fin-de-semana: hfom
crisantemo: gzim
vacuna: byap
motocicleta: tyok
mantra: dyot
semestre: myes
heroína: gwon
carpeta: flap
cátodo: kfoc
ideología: dlec
estacionamiento: prek
theta: fret
anticlímax: hxis
selenio: clem
ciclismo: blek
corteza: pros
equivalencia: swaf
corriente-pertinencia-marcador: hxak
aeropuerto: cwoc
amputar: gyet
baloncesto: bwet
impostor: mwip
cucaracha: tlek
cromo: hgom
litro: hl6t
sin-embargo: nwec
hormona: cwom
defectuoso: tluc
perforar: prec
animismo: nyom
polígono: cloc
feminista: hfes
conjugado: kcop
euro: dros
ginseng: hjes
algoritmo: hlof
láser: lwes
farmacia: dlot
milímetro: mlem
flexionar: flek
ánodo: nlok
matiz: hzus
medio-tiempo: prem
sensibilidad: nyec
demostrador: drom
helio: clum
bilingüe: dzic
acrónimo: hqim
initialism: nl6m
gerundio: gros
plasma: psem
cromosoma: rwom
ordinal: rwok
kilómetro: klum
fax: tfes
genética: nwek
peca: frek
destornillador: dres
brócoli: blok
pretérito: xrit
vitamina: tyem
cadmio: kyem
bombardeo: bwoc
gráfico: gjik
titanio: dyim
derroche: clec
lambda: lwem
novia: pcem
copular: kyuk
reloj-de-arena: tlus
empatía: mlif
boro: bres
helicóptero: cwet
telurio: tlum
fecha-tope: jyic
alinear: gwic
centímetro: hfem
molibdeno: mlom
litio: tfim
multimedia: myum
actualizar: dyet
caloría: clom
robot: ryoc
deberes: groc
logaritmo: grom
mantis: gzas
instalar: nwut
aminado: myoc
glifo: glif
aoristo: pyos
ecología: plec
sofisticar: flok
marijuana: bjam
micro: mrom
kilogramo: lwom
comer-con-exceso: jrot
previsible: dzik
Pizza: zyas
escuchar-a-escondidas: zris
lingüística: bwis
corte-de-pelo: braf
iridio: ryom
racismo: gwim
óptima: gyim
industrialización: drif
sede: krup
cerio: zrim
congruente: nrum
partitivo-caso: pxik
casete: ksep
fuerza-de-voluntad: blot
dimensional: dzen
parámetro: rwet
sincronizar: nrop
maximizar: dzim
seminario: mwec
disco: dyok
neón: nyok
osmio: hzom
Epifanía: hp6n
plagiar: lyap
artefacto: rwek
reactor: fyet
orégano: ryop
plutonio: pwum
itrio: tyom
aumentativo: hxat
nombre-de-usuario: mrum
graduado: zrot
derechista: dwaf
argón: jros
fobia: hxot
socializar: sluk
la-globalización: bluc
longitud-de-onda: hnef
codificar: kfom
reciclar: psoc
reiniciar: nrek
hepatitis: pyes
toro: fros
quimioterapia: myep
módulo: mwok
protón: zwot
disquete: dwet
miligramo: mlum
píxel: psep
tantalio: twem
sustancia-disoluta: hjot
genocidio: nyos
depredador: rwes
galio: glem
circonio: hzum
determinador: txin
no-lineal: nlem
pesticida: pyif
berilio: brem
neurona: nrus
predicativo: pxit
calzoncillos: tlif
factorial: kref
neutrón: zrut
niobio: nwom
germanio: hjem
metaloide: tlop
poner-en: dlap
prolative-caso: hl6k
biodiversidad: jwic
palanca-de-mando: jyok
antibiótico: twok
actinio: gjim
astronauta: srof
extraterrestre: tyes
chiflado: hwup
maratón: mrof
iterbio: zwim
autismo: tyif
ionizar: nlof
radón: cwos
nerium: nrem
epidemiología: pwip
de-vejez: lyuc
cámping: kyep
a-rayas: drip
de-indio: nyum
verídico: hvik
sitio-web: bwes
Corán: kwek
mostrada: fwet
nth--root: tfec
lawrencio: lyem
derechos-civiles: glip
teléfono-móvil: mlof
paralizado: twoc
protactinio: prum
radiación: hd6n
depender-en: pxin
torio-átomo: hxim
Jean-azul: bjun
planta-de-casa: hxas
individualmente: dvit
flujo-de-corriente: lwuk
punto-triple: ht6t
cuerpo-humano: hn6n
física: bzik
Al-por-menor almacenar: hxan
cesio: hs6m
largo-hace: hqan
hoja-de-cálculo: hxet
unidad-de-masa: hn6m
compilar: ml6n
binary--valor: vrim
humano-siendo: nyus
por-medio-de: hvan
depan-dari: pxat
praseodimio: pyom
cartulina: kxat
finito-verbo: hqik
prueba-número: hr6n
Pro-frase: hr6t
crítico: hk6k
embalaje: pxas
impermanencia: pxan
a-más: txas
descriptor: drop
neodimio: nyem
amistad: hvit
leer-solamente: xyak
encontradas: xwan
gnomic-estado-animico: kxin
fonema: hxom
racionalidad: xlit
fonológico: xlin
comida-habitación: hxac
vivo-habitación: hxic
céntrico-caso: zrik
hodierno-pre: hx6n
paciente-caso: hqak
oblicuo-caso: bwok
rural-zona: hqat
Recurse: hr6s
medio-voz: dyos
meitnerio: hm6m
cartero: hvak
evasivo: kxit
valores-mercado: xrak
identificable: hxap
Gol-desencadenar: krof
un-segundo: hxen
lative-caso: dvak
racionar: hr6c
no-humano: hg6n
vivo-cosa: hvic
también-pequeño: hxut
cine: hvin
hassio: xyim
atenuantes: ty6t
multal-número: ml6m
lechoso-camino: txam
neptunio: nwem
escritor-fantasma: txik
trans-número: ts6s
perder-el-tiempo: hqun
americio: myem
Mañana-gloria: txan
Bombero: xran
berkelio: blem
galaxia-género: kxan
nobelio: blum
adiós: hvac
budismo: hfum
fermium: frem
cian: xyan
soja: syof
distribuidor: qrit
rompehuelgas: txak
procesador: ples
abessive-caso: bvak
adesivo-caso: dvik
a-caso: kxak
agentiva-caso: dvek
rutherfordio: hr6m
anticuerpo: txip
como-mucho-como: hjos
agente-desencadenar: hg6t
actor-papel: xram
etidio: txim
común-género: hk6n
acompañante: kl6n
cártamo: kxam
francio: fyam
erbio: ry6m
pasivo-voz: xyis
astato: hqit
masticación-chicle: hqam
estrella-género: hqin
citación-formar: ht6m
curio: jrim
tira-cómica: kxis
daltoniano: hqon
de-Euler-- serie: hl6m
Mira-a: kxas
paso-de-peatones: pwok
campo-de-batalla: txat
automovilista: vrit
cortocircuito: txok
verbal-sustantivo: hvis
llorar-fuera: hk6t
estadísticamente: xyit
yogur: txot
xenón: hs6n
hipnotizar: hxif
tomar-apagado: hxaf
cláusula-de-la cola: hxok
directo-objeto: dwot
tienda-de-comestibles almacenar: kxun
consistir-de: hm6t
ergative-caso: gvik
en-su-idioma: txic
de-primera-mano: pxam
locativo-caso: hqok
piscina: slup
adverbial-caso: vlak
turismo: hqas
televisión-conjunto: ht6s
final-partícula: xlik
evitative-caso: hvek
rehabilitación: xlat
regresión: xris
bloquear-de-pisos: kxot
despertar-arriba: hxup
policía-oficial: ps6s
jurar---en: vran
entrevistador: qrat
renio: ryem
aerosol: xres
posesivo-caso: kxik
nominalización: mlec
poseído-caso: dzak
sobrecargar: pxak
auxiliar-verbo: xyik
primario-objeto: mlut
Virus-de-computadora: prus
persona-de-negocios: hqis
un-gente: hqen
antessive-caso: ts6k
primer-ministro: pxis
lutecio: lyum
europio: rwum
ser-emocionado: xrot
música-folclórica: zyik
poeta: vwit
Oficina-de-correo: pxot
según-cabe-suponer: hvas
animar-género: hven
subessive-caso: bvik
acelerador: glep
polaridad: pr6t
vehículo-género: vlin
mineral-género: xrin
verbo---sufijo: hvif
apasionado: pc6n
samario: sr6m
facilitador: hs6t
imaginaria---unidad: xyin
velocidad-de-la luz: kxac
fuerza-Aerea: hxes
empático-alegría: pfec
punto-crítico: qyit
tiempo-completo: hxem
hafnio: xyam
inhibición: hn6s
cambio-de-evento: qrin
holmio: xlim
diferente-evento: hf6t
universo-género: hvip
localidad-género: kxen
virtual-máquina: hvim
investigación-género: txen
artístico-género: ts6n
crastinal-tiempo: sl6t
abstracto-género: srep
exocéntrica-caso: zrek
transitivo-verbo: txif
morfema: tfom
chauvinista: dvis
pasado-perfectivo: xrat
profesional: hy6n
indirecto-habla: tyoc
segundo-idioma: draf
a-ser: txis
cementerio-cambio: vrak
colectivo-sustantivo: hxos
absolutive-caso: bvuk
paciente-desencadenar: tr6t
yo-confianza: hs6s
heces: hzos
reflexivo-voz: hf6s
impersonal-verbo: hxek
seaborgio: br6m
espacio-en-blanco: hxep
modal-caso: dlok
inanimado-género: hj6n
causante: qran
propositiva-estado-animico: psom
eléctrico-corriente: tr6n
de-asociación-caso: nwok
superlativo-caso: tluk
también-mucho: xyut
planetario-género: pxen
animado-caricatura: nwuk
recíproco-voz: vrik
legislar: hqaf
a-menos: vlas
gramatical-de-los casos: qrak
usuario: pxut
núcleo-benefactivo: kfef
portero: hgop
:-except-for: kcef
denominador: dvan
else-if: lyek
oblicuo: hx6s
El-uno-al otro: dles
sucesivo-cláusula: lyuk
al-desgaste-a cabo: hxun
pantalones-cortos: ht6k
disprosio: prom
pronto-futuro-tiempo: rwec
si-unidades: vyin
criptón: kxon
mendelevio: dlem
aplicativo-voz: hp6s
antipasiva-voz: tsef
continuativas-aspecto: ht6p
radiación-de-la enfermedad: hr6k
necessitative-estado-animico: hn6t
soltero-acción-verbo: hqek
automotor: xlak
superlativo-la-licenciatura: tlup
existencial-cláusula: hs6k
californio: kf6n
presente-participio: vrat
luminoso-intensidad: hc6t
singulativo-número: slus
gramatical-a-objetos: hy6t
pasivo-participio: vris
excesivo-duración: kxic
fluido-supercrítico: sr6t
cantidad-de-sustancia: ks6t
postposicional-caso: pxok
electivo-cuantificador: lwif
gadolinio: dl6n
epentético-morfema: hp6m
negativo-cuantificador: nwif
einstenio: ny6n
artificial-idioma: txac
conectivo-partícula: qrik
remoto-futuro-tiempo: twec
frecuentativo-aspecto: hfep
distributivo-pronombre: bvin
alocución-acuerdo: hk6m
calvo: blos
suburbio: syum
universal-cuantificador: vlit
computadora-programación: mr6m
televisión-programa: tr6m
de-punto-flotante de números: hvun
existencial-cuantificador: tl6t
la-día-después mañana: dwek
alternativa-cuantificador: lw6t
de-mal-humor: hdup
pasado-pasivo-participio: hp6t
la-día-antes de ayer: txet
locativo-direccional-caso: tc6k
contrafactual-condicional: ht6c
