ﻆﻓﺎﺣ-ﺍﺪﺧ: ﻆﻓﺎﺣﺍﺪﺧ, ﺩﻭﺭﺩ, PI, ﯽﻈﻓﺎﺣﺍﺪﺧ
: 
ﺯﺍ: ﻦﯿﺑ, ﻩﺭﺎﺑ-ﺭﺩ, ﻥﺁ
ﻪﺑ: ﺎﯿﺑ, ﺪﯾﺎﺑ
ﺭﺩ-ﻪﮐ: 
:-First-person: 
ﻦﻣ: ﻦﻣ-ﻪﺑ
:-Third-person: 
ﻪﮐ: IT, ﻪﮐ
ﺩﻮﺧ: ﻥﺁ, ﺩﻮﺧ
ﻭﺍ: IT
ﺎﺑ: 
ﯼﺍﺮﺑ: ﻩﺭﺎﺑ-ﺭﺩ, ﯼﻮﺳ-ﻪﺑ
ﻪﻟﺰﻨﻣ-ﻪﺑ: ﻪﮐ, ﻝﺎﺜﻣ, ﻪﻧﻮﮕﭼ
:-Second-person: 
ﻥﺩﻮﺑ: 
ﻭﺍ: ﻥﺁ
ﺮﺑ: ﻥﺩﺯ-ﮓﻧﺯ, ﻩﺭﺎﺑ-ﺭﺩ
ﺭﺩ: ﺐﺳﺍ
ﻂﺳﻮﺗ: ﻥﺩﺮﮐ-ﯽﻃ, ﻭ, ﻩﺭﺎﺑ-ﺭﺩ
ﺪﻧﺭﺍﺩ: ﻞﻤﺤﺗ
ﺎﯾ: ﻪﻧ-ﻭ
ﺐﻧﺎﺟ-ﺯﺍ: 
ﻦﯾﺍ: IT
ﺍﺭ-ﻭﺍ: ﻥﺁ
ﻭﺍ: ﺎﻬﻧﺁ, IT
ﻦﻣ: ﻡﺩﻮﺧ-ﻝﺎﻣ, ﻦﻣ-ﻪﺑ
ﻥﺎﺷ: ﻥﺁ, ﺎﻬﻧﺁ
ﻦﯾﺍﺮﺑﺎﻨﺑ: ﺐﯿﺗﺮﺗ-ﻦﯾﺪﺑ, ﯼﺩﻭﺯ-ﻪﺑ
: 
ﺎﻬﻧﺁ: ﺎﻬﻧﺁ, ﺎﻤﺷ
ﺎﻣ: ﺎﻣ, ﻦﻣ-ﻪﺑ
ﯽﺴﮐ-ﻪﭼ: ﻪﮐ-ﯽﺴﮐ-ﺮﻫ, ﻪﮐ
ﺍﺭ: ﺮﮑﻓ, ﺍﺭ
ﻩﺩﺍﺭﺍ: ﻩﺩﺍﺭﺍ-ﯼﻭﺮﯿﻧ
ﺮﯿﺧ: ﻪﻧ
ﺮﮔﺍ: ﻪﭼ, ﻩﺪﺷ-ﻪﺋﺍﺭﺍ
ﻻ﻿ﺎﺑ: ﻻ﻿ﺎﺑ-ﺭﺩ, ﻥﺪﻣﺁ-ﻻ﻿ﺎﺑ, ﺝﺭﺎﺧ, ﺮﺗﺪﺑ
ﻪﺑ: ﮏﯾ
ﺮﻫ: ﯽﻨﻌﯾ, ﻪﮐ, ﻪﻤﻫ, ﮏﺗ-ﮏﺗ
ﺍﺭ-ﺩﻮﺧ: ﺎﻤﺷ-ﻝﺎﻣ
ﯽﭼ: ﻪﻧ-ﻭ, ﻪﮐ, ﺰﯿﭼ
ﻩﺪﻨﻫﺩ-ﻥﺎﺸﻧ-ﺖﻟﺎﺣ: ﺩﻮﻤﻨﻫﺭ-ﺖﻟﺎﺣ
ﻥﺎﺴﻧﺍ: ﺺﺨﺷ, ﺮﻫﻮﺷ, ﺮﻧ
ﻪﺑ-ﺖﺒﺴﻧ: ﺶﯿﺑ, ﻩﺭﺎﺑ-ﺭﺩ, ﻪﻧﻮﮕﭼ
ﺎﻣ: ﺭﺎﻬﺑ, ﺎﻣ
ﺯﺍ-ﯽﺧﺮﺑ: ﯼﺪﺣﺎﺗ
ﺮﺑ: ﺯﺍ-ﺪﻌﺑ, ﻻ﻿ﺎﺑ-ﺭﺩ, ﺝﺭﺎﺧ
ﺖﺳﺍ-ﻦﮑﻤﻣ: ﺭﺩﺎﻗ
ﻥﻮﻨﮐﺍ: ﺮﺿﺎﺣ
ﺪﻨﻧﺎﻣ: ﻪﻧﻮﮕﭼ, ﻖﺸﻋ, ﻦﺘﺷﺍﺩ-ﻪﮕﻧ
ﻥﺍﻮﺗ-ﯽﻣ: ﺭﺩﺎﻗ, ﺖﺳﺍ-ﻪﺘﺴﻧﺍﻮﺗ, ﻪﺒﻌﺟ
ﺪﯾﺎﺑ: ﺪﯾﺎﺑ
ﺩﺍﺩ-ﻡﺎﺠﻧﺍ: ﻡﺎﺠﻧﺍ, ﺖﯿﻌﻗﺍﻭ
ﻦﯿﻨﭼ: ﺐﯿﺗﺮﺗ-ﻦﯾﺪﺑ
: ﮏﯾ
ﺎﻬﻨﯾﺍ: ﺎﻬﻧﺁ, IT
ﺮﺑ-ﻎﻟﺎﺑ: ﻻ﻿ﺎﺑ-ﺭﺩ, ﺶﯿﺑ
ﺭﺎﯿﺴﺑ: ﺭﺎﯿﺴﺑ, ﻢﺠﺣ
ﯼﺎﻗﺁ: ﺎﻗﺁ, ﺩﺎﺘﺳﺍ
ﺏﻮﺧ: ﻞﮕﺷﻮﺧ, ﯽﻟﺎﻋ, ﻉﻮﻧ
ﻦﯾﺮﺘﺸﯿﺑ: ﺶﯿﺑ, ﯼﺩﺎﯾﺯ-ﺪﺣ-ﺎﺗ, ﺖﯾﺮﺜﮐﺍ, ﺭﺎﯿﺴﺑ
ﺪﯾﺎﺑ: ﺪﯾﺎﺑ
ﻥﺁ: ﺎﻬﻧﺁ, ﻥﺁ
ﺩﻮﺧ: ﺩﻮﺧ, ﻥﺎﺴﮑﯾ, ﻥﺎﺷﺩﻮﺧ
ﯽﮔﺪﻧﺯ: ﻩﺪﻧﺯ, ﺮﻤﻋ-ﻝﻮﻃ, ﺭﺍﺩﺍﺪﺻ-ﻑﺮﺣ, ﺮﻤﮐ-ﺭﻭﺩ
ﻥﻭﺪﺑ: 
ﻦﺘﺧﺎﺳ: ﻡﺎﺠﻧﺍ, ﻥﺩﺭﻭﺁ-ﺩﻮﺟﻭ-ﻪﺑ
ﻲﺑﻮﺧ-ﻪﺑ: ﺖﺣﺍﺭ, ﺖﺳﺭﺩ
ﻦﺨﺳ-ﺮﮕﻧﺎﺸﻧ: 
ﻖﯾﺮﻃ-ﺯﺍ: ﻥﺩﺮﮐ-ﯽﻃ, ﺫﻮﻔﻧ
ﻦﮑﻤﻣ: ﺕﺭﺪﻗ, ﺪﯾﺎﺷ, ﺖﺳﺍ-ﻪﺘﺴﻧﺍﻮﺗ
ﻢﻫ: ﺭﺎﯿﺴﺑ, ﯽﺘﺣ
ﻮﻧ-ﺯﺍ: ﻊﻗﻮﻣ-ﻥﻭﺍ, ﺖﺸﮔﺯﺎﺑ, ﺭﺎﺑ-ﮏﯾ
ﯼﺭﺎﯿﺴﺑ: ﺖﯾﺮﺜﮐﺍ
ﺮﻫ: ﮏﺗ-ﮏﺗ, ﻪﮐ
ﺎﻫ-ﻥﺎﺴﻧﺍ: ﺺﺨﺷ, ﻉﺎﻤﺘﺟﺍ, ﻡﺩﺮﻣ
ﺮﮑﻓ: ﻱﮊﻮﻟﻮﺋﺪﻳﺍ, ﻪﺸﯾﺪﻧﺍ, ﺮﮑﻓ
ﺮﯾﺯ: ﻦﯿﯾﺎﭘ
ﺯﻮﻨﻫ: ﺶﯿﺑ
ﻥﺩﺍﺩ-ﯼﺎﺟ: ﻪﻄﻘﻧ, ﺖﯿﻌﻗﻮﻣ, ﻪﮐ-ﯽﯾﺎﺟ
ﻦﯿﺣ-ﺭﺩ: ﻪﮑﯿﻟﺎﺣ-ﺭﺩ, ﻥﺎﻣﺯ, ﺖﻗﻮﻣ
ﻂﻘﻓ: ﻂﻘﻓ, ﻩﺩﺎﺳ
ﻦﯿﻨﭽﻤﻫ: ﯽﺘﺣ, ﺐﯿﺗﺮﺗ-ﻦﯿﻤﻫ-ﻪﺑ, ﺶﯿﺑ
ﻥﻮﻨﮐﺎﺗ: ﺎﻣﺍ, ﻪﻧ-ﻭ, ﺩﻮﺟﻭ-ﻦﯾﺍ-ﺎﺑ, ﺶﯿﺑ
ﺮﺑﺍﺮﺑ-ﺭﺩ: ﯼﻮﺳ-ﻪﺑ, ﺯﺍ-ﻞﺒﻗ
ﻦﺘﻓﺮﮔ: ﺕﺎﻗﻼ﻿ﻣ, ﻦﺘﻓﺮﮔ, ﻖﺘﺸﻣ
ﻪﺸﯿﻤﻫ: ﯼﺪﺑﺍ, ﺰﮔﺮﻫ, ﻪﺸﯿﻤﻫ
ﺵﻮﻣﺎﺧ: ﻪﺘﺴﺑ, ﺭﻭﺩ, ﺝﺭﺎﺧ, ﻩﺪﺷ-ﻩﺩﺍﺩ-ﺶﺷﻮﭘ
ﺕﺭﻮﺻ: ﺢﻄﺳ, ﺪﺻ, ﺺﺨﺷ
ﺮﮕﯾﺩ: ﻪﺘﺷﺬﮔ, ﺮﮕﯾﺩ
ﺩﺮﮐ-ﮎﺮﺗ: ﺭﻭﺩ
ﺪﯾﺪﺟ: ﻮﺌﻧ, ﻥﺎﻣﺭ, ﺕﻭﺍﺮﻃ-ﺎﺑ, ﺮﻔﻧ-ﻪﻧ, ﻥﺍﻮﺟ
ﻢﻧﺎﺧ: 
ﻥﺩﺍﺩ-ﺭﺍﺮﻗ: ﻢﯿﻈﻨﺗ, ﻪﺘﺷﺬﮔ, ﻥﺩﺍﺩ
ﻪﺑ: ﻦﺘﻔﮔ
ﻦﻫﺫ: ﯼﺮﮑﻓ, ﺮﮑﻓ
ﺭﺎﻤﺷ-ﺖﺸﮕﻧﺍ: ﺮﻫﻮﺷ-ﻭ-ﻥﺯ, ﯽﻤﮐ-ﺭﺍﺪﻘﻣ
ﻪﮐ: ﻪﮐ, ﻪﮐ-ﯽﺴﮐ-ﺮﻫ
ﺭﺎﯿﺴﺑ: ﺭﻭﺩ, ﺭﻭﺩ-ﻩﺍﺭ-ﺯﺍ, ﺭﺎﯿﺴﺑ
ﺪﻧﻮﺷ-ﯽﻣ-ﻩﺪﯿﻣﺎﻧ: ﺮﮑﻓ
ﻡﺎﻤﺗ: ﻩﺪﺷ-ﺮﭘ, ﻪﻤﻫ
ﻭﺩ-ﺮﻫ: ﻭﺩ
ﻥﺩﺮﮐ-ﺍﺪﯿﭘ: ﻩﺪﺷ-ﺍﺪﯿﭘ, ﻥﺩﺮﮐ-ﻮﺠﺘﺴﺟ
ﻦﮐ-ﻩﺎﮕﻧ: ﻥﺪﯾﺩ, ﯽﺳﺭﺮﺑ, ﻩﺎﮕﻧ
ﺪﯿﻫﺩ-ﻩﺯﺎﺟﺍ: ﺱﻮﺑﻮﺗﺍ, ﻦﺘﺨﯾﺭ-ﻥﻭﺮﯿﺑ, ﻥﺩﺍﺩ, ﻦﺘﺧﺎﺳ-ﺭﺩﺎﻗ
ﺪﻧﻭﺍﺪﺧ: ﺩﺎﺘﺳﺍ, ﺎﻗﺁ, ﻩﺎﺷﺩﺎﭘ
ﻪﻧﺎﺧ: ﻪﻧﺎﺧ
ﯼﺰﯿﭼ-ﻪﯾ: ﯽﭼ-ﭻﯿﻫ, ﯼﺪﺣﺎﺗ
ﻪﻈﺤﻟ: ﻥﺎﻣﺯ
ﺭﺪﭘ: ﺭﺪﭘ
ﻥﺎﯿﻣ-ﺭﺩ: ﻦﯿﺑ
ﺎﻫ-ﻥﺯ: ﻥﺯ
ﺭﺩﺎﻣ: ﺭﺩﺎﻣ
ﻥﺎﯾﺎﭘ: ﺪﯿﺳﺭ-ﻥﺎﯾﺎﭘ-ﻪﺑ, ﻪﺘﺷﺬﮔ, ﺮﯾﺩ
ﮏﭼﻮﮐ: ﯽﻤﮐ-ﺭﺍﺪﻘﻣ, ﮏﭼﻮﮐ
ﻮﺗ: ﺎﻤﺷ
ﺪﯿﻫﺍﻮﺧ-ﯽﻣ: ﺪﯾﺎﺑ
ﺎﻣﺍ: ﺎﻣﺍ, ﺩﻮﺟﻭ-ﻦﯾﺍ-ﺎﺑ, ﻪﭼﺮﮔ
ﻼ﻿ﻣﺎﮐ: ﻼ﻿ﻣﺎﮐ, ﯼﺪﺣﺎﺗ, ﺭﺎﯿﺴﺑ, ﯽﻓﺎﮐ
ﻪﮐ: ﻪﮐ
ﻦﯾﺮﺘﻬﺑ: ﺮﺘﻬﺑ
ﻡﺩﻮﺧ: ﻦﻣ-ﻪﺑ, ﻥﺎﺷﺩﻮﺧ
ﻪﮑﻨﯾﺍ-ﺎﺗ: ﯽﺘﺣ, ﺯﺍ-ﻞﺒﻗ, ﻆﻓﺎﺣﺍﺪﺧ
ﻥﻮﭼ: ﻊﻗﻮﻣ-ﻥﻭﺍ, ﻝﻭﺍ, ﺍﺮﯾﺯ
ﺪﺷ-ﻩﺩﺎﻔﺘﺳﺍ: ﯽﻤﯾﺪﻗ, ﺖﻓﺎﯾﺯﺎﺑ
ﺎﺘﺒﺴﻧ: ﯼﺎﺠﺑ, ﯼﺪﺣﺎﺗ, ﺶﯿﺑ
ﺮﺘﻤﮐ: ﻩﺎﺗﻮﮐ-ﺪﻗ, ﻦﯿﯾﺎﭘ, ﻦﯾﺮﺘﻤﮐ
ﺩﻭﺪﺣ-ﺭﺩ-،ﻞﺧﺍﺩ ﺭﺩ: ﯽﻠﺧﺍﺩ, ﻖﯿﻤﻋ, ﻪﻧﺎﺧ-ﻞﺧﺍﺩ-ﺭﺩ
ﺮﮕﯾﺪﮑﯾ-ﺎﺑ: ﻢﯿﻈﻨﺗ
ﮒﺭﺰﺑ: ﯽﻟﺎﻋ, ﻢﯿﻈﻋ
ﻩﺩﺎﻣ: ﺰﯿﭼ, ﻉﻮﺿﻮﻣ, ﻝﺍﻮﺳ
ﯽﻀﻌﺑ: ﺺﺨﺸﻣ, ﺖﺳﺭﺩ
ﺵﺩﻮﺧ: ﻥﺎﺷﺩﻮﺧ
ﻢﯿﻧ: ﻩﺍﺭ-ﻪﻤﯿﻧ, ﻥﺩﺮﮐ-ﺏﺎﯿﺳﺁ, ﺖﻤﺳ
ﺖﺳﺭﺩ: ﯽﺘﺳﺍﺮﺑ, ﺖﯿﻌﻗﺍﻭ, ﺖﺳﺭﺩ
ﻱﺰﻴﭼ-ﺮﻫ: ﻪﭼ-ﺮﻫ, ﯼﺪﺣﺎﺗ, ﯽﭼ-ﭻﯿﻫ
ﻦﺘﺷﺍﺩ-ﻩﺎﮕﻧ: ﻦﺘﺷﺍﺩ-ﻪﮕﻧ, ﻢﯿﻈﻨﺗ, ﻆﻔﺣ
ﻥﺯ: ﻥﺯ
ﯼﺎﻨﻌﻣ-ﻪﺑ: ﺮﯿﺴﻣ
ﮏﯾﺩﺰﻧ: ﻥﺩﺮﮐ-ﯽﻃ, ﺎﺒﯾﺮﻘﺗ
ﻥﺩﺍﺩ-ﺡﺮﺷ-ءﺰﺟ ﻪﺑ ءﺰﺟ: ﺖﯿﻌﺿﻭ, ﻥﺪﺷ-ﻞﺧﺍﺩ, ﺭﻮﺸﮐ, ﺖﻟﻭﺩ
ﺲﮐ-ﯽﺑ: ﺎﻬﻨﺗ, ﮏﺗ, ﮏﯾ
ﺩﺭﻮﻣ: ﻁﻮﻘﺳ, ﻝﺎﺜﻣ, ﺖﺳﺍﻮﺧﺩﺍﺩ, ﻪﺛﺩﺎﺣ, ﺍﺮﯾﺯ
ﻮﺗ: ﺎﻤﺷ
ﻻ﻿ﺎﺑ: ﻻ﻿ﺎﺑ-ﺭﺩ, ﻪﻘﺒﻃ
ﺮﺘﺧﺩ: ﺮﺘﺧﺩ-ﺪﻧﺯﺮﻓ, ﻥﺯ, ﺮﺘﺧﺩ-ﺖﺳﻭﺩ
ﻢﺸﭼ-ﯼﻭﺭ-ﻪﺑ: ﻥﺩﺍﺩ-ﻥﺎﻨﯿﻤﻃﺍ, ﺖﺳﺭﺩ, ﯽﺘﺳﺍﺮﺑ
ﻊﻗﺍﻭ-ﺭﺩ: ﯽﺘﺳﺍﺮﺑ, ﺖﯿﻌﻗﺍﻭ
ﺩﻮﺧ: ﻥﺎﺷﺩﻮﺧ, ﺩﻮﺧ, ﻪﭼ
ﻩﺍﺮﻤﻫ: ﻩﺍﺮﻤﻫ, ﯽﻧﻻ﻿ﻮﻃ, ﻝﻮﻃ
ﻦﯿﻣﺯ: ﺭﻮﺸﮐ
ﺖﺸﮔﺮﺑ: ﺖﻓﺮﺴﭘ, ﺖﺸﮔﺯﺎﺑ, ﺩﺍﺩﺮﺘﺳﺍ
ﻥﺩﺮﮐ-ﮎﺮﺗ: ﺖﻤﯾﺰﻋ, ﺕﻼ﻿ﯿﻄﻌﺗ, ﻪﮐﻭﺮﺘﻣ, ﺭﻭﺩ, ﻩﺯﺎﺟﺍ
ﻢﻫ: ﯽﺘﺣ
ﻥﻮﻧﺎﻗ: ﺖﺳﺭﺩ, ﯽﻧﻮﻧﺎﻗ, ﻥﻮﻧﺎﻗ
ﯽﻧﺎﺣﻭﺭ-ﺮﯿﻏ: ﻢﯿﻈﻨﺗ, ﺭﻻ﻿ﻮﮑﺳ, ﮏﻤﮐ
ﻥﺩﺮﻛ-ﻩﺭﺎﺷﺍ: ﻪﻄﻘﻧ, ﻞﻤﻋ, ﻂﻘﻓ, ﺪﻨﺑ
ﻞﻔﻃ: ﺎﻫ-ﻪﭽﺑ
ﻥﺩﺮﮐ-ﻭﺯﺭﺁ: ﺪﯿﻣﺍ, ﻦﺘﺷﺍﺩ-ﻞﻳﺎﻤﺗ
ﻦﺘﻔﮔ-ﻦﺨﺳ: ﻦﺘﻔﮔ, ﺪﯿﻨﮐ-ﺖﺒﺤﺻ
ﻥﺎﯾﺮﺟ-ﺭﺩ: ﻥﺎﻣﺯ, ﻪﮑﯿﻟﺎﺣ-ﺭﺩ
ﺪﻨﭼ: ﻦﯿﺟﻭﺩ, ﺮﻫﻮﺷ-ﻭ-ﻥﺯ, ﺶﯿﺑ
ﺕﺭﺎﺠﺗ: ﺕﺭﺎﺠﺗ, ﻩﺎﮕﺷﻭﺮﻓ, ﺖﮐﺮﺷ, ﺭﺎﮐ, ﯼﺭﺎﺠﺗ, ﯽﯾﺎﺠﺑﺎﺟ
ﺵﻭﺭ: ﺮﯿﺴﻣ, ﺵﻭﺭ
ﻦﯿﻣﻭﺩ: ﺮﮕﯾﺩ
ﯽﻣﻮﻤﻋ: ﺞﯾﺍﺭ, ﯽﻠﮐ-ﺭﻮﻄﺑ, ﻡﺩﺮﻣ-ﻡﻮﻤﻋ
ﺖﺸﭘ: ﺖﺸﮔﺯﺎﺑ
ﻥﺪﺷ: ﺎﯿﺑ
ﻥﺎﺟ-ﯽﺑ: ﻥﺩﺮﻣ, ﮒﺮﻣ
ﻦﯿﻣﺯ: ﺭﻮﺸﮐ
ﺮﺴﭘ: ﺮﺴﭘ-ﺪﻧﺯﺮﻓ
ﺱﺎﺴﺣﺍ: ﺱﺎﺴﺣﺍ, ﻥﺪﯿﻨﺷ
ﺡﻭﺭ: ﺡﻭﺭ
ﺖﻘﯿﻘﺣ: ﺖﯿﻌﻗﺍﻭ
ﻦﯿﻣﺯ: ﻪﻘﺒﻃ, ﺭﻮﺸﮐ, ﻪﻄﻘﻧ
ﺎﻌﻗﺍﻭ: ﯽﺘﺳﺍﺮﺑ, ﺭﺎﯿﺴﺑ, ﺖﯿﻌﻗﺍﻭ
ﯽﻗﺎﺑ: ﺮﮕﯾﺩ, ﯽﺘﺣﺍﺭ, ﻪﺘﺴﺸﻧﺯﺎﺑ, ﯽﻗﺎﺑ, ﺕﻼ﻿ﯿﻄﻌﺗ
ﻒﻠﺘﺨﻣ: ﻒﻠﺘﺨﻣ, ﺕﻭﺎﻔﺗ, ﺮﮕﯾﺩ
ﻦﮑﻤﻣ: ﺪﯾﺎﺷ
ﻥﺎﺴﻧﺍ: ﺺﺨﺷ, ﺖﯾﺮﺸﺑ
ﺮﻬﺷ: ﻥﺎﺘﺳﺮﻬﺷ
ﻥﺩﺮﮐ-ﻝﺎﺒﻧﺩ: ﺪﻌﺑ, ﻥﺩﺮﮐ-ﻝﺎﺒﻧﺩ, ﺯﺍ-ﺪﻌﺑ
ﻦﺘﺷﺍﺩ-ﻡﺯﻻ﻿: ﻡﺯﻻ﻿, ﺪﯾﺎﺑ
ﺩﻮﺷ-ﯽﻣ-ﺐﺒﺳ: ﻞﯿﻟﺩ, ﻥﺩﺮﮐ-ﺭﺍﺩﺍﻭ, ﺍﺮﯾﺯ
ﺐﺷ: ﺐﺷ, ﺮﻬﻇ-ﺯﺍ-ﺪﻌﺑ
ﺞﻨﭘ: ﻢﺠﻨﭘ, ﻝﺎﺳ
ﯼﻮﻗ: ﺕﺭﺪﻗ, ﺭﺩﺎﻗ, ﺪﯾﺪﺷ
ﻢﻧﺎﺧ: ﻥﺯ
ﻑﺍﺮﻃﺍ-ﺭﺩ: ﻑﺍﺮﻃﺍ, ﺎﺒﯾﺮﻘﺗ, ﻩﺭﺎﺑ-ﺭﺩ, ﻢﺸﭼ
ﻥﺩﺯ-ﺭﻭﺩ: ﺖﻤﺳ, ﻢﯿﻈﻨﺗ, ﺐﯿﺗﺮﺗ
ﺲﺣ: ﻦﺘﺷﺍﺩ-ﺭﻮﻈﻨﻣ, ﺱﺎﺴﺣﺍ, ﯽﻨﻤﺿ-ﺖﻟﻻ﻿ﺩ
ﻦﺘﺴﺑ: ﻪﺘﺴﺑ, ﺎﺒﯾﺮﻘﺗ
ﺖﯿﺼﺨﺷ: ﻪﺼﺨﺸﻣ, ﺖﯿﺼﺨﺷ, ﺖﻣﻼ﻿ﻋ, ﺖﻌﯿﺒﻃ
ﯼﺯﺎﺳ-ﺐﺗﺮﻣ: ﯼﺪﻨﺑ-ﻢﯿﺴﻘﺗ, ﻉﻮﻧ
ﻩﺮﻈﻨﻣ: ﺯﺍﺪﻧﺍ-ﻢﺸﭼ, ﻮﻠﺟ-ﻪﺑ, ﻪﻨﺤﺻ, ﻥﺪﯾﺩ, ﻩﺎﮕﻧ
ﺏﺰﺣ: ﻦﺸﺟ, ﻝﻮﮔﺮﯾﻭ, ﺭﻮﺸﮐ
ﺏﻮﺧ: ﯽﻟﺎﻋ, ﺮﻏﻻ﻿
ﻥﺩﻮﺑ-ﻩﺩﺎﻣﺁ: ﻥﺩﺮﮐ-ﻩﺩﺎﻣﺁ, ﻼ﻿ﺒﻗ, ﻪﺠﻨﭘ-ﮎﻮﻧ, ﺪﯿﺳﺭ-ﻥﺎﯾﺎﭘ-ﻪﺑ
ﺏﺎﺴﺣ: ﻞﯿﻟﺩ, ﻪﺤﯾﻻ﻿, ﻪﺒﺳﺎﺤﻣ, ﻥﺩﺮﻤﺷ
ﺖﺳﺍ-ﻩﺪﺷ-ﻪﺘﺷﻮﻧ: ﻦﺘﺷﻮﻧ
ﻦﺳ: ﯽﻤﯾﺪﻗ, ﻥﺮﻗ
ﯼﺮﮕﯾﺩ: ﺮﮕﯾﺩ, ﻪﺘﺷﺬﮔ, ﺮﮕﯾﺩ-ﯼﺎﺟ-ﺭﺩ, ﺶﯿﺑ
ﻥﺩﺮﻛ-ﺭﻮﺒﺠﻣ: ﺕﺭﺪﻗ, ﻥﺩﺮﮐ-ﺮﯾﺰﮔﺎﻧ, ﻞﯿﻤﺤﺗ
ﻥﺎﯿﻣ-ﺭﺩ: ﻻ﻿ﺎﺑ-ﺭﺩ, ﻞﺑﺎﻘﻣ
ﻪﯿﻟﻭﺍ: ﺱﺭﺎﻧ, ﻉﻭﺮﺷ, ﻪﯿﻟﻭﺍ, ﯼﺩﻭﺯ-ﻪﺑ
ﺏﺎﺘﻓﺁ: 
ﺪﻌﺑ: ﻩﺪﻨﯾﺁ, ﻊﻗﻮﻣ-ﻥﻭﺍ, ﺯﺍ-ﺪﻌﺑ, ﺪﻌﺑ
ﯼﺰﯿﭼ-ﺮﻫ: ﻪﻤﻫ
ﻪﺘﺷﺬﮔ: ﻩﺪﺷ-ﯼﺮﭙﺳ, ﺮﮕﻧ-ﻪﺘﺷﺬﮔ, ﻪﺘﺷﺬﮔ, ﺯﺍ-ﺪﻌﺑ
ﻞﻤﻋ: ﻪﺤﯾﻻ﻿, ﻞﻌﻓ, ﻞﻤﻋ, ﺭﺎﮐ, ﯽﯾﺎﺠﺑﺎﺟ
ﺮﺘﺸﯿﺑ: ﻮﻠﺟ-ﻪﺑ, ﺶﯿﺑ, ﯽﻓﺎﺿﺍ
ﺮﺗﺍﺮﻓ: ﺶﯿﺑ, ﺝﺭﺎﺧ
ﮏﯾ-ﭻﯿﻫ: ﻪﻧ-ﻭ, ﻪﮐ
ﺯﺍﺪﻧﺍ-ﻢﺸﭼ: ﺭﺎﻬﻇﺍ, ﻩﺎﮕﻧ, ﻥﺪﯾﺩ, ﺯﺍﺪﻧﺍ-ﻢﺸﭼ, ﻪﻨﺤﺻ, ﻢﯾﻮﻘﺗ
ﺍﺪﺻ: ﺍﺪﺻ
ﭻﯿﻫ: ﯽﭼ-ﭻﯿﻫ, ﻞﮑﯿﻧ
ﺢﺿﺍﻭ: ﻦﮐ-ﺯﺎﺑ, ﺩﻮﻬﺸﻣ, ﻪﺟﻮﺗ-ﻞﺑﺎﻗ, ﮏﺒﺳ
ﻩﺩﺎﺟ: ﻩﺍﺮﮔﺭﺰﺑ, ﺮﯿﺴﻣ
ﯽﻌﻗﺍﻭ: ﯼﺯﺎﺠﻣ, ﺖﯿﻌﻗﺍﻭ, ﯽﺘﻨﻄﻠﺳ
ﺎﺒﯾﺮﻘﺗ: ﺎﺒﯾﺮﻘﺗ, ﻩﺭﺎﺑ-ﺭﺩ
ﺶﻧﺍﺩ: ﺕﺎﻋﻼ﻿ﻃﺍ
ﻪﺑ-ﺖﺒﺴﻧ: ﯼﻮﺳ-ﻪﺑ
ﺪﺑ: ﺮﺗﺪﺑ, ﺪﺑ, ﺮﯿﻘﻓ
ﻥﺩﺮﻛ-ﻲﮔﺪﻧﺯ: ﻩﺪﻧﺯ, ﺮﻤﮐ-ﺭﻭﺩ, ﺮﻤﻋ-ﻝﻮﻃ
ﺢﻠﺻ: ﻕﺎﺗﺍ
ﻢﮐ: ﻩﺎﺗﻮﮐ-ﺪﻗ, ﻥﺍﺯﺭﺍ, ﻦﯿﻨﺟ-ﻂﻘﺳ
ﻝﺎﻤﺷ: ﻩﺪﺑ-ﺏﺍﻮﺟ, ﯽﻟﺎﻤﺷ, ﺐﺷ-ﻪﻤﯿﻧ
ﯽﻌﯿﺒﻃ: ﺖﻌﯿﺒﻃ
ﺭﺎﯿﺴﺑ: ﻞﮕﺷﻮﺧ, ﺭﺎﯿﺴﺑ, ﯽﻓﺎﮐ
ﻪﻧﻻ﻿ﺩﺎﻋ: ﺖﺳﺭﺩ, ﺵﺭﺍﺰﮔ, ﻩﺩ
ﯽﻧﺎﺳﺭ-ﺖﻣﺪﺧ: ﺖﻣﺪﺧ, ﻥﺩﺍﺩ-ﺖﻴﻤﻫﺍ
ﺮﯾﺯ-ﺭﺩ: ﻦﯿﯾﺎﭘ
ﺕﺬﻟ: ﻝﺎﺤﺷﻮﺧ
ﺦﯾﺭﺎﺗ: ﻥﺎﺘﺳﺍﺩ, ﺦﯾﺭﺎﺗ, ﯽﺨﯾﺭﺎﺗ
ﺪﯿﺷﺎﺑ-ﻪﺘﺷﺍﺩ-ﻪﺟﻮﺗ: ﻥﺩﺭﻭﺁ-ﺩﺎﻳ-ﻪﺑ, ﯼﺭﺍﺬﮔ-ﻥﺎﺸﻧ
ﻪﻜﻨﻳﺍ-ﺎﺑ: ﻪﭼﺮﮔ
ﻮﻠﺟ: ﻞﺑﺎﻘﻣ, ﻮﻠﺟ-ﻪﺑ, ﺯﺍ-ﻞﺒﻗ
ﮒﺭﺰﺑ: ﯽﻟﺎﻋ, ﻢﯿﻈﻋ
ﺎﻌﻄﻗ: ﺍﺪﮐﻮﻣ, ﻩﺭﻭﺩ, ﯽﺘﺳﺍﺮﺑ
ﺩﺎﺑ: ﺍﻮﻫ, ﯽﻧﺍﻭﺮﯿﺷ-ﺮﯾﺯ-ﻕﺎﺗﺍ
ﻥﺩﺮﻛ-ﺖﻓﺎﻳﺭﺩ: ﻝﻮﺻﻭ-ﻡﻼ﻿ﻋﺍ, ﻦﺘﻓﺮﮔ, ﻖﺘﺸﻣ
ﻪﺟﻮﺗ: ﻥﺩﺍﺩ-ﺖﻴﻤﻫﺍ, ﺖﯾﻮﻟﻭﺍ, ﺰﮐﺮﻤﺗ, ﻪﺟﻮﺗ, ﺪﯿﮐﺎﺗ
ﻡﺎﮑﺤﺘﺳﺍ: ﺕﺭﺪﻗ
ﺪﯾﺎﺷ: ﺪﯾﺎﺷ
ﻝﺎﺤﺷﻮﺧ: ﻝﺎﺤﺷﻮﺧ, ﺭﺍﺩ-ﻩﺪﻨﺧ, ﯽﺿﺍﺭ
ﺖﯿﻤﻫﺍ-ﺎﺑ: ﻡﺯﻻ﻿, ﻢﻬﻣ
ﺕﺩﻮﺧ: ﺩﻮﺧ, ﻥﺎﺷﺩﻮﺧ
ﺭﺎﮑﻤﻫ: ﺭﺎﮑﻤﻫ, ﺖﺳﻭﺩ
ﺮﻈﻧ: ﺭﺎﻬﻇﺍ, ﻪﺸﯾﺪﻧﺍ
ﻥﺎﻤﯾﺍ: ﻦﺘﺷﺍﺩ-ﺩﺎﻘﺘﻋﺍ, ﯼﺭﺍﺩﺎﻓﻭ
ﺶﯿﭘ: ﻕﺮﺷ, ﻊﻗﻮﻣ-ﻥﻭﺍ, ﺯﺍ-ﻞﺒﻗ, ﻮﻠﺟ-ﻪﺑ, ﺖﺸﮔﺯﺎﺑ
ﮊﺭﺎﺷ: ﺽﺭﺍﻮﻋ, ﻪﻨﯾﺰﻫ, ﻦﺘﻓﺮﮔ
ﻭﺯﺎﺑ: ﺖﺳﺩ, ﺮﯿﻘﻓ, ﻦﯿﺘﺳﺍ, ﺡﻼ﻿ﺳ, ﻪﻧﺎﺷ
ﯽﻣﻭﺩ: ﻪﺘﺷﺬﮔ
ءﯽﺷ: ﻑﺪﻫ, ﯽﭼ-ﭻﯿﻫ, ﻉﻮﺿﻮﻣ
ﺎﻗﺁ: ﺮﻧ, ﺎﻗﺁ, ﺩﺎﺘﺳﺍ
ﺹﺎﺧ: ﺹﻮﺼﺨﺑ, ﯽﻨﻌﯾ
ﯽﺘﺨﺳ-ﻪﺑ: ﻪﻧ, ﺎﺒﯾﺮﻘﺗ, ﺭﺩﺎﻧ
ﺲﯿﺋﺭ: ﺮﯾﺪﻣ, ﺮﺳ
ﺲﻧﺎﺷ: ﯽﻗﺎﻔﺗﺍ, ﺖﯿﻌﻗﻮﻣ, ﺖﺒﺳﺎﻨﻣ, ﻝﺎﻤﺘﺣﺍ
ﻪﻣﺎﻧ-ﻢﻫﺎﻔﺗ: ﺡﺮﻃ, ﻩﺎﮕﺷﻭﺮﻓ, ﯼﺭﺎﮑﻤﻫ-ﺩﺍﺩﺭﺍﺮﻗ
ﺮﮑﻔﺗ: ﺮﮑﻓ
ﻦﯿﮕﻨﺳ: ﺭﺍﺮﮑﺗ, ﻥﺯﻭ, ﯼﺪﺟ-ﺭﻮﻃ-ﻪﺑ, ﺖﺨﺳ
ﻩﺩﺎﺳ: ﻦﮐ-ﺯﺎﺑ, ﻩﺩﺎﺳ, ﯽﻟﺎﺧﻮﺗ
ﻪﻠﺻﺎﻓﻼ﻿ﺑ: ﺭﺎﺑ-ﮏﯾ, ﯼﺩﻭﺯ-ﻪﺑ
ﻥﺎﻫﺩ: ﺺﺨﺷ
ﻩﺪﯿﺳﺮﺗ: ﻩﺩﺯ-ﺖﺸﺣﻭ, ﺱﺮﺗ, ﺲﭘﺍﻮﻟﺩ
ﺎﻬﻨﺗ: ﮏﯾ, ﺎﻬﻨﺗ
ﺕﺬﻟ: ﻝﺎﺤﺷﻮﺧ, ﻥﺎﺠﯿﻫ
ﻪﺘﺴﮑﺷ: ﺩﺮﮔﻮﮔ, ﺵﺮﺑ
ﻪﮑﻨﯾﺍ-ﺮﮕﻣ: ﺰﺠﺑ
ﻞﻤﺣ: ﻞﻤﺤﺗ, ﻥﺪﯿﺷﻮﭘ, ﺍﺭ, ﻦﺘﺧﺎﺳ-ﺭﺩﺎﻗ
ﺮﯿﺛﺎﺗ: ﺮﺛﺍ, ﺍﺰﻧﺍﻮﻠﻔﻧﺍ
ﺪﺳﺭ-ﯽﻣ-ﺮﻈﻧ ﻪﺑ: ﻥﺪﺷ-ﺭﺍﺪﯾﺪﭘ, ﺪﺳﺭ-ﯽﻣ-ﺮﻈﻧ ﻪﺑ
ﺯﺍ-ﺝﺭﺎﺧ: ﺝﺭﺎﺧ, ﺰﺠﺑ
ﻢﻨﻛ-ﻰﻣ-ﺶﻫﺍﻮﺧ: ﺰﯿﻣﺁ-ﺖﺒﺤﻣ, ﻥﺪﯿﺳﺮﭘ
ﯼﺮﻫﺎﻇ-ﻞﮑﺷ: ﻥﺪﺷ-ﺭﺍﺪﯾﺪﭘ, ﺪﺳﺭ-ﯽﻣ-ﺮﻈﻧ ﻪﺑ
ﯽﻣﺍﺭﺁ-ﻪﺑ: ﻪﺘﻓﺭ-ﻪﺘﻓﺭ, ﺮﯾﺩ
ﯽﻧﺎﻣﺯ-ﻩﺭﻭﺩ: ﺯﺎﻓ, ﻥﺎﻣﺯ
ﺮﻫﺍﻮﺧ: ﺭﺩﺍﺮﺑ
ﺩﺮﺒﻧ: ﻥﺩﺮﮐ-ﻩﺯﺭﺎﺒﻣ, ﮓﻨﺟ
ﻖﺑﺎﺳ: ﯽﻤﯾﺪﻗ
ﻥﺎﻧﺍﻮﺟ: ﻥﺍﻮﺟ
ﺎﻬﻨﺗ: ﻂﻘﻓ, ﻩﺩﺎﺳ, ﺎﻬﻨﺗ
ﻪﺑ-ﻥﺪﯿﺳﺭ: ﺵﻭﺭ, ﻥﺪﯿﺳﺭ, ﺎﯿﺑ
ﻢﺘﺴﯿﺳ: ﺐﯿﺗﺮﺗ, ﺐﺗﺍﺮﻣ-ﻪﻠﺴﻠﺳ, ﻥﺎﻣﺯﺎﺳ
ﻡﺎﺷ: ﺐﺷ, ﺭﺎﻫﺎﻧ
ﻥﺁ-ﺯﺍ-ﺪﻌﺑ: ﻩﺪﻨﯾﺁ, ﺯﺍ-ﺪﻌﺑ
ﻦﺘﻓﺭ-ﻩﺍﺭ: ﺝﺁ, ﻦﺘﻓﺭ, ﻪﻘﺒﻃ, ﺎﭘ
ﺐﺠﻌﺗ: ﻩﺰﺠﻌﻣ, ﺐﻳﺮﻏ-ﻭ-ﺐﻴﺠﻋ, ﻥﺪﺷ-ﺮﯿﮕﻠﻓﺎﻏ
ﻝﻮﻤﻌﻣ: ﯽﻠﮐ-ﺭﻮﻄﺑ, ﺞﯾﺍﺭ, ﻪﺸﯿﻤﻫ
ﻞﮑﺷ: ﻝﺎﺘﯿﺠﯾﺩ, ﻡﺎﻗﺭﺍ, ﻞﮑﺷ, ﺩﺪﻋ, ﺽﺭﺍﻮﻋ, ﺮﯾﻮﺼﺗ
ﯽﻧﺎﺘﺳﺎﺑ: ﯽﻤﯾﺪﻗ, ﻩﺩﺎﺘﻓﺍ-ﺪﻣ-ﺯﺍ
ﻡﺍﺮﺘﺣﺍ: ﻪﺟﻮﺗ, ﺭﺎﺨﺘﻓﺍ, ﺮﻄﺧ, ﯼﻮﺳ-ﻪﺑ
ﻡﻮﺳ: ﻪﺳ, ﻪﺒﻨﺸﻬﺳ
ﻥﺪﻧﺎﻣ: ﻥﺩﺮﮐ-ﺖﻣﺎﻗﺍ
ﻪﻌﻣﺎﺟ: ﯽﻋﺎﻤﺘﺟﺍ, ﻉﺎﻤﺘﺟﺍ, ﺖﮐﺮﺷ
ﻪﺠﯿﺘﻧ: ﻪﺠﯿﺘﻧ, ﺮﺛﺍ
ﻥﺎﻣﺮﻓ: ﺐﯿﺗﺮﺗ
ﺾﺤﻣ: ﻂﻘﻓ, ﻩﺩﺎﺳ
ﺭﺎﻨﻛ-ﺭﺩ: ﻥﺩﺮﮐ-ﯽﻃ, ﺪﻌﺑ, ﺰﺠﺑ
ﺍﺪﺻ-ﯽﺑ: ﻡﺍﺭﺁ
ﻞﻣﺎﮐ: ﺐﺳﺎﻨﻣ, ﯽﻟﺎﻋ
ﻥﺎﺑﺎﯿﺧ: ﺮﯿﺴﻣ
ﻪﺘﺷﻮﻧ: ﻦﺘﺷﻮﻧ, ﻪﻣﺎﻧ
ﺏﻮﭼ: ﯽﺑﻮﭼ, ﺖﺧﺭﺩ, ﺏﻮﭼ
ﺖﻋﺮﺳ-ﻪﺑ: ﯼﺩﻭﺯ-ﻪﺑ
ﻉﻼ﻿ﻃﺍ: ﻥﺪﯾﺩ, ﺩﻼ﻿ﯿﻣ-ﺯﺍ-ﺪﻌﺑ, ﺭﺍﺪﺸﻫ
ﻦﺷﻭﺭ: ﺰﯿﺗ, ﮏﺒﺳ, ﻕﺍﺮﺑ, ﻪﺟﻮﺗ-ﻞﺑﺎﻗ
ﻖﯾﺎﻗ: ﯽﺘﺸﮐ, ﺭﻭﺎﻨﺷ, ﯽﻧﺎﺑﺩﺎﺑ-ﻖﯾﺎﻗ
ﺐﯿﺠﻧ: ﯽﻟﺎﻋ, ﻩﻮﮑﺷ-ﺎﺑ
ﻩﺮﻈﺘﻨﻣ-ﺮﻴﻏ: ﻩﺭﺎﺒﮑﯾ-ﻪﺑ
ﺵﺯﺭﺍ: ﺵﺯﺭﺍ, ﻪﺒﺗﺭ, ﺖﯿﻤﻫﺍ
ﺯﺍ-ﯽﺷﺎﻧ: ﺍﺮﯾﺯ
ﺖﺋﺍﺮﻗ: ﻥﺪﻧﺍﻮﺧ, ﻝﺍﻮﺳ
ﻥﺩﺮﮐ-ﻝﻮﺒﻗ: ﯼﺭﺎﮑﻤﻫ-ﺩﺍﺩﺭﺍﺮﻗ
ﻦﻛ-ﺮﺒﺻ: ﺭﺎﻈﺘﻧﺍ, ﻦﺘﺷﺍﺩ-ﻪﮕﻧ, ﻥﺩﺮﮐ-ﺖﻣﺎﻗﺍ
ﻪﻌﻄﻗ: ﻪﺷﺍﺮﺗ, ﺶﺨﺑ, ﻂﺴﺑ
ﻖﺑﺎﺳ: ﯽﻤﯾﺪﻗ
ﻮﮕﺘﻔﮔ: ﺪﯿﻨﮐ-ﺖﺒﺤﺻ, ﺩﻮﻨﺷ-ﻭ-ﺖﻔﮔ
ﺖﺻﺮﻓ: ﺖﺒﺳﺎﻨﻣ, ﺖﯿﻌﻗﻮﻣ
ﻪﻨﯾﺰﻫ: ﻪﻨﯾﺰﻫ, ﺖﺧﺍﺩﺮﭘ
ﻪﺟﻮﺗ-ﻞﺑﺎﻗ: ﯽﻟﺎﻋ, ﻢﻬﻣ, ﻪﺟﻮﺗ-ﻞﺑﺎﻗ
ﻦﺘﺴﺸﻧ: ﻥﺩﺮﮐ-ﺖﻣﺎﻗﺍ
ﻻ﻿ﺎﺑ: ﻪﻨﯿﻬﺑ, ﺱﺍﺮﻟﺍ-ﻂﺧ, ﻻ﻿ﺎﺑ-ﺭﺩ, ﻪﻠﻗ
ﺝﺍﻭﺩﺯﺍ: ﻩﺩﺮﮐ-ﺝﺍﻭﺩﺯﺍ
ﻡﺎﮔ: ﻞﻤﻋ, ﺝﺁ, ﺯﺎﻓ
ﺯﺎﻏﺁ: ﻉﻭﺮﺷ
ﺮﻫ-ﺭﺩ: ﮏﺗ-ﮏﺗ, ﯼﻮﺳ-ﻪﺑ
ﯼﺩﺮﻓ: ﺺﺨﺷ, ﻪﻧﺎﮔﺍﺪﺟ-ﺭﻮﻃ-ﻪﺑ, ﻢﺗﺍ
ﺭﺍﻮﺷﺩ: ﺖﺨﺳ
ﻩﺭﺫ: ﺶﺨﺑ, ﯽﻤﮐ-ﺭﺍﺪﻘﻣ, ﺶﭙﺷ, ﻪﻤﻘﻟ
ﯽﻧﺍﺮﻨﺨﺳ: ﺪﯿﻨﮐ-ﺖﺒﺤﺻ
ﻦﺘﺷﺍﺩ-ﺭﺎﯿﺘﺧﺍ: ﻩﺎﮔﺩﺍﺩ-ﻦﯾﺍ-ﺖﯿﺣﻼ﻿ﺻ, ﺕﺭﺪﻗ
ﯼﺩﺎﺷ: ﻝﺎﺤﺷﻮﺧ
ﺪﻨﮐ-ﯽﻣ-ﻢﻫﺍﺮﻓ: ﻩﺪﺷ-ﻪﺋﺍﺭﺍ, ﻥﺩﺍﺩ, ﻥﺩﺍﺩ-ﻥﺎﻨﯿﻤﻃﺍ
ﻥﺩﺮﮐ-ﻞﯿﺼﺤﺗ: ﺮﯿﮕﺑ-ﺩﺎﯾ, ﻞﯿﻠﺤﺗ, ﻩﺎﮔﺭﺎﮐ
ﯽﺼﺨﺷ: ﯽﺻﻮﺼﺧ, ﻪﻧﺎﮔﺍﺪﺟ-ﺭﻮﻃ-ﻪﺑ, ﻥﺎﻨﮐﺭﺎﮐ
ﻥﺩﺮﮐ-ﺎﺷﺎﻤﺗ: ﯽﺳﺭﺮﺑ, ﺭﻮﺘﯿﻧﺎﻣ, ﻥﺪﯾﺩ
ﻝﺎﺤﺷﻮﺧ: ﯽﺿﺍﺭ, ﻝﺎﺤﺷﻮﺧ
ﻡﺮﮔ: ﻡﺮﮔ, ﯼﺯﻮﺳ-ﺶﺗﺁ
ﺵﻼ﻿ﺗ: ﻥﺩﺮﻛ-ﺵﻼ﻿ﺗ, ﺩﺍﮋﻧ
ﻩﺪﺷ-ﻩﺩﺎﻣﺁ: ﻥﺩﺮﮐ-ﻩﺩﺎﻣﺁ, ﻼ﻿ﺒﻗ
ﺶﺷﻮﮐ: ﻥﺩﺮﻛ-ﺵﻼ﻿ﺗ, ﻥﺎﺤﺘﻣﺍ, ﻥﺩﺯ-ﻢﺧﺯ
ﻊﯾﺮﺳ: ﯼﺩﻭﺯ-ﻪﺑ, ﺯﺮﻓ
ﺮﯾﺯ-ﺭﺩ: ﻦﯿﯾﺎﭘ, ﺯﺍ-ﺪﻌﺑ
ﻩﺪﺷ-ﻪﺘﻓﺮﮔ-ﺮﻈﻧ ﺭﺩ: ﺪﺼﻗ, ﺰﮐﺮﻤﺗ, ﻑﺪﻫ
ﺖﺳﺍﺭ-ﺮﺳ: ﻢﯿﻘﺘﺴﻣ-ﺭﻮﻃ-ﻪﺑ, ﻩﺩﺎﺳ
ﺩﺭﺍﺩ-ﻝﺎﻤﺘﺣﺍ: ﯽﻧﺎﺳﺁ-ﻪﺑ, ﻝﺎﻤﺘﺣﺍ, ﺪﯾﺎﺷ, ﺍﺮﻫﺎﻇ
ﺖﻟﺍﺪﻋ: ﺖﺳﺭﺩ
ﻩﺩﺎﺳ-ﻥﺎﺑﺯ-ﻪﺑ: ﻂﻘﻓ, ﻩﺩﺎﺳ
ﺩﺎﻤﺘﻋﺍ: ﻦﺘﺷﺍﺩ-ﺩﺎﻘﺘﻋﺍ, ﯼﺭﺍﺩﺎﻓﻭ
ﺭﻮﺒﻋ: ﺶﺨﺑ, ﺭﻮﺒﻋ, ﻥﻮﺘﺳ, ﻥﺩﺮﮐ-ﯽﻃ, ﻂﺴﺑ
ﻪﺘﺴﺑ: ﻪﺘﺴﺑ, ﯽﺟﺎﺴﻧ, ﻩﺪﺷ-ﻩﺩﺍﺩ-ﺶﺷﻮﭘ
ﻥﺎﻣﺩﻮﺧ: ﻥﺎﺷﺩﻮﺧ
ﺭﻮﺒﻋ: ﻥﺩﺮﮐ-ﯽﻃ, ﻩﺪﺷ-ﯼﺮﭙﺳ, ﺭﻮﺒﻋ
ﻂﺳﻮﺘﻣ: ﻡﻭﺩ, ﻦﺘﺷﺍﺩ-ﺭﻮﻈﻨﻣ
ﻦﺘﺷﺍﺩ-ﺭﺎﯿﺘﺧﺍ-ﺭﺩ: ﯽﮔﮋﯾﻭ
ﺮﯾﺬﭙﻟﺩ: ﺖﺣﺍﺭ, ﻉﻮﻧ
ﻼ﻿ﻣﺎﮐ: ﻼ﻿ﻣﺎﮐ, ﯽﺘﺳﺍﺮﺑ
ﻻ﻿ﻮﻤﻌﻣ: ﺞﯾﺍﺭ, ﯽﻠﮐ-ﺭﻮﻄﺑ, ﻞﯾﺎﻤﺗ
ﺮﺒﻗ: ﺖﺨﺳ
ﺪﺷ-ﺖﺳﺭﺩ: ﺖﺑﺎﺛ, ﻪﭼﺮﮔ, ﺩﺭﺍﺪﻧﺎﺘﺳﺍ, ﻲﻤﺋﺍﺩ
ﯼﺎﻫﻭﺮﯿﻧ: ﺶﺗﺭﺍ
ﯼﺭﺎﮐ-ﻪﺴﻠﺟ: ﻪﺴﻠﺟ, ﮊﺎﺘﻧﻮﻣ, ﺕﺎﻗﻼ﻿ﻣ
ﻩﺎﮔﻭﺩﺭﺍ: ﻥﺩﺯ-ﺭﺩﺎﭼ, ﻩﺯﻮﺣ
ﺖﻠﻣ: ﺭﻮﺸﮐ, ﯽﻠﻣ
ﺩﻮﺟﻭ: ﺭﻮﻀﺣ
ﺦﺳﺎﭘ: ﻩﺪﺑ-ﺏﺍﻮﺟ, ﺩﺍﺩﺮﺘﺳﺍ
ﻥﺎﻤﺳﺁ: ﻮﺟ, ﻥﺎﻤﺳﺁ
ﺮﺑﺍﺮﺑ: ﻥﺎﺴﮑﯾ, ﻪﺟﺭﺩ
ﺕﻭﺮﺛ: ﺖﺷﻮﻧﺮﺳ, ﺖﯿﻌﺿﻭ, ﯽﮔﮋﯾﻭ
ﻪﻨﻣﺍﺩ: ﻩﺯﻮﺣ
ﺖﯿﻌﺿﻭ: ﺖﯿﻌﻗﻮﻣ, ﺖﯿﻌﺿﻭ
ﻂﺳﻮﺘﻣ: ﻦﺘﺷﺍﺩ-ﺭﻮﻈﻨﻣ, ﻩﺍﺭ-ﻪﻤﯿﻧ, ﺮﻤﮐ-ﺭﻭﺩ
ﻥﺎﺘﺴﻣﺯ: ﺩﺮﺳ
ﻥﺩﺍﺩ-ﻩﺯﺎﺟﺍ: ﻩﺯﺎﺟﺍ, ﻦﺘﺧﺎﺳ-ﺭﺩﺎﻗ
ﻩﺪﯾﺮﭘ-ﮓﻧﺭ: ﺩﺭﺯ-ﮓﻧﺭ, ﮓﻧﺭ, ﻦﺘﻓﺭ-ﻝﺎﺣ-ﺯﺍ, ﯽﮕﻧﺭ-ﺩﺍﺪﻣ-ﺎﺑ ﯽﺷﺎﻘﻧ, ﻦﮐ-ﺯﺎﺑ, ﮏﺒﺳ
ﺍﺮﺟﺍ-ﻝﺎﺣ-ﺭﺩ: ﻪﻘﺑﺎﺴﻣ, ﻥﺪﯾﻭﺩ
ﯽﻨﯾﺩ: ﻦﯾﺩ, ﯽﻧﺎﻣﺭﺩ-ﯽﻤﯿﺷ
ﯼﺮﺒﻫﺭ: ﻥﺩﺮﮐ-ﺭﺍﺩﺍﻭ, ﺍﺭ
ﺖﮐﺮﺣ: ﺝﺁ, ﻝﺪﺟ-ﻭ-ﺚﺤﺑ, ﻥﺩﺍﺩ-ﻥﺎﮑﺗ, ﯽﯾﺎﺠﺑﺎﺟ, ﻞﻤﻋ
ﻥﺩﺮﮐ-ﻒﻗﻮﺘﻣ: ﺢﻳﺮﻔﺗ-ﮓﻧﺯ, ﻥﺩﺎﺘﺴﯾﺍ
ﯼﺭﺎﺘﻔﮔ: ﻦﺘﻔﮔ, ﯽﻫﺎﻔﺷ, ﺪﯿﻨﮐ-ﺖﺒﺤﺻ
ﻪﺘﺨﺗ: ﻥﺪﻣﺁ-ﻻ﻿ﺎﺑ, ﻮﻠﺑﺎﺗ, ﺖﺤﯿﺼﻧ, ﻪﺒﻟ, ﻥﻮﯿﺴﯿﻤﮐ
ﻩﺩﻮﻬﯿﺑ: ﻥﺩﺮﮐ-ﺩﺍﺯﺁ, ﯽﻟﺎﺧ
ﻥﺎﯾﺯ: ﺭﺮﺿ, ﻩﺪﺷ-ﻢﮐ, ﺖﺸﻧ
ﺩﺎﻬﻨﺸﯿﭘ: ﻩﺪﺷ-ﻪﺋﺍﺭﺍ, ﺩﺎﻬﻨﺸﯿﭘ, ﻥﺩﺍﺩ, ﻩﺎﮕﺸﯾﺎﻤﻧ, ﺖﻣﺪﺧ, ﺯﺎﯿﺘﻣﺍ
ﺱﻼ﻿ﮐ: ﻉﻮﻧ, ﺭﺍﺪﻣ, ﻪﺒﺗﺭ
ﻞﯿﻤﮑﺗ: ﻩﺪﺷ-ﺮﭘ
ﯽﺳﺮﺘﺳﺩ: ﺪﯾﺩﺯﺎﺑ, ﺵﻭﺭ, ﺏﺎﺴﺘﮐﺍ
ﺭﻮﺷ: ﻕﺎﯿﺘﺷﺍ, ﺱﺎﺴﺣﺍ
ﯽﮑﯾﺰﯿﻓ: ﮏﯾﺰﯿﻓ, ﻥﺪﺑ
ﻝﺎﺜﻣ: ﻝﺎﺜﻣ
ﻉﻭﺮﺷ: ﻉﻭﺮﺷ
ﻪﻨﯿﮐ: ﻢﺸﺧ
ﯼﺪﺟ: ﯽﻟﺎﻋ, ﯼﺪﺟ-ﺭﻮﻃ-ﻪﺑ, ﻁﺮﻔﻣ
ﻩﺮﻘﻧ: ﻝﻮﭘ, ﻪﻌﻤﺟ
ﯽﻓﺎﮐ: ﯽﻓﺎﮐ
ﯽﻠﺻﺍ: ﺮﺳ, ﺩﺎﺘﺳﺍ, ﺪﯿﻠﮐ, ﯽﻠﺻﺍ, ﯼﺰﯿﭼ-ﺮﻫ-ﯽﻠﺻﺍ ءﺰﺟ
ﺰﯿﮕﻧﺍ-ﺖﻔﮕﺷ: ﺐﻳﺮﻏ-ﻭ-ﺐﻴﺠﻋ, ﺪﯾﺪﺷ, ﯽﻟﺎﻋ
ﺮﯿﺴﻣ: ﺮﯿﺴﻣ
ﯽﻨﻌﻣ: ﯽﻨﻤﺿ-ﺖﻟﻻ﻿ﺩ, ﻦﺘﺷﺍﺩ-ﺭﻮﻈﻨﻣ, ﺖﯿﻤﻫﺍ, ﻉﻮﺿﻮﻣ
ﻥﺪﺷ-ﺎﺟ: ﺖﺳﺍﻮﺧﺩﺍﺩ, ﺐﺳﺎﻨﻣ
ﺭﺎﯿﺴﺑ: ﻡﺮﺟ, ﺭﺎﯿﺴﺑ, ﺖﺷﻮﻧﺮﺳ
ﯽﻟﺪﻨﺻ: ﯽﻟﺪﻨﺻ, ﻩﺮﺻﺎﺤﻣ, ﺩﺎﺘﺳ
ﯼﺯﺎﺑ: ﺭﺎﻤﻗ, ﯼﺯﺎﺑ
ﻪﯿﻧﺎﯿﺑ: ﻥﺎﯿﺑ, ﺵﺭﺍﺰﮔ
ﺏﺍﻮﺧ: ﺱﻮﺑﺎﮐ, ﺏﺍﻮﺧ
ﮓﻨﺳ: ﻩﺮﺨﺻ, ﻦﻣﺍﺩ, ﮓﻨﺳ
ﻩﮋﯾﻭ: ﺹﻮﺼﺨﺑ, ﯽﺻﻮﺼﺧ, ﺱﺎﻨﺷﺭﺎﮐ
ﺖﺧﺍﺩﺮﭘ: ﻪﻨﯾﺰﻫ, ﺽﺭﺍﻮﻋ, ﺖﺧﺍﺩﺮﭘ
ﻢﻬﺳ: ﺶﺨﺑ, ﻁﺮﺷ, ﺶﻘﻧ, ﻊﯾﺯﻮﺗ
ﻥﺩﺍﺩ-ﺭﺎﺸﺘﻧﺍ: ﺕﺎﯿﺋﺰﺟ, ﻩﺩﺮﺘﺴﮔ, ﻥﺩﺮﮐ-ﺶﺨﭘ, ﻞﯿﻟﺩ
ﻩﻮﮑﺷ: ﺭﺎﺨﺘﻓﺍ, ﺶﯾﺎﺘﺳ
ﺎﻀﻓ: ﺖﯿﻌﻗﻮﻣ, ﻦﻟﺎﺳ, ﻩﺯﻮﺣ, ﺩﺭﻮﻧﺎﻀﻓ
ﯽﻟﻮﻤﻌﻣ: ﺞﯾﺍﺭ, ﻩﺩﺎﺳ
ﻦﺘﻓﺮﮔ-ﺮﻈﻧ-ﺭﺩ: ﺮﮑﻓ, ﻪﺟﻮﺗ
ﯼﺩﺎﯾﺯ-ﺪﺣ-ﺎﺗ: ﺭﺎﯿﺴﺑ, ﯼﺩﺎﯾﺯ-ﺪﺣ-ﺎﺗ
ﺮﺴﻓﺍ: ﯽﻤﺳﺭ
ﺥﺮﻧ: ﺩﺭﺍﺪﻧﺎﺘﺳﺍ, ﺭﺎﺨﺘﻓﺍ, ﻩﺭﻭﺩ
ﻥﺩﺮﮐ-ﺎﻀﻣﺍ: ﯼﺭﺍﺬﮔ-ﻥﺎﺸﻧ, ﺖﺳﮊ, ﺖﻣﻼ﻿ﻋ, ﻪﻄﻘﻧ
ﯽﻣﻮﺑ: ﺖﻌﯿﺒﻃ, ﯽﻠﺻﺍ, ﻦﮐﺎﺳ
ﻥﺩﺮﮐ-ﺭﺎﮐ: ﺪﻨﻣﺭﺎﮐ, ﺭﺎﮐ
ﻥﺩﺮﮐ-ﺝﺍﻭﺩﺯﺍ: ﻩﺩﺮﮐ-ﺝﺍﻭﺩﺯﺍ
ﺪﺣ: ﻥﺍﺮﮐ, ﻢﺠﺣ, ﻪﺟﺭﺩ
ﺵﻭﺭ: ﺮﯿﺴﻣ, ﺭﺎﺑ-ﮏﯾ, ﺵﻭﺭ
ﯽﻟﺎﻋ: ﺮﺘﻬﺑ, ﯽﻟﺎﻋ
ﺲﻔﻧ-ﻪﺑ-ﺩﺎﻤﺘﻋﺍ: ﻦﺘﺷﺍﺩ-ﺩﺎﻘﺘﻋﺍ
ﻼ﻿ﻣﺎﮐ: ﯽﺘﺳﺍﺮﺑ, ﺹﻮﺼﺨﺑ, ﻩﺪﺷ-ﺮﭘ, ﻼ﻿ﻣﺎﮐ
ﻊﯿﺳﻭ: ﯽﻟﺎﻋ
ﯽﻨﻨﻔﺗ: ﻞﯿﺨﺗ, ﻞﮕﺷﻮﺧ
ﻊﯾﺮﺳ: ﯼﺩﻭﺯ-ﻪﺑ, ﺯﺮﻓ
ﻪﻠﺑ: ﻩﺭﺁ, ﺐﯿﺗﺮﺗ-ﻦﯾﺪﺑ
ﯼﺩﺍﺯﺁ: ﻥﺩﺮﮐ-ﺩﺍﺯﺁ, ﻝﻼ﻿ﻘﺘﺳﺍ
ﺖﺴﻫ-ﺐﻟﺎﺟ: ﻢﺳﺭ, ﻭﺎﮑﺠﻨﮐ
ﺯﺍ-ﻪﺘﺷﺬﮔ: ﻢﻫ-ﺯﺍ-ﺍﺪﺟ, ﯼﺭﻭ-ﮏﯾ, ﺰﺠﺑ
ﺺﻟﺎﺧ: ﺕﻭﺍﺮﻃ-ﺎﺑ, ﺺﻟﺎﺧ
ﻩﺭﺎﺑ-ﺭﺩ: ﻻ﻿ﺎﺑ-ﺭﺩ, ﻩﺭﺎﺑ-ﺭﺩ, ﻪﺟﻮﺗ
ﯽﮐﺭﺪﻣ: ﮎﺭﺪﻣ, ﺩﻮﻬﺸﻣ
ﺭﻭﺩ: ﺭﻭﺩ, ﺭﻭﺩ-ﻩﺍﺭ-ﺯﺍ
ﻢﻫ-ﻪﯿﺒﺷ: ﻪﯿﺒﺷ, ﻥﺎﺴﮑﯾ, ﺲﻧﺎﺠﺘﻣ, ﻪﺴﯾﺎﻘﻣ-ﻞﺑﺎﻗ
ﮏﯾﺭﺎﺑ: ﺮﻏﻻ﻿, ﻩﺎﺗﻮﮐ-ﺪﻗ
ﻉﻮﻤﺠﻣ: ﻼ﻿ﻣﺎﮐ
ﻪﺤﻔﺻ: ﺖﻤﺳ, ﻁﺎﯿﺣ
ﺹﻮﺼﺧ-ﻪﺑ: ﺹﻮﺼﺨﺑ
ﻩﻮﮐ: ﻪﭙﺗ
ﺭﻭﺮﻐﻣ: ﺭﻭﺮﻏ
ﯽﻨﺷﻭﺭ-ﻪﺑ: ﺎﺤﯾﺮﺻ, ﻦﮐ-ﺯﺎﺑ, ﺩﻮﻬﺸﻣ
ﺖﻤﯿﻗ: ﺭﺎﺨﺘﻓﺍ
ﺭﺎﻤﯿﺑ: ﺭﺎﻤﯿﺑ
ﯼﺭﻭﺍﺩ: ﻢﯿﻤﺼﺗ, ﻪﻠﻤﺟ, ﻥﻮﻧﺎﻗ, ﯽﺿﺎﻗ, ﻩﺎﮔﺩﺍﺩ-ﻦﯾﺍ-ﺖﯿﺣﻼ﻿ﺻ, ﻥﺍﺮﺤﺑ
ﺪﯿﻨﮐ-ﺪﯿﯾﺎﺗ: ﻝﻮﺒﻗ-ﻞﺑﺎﻗ, ﻥﺩﺮﮐ-ﺭﺍﺮﻗﺍ, ﻦﺘﻓﺮﮔ
ﺎﻫ-ﻪﻧﻮﮔ: ﻉﻮﻧ
ﻝﺎﺒﻧﺩ-ﻪﺑ: ﻥﺩﺮﮐ-ﻮﺠﺘﺴﺟ
ﺭﺎﺨﺘﻓﺍ: ﺭﺎﺨﺘﻓﺍ
ﺵﻮﮔ: ﻩﺯﺎﺟﺍ
ﻦﯿﯾﺎﭘ: ﻦﯿﯾﺎﭘ, ﻪﻘﺒﻃ, ﯼﺎﻨﺑ-ﺮﯾﺯ
ﮏﻤﮐ: ﺯﺪﯾﺍ, ﮏﻤﮐ, ﻥﺩﺮﮐ-ﺖﯾﺎﻤﺣ
ﻼ﻿ﻣﺎﮐ: ﻩﺪﺷ-ﺮﭘ, ﻼ﻿ﻣﺎﮐ
ﺕﺬﻟ: ﻝﺎﺤﺷﻮﺧ, ﺪﻨﯾﺎﺷﻮﺧﺎﻧ
ﻥﺍﺰﯿﻣ: ﯽﻣﻮﺘﻧﺍﻮﮐ, ﻢﺠﺣ, ﺖﯿﻌﻤﺟ, ﺩﺪﻋ
ﻥﺩﺭﻭﺁ-ﺖﺳﺩ-ﻪﺑ: ﺏﺎﺴﺘﮐﺍ, ﻖﺘﺸﻣ, ﻦﺘﻓﺮﮔ
ﺕﺎﯿﻟﺎﻣ: ﻥﺩﺮﮐ-ﻩﺭﺎﺟﺍ, ﻂﺧ
ﺐﯿﻠﺻ: ﺭﻮﺒﻋ, ﻥﺩﺮﮐ-ﯽﻃ, ﺯﻭﺎﺠﺗ
ﻪﻧﺎﮕﯿﺑ: ﻥﺎﻤﻬﻣ, ﺐﻳﺮﻏ-ﻭ-ﺐﻴﺠﻋ, ﯽﺟﺭﺎﺧ, ﻪﺘﺧﺎﻨﺷﺎﻧ
ﺖﻣﺎﻬﺷ: ﺖﻋﺎﺠﺷ
ﻥﺩﺮﮐ-ﺪﺷﺭ: ﻥﺪﻣﺁ-ﻻ﻿ﺎﺑ
ﻂﻠﻏ: ﻍﻭﺭﺩ, ﻩﺎﺒﺘﺷﺍ, ﺭﺎﻤﯿﺑ, ﺺﻗﺎﻧ
ﺪﻨﻠﺑ: ﯽﻧﻻ﻿ﻮﻃ, ﻪﻘﺒﻃ
ﯼﺩﻭﺭﻭ-ﺭﺩ: ﺏﺭﺩ
ﻪﻧﺍﺩﺍﺯﺁ: ﻝﻼ﻿ﻘﺘﺳﺍ, ﻥﺩﺮﮐ-ﺩﺍﺯﺁ, ﻞﻘﺘﺴﻣ-ﺭﻮﻃ-ﻪﺑ, ﻞﺷ
ﻪﺑﺮﺿ: ﻥﺪﺷ-ﻪﮐﻮﺷ, ﻪﺑﺮﺿ, ﺲﮑﻋ, ﻥﺩﺯ-ﺪﮕﻟ
ﺵﻭﺭ: ﺵﻭﺭ, ﺎﯿﺑ
ﻪﻧﺍﺯﻭﺭ: ﺯﻭﺭ
ﻊﯾﺯﻮﺗ: ﻊﯾﺯﻮﺗ
ﺕﻭﺮﺛ: ﻝﻮﭘ, ﯽﮔﮋﯾﻭ
ﯼﺩﺍﺯﺍ: ﻥﺩﺮﮐ-ﺩﺍﺯﺁ, ﻝﻼ﻿ﻘﺘﺳﺍ
ﻥﺩﺮﺑ-ﺶﯿﭘ: ﻦﺘﻓﺭ-ﺶﯿﭘ
ﻢﯾﻼ﻿ﻣ: ﻡﺮﻧ, ﻦﯾﺮﯿﺷ
ﺎﻤﻠﺴﻣ: ﻩﺭﻭﺩ, ﯽﺘﺳﺍﺮﺑ
ﻦﻣﺍ: ﺮﻄﺧ-ﯽﺑ, ﺖﻈﻓﺎﺤﻣ, ﻥﺩﺍﺩ-ﻥﺎﻨﯿﻤﻃﺍ
ﻩﺪﺷ-ﻝﺎﻐﺷﺍ: ﻥﺩﺮﮐ-ﺐﺣﺎﺼﺗ, ﮒﺮﮕﺗ, ﻝﻮﻐﺸﻣ
ﻪﻨﺤﺻ: ﻮﮑﺳ, ﻞﻤﻋ, ﺯﺎﻓ, ﺖﯿﻌﺿﻭ, ﻪﻨﺤﺻ
ﺶﺨﺑ: ﺶﺨﺑ, ﻩﺮﯿﺟ
ﻥﺎﺑﺯ: ﻥﺎﺑﺯ, ﻦﻫﺩ-ﺏﺁ
ﻦﯿﮕﻤﺸﺧ: ﻢﺸﺧ
ﻪﮑﺴﻟﺎﮐ: ﺭﺎﻄﻗ, ﯽﻗﺮﺑ-ﻦﮔﺍﻭ, ﻞﺗﺎﺷ
ﺍﻮﻫ: ﻢﯿﻠﻗﺍ, ﺍﻮﻫ, ﻥﺎﻣﺯ
ﺕﺭﻭﺮﺿ: ﺖﯿﻤﻫﺍ
ﻞﻤﻋ: ﻦﯾﺮﻤﺗ, ﻞﻤﻋ, ﯽﺷﺭﺎﻔﺳ
ﺎﻋﺩﺍ: ﻥﺩﺮﮐ-ﺎﺿﺎﻘﺗ, ﺖﺳﺍﻮﺧﺩﺍﺩ
ﻩﺩﺍﺰﻫﺎﺷ: ﮎﻭﺩ
ﻩﻭﺮﮔ: ﻢﯿﻈﻨﺗ, ﻁﻼ﻿ﺘﺧﺍ, ﻪﻠﮔ, ﺪﻧﺎﺑ, ﻮﻠﺑﺎﺗ
ﺮﺳﺍﺮﺳ: ﺎﺟ-ﻪﻤﻫ-ﺭﺩ
ﻥﺩﺮﮐ-ﻪﻓﺎﺿﺍ: ﻥﺩﺮﮐ-ﻦﻬﭘ, ﯽﻓﺎﺿﺍ, ﻥﺩﺍﺩ-ﺶﯾﺍﺰﻓﺍ
ﻥﺩﺮﮐ-ﺎﻋﺩ: ﻥﺪﯿﺳﺮﭘ
ﻥﺪﺷ-ﯽﻬﺘﻨﻣ: ﻢﻬﻣ, ﺩﺎﺘﺳﺍ
ﯼﺮﺘﺴﮐﺎﺧ: ﻱﺍ-ﻩﻮﻬﻗ, ﺮﺘﺴﮐﺎﺧ
ﺎﺒﻟﺎﻏ: ﻊﻗﺍﻮﻣ-ﺮﺘﺸﯿﺑ, ﺭﺮﮑﻣ, ﻲﻤﺋﺍﺩ
ﻑﻭﺮﻌﻣ: ﺪﻨﺴﭘ-ﻪﻣﺎﻋ, ﻡﺎﻨﮑﯿﻧ, ﺭﺍﺩﺍﺪﺻ-ﻑﺮﺣ
ﺪﻨﻤﺗﺭﺪﻗ: ﺕﺭﺪﻗ, ﺭﺩﺎﻗ
ﻩﺪﻧﺯ: ﻩﺪﻧﺯ
ﻒﯿﻌﺿ: ﻦﺘﻓﺭ-ﻝﺎﺣ-ﺯﺍ, ﺮﯿﻘﻓ
ﻩﺩﺎﻣ: ﺍﻮﺘﺤﻣ, ﻉﻮﺿﻮﻣ
ﺢﯾﺮﺻ: ﻕﺩﺎﺻ, ﻞﺻﺍ
ﺕﺭﺍﺮﺣ: ﻥﺎﺘﺴﺑﺎﺗ, ﻡﺮﮔ
ﻥﺩﺮﮐ-ﺖﻈﻓﺎﺤﻣ: ﺖﻈﻓﺎﺤﻣ, ﻥﺩﺍﺩ-ﺖﻴﻤﻫﺍ
ﻥﺎﺴﮑﯾ-ﺭﻮﻃ-ﻪﺑ: ﻝﺩﺎﻌﺗ, ﻥﺎﺴﮑﯾ, ﺐﯿﺗﺮﺗ-ﻦﯿﻤﻫ-ﻪﺑ
ﯽﻌﯿﺒﻃ-ﺭﻮﻃ-ﻪﺑ: ﺖﻌﯿﺒﻃ
ﻪﺟﻮﺗ-ﺐﻟﺎﺟ: ﺐﻳﺮﻏ-ﻭ-ﺐﻴﺠﻋ, ﻩﺮﻈﺘﻨﻣ-ﺮﯿﻏ, ﯽﻟﺎﻋ
ﻩﺎﻣ: ﻩﺎﻣ
ﮎﺪﻧﺍ: ﯽﻤﮐ-ﺭﺍﺪﻘﻣ, ﯽﻧﺎﺳﺁ-ﻪﺑ, ﮏﺒﺳ, ﺮﻏﻻ﻿, ﻩﺎﺗﻮﮐ-ﺪﻗ
ﮏﺒﺳ: ﮏﺒﺳ
ﻥﺎﺸﻧ-ﺮﻃﺎﺧ: ﻩﺮﮑﻤﯿﻧ, ﺰﯿﺗ
ﻞﺻﺍ: ﻪﯾﺮﻈﻧ, ﻞﺻﺍ, ﻉﻭﺮﺷ
ﯼﺭﻮﻓ: ﯼﺩﻭﺯ-ﻪﺑ, ﻢﯿﻘﺘﺴﻣ-ﺭﻮﻃ-ﻪﺑ
ﻞﯾﺎﻣ: ﻼ﻿ﺒﻗ, ﻪﺠﻨﭘ-ﮎﻮﻧ, ﻞﯾﺎﻣ
ﻪﺠﯿﺘﻧ: ﻢﻬﻣ, ﺮﺛﺍ, ﻪﺠﯿﺘﻧ
ﻪﺼﻗﺎﻨﻣ: ﻡﺮﻧ, ﯼﺭﺎﮑﻤﻫ-ﺩﺍﺩﺭﺍﺮﻗ, ﻪﻘﺑﺎﺴﻣ
ﺪﻨﻣ-ﻪﻗﻼ﻿ﻋ: ﺪﺼﻗ, ﻪﻗﻼ﻿ﻋ
ﻊﺑﺭ: ﺎﭘ
ﻪﺘﻓﺮﺸﯿﭘ: ﻻ﻿ﺎﺑ-ﺭﺩ, ﻮﻠﺟ-ﻪﺑ
ﺍﺮﻫﺎﻇ: ﺎﺤﯾﺮﺻ, ﺍﺮﻫﺎﻇ, ﺪﺳﺭ-ﯽﻣ-ﺮﻈﻧ ﻪﺑ
ﻝﺎﻌﻓ: ﺭﺎﮐ, ﻞﻤﻋ
ﻊﻠﻄﻣ: ﺍﺪﻤﻋ, ﻦﺘﺴﻧﺍﺩ
ﮎﺎﻧﺮﻄﺧ: ﺮﻄﺧ, ﺭﻭﺁ-ﻥﺎﯾﺯ, ﺰﯿﻣﺁ-ﺪﯾﺪﻬﺗ
ﻡﺍﺭﺁ: ﻡﺍﺭﺁ
ﺱﺪﻘﻣ: ﯽﻬﻟﺍ, ﺱﺪﻘﻣ
ﯽﻫﺎﺷﺩﺎﭘ: ﯽﺘﻨﻄﻠﺳ
ﻡﺎﻤﺗ: ﻼ﻿ﻣﺎﮐ, ﻪﻤﻫ, ﻩﺪﺷ-ﺮﭘ
ﺏﻮﺧ: ﻞﮕﺷﻮﺧ
ﺕﺩﺎﻋ: ﻪﺼﺨﺸﻣ, ﺮﯿﺴﻣ, ﯽﺷﺭﺎﻔﺳ
ﻢﯿﻘﺘﺴﻣ: ﺩﻮﻬﺸﻣ, ﻢﯿﻘﺘﺴﻣ-ﺭﻮﻃ-ﻪﺑ, ﻝﻭﺍ-ﺖﺳﺩ
ﻊﻗﺍﻭﺭﺩ: ﯽﺘﺳﺍﺮﺑ, ﺖﯿﻌﻗﺍﻭ
ﯽﯾﺍﻮﻨﺷ: ﻥﺪﯿﻨﺷ
ﯼﻭﺭ-ﻩﺩﺎﯿﭘ: ﺝﺁ, ﺎﭘ, ﻩﺩﺎﯿﭘ-ﺮﺑﺎﻋ
ﻥﺩﺮﻛ-ﺕﺮﭘ: ﻦﺘﺨﯾﺭ-ﻥﻭﺮﯿﺑ, ﺐﻟﺎﻗ, ﺲﮑﻋ
ﺩﺮﺧ: ﯼﺮﮑﻓ
ﻮﯾﺍﺭﺩ: ﯽﮔﺪﻨﻧﺍﺭ, ﺮﮐ-ﻩﻭﺮﮔ, ﺮﻔﺳ, ﺭﺎﺸﻓ, ﻥﺪﯾﻭﺩ, ﮏﺴﯾﺩ
ﺎﻄﺧ: ﺶﻧﺯﺮﺳ, ﻩﺎﺒﺘﺷﺍ
ﺮﻣﺍ: ﺰﯿﭼ, ﻉﻮﺿﻮﻣ, ﻂﺑﺍﻭﺭ
ﺱﺎﻤﺗ: ﺕﺎﺒﺗﺎﮑﻣ, ﻪﺑ-ﻥﺩﺯ-ﺖﺳﺩ
ﻩﺎﮕﺘﺴﯾﺍ: ﻥﺩﺎﺘﺴﯾﺍ, ﺰﮐﺮﻣ, ﻞﺼﻓ
ﻩﺪﺑ-ﺵﻮﮔ: ﻥﺪﯿﻨﺷ, ﻥﺪﯿﺳﺮﭘ, ﻥﺩﺮﮐ-ﺖﻋﺎﻃﺍ
ﻪﻣﺪﺻ: ﯽﮔﺪﯾﺩ-ﺐﯿﺳﺁ, ﺩﺭﺩ, ﺡﻭﺮﺠﻣ
ﻥﺎﯿﺑ: ﻥﺎﯿﺑ, ﺢﯿﺿﻮﺗ
ﻒﻄﻟ: ﺖﻤﺳ, ﺖﻓﺍﺮﻇ, ﺮﺘﺳﺎﻓ
ﻉﺎﻔﺗﺭﺍ: ﻝﻮﻃ
ﻩﺯﺍﺪﻧﺍ: ﯼﺪﻌﺑ, ﻩﺯﺍﺪﻧﺍ, ﻩﺪﺷ-ﺮﭘ
ﻪﻔﯿﻇﻭ: ﻞﻤﻋ, ﺭﺎﮐ, ﻪﻔﯿﻇﻭ
ﯼﺩﺭﺪﻤﻫ-ﺯﺍﺮﺑﺍ: ﯽﻟﺪﮑﯾ, ﻢﺣﺮﺗ
ﻩﺪﯿﺷﻮﭘ-ﺱﺎﺒﻟ: ﺱﺎﺒﻟ
ﺮﺗﺭﻭﺩ: ﻮﻠﺟ-ﻪﺑ
ﯽﺘﺸﮐ: ﺭﺍﺰﺑﺍ, ﯽﺘﺸﮐ
ﺖﺒﺤﻣ: ﻖﺸﻋ
ﻥﺪﯿﺸﮐ-ﺞﻧﺭ: ﻪﺠﻨﮑﺷ, ﯽﺘﺨﺑﺪﺑ, ﺦﻠﺗ, ﻞﮑﺸﻣ
ﺖﺷﻮﮔ: ﺖﺷﻮﮔ, ﻥﺪﺑ
ﮒﺭﺰﺑ: ﻢﯿﻈﻋ, ﯽﻟﺎﻋ
ﺖﺴﭘ: ﻪﺒﺗﺭ, ﺖﺴﭘ-ﻩﺭﺍﺩﺍ, ﺯﺍ-ﺪﻌﺑ, ﻝﺎﺳﺭﺍ, ﺖﯿﻌﻗﻮﻣ
ﻪﻋﻮﻤﺠﻣ: ﯽﮕﺘﺷﺎﺒﻧﺍ, ﻢﯿﻈﻨﺗ, ﺲﮑﻋ-ﻡﻮﺒﻟﺁ, ﻪﺠﯿﺘﻧ
ﻦﮐ-ﺭﻮﺼﺗ: ﻞﯿﺨﺗ, ﺮﮑﻓ
ﺩﻭﺭﻭ: ﺎﯿﺑ
ﺪﻨﻠﺑ-ﯼﺍﺪﺻ-ﺎﺑ: ﻥﺩﺮﮐ-ﺭﺍﺮﺻﺍ, ﯽﻟﺎﻋ, ﺖﺨﺳ
ﻲﻨﺘﺷﺍﺩ-ﺖﺳﻭﺩ: ﻞﮕﺷﻮﺧ, ﻩﻮﮑﺷ-ﺎﺑ
ﻩﺩﺎﻌﻟﺍ-ﻕﺭﺎﺧ: ﺐﻳﺮﻏ-ﻭ-ﺐﻴﺠﻋ, ﻩﺮﻈﺘﻨﻣ-ﺮﯿﻏ
ﻦﺘﺳﻮﯿﭘ-ﻉﻮﻗﻭ-ﻪﺑ: ﻪﻧ-ﻭ
ﻪﻧﺎﺤﺒﺻ: ﺢﺒﺻ, ﺭﺎﻫﺎﻧ
ﺖﯿﻌﻤﺟ: ﺖﯿﻌﻤﺟ
ﻪﻠﺴﻠﺳ: ﺮﯿﺠﻧﺯ, ﻢﯿﻈﻨﺗ
ﻦﯿﮑﺴﺗ: ﺯﺪﯾﺍ, ﯽﺘﺣﺍﺭ, ﻩﺪﺷ-ﯼﺭﺎﺠﺣ-ﻥﺎﺸﻧ ﺎﯾ ﺖﻣﻼ﻿ﻋ
ﺱﺎﺴﺣﺍ: ﺮﺛﺍ, ﺱﺎﺴﺣﺍ, ﻦﺘﺷﺍﺬﮔ-ﺮﯿﺛﺎﺗ, ﭖﺎﭼ
ﺖﯾﺎﺿﺭ: ﯽﺿﺍﺭ
ﻞﮑﺷ: ﯼﺪﻌﺑ, ﻥﺪﺷ-ﻞﻴﻜﺸﺗ, ﻞﮑﺷ
ﺪﻟﻮﺗ: ﻥﺪﻣﺁ-ﺎﯿﻧﺪﺑ
ﻪﺟﻮﺗ: ﻪﺸﯾﺪﻧﺍ, ﻪﺟﻮﺗ
ﻢﻈﻨﻣ: ﯼﺎﻫﺭﻭﺩ, ﺭﺮﮑﻣ, ﯽﺒﯿﺗﺮﺗ
ﯽﺸﮐ-ﺙﺎﺛﺍ: ﻥﺩﺍﺩ-ﻥﺎﮑﺗ, ﯽﯾﺎﺠﺑﺎﺟ
ﻝﻮﻐﺸﻣ: ﻝﻮﻐﺸﻣ
ﺖﯿﻔﯿﮐ: ﻡﺮﺟ, ﻪﺟﺭﺩ
ﻥﺩﺮﻛ-ﻒﺸﻛ: ﻩﺪﺷ-ﺍﺪﯿﭘ, ﻥﺩﺮﮐ-ﻮﺠﺘﺴﺟ, ﻥﺩﺮﮐ-ﺵﺎﻓ
ﻞﺧﺍﺩ: ﯽﻠﺧﺍﺩ, ﻖﯿﻤﻋ, ﻪﻧﺎﺧ-ﻞﺧﺍﺩ-ﺭﺩ
ﮎﺎﺧ: ﻞﮔ, ﻪﻘﺒﻃ, ﮏﺗ, ﺭﻮﺸﮐ
ﻞﻣﺎﮐ-ﺕﺭﻮﺻ-ﻪﺑ: ﻼ﻿ﻣﺎﮐ
ﻡﺎﯿﭘ: ﺕﺎﻋﻼ﻿ﻃﺍ, ﺭﺎﺒﺧﺍ
ﺕﺭﺎﺒﻋ: ﻥﺎﯿﺑ, ﻪﻠﻤﺟ
ﻩﺭﺎﺷﺍ: ﺮﻧ
ﺖﻔﺟ: ﺖﺳﺭﺩ, ﺮﻫﻮﺷ-ﻭ-ﻥﺯ
ﻥﺍﻮﻨﻋ: ﻥﺍﻮﻨﻋ, ﺮﺳ, ﻉﻮﺿﻮﻣ
ﻥﺩﺮﻛ-ﻙﺭﺩ: ﻦﮐ-ﮎﺭﺩ, ﯽﻟﺪﮑﯾ
ﻪﺒﻨﺸﮑﯾ: ﻪﺘﻔﻫ
ﻪﻧﺍﻮﯾﺩ: ﻞﺧ, ﻖﻤﺣﺍ
ﻼ﻿ﻣﺎﮐ: ﻼ﻿ﻣﺎﮐ, ﺍﺪﮐﻮﻣ
ﻡﺍﺭﺁ: ﻡﺍﺭﺁ
ﺖﻤﺣﺭ: ﻢﺣﺮﺗ, ﺖﻓﺍﺮﻇ
ﯼﻭﺎﺣ: ﻪﻠﻤﺟ-ﺯﺍ, ﺍﻮﺘﺤﻣ
ﻢﻏ: ﻩﻭﺪﻧﺍ-ﻭ-ﻢﻏ, ﺩﺭﺩ
ﺯﺎﺑﺮﺳ: ﺶﺗﺭﺍ, ﻭﺮﮔ
ﯽﻠﺒﻗ: ﻕﺮﺷ
ﺢﯿﺿﻮﺗ: ﺢﯿﺿﻮﺗ, ﺕﺎﻋﻼ﻿ﻃﺍ
ﺯﺎﻤﻧ: ﻥﺩﺮﮐ-ﺎﺿﺎﻘﺗ
ﺭﻭﺎﺑ: ﻦﺘﺷﺍﺩ-ﺩﺎﻘﺘﻋﺍ, ﯼﺭﺍﺩﺎﻓﻭ
ﺖﺑﺎﺛ: ﺭﺮﮑﻣ, ﺩﺭﺍﺪﻧﺎﺘﺳﺍ, ﺖﺑﺎﺛ, ﻲﻤﺋﺍﺩ
ﯽﯾﺎﻬﻧ: ﻪﺘﺷﺬﮔ, ﺖﯾﺎﻬﻧ-ﺭﺩ
ﻥﺪﺷ-ﺭﺍﻮﺳ: ﯼﺭﺍﻮﺳ, ﺎﻘﯾﺮﻓﺍ-ﺭﺩ-ﯽﻓﺎﺸﺘﮐﺍ ﺖﺣﺎﯿﺳ, ﻥﺪﻣﺁ-ﻻ﻿ﺎﺑ, ﯽﮔﺪﻨﻧﺍﺭ
ﺖﺳﺎﯿﺳ: ﯽﺳﺎﯿﺳ
ﻢﺳﺭ: ﺮﯾﻮﺼﺗ, ﻢﺳﺭ, ﺡﺮﻃ
ﮒﺮﻣ-ﻝﺎﺣ-ﺭﺩ: ﮒﺮﻣ, ﻥﺩﺮﻣ
ﺎﺿﺎﻘﺗ: ﻥﺩﺮﮐ-ﺎﺿﺎﻘﺗ, ﻝﺍﻮﺳ
ﻻ﻿ﺎﺑ: ﻻ﻿ﺎﺑ-ﺭﺩ
ﻉﻮﻤﺠﻣ: ﻭ, ﺎﮔﻮﯾ, ﺩﺪﻋ
ﺖﮐﺮﺣ: ﯽﯾﺎﺠﺑﺎﺟ, ﺩﺎﻬﻨﺸﯿﭘ
ﺖﻧﻭﺎﻌﻣ: ﻥﺩﺮﮐ-ﺖﯾﺎﻤﺣ, ﮏﻤﮐ
ﺭﺎﻗﻭ: ﺭﺎﺨﺘﻓﺍ
ﻦﺘﻓﺮﮔ: ﻦﺘﺷﺍﺩ-ﻪﮕﻧ, ﻦﺘﻓﺮﮔ, ﺭﻮﺼﺗ
ﻥﺎﯿﻣ-ﺭﺩ: ﻦﯿﺑ
ﯼﺭﺎﺟ: ﺮﺿﺎﺣ, ﻥﺎﯾﺮﺟ
ﻻ﻿ﺎﻤﺘﺣﺍ: ﻝﺎﻤﺘﺣﺍ, ﺪﯾﺎﺷ, ﺖﺳﺍ-ﻪﺘﺴﻧﺍﻮﺗ
ﻪﻧﺎﮔﺍﺪﺟ: ﻢﻫ-ﺯﺍ-ﺍﺪﺟ, ﺕﻭﺎﻔﺗ, ﮏﺗ
ﻦﯾﺮﺗﺪﺑ: ﺮﺗﺪﺑ, ﺮﯿﻘﻓ
ﺖﺸﺣﻭ: ﺱﺮﺗ, ﯽﺘﺴﯾﺭﻭﺮﺗ
ﻝﺮﺘﻨﮐ: ﺕﺍﺭﺮﻘﻣ, ﻝﺮﺘﻨﮐ, ﯽﺳﺭﺮﺑ, ﺖﯾﺮﯾﺪﻣ
ﻪﺑ-ﺭﺩﺎﻗ: ﻦﺘﺧﺎﺳ-ﺭﺩﺎﻗ, ﺭﺩﺎﻗ, ﺮﻫﺎﻣ, ﺕﺭﺎﻬﻣ
ﺖﮐﺮﺷ: ﺖﮐﺮﺷ, ﻪﭼﺮﮔ
ﺮﺗﺮﺑ: ﺮﺘﻬﺑ
ﯽﻧﺎﺣﻭﺭ: ﯽﻨﻫﺫ, ﯽﻗﻼ﻿ﺧﺍ, ﯼﺮﮑﻓ
ﺕﺎﺒﺛﺍ: ﻥﺩﺮﻛ-ﺖﺑﺎﺛ, ﮎﺭﺪﻣ
ﻁﺎﺒﺗﺭﺍ: ﻂﺑﺍﻭﺭ, ﺵﺭﺍﺰﮔ, ﻪﺟﻮﺗ
ﻥﺍﺮﮕﻧ: ﻥﺩﺍﺩ-ﺖﻴﻤﻫﺍ, ﺲﭘﺍﻮﻟﺩ, ﻩﺍﺮﻤﻫ
ﺎﻘﯿﻤﻋ: ﻖﯿﻤﻋ, ﺕﺎﯿﺋﺰﺟ
ﻥﺪﻧﺍﻮﺧ: ﻥﺪﻧﺍﻮﺧ
ﻪﻧﺎﺘﺳﻭﺩ: ﺲﻧﺎﺠﺘﻣ, ﺰﯿﻣﺁ-ﺖﺒﺤﻣ, ﯽﺘﺳﻭﺩ, ﻉﻮﻧ
ﺩﻭﺭﻭ: ﺏﺭﺩ, ﻝﻮﺻﻭ-ﻡﻼ﻿ﻋﺍ
ﻦﯿﻣﺎﺗ: ﺽﺮﻋ, ﻩﺪﺷ-ﻪﺋﺍﺭﺍ
ﺰﯿﻤﺗ: ﺕﻭﺍﺮﻃ-ﺎﺑ, ﻪﺘﻓﺭ-ﻭ-ﻪﺘﺴﺷ
ﺪﯿﻔﻣ: ﻡﺯﻻ﻿, ﺭﺍﺬﮔ-ﺮﻴﺛﺎﺗ
ﻒﯾﺮﻇ: ﻩﺪﻨﻨﮑﺷ, ﺮﻏﻻ﻿, ﺎﺒﯾﺯ
ﻦﺘﺷﺍﺩﺮﺑ: ﺮﺷ-ﺯﺍ-ﻥﺪﺷ ﺹﻼ﻿ﺧ, ﻥﺩﺮﮐ-ﻑﺬﺣ, ﻢﺳﺭ
ﺏﺎﺨﺘﻧﺍ: ﻥﺩﺮﻛ-ﺏﺎﺨﺘﻧﺍ, ﺏﺎﺨﺘﻧﺍ, ﯽﺳﺭﺮﺑ
ﮒﺭﺰﺑ: ﻢﯿﻈﻋ, ﯽﻟﺎﻋ
ﻥﺍﻮﺗﺎﻧ: ﻥﺍﻮﺗ-ﯽﻤﻧ, ﻪﻧ, ﺖﺴﮑﺷ
ﺶﺷﻮﭘ: ﺖﮐ, ﻝﻮﻤﺷ, ﻮﺘﭘ, ﻥﺩﺮﮐ-ﯼﺪﻨﺑ-ﻪﺘﺴﺑ, ﻭﺭ-ﻩﺩﺎﻴﭘ
ﺮﺑﺍﺮﺑ-ﻭﺩ: ﻮﻠﻗﻭﺩ, ﺮﺑﺍﺮﺑ-ﻭﺩ, ﺮﻫﻮﺷ-ﻭ-ﻥﺯ
ﯼﺯﻭﺮﯿﭘ: ﺖﯿﻘﻓﻮﻣ
ﻡﻭﺍﺪﻣ-ﺭﻮﻃ-ﻪﺑ: ﻊﻗﺍﻮﻣ-ﺮﺘﺸﯿﺑ, ﺭﺮﮑﻣ, ﻪﺸﯿﻤﻫ, ﻪﻣﺍﺩﺍ
ﺢﻄﺳ: ﺩﺭﺍﺪﻧﺎﺘﺳﺍ, ﺖﯿﻌﺿﻭ, ﺢﻄﺳ
ﻥﺩﺮﮐ-ﺩﺍﺯﺁ: ﻪﯿﻠﺨﺗ, ﺭﺎﺸﺘﻧﺍ, ﻥﺩﺮﮐ-ﺩﺍﺯﺁ
ﻦﺸﺧ: ﺮﺗﺪﺑ, ﻕﻼ﻿ﺧﺍ-ﺪﺑ, ﺏﺩﺍ-ﯽﺑ
ﺶﯿﭘ-ﺭﺩ: ﻮﻠﺟ-ﻪﺑ, ﻻ﻿ﺎﺑ-ﺭﺩ
ﻞﺼﺘﻣ: ﻥﺍﺮﮐ, ﻪﺘﺴﺑﺍﻭ, ﻩﺍﺮﻤﻫ, ﺝﻭﺩﺰﻣ
ﻥﺩﺮﮐ-ﺐﺴﮐ: ﺏﺎﺴﺘﮐﺍ, ﺖﯾﺰﻣ
ﻪﻓﺎﺿﺍ: ﯽﻓﺎﺿﺍ, ﻩﺪﻨﻨﮐ-ﻞﯿﻤﮑﺗ
ﻕﺎﺗﺍ: ﻕﺎﺗﺍ, ﻦﻟﺎﺳ, ﻦﯿﺑﺭﻭﺩ
ﯽﯾﺎﻨﺷﺁ: ﺎﻨﺷﺁ, ﺮﮔﺯﺎﻏﺁ
ﻩﺎﺒﺘﺷﺍ: ﻩﺎﺒﺘﺷﺍ
ﺮﻘﺘﺴﻣ: ﯼﺎﻨﺑ-ﺮﯾﺯ, ﺕﺎﺣﻼ﻿ﻄﺻﺍ
ﻭﺭﺩﻮﺧ: ﺭﺎﻄﻗ
ﺲﻛ-ﭻﻴﻫ: ﯽﺴﮐ-ﺮﻫ, ﯽﭼ-ﭻﯿﻫ
ﯼﮊﺮﻧﺍ: ﺕﺭﺪﻗ
ﺖﺨﻟ: ﻦﮐ-ﺯﺎﺑ, ﺭﺎﺑ, ﻡﺮﺷ, ﯽﻟﺎﺧﻮﺗ, ﻮﻣ-ﻥﻭﺪﺑ
ﯼﺪﺣﺎﺗ: ﻩﺍﺭ-ﻪﻤﯿﻧ, ﺶﺨﺑ, ﯼﺪﺣﺎﺗ
ﮓﻧﺭ: ﮓﻧﺭ
ﯽﻨﻤﯾﺍ: ﺮﻄﺧ-ﯽﺑ, ﺕﺎﺠﻧ, ﻥﺩﺍﺩ-ﺖﻴﻤﻫﺍ
ﺕﺎﺤﯿﺿﻮﺗ: ﻥﺩﺮﮐ-ﻒﯿﺻﻮﺗ, ﺕﺎﻋﻼ﻿ﻃﺍ, ﻒﺻﺍﻭ, ﻒﯾﺮﻌﺗ
ﻩﺪﯿﺑﺍﻮﺧ: ﺏﺍﻮﺧ
ﻥﺩﺮﮐ-ﺎﻫﺭ: ﺐﯿﺷ, ﻁﻮﻘﺳ, ﺖﺸﻧ
ﻥﺎﺸﺧﺭﺩ: ﻩﻮﮑﺷ-ﺎﺑ, ﻕﺍﺮﺑ, ﯽﻟﺎﻋ
ﺮﺼﺘﺨﻣ: ﻒﻔﺨﻣ, ﻩﺎﺗﻮﮐ-ﺪﻗ
ﯼﺮﺘﺴﮐﺎﺧ: ﻱﺍ-ﻩﻮﻬﻗ, ﺮﺘﺴﮐﺎﺧ
ﺭﺎﯿﺴﺑ: ﺭﺎﯿﺴﺑ
ﻪﺘﺨﯿﮕﻧﺍﺮﺑ: ﻥﺎﺠﯿﻫ, ﮏﯾﺮﺤﺗ
ﺱﺎﯾ: ﯼﺪﯿﻣﺍ-ﺎﻧ, ﻦﺘﻓﺭ-ﻝﺎﺣ-ﺯﺍ
ﺖﻟﻮﻬﺳ: ﯽﺘﺣﺍﺭ, ﻥﺩﺍﺩ-ﺶﻫﺎﻛ
ﻊﻤﺟ: ﺖﺷﺭﺩ, ﻪﻤﻫ
ﯽﻧﺎﺑﺮﻬﻣ: ﺍﻮﻘﺗ, ﺖﻓﺍﺮﻇ
ﻩﺮﯾﺍﺩ: ﻪﺧﺮﭼ, ﯽﻧﻮﮑﺴﻣ-ﻥﺎﻤﺗﺭﺎﭘﺁ, ﺩﺮﮔ, ﺥﺮﭼ
ﺪﻨﮐ: ﻥﺩﺮﮐ-ﺥﺍﺭﻮﺳ-ﻪﺘﻣ ﺎﺑ
ﺪﺼﻗ: ﺪﺼﻗ, ﻑﺪﻫ
ﺕﺪﻣ: ﺕﺎﺣﻼ﻿ﻄﺻﺍ, ﯽﻠﯿﺼﺤﺗ-ﻡﺮﺗ, ﻞﺟﻻ﻿ﺍ-ﺏﺮﺿ
ﻞﻣﺎﮐ-ﺭﻮﻄﺑ: ﺖﺣﺍﺭ, ﻼ﻿ﻣﺎﮐ
ﺖﺳﺍﻮﺧﺭﺩ: ﻥﺩﺮﮐ-ﻩﺩﺎﻔﺘﺳﺍ
ﺭﺎﮐ: ﺭﺎﮐ
ﺵﻮﻫ: ﯼﺮﮑﻓ
ﺏﺎﺼﺘﻋﺍ: ﻪﻠﻤﺣ, ﻪﺟﻮﺗ-ﻞﺑﺎﻗ
ﻪﻧﺎﻔﺼﻨﻣ: ﻼ﻿ﻣﺎﮐ, ﯽﻓﺎﮐ, ﺭﺎﯿﺴﺑ
ﻖﺑﺎﻄﻣ: ﺕﺎﻗﻼ﻿ﻣ, ﻥﺩﺮﮐ-ﺖﻋﺎﻃﺍ, ﺍﻮﺘﺤﻣ
ﻪﻌﻗﺍﻭ: ﻪﺛﺩﺎﺣ, ﺖﺒﺳﺎﻨﻣ, ﺶﯾﺎﻤﻧ
ﯽﻣﺍﺭﺁ-ﻪﺑ: ﻡﺮﻧ, ﺰﯿﻣﺁ-ﺖﺒﺤﻣ
ﻝﺎﺼﺗﺍ: ﯽﮕﺘﺳﻮﯿﭘ, ﯽﮕﺘﺴﺒﻟﺩ, ﻥﺩﺯ-ﮓﻧﺯ
ﺖﻇﺎﻔﺣ: ﺖﻈﻓﺎﺤﻣ, ﻩﺎﻨﭘ-ﻥﺎﺟ, ﻥﺩﺍﺩ-ﺖﻴﻤﻫﺍ
ﻪﻧﺎﻫﺎﮔﺁ: ﺭﺍﺪﯿﺑ, ﺍﺪﻤﻋ, ﺱﺎﺴﺣﺍ
ﭖﺎﭼ: ﻪﻨﯾﺰﻫ, ﭖﺎﭼ, ﺭﺎﺸﺘﻧﺍ, ﻩﺯﺎﺟﺍ
ﺯﺍﻭﺮﭘ: ﻩﺪﻧﺮﭘ, ﺯﺍﻭﺮﭘ, ﻦﺘﻓﺮﮔ-ﺝﻭﺍ
ﻉﺍﻮﻧﺍ: ﻉﻮﻧ, ﻒﻠﺘﺨﻣ
ﺍﺪﺟ: ﻢﻫ-ﺯﺍ-ﺍﺪﺟ, ﺭﻭﺩ, ﺰﺠﺑ, ﻞﻘﺘﺴﻣ-ﺭﻮﻃ-ﻪﺑ
ﺡﺎﻀﺘﻓﺍ: ﮎﺎﻨﺘﺸﺣﻭ, ﻢﺣﺮﺗ
ﯽﺴﮐ-ﺮﻫ: ﻪﻤﻫ, ﯽﺴﮐ-ﺮﻫ
ﺭﺎﮐ: ﺭﺎﮐ
ﻖﺷﺎﻋ: ﺰﯾﺰﻋ, ﺮﺘﺧﺩ-ﺖﺳﻭﺩ
ﯽﮔﺪﻨﻧﺍﻮﺧ: ﻪﻧﺍﺮﺗ
ﻕﺎﯿﺘﺷﺍ-ﺎﺑ: ﻦﺘﺷﺍﺩ-ﻞﻳﺎﻤﺗ, ﺮﺒﺻ-ﯽﺑ, ﻭﺎﮑﺠﻨﮐ, ﺲﭘﺍﻮﻟﺩ
ﺯﺎﯿﻧ: ﻥﺪﯿﺳﺮﭘ, ﻥﺩﺮﮐ-ﺎﺿﺎﻘﺗ, ﻥﺩﺮﮐ-ﺭﺍﺮﺻﺍ
ﻪﮐ-ﻥﺎﻣﺯ-ﺮﻫ: ﯽﻧﺎﻣﺯ-ﻪﭼ
ﻥﺪﺷ-ﻖﻓﻮﻣ: ﺖﯿﻘﻓﻮﻣ
ﻥﺩﺮﺑ-ﻻ﻿ﺎﺑ: ﻥﺩﺮﮐ-ﻦﻬﭘ, ﻥﺩﺮﮐ-ﺪﻨﻠﺑ, ﻥﺩﺍﺩ-ﺶﯾﺍﺰﻓﺍ, ﻥﺪﻣﺁ-ﻻ﻿ﺎﺑ
ﻪﻌﺳﻮﺗ: ﻦﺘﻓﺭ-ﺶﯿﭘ
ﮏﻨﺧ: ﺩﺮﺳ, ﻞﮕﺷﻮﺧ
ﺶﯾﺎﻣﺯﺁ: ﺮﮕﺷﻭﺎﮐ, ﺪﻨﯾﺁﺮﻓ, ﻩﺎﮔﺩﺍﺩ
ﺭﻮﺸﮐ-ﺯﺍ-ﺝﺭﺎﺧ: ﯽﺟﺭﺎﺧ, ﺪﯿﻌﺒﺗ
ﺭﺎﮐﺍﺪﻓ: ﯼﺭﺍﺩﺎﻓﻭ, ﻥﺎﻤﯾﺍ-ﺎﺑ
ﯽﺑﺩﺍ: ﺕﺎﯿﺑﺩﺍ
ﻩﺪﻨﺴﯾﻮﻧ: ﻩﺪﻨﺴﯾﻮﻧ
ﺱﺭﻮﺑ-ﻥﺎﻣﺯﺎﺳ: ﺏﻮﭼ, ﺶﻘﻧ, ﻞﻤﻋ
ﻉﻮﻧ: ﻉﻮﻧ, ﻦﺘﺷﻮﻧ, ﺕﺎﻋﻮﺒﻄﻣ
ﻥﺍﻭﺍﺮﻓ: ﺪﻨﻤﺗﻭﺮﺛ, ﯽﮕﻧﻭﺰﻓﺍ, ﯽﻓﺎﮐ
ﻥﺩﺮﮐ-ﺏﺎﻨﺘﺟﺍ: ﻥﺩﺮﮐ-ﯼﺮﯿﮔﻮﻠﺟ
ﻒﻄﻟ: ﺖﻤﺳ, ﺖﻓﺍﺮﻇ, ﺮﺘﺳﺎﻓ
ﯽﻧﺍﻭﺭ: ﯼﺮﮑﻓ, ﯽﻨﻫﺫ, ﯽﻠﺧﺍﺩ
ﺵﺮﮕﻧ: ﻩﺎﮕﻧ, ﻥﺩﺎﺘﺴﯾﺍ, ﺖﺳﮊ, ﺵﻭﺭ, ﯽﮕﺘﺴﺑﺍﻭ, ﺪﻨﺑ
ﻦﯿﺴﺤﺗ: ﺶﯾﺎﺘﺳ
ﺏﺍﺮﻄﺿﺍ: ﺲﭘﺍﻮﻟﺩ, ﺱﺮﺗ, ﯽﮕﺘﻔﯿﺷ, ﻥﺎﺠﯿﻫ
ﺵﺯﻮﻣﺁ: ﻦﺘﺴﻧﺍﺩ, ﺮﯿﮕﺑ-ﺩﺎﯾ
ﺖﯾﻭﺭ-ﻞﺑﺎﻗ: ﻦﺘﺴﻧﺍﺩ
ﺎﻤﻨﻫﺍﺭ: ﯼﺎﻤﻨﻫﺍﺭ-ﻪﭽﺑﺎﺘﮐ, ﮎﺭﺪﻣ, ﯽﮔﺪﻨﻧﺍﺭ
ﯽﻌﻗﺍﻭ: ﯼﺯﺎﺠﻣ, ﺖﯿﻌﻗﺍﻭ, ﯽﺘﻨﻄﻠﺳ
ﯽﺘﺨﺑﺪﺑ: ﻩﺪﻨﺴﺑﺎﻧ, ﻦﯿﮕﻤﻏ, ﻡﺎﮐﺎﻧ, ﯽﺘﺨﺑﺪﺑ, ﻩﺪﻧﺎﻣﺭﺩ
ﻪﻣﺪﺻ: ﺪﺑ, ﺭﻭﺁ-ﻥﺎﯾﺯ, ﯽﮔﺪﯾﺩ-ﺐﯿﺳﺁ, ﻢﺣﺮﺗ
ﺶﺸﺨﺑ: ﺶﺨﺒﺑ, ﻒﺳﺎﺘﻣ, ﻥﺩﺮﮐ-ﯽﻫﺍﻮﺧ-ﺭﺬﻋ, ﺖﻓﺍﺮﻇ
ﺕﺭﺪﻨﺑ: ﺎﻬﺘﻗﻭ-ﯽﻀﻌﺑ
ﺩﺭﻮﮐﺭ: ﺖﺒﺛ, ﮏﺴﯾﺩ, ﯽﯾﻮﺟ-ﻪﻓﺮﺻ
ﯽﺑﺮﭼ: ﺖﻔﻧ, ﻢﯿﺨﺿ
ﺖﺨﺗ: ﯽﻧﻮﮑﺴﻣ-ﻥﺎﻤﺗﺭﺎﭘﺁ, ﻪﻧﺎﻓﺮﻃ, ﺡﺮﻃ
ﻪﯾﺪﻫ: ﻩﺰﯾﺎﺟ, ﺮﺿﺎﺣ
ﺪﺒﻌﻣ: ﻪﻧﺎﺧ, ﻊﻣﺎﺟ-ﯼﺎﺴﯿﻠﮐ
ﺯﻮﺠﻣ: ﻩﺯﺎﺟﺍ
ﺖﯾﺎﺿﺭ: ﺐﯾﻮﺼﺗ, ﻩﺯﺎﺟﺍ
ﯽﻓﺎﮐ-ﻩﺯﺍﺪﻧﺍ-ﻪﺑ: ﻩﺪﺷ-ﺮﭘ, ﯽﻓﺎﮐ
ﻢﺧﺯ: ﯽﮔﺪﯾﺩ-ﺐﯿﺳﺁ, ﺡﻭﺮﺠﻣ, ﻢﺧﺯ
ﺭﻮﺴﺟ: ﺖﻋﺎﺠﺷ, ﻉﺎﺠﺷ
ﺎﺟ-ﺮﻫ: ﯽﯾﺎﺟ-ﮏﯾ, ﺎﺟ-ﻪﻤﻫ-ﺭﺩ
ﺪﻫﺎﺷ: ﮎﺭﺪﻣ
ﻖﻤﺣﺍ: ﻥﺍﺩﺎﻧ, ﻖﻤﺣﺍ
ﯽﺼﺨﺷ-ﺮﻫ: ﯽﺴﮐ-ﺮﻫ, ﻪﮐ-ﯽﺴﮐ-ﺮﻫ
ﺩﻮﺧ: ﯽﺻﻮﺼﺧ, ﻥﺎﺷﺩﻮﺧ, ﺩﻮﺧ
ﯽﻠﯿﺧ: ﺭﺎﯿﺴﺑ, ﻩﺮﻈﺘﻨﻣ-ﺮﯿﻏ
ﻥﺎﻣﺭﺩ: ﻥﺎﻣﺭﺩ, ﻥﺩﺍﺩ-ﺖﻴﻤﻫﺍ
ﻮﻠﮔ: ﻥﺩﺮﮔ, ﻦﺘﻓﺮﮔ-ﺝﻭﺍ, ﺭﺎﯿﺧ
ﺭﺎﻤﯿﺑ: ﺭﺎﻤﯿﺑ
ﺪﺷﺭ: ﻥﺩﺍﺩ-ﺶﯾﺍﺰﻓﺍ
ﺭﺍﺪﻘﻣ: ﯽﻣﻮﺘﻧﺍﻮﮐ, ﻡﺮﺟ, ﺖﯿﻌﻤﺟ, ﺭﺍﺪﻘﻣ, ﺩﺪﻋ, ﻩﺯﺍﺪﻧﺍ
ﺪﯾﺪﺷ: ﺍﺪﮐﻮﻣ, ﺪﯾﺪﺷ, ﺖﺨﺳ
ﻪﻧﺎﻬﺑ: ﺶﺨﺒﺑ, ﻞﯿﻟﺩ, ﯼﺪﻌﺘﻣ, ﻒﺳﺎﺘﻣ
ﺐﺴﻧ-ﻭ-ﻞﺻﺍ: ﯽﻠﺻﺍ, ﺖﻌﯿﺒﻃ
ﺭﺎﻀﺣ: ﻝﺎﻌﻓ-ﺮﯿﻏ, ﻡﺩﺮﻣ-ﻡﻮﻤﻋ
ﻩﺪﻧﺎﻣ-ﯽﻗﺎﺑ: ﯽﻗﺎﺑ
ﯼﺯﻭﺮﯿﭘ: ﺖﯿﻘﻓﻮﻣ
ﻥﺯ-ﺖﻣﺪﺨﺸﯿﭘ: ﺭﺍﺰﮕﺘﻣﺪﺧ
ﻢﯾﻼ﻿ﻣ: ﻡﺮﻧ, ﻡﺍﺭﺁ
ﺖﯿﻌﻗﺍﻭ: ﺖﯿﻌﻗﺍﻭ
ﻞﺤﻣ: ﻪﻨﺤﺻ, ﯽﺘﻧﺮﺘﻨﯾﺍ-ﺖﯾﺎﺳ, ﻪﻄﻘﻧ
ﻥﺎﺑﺩﺎﺑ: ﯽﺘﺸﮐ, ﻪﻧﺎﻧﺯ-ﺭﺩﺎﭼ
ﻩﺎﮕﺷﻭﺮﻓ: ﻩﺎﮕﺷﻭﺮﻓ, ﯼﺯﺎﺳ-ﻩﺮﯿﺧﺫ, ﯽﯾﻮﺟ-ﻪﻓﺮﺻ
ﺭﺎﻬﻇﺍ: ﺭﺎﻬﻇﺍ, ﻪﺟﻮﺗ
ﻒﻗﻮﺗ: ﺢﻳﺮﻔﺗ-ﮓﻧﺯ
ﺪﻨﻤﺷﺯﺭﺍ: ﺵﺯﺭﺍ
ﻭﺭ-ﻦﯾﺍ-ﺯﺍ: ﺐﯿﺗﺮﺗ-ﻦﯾﺪﺑ, ﻭﺭ-ﻦﯾﺍ-ﺯﺍ
ﻩﺎﯿﮔ: ﻥﺪﻣﺁ-ﻻ﻿ﺎﺑ, ﺖﺧﺭﺩ, ﻪﻧﺎﺧﺭﺎﮐ
ﺦﯾ: ﻑﺮﺑ
ﻖﻠﻄﻣ: ﻩﺪﺷ-ﺮﭘ, ﻼ﻿ﻣﺎﮐ
ﯽﻧﺎﺳﺁ-ﻪﺑ: ﯽﻧﺎﺳﺁ-ﻪﺑ, ﯼﺩﻭﺯ-ﻪﺑ
ﻩﺪﻧﺭﺩ: ﺰﯿﺗ, ﺪﯾﺪﺷ, ﺖﺨﺳ, ﻪﻧﺎﻤﻟﺎﻇ, ﻩﺪﻧﺭﺩ, ﯽﺸﺣﻭ
ﻢﺸﺧ: ﻢﺸﺧ
ﻒﺸﮐ: ﻩﺪﺷ-ﺍﺪﯿﭘ, ﻥﺩﺮﮐ-ﻮﺠﺘﺴﺟ, ﻉﺍﺮﺘﺧﺍ, ﺡﺎﺘﺘﻓﺍ
ﻁﻮﺑﺮﻣ: ﻩﺍﺮﻤﻫ
ﺕﺍﺯﺎﺠﻣ: ﻪﻠﻤﺟ
ﯽﻤﮐ: ﯽﻤﮐ-ﺭﺍﺪﻘﻣ, ﯽﻧﺎﺳﺁ-ﻪﺑ, ﯼﺪﺣﺎﺗ
ﺰﯿﻣﺁ-ﺭﺍﺮﺳﺍ: ﺯﺍﺭ, ﻢﻬﺒﻣ, ﯽﻔﺨﻣ
ﻪﯾﺎﺳ: ﻪﯾﺎﺳ, ﻦﺤﻟ, ﻒﯾﺮﻇﻭ-ﻖﯿﻗﺩ-ﺕﺎﮑﻧ
ﯽﺸﮐ-ﻡﺩﺁ: ﻦﺘﺸﮐ
ﯽﻧﺎﺠﯿﻫ: ﺱﺎﺴﺣﺍ, ﯽﺗﺎﺳﺎﺴﺣﺍ
ﺐﯾﺮﺨﺗ: ﯽﻫﺎﺒﺗ, ﻦﺘﻓﺭ-ﻦﯿﺑ-ﺯﺍ
ﺖﺸﺣﻭ: ﺱﺮﺗ
ﯽﻠﺤﻣ: ﯽﻠﺤﻣ-ﺕﺭﻮﺻ-ﻪﺑ, ﯽﻠﺧﺍﺩ, ﻪﻄﻘﻧ
ﻩﺩﻭﺪﺤﻣ: ﻒﻠﺘﺨﻣ, ﻪﻠﺻﺎﻓ, ﻢﯿﻈﻨﺗ
ﻥﺎﺑﺰﯿﻣ: ﺶﺗﺭﺍ, ﻥﺎﻤﻬﻣ, ﺖﯿﻌﻤﺟ
ﺏﻮﻃﺮﻣ: ﻥﺍﺭﺎﺑ, ﺖﺑﻮﻃﺭ
ﺯﺍﺭ: ﺯﺍﺭ
ﯼﺍﺭﺍﺩ: ﺩﻮﺧ, ﻞﻤﺤﺗ
ﯼﺭﺎﯿﺷﻮﻫ: ﺖﯿﻧﻼ﻿ﻘﻋ, ﺱﺎﺴﺣﺍ, ﻥﺍﺪﺟﻭ
ﻖﺑﺎﺳ: ﺯﺍ-ﻞﺒﻗ
ﺪﯿﻟﻮﺗ: ﻥﺩﺮﮐ-ﺪﯿﻟﻮﺗ
ﻪﺷﺮﻋ: ﻞﭘ
ﮎﻼ﻿ﻣﺍ: ﯽﮔﮋﯾﻭ
ﺖﻨﻄﻠﺳ: ﻩﺎﺷﺩﺎﭘ, ﯽﺘﻨﻄﻠﺳ-ﻩﺩﺍﻮﻧﺎﺧ-ﯼﺎﻀﻋﺍ
ﻕﺎﺒﻄﻧﺍ: ﻥﺩﺮﮐ-ﻝﺎﺒﻧﺩ, ﻕﺎﺒﻄﻧﺍ
ﻭﺍ-...: ﻥﺁ
ﻒﺳﺎﺗ-ﻪﯾﺎﻣ: ﻪﻧﺎﻔﺳﺎﺘﻣ, ﯽﻗﺎﻔﺗﺍ, ﻡﺎﮐﺎﻧ, ﻢﺣﺮﺗ, ﻩﺪﻨﺴﺑﺎﻧ
ﻞﮔ: ﻥﺩﺮﮐ-ﺝﺮﺧ, ﻪﻗﻼ﻿ﻋ, ﻞﮔ
ﺮﮑﺸﺗ-ﺎﺑ: ﺮﮑﺸﺗ
ﻖﻠﻌﺗ: ﯽﮔﮋﯾﻭ, ﻪﻠﻤﺟ-ﺯﺍ
ﺭﺍﺯﺎﺑ: ﺪﯾﺮﺧ
ﺭﺍﺩ-ﻪﺒﻟ-ﻩﻼ﻿ﮐ: ﻩﻼ﻿ﮐ, ﻪﺒﻨﭘ-ﺏﻮﭼ
ﻝﺎﺤﺷﻮﺧ: ﻝﺎﺤﺷﻮﺧ
ﻝﺰﻨﻣ-ﻡﺯﺍﻮﻟ: ﻩﺩﺍﻮﻧﺎﺧ, ﻪﻧﺎﺧ
ﻥﺎﮔﻭﺎﻧ: ﯽﺘﺸﮐ, ﯽﯾﺎﯾﺭﺩ-ﯼﻭﺮﯿﻧ, ﺭﻭﺎﻨﺷ
ﮎﺩﻮﮐ: ﺎﻫ-ﻪﭽﺑ, ﮏﺳﻭﺮﻋ
ﻪﻘﻄﻨﻣ: ﻩﺯﻮﺣ
ﻖﯿﻗﺩ: ﺭﺩﻮﭘ, ﺐﺳﺎﻨﻣ, ﻩﺪﺷ-ﺮﭘ, ﻖﯿﻗﺩ
ﺮﯾﻮﺼﺗ: ﺮﯾﻮﺼﺗ
ﻦﻇ-ءﻮﺳ: ﻥﺩﺮﻛ-ﻚﺷ, ﮎﻮﮑﺸﻣ
ﺩﺭ: ﺭﺎﮑﻧﺍ, ﺩﺭ, ﯽﻨﺘﺨﯾﺭ-ﺭﻭﺩ
ﯽﻫﺪﺑ: ﻪﻔﯿﻇﻭ, ﺶﻧﺯﺮﺳ
ﻩﺩﺯ-ﺖﻟﺎﺠﺧ: ﻡﺮﺷ
ﯽﯾﺍﺬﻏ-ﻩﺪﻋﻭ: ﺍﺬﻏ, ﻥﺩﺭﻮﺧ, ﺭﺩﻮﭘ
ﺖﯿﻌﺿﻭ: ﺖﯿﻌﻗﻮﻣ, ﺖﯿﻌﺿﻭ
ﻥﺩﺍﺩ-ﻥﺎﺸﻧ: ﻥﺪﺷ-ﻞﺧﺍﺩ, ﺶﯾﺎﻤﻧ
ﺮﻌﺷ: ﺮﻌﺷ, ﻪﻧﺍﺮﺗ
ﺪﻨﯾﺁ-ﯽﻣ-ﺩﻮﺟﻮﺑ: ﻥﺪﺷ-ﺭﺍﺪﯾﺪﭘ, ﻥﺪﻣﺁ-ﻻ﻿ﺎﺑ
ﺮﻔﺳ: ﺎﻘﯾﺮﻓﺍ-ﺭﺩ-ﯽﻓﺎﺸﺘﮐﺍ ﺖﺣﺎﯿﺳ, ﺮﻔﺳ
ﻥﺩﺮﻛ-ﻪﻌﺟﺍﺮﻣ: ﻥﺩﺮﮐ-ﻞﺻﻭ
ﻦﺘﺷﺍﺩ-ﺖﻋﺎﻄﺘﺳﺍ: ﺪﯾﺮﺧ, ﻥﺩﺍﺩ, ﻞﻤﺤﺗ
ﻥﺩﺮﮐ-ﺍﺪﻫﺍ: ﺖﮐﺭﺎﺸﻣ, ﻥﺩﺍﺩ
ﺭﺎﮐ: ﺭﺎﮐ
ﻪﻣﺍﺩﺍ: ﻪﻣﺍﺩﺍ, ﻥﺩﺍﺩ-ﺶﯾﺍﺰﻓﺍ, ﻦﺘﻓﺭ-ﺶﯿﭘ, ﻥﺩﺮﮐ-ﯽﻃ
ﻥﺪﺷ-ﻥﺎﻤﻴﺸﭘ: ﻒﺳﺎﺘﻣ
ﺮﻄﺧ: ﺮﻄﺧ
ﻊﯾﺮﺳ: ﯼﺩﻭﺯ-ﻪﺑ, ﺯﺮﻓ
ﺰﯾﺎﻤﺘﻣ: ﻢﻫ-ﺯﺍ-ﺍﺪﺟ, ﺕﻭﺎﻔﺗ
ﯽﺘﺳﺭﺩ-ﻪﺑ: ﺐﺳﺎﻨﻣ, ﺖﺣﺍﺭ
ﺕﺮﻬﺷ: ﺶﯾﺎﺘﺳ
ﺩﺮﻔﻣ: ﺪﺤﺘﻣ, ﺪﺣﺍﻭ
ﺎﻄﺧ: ﻩﺎﺒﺘﺷﺍ
ﺕﺮﻬﺷ: ﺶﯾﺎﺘﺳ
ﺖﺳﺍﻮﺧﺭﺩ: ﻢﺳﺭ, ﻥﺩﺯ-ﮓﻧﺯ
ﻡﺪﻋ: ﺵﺮﺑ, ﺺﻗﺎﻧ, ﻡﺪﻋ
ﺖﻧﻮﺸﺧ: ﺪﯾﺪﺷ
ﻪﺋﺍﺭﺍ: ﻡﺎﺠﻧﺍ, ﻥﺩﺮﮐ-ﯽﻓﺮﻌﻣ, ﻥﺩﺍﺩ
ﯼﺍ-ﻪﻓﺮﺣ: ﻪﻓﺮﺣ, ﺭﺎﮐ
ﻥﺩﺮﮐ-ﯽﺣﺍﺮﻃ: ﺭﻮﺼﺗ, ﺡﺮﻃ
ﺩﺎﻬﻨﺸﯿﭘ: ﻪﻠﻤﺟ, ﺩﺎﻬﻨﺸﯿﭘ
ﻖﻠﻄﻣ: ﻆﻔﻠﺗ, ﻩﺪﺷ-ﺮﭘ
ﺡﻮﺿﻭ: ﻢﯿﻤﺼﺗ, ﻪﺠﯿﺘﻧ, ﻞﯿﻠﺤﺗ, ﻥﺩﺮﮐ-ﻦﻬﭘ
ﯽﮐﺪﯾ: ﺏﻭﺎﻨﺘﻣ, ﯽﻓﺎﺿﺍ, ﻥﺩﺮﮐ-ﻦﯾﺰﮕﯾﺎﺟ, ﻩﺰﯿﻧ
ﯽﮕﻧﺎﺧ: ﯽﻧﺪﻣ, ﯽﻠﺧﺍﺩ, ﻦﮐﺎﺳ, ﯽﻠﻣ
ﻊﺟﺮﻣ: ﯽﻋﺎﺟﺭﺍ, ﻪﻈﻓﺎﺣ
ﺩﻮﺟﻭ: ﺭﻮﻀﺣ, ﺮﺿﺎﺣ
ﻪﻟﺎﺴﻣ: ﺯﺎﺳ-ﻞﮑﺸﻣ, ﺕﺎﺣﻼ﻿ﻄﺻﺍ, ﻞﮑﺸﻣ, ﻉﻮﺿﻮﻣ, ﻝﺍﻮﺳ, ﺮﺸﻧ
ﻥﺩﺭﻭﺁ-ﻢﻫﺍﺮﻓ: ﻩﺪﺷ-ﻪﺋﺍﺭﺍ, ﻥﺩﺍﺩ
ﻪﻠﻌﺷ: ﯼﺯﻮﺳ-ﺶﺗﺁ
ﻞﻬﺟ: ﻥﺍﺩﺎﻧ, ﯽﺷﻮﭘ-ﻢﺸﭼ
ﻩﺎﮕﯿﺑ-ﻭ-ﻩﺎﮔ: ﺎﻬﺘﻗﻭ-ﯽﻀﻌﺑ, ﺭﺮﮑﻣ
ﺯﺍﻭﺮﭘ: ﺯﺍﻭﺮﭘ
ﻪﭼﺭﺎﭘ: ﻪﭼﺭﺎﭘ, ﺎﻫ-ﺱﺎﺒﻟ
ﺩﻮﺳ: ﺖﯾﺰﻣ
ﻡﺭﺎﻬﭼ: ﺭﺎﻬﭼ, ﻪﺒﻨﺷ-ﺭﺎﻬﭼ, ﻕﺎﺗﺍ
ﺱﻮﻗﺎﻧ: ﺮﻄﺧ-ﮓﻧﺯ, ﺖﻋﺎﺳ
ﻥﺩﺮﺑ-ﻩﺮﻬﺑ: ﺖﯾﺰﻣ
ﻞﺼﻓ: ﺏﺭﺩ, ﺶﺨﺑ, ﺮﺳ, ﻞﺼﻓ, ﺖﺨﺘﯾﺎﭘ-،ﻪﯾﺎﻣﺮﺳ, ﻥﺎﺷﺩﻮﺧ
ﺥﺍﺭﻮﺳ: ﻥﺩﺮﮐ-ﺥﺍﺭﻮﺳ-ﻪﺘﻣ ﺎﺑ, ﻝﺍﺩﻮﮔ
ﻝﻮﻘﻌﻣ: ﺐﺳﺎﻨﻣ, ﺎﻧﺍﺩ, ﯽﻘﻄﻨﻣ
ﺪﻨﻗ: ﯽﺘﺴﻣ, ﺮﯿﺴﻣ
ﯽﻨﯾﺰﮕﯾﺎﺟ: ﻥﺩﺮﮐ-ﻦﯾﺰﮕﯾﺎﺟ, ﯼﺎﺠﺑ, ﯼﺮﻤﺘﺴﻣ, ﺏﻭﺎﻨﺘﻣ, ﻝﺩﺎﺒﺗ
ﺭﺎﺸﻓ: ﻥﺩﺮﮐ-ﺭﺍﺮﺻﺍ, ﻩﺮﮔ, ﺖﺧﺍﺩﺮﭘ, ﺭﺎﺸﻓ, ﻪﺑ-ﻥﺩﺍﺩ-ﻩﺰﯿﮕﻧﺍ
ﺏﺎﻗ: ﺱﺎﯿﻘﻣ, ﯽﻧﻮﻧﺎﻗ, ﺲﮑﻋ
ﻩﺩﺎﻣ: ﻉﻮﺿﻮﻣ
ﮏﯿﻧﻭﺮﺘﮑﻟﺍ-ﺖﺴﭘ: ﻝﺎﺳﺭﺍ
ﺶﺨﺑ: ﺶﺨﺑ
ﯽﮔﺩﺮﺑ: ﻩﺩﺮﺑ
ﺮﻌﺷ: ﺮﻌﺷ, ﺪﻨﺑ
ﯽﻟﺎﻤﺘﺣﺍ: ﺪﯾﺎﺷ
ﮎﺎﻧﺩﺭﺩ: ﺦﻠﺗ, ﺩﺭﺩ
ﻪﺸﯿﻤﻫ-ﯼﺍﺮﺑ: ﻪﺸﯿﻤﻫ, ﯼﺪﺑﺍ
ﺱﻮﻧﺎﯿﻗﺍ: ﺎﯾﺭﺩ
ﺐﻘﻋ: ﺯﺍ-ﺪﻌﺑ, ﺖﺸﮔﺯﺎﺑ, ﺱﻮﮑﻌﻣ
ﺮﺒﻫﺭ: ﺮﺳ, ﺮﯾﺪﻣ, ﺮﺘﺴﮐﺭﺍ-ﺮﺒﻫﺭ, ﯼﺎﻤﻨﻫﺍﺭ-ﻪﭽﺑﺎﺘﮐ
ﻕﺎﺘﺸﻣ: ﺪﺼﻗ, ﺲﭘﺍﻮﻟﺩ, ﺰﯿﺗ
ﺲﻧﺎﺷ: ﺖﺷﻮﻧﺮﺳ
ﺮﻫﺎﻇ: ﺩﻮﻬﺸﻣ, ﻞﺻﺍ
ﻪﻠﺠﻋ: ﯼﺩﻭﺯ-ﻪﺑ, ﻪﻟﺎﺳﻮﮔ
ﺡﺮﻃ: ﺡﺮﻃ, ﻩﺍﺭ-ﻩﺍﺭ, ﯽﻧﺎﻣﺯﺎﺳ-ﺕﺭﺎﭼ
ﺭﻮﺨﻧ-ﺩﺭﺪﺑ: ﯽﻨﺘﺨﯾﺭ-ﺭﻭﺩ
ﻑﺎﺻﻭﺍ-ﻦﯾﺍ-ﺎﺑ: ﻪﭼﺮﮔ, ﺩﻮﺟﻭ-ﻦﯾﺍ-ﺎﺑ
ﻑﺎﺻ: ﻡﺮﻧ
ﺪﻣﺎﺟ: ﯽﺸﯾﺎﻤﻧ, ﺩﺎﺠﯾﺍ, ﻪﭼﺮﮔ, ﺭﻮﺟ-ﻭ-ﻊﻤﺟ
ﺎﻣﻭﺰﻟ: ﺪﯾﺎﺑ, ﻡﺯﻻ﻿
ﻦﺘﺧﺎﺳ: ﻥﺩﺭﻭﺁ-ﺩﻮﺟﻭ-ﻪﺑ, ﺎﻨﺑ, ﯼﺪﻨﺑ-ﻝﻮﻣﺮﻓ
ﺵﻼ﻿ﺗ: ﻥﺩﺮﻛ-ﺵﻼ﻿ﺗ, ﻥﺩﺯ-ﻢﺧﺯ
ﻝﺩﺎﻌﻣ: ﻥﺎﺴﮑﯾ
ﺮﯿﺧﺍ: ﯽﮔﺯﺎﺗ-ﻪﺑ, ﻥﺭﺪﻣ, ﻪﺘﺷﺬﮔ
ﻦﺘﻓﺭ-ﺮﻔﺳ: ﺪﯾﺩﺯﺎﺑ, ﯼﺩﺮﮕﻧﺎﻬﺟ
ﺮﻬﻇ: ﺮﻬﻇ-ﺯﺍ-ﺪﻌﺑ, ﺏﻮﻨﺟ
ﻊﻗﺍﻭ: ﻁﻮﻘﺳ
ﻥﻼ﻿ﻋﺍ: ﺩﻼ﻿ﯿﻣ-ﺯﺍ-ﺪﻌﺑ
ﻒﻗﻮﺗ: ﻥﺩﺮﮐ-ﯼﺮﯿﮔﻮﻠﺟ
ﯽﮕﻧﻮﮕﭼ: ﺖﯿﻌﺿﻭ, ﻪﻣﺎﻧ-ﺖﻛﺎﭘ
ﺭﺩﺎﭼ: ﻦﯿﺑﺎﮐ, ﻪﻨﺤﺻ
ﺭﺮﮑﻣ: ﺭﺮﮑﻣ, ﻊﻗﺍﻮﻣ-ﺮﺘﺸﯿﺑ
ﺪﻨﻠﺑ-ﯼﺍﺪﺻ-ﺎﺑ: ﺍﺪﺻ
ﻞﻘﺘﺴﻣ: ﻝﻼ﻿ﻘﺘﺳﺍ, ﻞﺷ, ﻞﻘﺘﺴﻣ-ﺭﻮﻃ-ﻪﺑ
ﯼﺭﻭﺮﺿ: ﻡﺯﻻ﻿, ﯼﺰﯿﭼ-ﺮﻫ-ﯽﻠﺻﺍ ءﺰﺟ
ﻩﺪﻫﺎﺸﻣ: ﻥﺩﺮﮐ-ﻩﺪﻫﺎﺸﻣ
ﯽﺳﺎﻨﺷ-ﻖﺣ: ﺮﮑﺸﺗ
ﻆﻔﺣ: ﻆﻔﺣ, ﯼﺯﺎﺳ-ﻩﺮﯿﺧﺫ, ﺖﻈﻓﺎﺤﻣ
ﻪﺒﻨﺟ: ﺮﺼﻨﻋ, ﺖﻤﺳ
ﺖﺸﺣﻭ: ﺱﺮﺗ, ﺭﺎﺟﺰﻧﺍ, ﻩﺩﺯ-ﺖﺸﺣﻭ
ﺵﻮﻫﺎﺑ: ﺮﻫﺎﻣ, ﺎﻧﺍﺩ
ﻪﯿﺣﺎﻧ: ﻩﺪﻧﺯ
ﺖﺴﮑﺷ: ﺖﺴﮑﺷ, ﻩﺎﺒﺘﺷﺍ, ﯽﮕﺘﺴﮑﺷﺭﻭ, ﻦﯿﻨﺟ-ﻂﻘﺳ
ﺪﺻﺭﺩ: ﯽﻨﭘ, ﺪﺻ-ﺭﺩ, ﺪﺻ
ﺱﺎﺴﺣﺍ: ﺱﺎﺴﺣﺍ
ﻞﻣﺎﻋ: ﻦﺘﺷﺍﺩ-ﺭﻮﻈﻨﻣ
ﻪﺘﺷﺬﮔ-ﻥﺎﺟ-ﺯﺍ: ﻦﺘﻓﺭ-ﻝﺎﺣ-ﺯﺍ
ﻪﯾﺩﺎﺤﺗﺍ: ﺩﺎﺤﺗﺍ, ﺪﺤﺘﻣ
ﻥﺩﺮﮐ-ﺎﻄﻋﺍ: ﻥﺩﺮﮐ-ﺭﺍﺮﻗﺍ
ﺖﺑﺎﺻﺍ: ﻥﺩﺮﮐ-ﺮﯿﺜﮑﺗ, ﻥﺩﺯ-ﺪﮕﻟ, ﺖﯿﻘﻓﻮﻣ
ﻢﯿﻈﻋ: ﯽﻟﺎﻋ, ﻢﯿﻈﻋ
ﻩﺪﯿﻘﻋ: ﻪﻠﻤﺟ
ﺐﺗ: ﯼﺯﻮﺳ-ﺶﺗﺁ, ﺍﺰﻧﺍﻮﻠﻔﻧﺍ
ﻥﺎﻣﺭﺩ: ﻥﺎﻣﺭﺩ, ﺪﻨﯾﺁﺮﻓ, ﺎﻔﺷ
ﺎﻣ-ﻝﺎﻣ: ﺭﺎﻬﺑ, ﺎﻣ
ﻩﺎﺒﺘﺷﺍ: ﻩﺎﺒﺘﺷﺍ, ﻩﺩﺎﻔﺘﺳﺍ-ﻮﺳ, ﺺﻗﺎﻧ
ﻝﺁ-ﻩﺪﯾﺍ: ﺮﺘﻬﺑ
ﻥﺩﺮﺑ-ﻡﻮﺠﻫ: ﺖﯿﻌﻤﺟ, ﻪﺑﺮﺿ
ﺖﺳﺭﺩ: ﺐﺳﺎﻨﻣ, ﺖﺳﺭﺩ, ﻥﺎﻤﯾﺍ-ﺎﺑ, ﺖﺑﺎﺛ
ﻥﺩﺍﺩ-ﻡﺎﺠﻧﺍ: ﺶﯾﺎﻤﻧ, ﻡﺎﺠﻧﺍ
ﯼﻮﺤﻧ-ﻪﺑ: ﯼﺪﺣﺎﺗ
ﻡﻮﻬﻔﻣ: ﺭﻮﺼﺗ, ﯽﻨﻤﺿ-ﺖﻟﻻ﻿ﺩ, ﻪﺸﯾﺪﻧﺍ
ﻪﺜﺣﺎﺒﻣ: ﻮﮕﺘﻔﮔ-ﻭ-ﺚﺤﺑ, ﻝﺪﺟ-ﻭ-ﺚﺤﺑ
ﻢﮑﺤﻣ: ﺩﺎﺠﯾﺍ, ﻪﭼﺮﮔ
ﺖﺑﺎﺛ: ﺩﺭﺍﺪﻧﺎﺘﺳﺍ, ﺖﺑﺎﺛ, ﺭﺍﻮﺘﺳﺍ, ﻲﻤﺋﺍﺩ
ﯽﯾﺍﻭﺮﻧﺎﻣﺮﻓ: ﯽﺘﻨﻄﻠﺳ
ﻢﻠﻗ: ﺩﺍﺪﻣ, ﺮﺳ
ﻩﺯﺎﺟﺍ: ﻩﺯﺎﺟﺍ
ﻦﺘﺷﺍﺩ-ﻪﮕﻧ: ﻦﺘﺷﺍﺩ-ﻪﮕﻧ, ﺖﻈﻓﺎﺤﻣ, ﻆﻔﺣ
ﻍﻮﻠﺷ: ﺖﯿﻌﻤﺟ, ﻢﮐﺍﺮﺗ
ﺖﯾﺩﻭﺪﺤﻣ: ﻥﺍﺮﮐ, ﯼﺭﺍﺩ-ﻦﺘﺸﯾﻮﺧ
ﺭﺎﺑ-ﺖﺒﯿﺼﻣ: ﮎﺎﻨﺘﺸﺣﻭ
ﺭﺪﻨﺑ: ﻩﺎﮔﺭﺪﻨﺑ, ﺏﺭﺩ
ﻪﺑﺮﺠﺗ-ﺎﺑ: ﻪﺑﺮﺠﺗ, ﺮﻫﺎﻣ, ﺱﺎﻨﺷﺭﺎﮐ
ﻒﻟﺎﺨﻣ: ﺖﻔﻟﺎﺨﻣ, ﻞﺑﺎﻘﻣ, ﯼﻮﺳ-ﻪﺑ, ﺩﺎﻀﺘﻣ
ﻩﺪﻫﺎﻌﻣ: ﺖﺷﺍﺩﺩﺎﯾ, ﯼﺭﺎﮑﻤﻫ-ﺩﺍﺩﺭﺍﺮﻗ
ﻦﺘﺳﻮﯿﭘ-ﻉﻮﻗﻭ-ﻪﺑ: ﺎﯿﺑ
ﻝﺎﺒﻧﺩ-ﻪﺑ: ﻥﺩﺮﻛ-ﺶﻫﺍﻮﺧ, ﻥﺩﺮﮐ-ﻮﺠﺘﺴﺟ
ﻼ﻿ﻤﻋ: ﺎﺒﯾﺮﻘﺗ, ﯽﺘﺳﺍﺮﺑ, ﯽﻠﻤﻋ
ﺩﺭ: ﺖﻣﻼ﻿ﻋ, ﺩﺭ
ﺵﻮﺧ: ﻝﺎﺤﺷﻮﺧ, ﺭﺍﺩ-ﻩﺪﻨﺧ
ﺐﯿﺗﺮﺗ: ﺐﯿﺗﺮﺗ, ﻊﺿﻭ, ﻪﺘﻓﺎﯾ-ﻥﺎﻣﺯﺎﺳ, ﯼﺭﺎﮑﻤﻫ-ﺩﺍﺩﺭﺍﺮﻗ
ﯽﺑﺮﻏ: ﺏﺮﻏ
ﺭﺎﺸﻓ: ﺪﯿﮐﺎﺗ, ﭖﺎﭼ, ﺭﺎﺸﻓ, ﻥﺯﻭ
ﺖﺳﺎﯿﺳ: ﯽﺳﺎﯿﺳ
ﯽﻤﻠﻋ: ﯽﺑﺮﺠﺗ-ﻡﻮﻠﻋ, ﺪﻨﻤﺸﻧﺍﺩ
ﯽﮕﺘﺴﯾﺎﺷ: ﺶﯾﺎﺘﺳ, ﻥﺪﺷ-ﻂﯾﺍﺮﺷ-ﺪﺟﺍﻭ, ﺵﺯﺭﺍ
ﻪﺒﺣﺎﺼﻣ: ﺪﯾﺩﺯﺎﺑ, ﻪﺒﺣﺎﺼﻣ
ﻭﺮﻤﻠﻗ: ﻩﺯﻮﺣ
ﯽﺴﻨﺟ-ﻁﺎﺒﺗﺭﺍ: ﺩﺮﻣ-ﯽﻠﺳﺎﻨﺗ-ﺖﻟﺁ, ﯽﺴﻨﺟ, ﺶﺷ
ﺩﺎﺠﯾﺍ: ﻥﺩﺭﻭﺁ-ﺩﻮﺟﻭ-ﻪﺑ, ﯼﺪﻨﺑ-ﻝﻮﻣﺮﻓ, ﺩﺎﺠﯾﺍ
ﻪﻟﺎﺒﻧﺩ: ﺖﻣﻼ﻿ﻋ, ﺏﺎﺨﺘﻧﺍ, ﺮﯿﺴﻣ
ﺯﺍﺪﻧﺍ-ﻢﺸﭼ: ﺪﯿﻣﺍ, ﻝﺎﻤﺘﺣﺍ, ﺯﺍﺪﻧﺍ-ﻢﺸﭼ, ﻪﻨﺤﺻ
ﺩﺮﮑﻠﻤﻋ: ﯽﮔﺪﻧﺍﺭ, ﺪﻨﯾﺁﺮﻓ, ﻞﻤﻋ, ﺡﺍﺮﺟ
ﻖﯿﻤﻋ: ﻖﯿﻤﻋ
ﻦﺘﺷﺍﺩ-ﯽﻧﺍﻮﺨﻤﻫ: ﺭﺎﻤﻗ, ﻥﺪﺷ-ﻑﺩﺎﺼﻣ, ﯽﻗﺎﻔﺗﺍ, ﻪﻘﺑﺎﺴﻣ
ﻡﺮﻓ-ﺱﺎﺒﻟ: ﺱﺎﺒﻟ
ﯽﻫﺪﺑ: ﺶﻧﺯﺮﺳ, ﻦﯾﺩ, ﻪﻔﯿﻇﻭ, ﺭﺎﺒﺘﻋﺍ
ﯼﺭﺍﺬﮔ-ﻪﯾﺎﻣﺮﺳ: ﺍﺮﺟﺎﻣ, ﯼﺭﺍﺬﮔ-ﻪﯾﺎﻣﺮﺳ, ﺖﮐﺮﺷ
ﺍﺮﺟﺍ: ﻞﻤﻋ
ﺖﻟﺎﺣ: ﺱﺎﺴﺣﺍ, ﯽﻌﺒﻃ-ﺥﻮﺷ, ﻊﺿﻭ
ﻪﻣﺪﺧ: ﻥﺎﻨﮐﺭﺎﮐ
ﮎﺭﺩ: ﻦﮐ-ﮎﺭﺩ, ﺭﻮﺼﺗ, ﻥﺪﯾﺩ
ﻦﺘﺷﺍﺩ-ﺭﺎﻬﻇﺍ: ﺢﯿﺿﻮﺗ
ﻪﺨﺴﻧ: ﻪﺨﺴﻧ, ﻝﻮﻠﺳ
ﺩﺮﻓ: ﺐﻳﺮﻏ-ﻭ-ﺐﻴﺠﻋ, ﻩﺮﻈﺘﻨﻣ-ﺮﯿﻏ
ﺭﺍﺰﮕﺳﺎﭙﺳ: ﺮﮑﺸﺗ
ﺖﻳﺎﻬﻧ-ﻲﺑ: ﯼﺪﺑﺍ, ﺭﺪﺼﻣ
ﺖﯿﻨﻣﺍ: ﺮﻄﺧ-ﯽﺑ, ﻥﺩﺍﺩ-ﺖﻴﻤﻫﺍ
ﻝﻮﻘﻌﻣ: ﺎﻧﺍﺩ, ﯽﻘﻄﻨﻣ, ﺱﺎﺴﺣ
ﻪﺒﻠﮐ: ﻪﺒﻠﮐ, ﻦﯿﺑﺎﮐ
ﺖﯿﻓﺮﻇ: ﺭﺩﺎﻗ, ﺕﺭﺎﻬﻣ, ﻢﺠﺣ
ﻞﺼﻓ-ﻭ-ﻞﺣ: ﻥﺩﺮﮐ-ﺖﻣﺎﻗﺍ
ﺭﺎﮐﺭﺪﻧﺍ-ﺖﺳﺩ: ﻝﻮﻐﺸﻣ, ﻥﺩﺮﮐ-ﻞﺻﻭ
ﺍﺭﻮﺷ: ﺖﺤﯿﺼﻧ
ﻪﻨﯾﺎﻌﻣ: ﺮﮕﺷﻭﺎﮐ, ﯽﺳﺭﺮﺑ, ﻥﺩﺮﻛ-ﺏﺎﺨﺘﻧﺍ
ﺩﻻ﻿ﻮﻓ: ﻥﺪﯿﺸﮐ-ﻮﺗﺍ
ﺖﺴﺗ: ﯽﺳﺭﺮﺑ, ﻥﺩﺮﻛ-ﺵﻼ﻿ﺗ
ﻪﻗﺪﺻ: ﻖﺸﻋ
ﻦﺘﺨﯾﺭ: ﻦﺘﺨﯾﺭ, ﺐﻟﺎﻗ
ﻁﺎﺒﺗﺭﺍ: ﺕﺎﺒﺗﺎﮑﻣ, ﻂﺑﺍﻭﺭ
ﯽﺴﮐ: ﻪﮐ-ﯽﺴﮐ-ﺮﻫ, ﺺﺨﺷ, ﯽﺴﮐ-ﺮﻫ
ﻒﯾﺩﺭ: ﻂﺧ, ﯽﺒﯿﺗﺮﺗ, ﻢﯿﻈﻨﺗ, ﺖﻟﻭﺩ, ﺐﯿﺗﺮﺗ
ﯽﻟﻮﭘ-ﯽﺑ: ﺮﯿﻘﻓ
ﺪﯾﺪﺷ: ﻪﺒﻟ, ﻁﺮﻔﻣ, ﺪﯾﺪﺷ
ﻉﺍﺰﻧ: ﻥﺩﺮﮐ-ﻩﺯﺭﺎﺒﻣ
ﺱﺮﺘﺳﺩ-ﺭﺩ: ﻩﺪﺷ-ﻪﺋﺍﺭﺍ, ﺮﺿﺎﺣ
ﺖﻣﻭﺎﻘﻣ: ﺖﻔﻟﺎﺨﻣ
ﻝﻮﻤﻌﻣ-ﺮﯿﻏ: ﻩﺮﻈﺘﻨﻣ-ﺮﯿﻏ, ﺞﯾﺍﺭ
ﻪﻨﮑﺳ-ﺯﺍ-ﯽﻟﺎﺧ: ﻪﮐﻭﺮﺘﻣ, ﺮﯾﻮﮐ
ﯼﺍﺭ: ﻥﺩﺮﻛ-ﺏﺎﺨﺘﻧﺍ, ﺍﺪﺻ
ﻞﻤﺤﺗ: ﻞﻤﺤﺗ, ﯽﻣﺎﺣ, ﻪﺘﺷﺬﮔ, ﻥﺩﺮﺑ-ﺞﻧﺭ
ﻥﺪﺷ-ﻖﻓﻮﻣ: ﺖﯿﻘﻓﻮﻣ
ﺎﭘ: ﺎﭘ, ﻥﺍﻮﺨﺘﺳﺍ
ﺩﺎﻬﻨﺸﯿﭘ: ﺩﺎﻬﻨﺸﯿﭘ, ﻥﺩﺮﮐ-ﺎﺿﺎﻘﺗ
ﯽﻠﺧﺍﺩ: ﯽﻠﺧﺍﺩ
ﮏﺒﺳ: ﯽﻧﺎﺳﺁ-ﻪﺑ, ﮏﺒﺳ
ﻥﺩﺍﺩ-ﺶﯾﺎﻤﻧ: ﺶﯾﺎﻤﻧ, ﻩﺎﮕﺸﯾﺎﻤﻧ, ﺶﯾﺎﻤﻧ-ﻪﺤﻔﺻ, ﻪﻨﺤﺻ, ﮎﺭﺪﻣ
ﺩﻭﺪﺤﻣ: ﺩﻭﺪﺤﻣ, ﻂﻘﻓ
ﻦﺘﻓﺮﮔ-ﻪﻧﺎﺸﻧ: ﻑﺪﻫ, ﺰﮐﺮﻤﺗ
ﯽﻧﺍﺮﺤﺑ: ﻡﺯﻻ﻿, ﺪﻘﺘﻨﻣ
ﻪﺴﯿﮐ: ﺐﯿﺟ, ﻪﺴﯿﮐ, ﺪﺒﺳ
ﻥﺩﺮﮐ-ﺭﺍﺮﮑﺗ: ﺭﺍﺮﮑﺗ, ﺖﺸﮔﺯﺎﺑ, ﺭﺮﮑﻣ
ﺮﯿﺴﻣ: ﺭﻮﺘﯿﻧﺎﻣ, ﻪﻧﺍﺮﺗ, ﺮﯿﺴﻣ, ﻥﺩﺮﮐ-ﻝﺎﺒﻧﺩ
ﺖﻣﺎﻗﺍ-ﻞﺤﻣ: ﻩﺎﻨﭘ-ﻥﺎﺟ
ﯽﻣﺮﮔﺮﺳ: ﻝﺎﺤﺷﻮﺧ, ﺭﺍﺩ-ﻩﺪﻨﺧ, ﯽﻣﺮﮔﺮﺳ-ﻭ​​-ﺢﯾﺮﻔﺗ
ﻉﺎﻓﺩ: ﺖﻈﻓﺎﺤﻣ
ﺕﺪﺷ-ﻪﺑ: ﻥﺯﻭ, ﯼﺪﺟ-ﺭﻮﻃ-ﻪﺑ
ﺰﯿﭼ: ﺍﻮﺘﺤﻣ, ﺕﻻ﻿ﻮﺼﺤﻣ, ﺰﯿﭼ
ﺶﺨﺑ: ﺶﺨﺑ, ﯽﻓﺎﮑﺷ-ﺪﺒﻟﺎﮐ
ﻥﺎﮑﺳﺍ: ﯼﺭﺎﮑﻤﻫ-ﺩﺍﺩﺭﺍﺮﻗ, ﻩﺎﻨﭘ-ﻥﺎﺟ, ﺕﺍﺭﺮﻘﻣ
ﻪﺤﻔﺻ: ﻮﻠﺑﺎﺗ, ﮏﺴﯾﺩ, ﻮﮑﺴﯾﺩ
ﺮﺑ-ﻪﺒﻠﻏ: ﻪﻠﺑﺎﻘﻣ, ﺯﻭﺎﺠﺗ, ﻢﺘﺷ-ﻭ-ﺏﺮﺿ
ﻪﻨﯿﻣﺯ: ﻞﯿﻟﺩ, ﺕﺎﺣﻼ﻿ﻄﺻﺍ, ﻒﯿﺗﻮﻣ
ﺮﻣﺮﻣ-ﮓﻨﺳ: ﮓﻨﺳ
ﯽﯾﺎﻧﺍﻮﺗ: ﺭﺩﺎﻗ, ﺕﺭﺎﻬﻣ, ﺩﺍﺪﻌﺘﺳﺍ
ﻥﺩﺍﺩ-ﻥﺎﮑﺗ-ﺖﺳﺩ: ﺪﻣ-ﻭ-ﺭﺰﺟ, ﻢﻬﺒﻣ
ﻡﺩﺮﻣ: ﻡﺩﺮﻣ, ﺪﻨﺴﭘ-ﻪﻣﺎﻋ
ﯼﺮﯾﺬﭘ-ﻥﺎﮑﻣﺍ: ﻝﺎﻤﺘﺣﺍ, ﺭﺩﺎﻗ
ﻩﺮﮐ: ﺖﻔﻧ
ﺕﺮﻔﻧ: ﺮﯿﻘﺤﺗ, ﺕﺮﻔﻧ
ﺐﯿﻘﻌﺗ: ﻥﺩﺮﮐ-ﻮﺠﺘﺴﺟ
ﻥﺪﯿﺸﮐ: ﻢﺳﺭ, ﯽﭽﯿﻗ
ﻝﺎﻨﮕﯿﺳ: ﺖﺳﮊ, ﺖﻣﻼ﻿ﻋ, ﺭﻮﺒﻋ-ﺰﻣﺭ
ﺮﻄﺧ-ﻥﻭﺪﺑ: ﺮﻄﺧ-ﯽﺑ
ﯽﮕﺘﺧﻮﺳ: ﻪﺘﺧﻮﺳ, ﺩﻭﺩ
ﺱﺭﺩ: ﺕﻼ﻿ﯿﺼﺤﺗ, ﻉﻮﺿﻮﻣ, ﻩﺭﻭﺩ
ﻪﻧﺎﯿﻟﺎﺳ: ﻝﺎﺳ
ﺕﺭﺎﮐ: ﺍﻮﻘﻣ, ﻪﺸﻘﻧ, ﻩﺎﺗﻮﮐ-ﺪﻗ, ﺬﻏﺎﮐ
ﺭﺍﺰﻓﺍ-ﻡﺮﻧ: ﻥﺩﺮﮐ-ﻩﺩﺎﻔﺘﺳﺍ, ﺭﺍﺰﻓﺍ-ﻡﺮﻧ, ﻥﺩﺮﮐ-ﺎﺿﺎﻘﺗ
ﺪﻨﻤﺷﻮﻫ---ﺵﻮﻫﺎﺑ: ﯼﺮﮑﻓ, ﺎﻧﺍﺩ
ﻥﺎﺘﺳﺮﻬﺷ: ﻢﯾﺮﺤﺗ, ﯼﺍ-ﻪﻘﻄﻨﻣ, ﻥﺎﺘﺳﺮﻬﺷ, ﺭﻮﺸﮐ
ﺐﻟﺎﻗ: ﻥﺪﺷ-ﻞﻴﻜﺸﺗ, ﺐﻟﺎﻗ
ﻥﺎﯾﺮﺟ: ﻥﺎﯾﺮﺟ
ﻥﺪﻧﺎﺳﺭ-ﺐﯿﺳﺁ: ﯽﻫﺎﺒﺗ, ﯽﮔﺪﯾﺩ-ﺐﯿﺳﺁ, ﻢﺣﺮﺗ
ﻦﯾﺍ-ﺮﺑ-ﻩﻭﻼ﻿ﻋ: ﯽﻓﺎﺿﺍ, ﯽﺘﺣ, ﺶﯿﺑ
ﺕﺭﺎﺠﺗ: ﺕﺭﺎﺠﺗ
ﯽﺑﻮﻨﺟ: ﺏﻮﻨﺟ
ﯽﻧﻭﺮﯿﺑ: ﺝﺭﺎﺧ
ﻂﺳﻮﺘﻣ: ﻡﻭﺩ, ﻦﺘﺷﺍﺩ-ﺭﻮﻈﻨﻣ
ﻪﻨﻫﺮﺑ: ﻡﺮﺷ
ﺢﺿﺍﻭ: ﺩﻮﻬﺸﻣ, ﻦﮐ-ﺯﺎﺑ, ﻞﺻﺍ
ﻪﯾﺎﭘ: ﯼﺎﻨﺑ-ﺮﯾﺯ, ﻮﮑﺳ
ﻪﻗﻼ﻿ﻋ: ﻥﺩﺍﺩ-ﺖﻴﻤﻫﺍ, ﺲﭘﺍﻮﻟﺩ, ﻩﺍﺮﻤﻫ, ﻪﻗﻼ﻿ﻋ, ﯽﮕﺘﻔﯿﺷ
ﻭﺩﺎﺟ: ﻥﻮﺴﻓﺍ
ﯽﺗﺎﺑﺎﺨﺘﻧﺍ-ﺕﺍﺯﺭﺎﺒﻣ: ﯽﯾﺎﺠﺑﺎﺟ, ﺮﻔﺳ
ﻝﺍﺮﺒﯿﻟ: ﻩﺪﻨﺸﺨﺑ
ﺎﻣﻮﻤﻋ: ﺞﯾﺍﺭ, ﻊﻗﺍﻮﻣ-ﺮﺘﺸﯿﺑ, ﯽﻠﮐ-ﺭﻮﻄﺑ
ﺭﺎﮑﺷ: ﺪﯿﺻ
ﻢﻠﻌﻣ: ﻩﺪﻨﺴﯾﻮﻧ
ﯽﻫﺎﺗﻮﮐ-ﺕﺪﻣ: ﯼﺩﻭﺯ-ﻪﺑ, ﻩﺎﺗﻮﮐ-ﺪﻗ, ﺎﺒﯾﺮﻘﺗ
ﺖﮐﺮﺑ: ﺖﮐﺮﺑ
ﮏﭼﻮﮐ: ﯽﻤﮐ-ﺭﺍﺪﻘﻣ, ﮏﭼﻮﮐ
ﺕﺪﺷ-ﻪﺑ: ﺖﻋﺮﺳ, ﺰﯿﺗ, ﯼﺪﺟ-ﺭﻮﻃ-ﻪﺑ
ﻪﻨﯿﺳ-ﻪﺴﻔﻗ: ﻥﺎﺘﺴﭘ
ﻖﻤﻋ: ﻖﯿﻤﻋ
ﺩﺮﮑﻠﻤﻋ: ﺶﯾﺎﻤﻧ, ﯼﺭﻭ-ﻩﺮﻬﺑ
ﯽﺑﺎﯿﻣﺎﮐ: ﻥﺪﺷ-ﺎﻓﻮﮑﺷ, ﺖﯿﻘﻓﻮﻣ, ﻩﺎﻓﺭ
ﯽﺸﻨﻣ: ﺪﻨﻣﺭﺎﮐ, ﯽﻤﺳﺭ
ﻦﺘﻓﺮﮔ-ﻢﻴﻤﺼﺗ: ﻢﯿﻤﺼﺗ, ﺺﺨﺸﻣ, ﻊﻃﺎﻗ, ﻝﻮﻠﺤﻣ-ﺭﺩ-ﺩﻮﺟﻮﻣ
ﯽﻧﺎﺑﺮﻗ: ﺪﯿﺻ, ﯽﻧﺎﺑﺮﻗ, ﺽﺭﺍﻮﻋ
ﻩﺰﯿﮕﻧﺍ: ﺪﺼﻗ, ﻒﯿﺗﻮﻣ, ﺭﻮﺗﻮﻣ, ﻑﺪﻫ, ﮎﺮﺤﻣ
ﯽﻌﻄﻗ: ﺺﺨﺸﻣ, ﺩﻮﻬﺸﻣ
ﺶﯾﺍﺮﮔ: ﻪﺼﺨﺸﻣ, ﻞﯾﺎﻣ, ﻊﺿﻭ, ﯽﮔﺪﻧﺍﺭ
ﻥﺎﯾﺎﭘ: ﺪﯿﺳﺭ-ﻥﺎﯾﺎﭘ-ﻪﺑ, ﮓﻧﺭ
ﻢﭼﺮﭘ: ﻢﭼﺮﭘ, ﻦﺘﺴﻧﺍﺩ
ﺖﻣﻮﮑﺣ: ﻥﻮﻧﺎﻗ, ﺖﯾﺮﯾﺪﻣ
ﺕﺭﺪﻧ-ﻪﺑ: ﺭﺩﺎﻧ
ﯽﻌﻗﺍﻭ: ﯼﺯﺎﺠﻣ, ﯽﻠﺻﺍ
ﺵﺯﻮﻣﺁ: ﺕﻼ﻿ﯿﺼﺤﺗ, ﻢﯿﻠﻌﺗ
ﺪﺑ: ﻩﺎﺒﺘﺷﺍ, ﺭﺎﯿﺴﺑ, ﺮﺗﺪﺑ, ﺪﺑ, ﺭﺎﻤﯿﺑ
ﻥﺩﺮﮐ-ﻪﯾﺬﻐﺗ: ﻥﺩﺭﻮﺧ, ﺮﺘﺳﺎﻓ, ﺍﺬﻏ
ﯼﺰﮐﺮﻣ: ﺰﮐﺮﻣ, ﻝﺍﺭﺪﻓ
ﺩﺎﻀﺗ: ﺩﺎﻀﺘﻣ, ﺖﻔﻟﺎﺨﻣ, ﺩﺎﻀﺗ
ﺭﺎﺘﺧﺎﺳ: ﺎﻨﺑ, ﯼﺭﺎﺘﺧﺎﺳ, ﻥﺎﻣﺯﺎﺳ
ﺖﺧﺍﺩﺮﭘ: ﺖﺧﺍﺩﺮﭘ
ﺖﻋﺮﺳ: ﺖﻋﺮﺳ
ﻮﺟ-ﻭ-ﺱﺮﭘ: ﺮﮕﺷﻭﺎﮐ, ﻥﺩﺮﮐ-ﺎﺿﺎﻘﺗ, ﻥﺩﺮﮐ-ﻮﺠﺘﺴﺟ
ﻪﮐ-ﺎﺠﮐ-ﺮﻫ: ﻪﮐ-ﯽﯾﺎﺟ
ﻥﺩﻮﺑ-ﺭﺎﮑﻫﺪﺑ: ﺭﺎﮑﻫﺎﻨﮔ, ﻪﻔﯿﻇﻭ
ﯽﮔﺪﯿﺳﺭ: ﺪﻨﯾﺁﺮﻓ, ﺖﯾﺮﯾﺪﻣ, ﻪﻠﺑﺎﻘﻣ, ﯼﺭﺎﮐ-ﺖﺳﺩ
ﺮﻔﺳ: ﺪﯾﺩﺯﺎﺑ, ﺎﻘﯾﺮﻓﺍ-ﺭﺩ-ﯽﻓﺎﺸﺘﮐﺍ ﺖﺣﺎﯿﺳ, ﺵﺩﺮﮔ, ﺮﻔﺳ
ﻦﺘﺨﯾﺭ-ﻥﻭﺮﯿﺑ: ﺲﮑﻋ, ﺪﯿﻌﺒﺗ, ﻦﺘﺨﯾﺭ-ﻥﻭﺮﯿﺑ
ﻡﺍﺪﺨﺘﺳﺍ: ﺭﺎﮐ-ﯽﺑ, ﯽﮕﺘﻔﯿﺷ, ﺭﺎﮐ
ﻥﺩﺍﺩ-ﺵﺮﺑ: ﺵﺮﺑ
ﻥﺩﺮﮐ-ﺖﻣﻭﺎﻘﻣ: ﺖﻔﻟﺎﺨﻣ
ﻥﺪﺷ-ﻦﯿﯿﻌﺗ: ﻩﺪﻧﺮﯿﮔ-ﻢﯿﻤﺼﺗ, ﺺﺨﺸﻣ, ﻊﻃﺎﻗ, ﻞﯿﻤﺤﺗ, ﺖﺑﺎﺛ
ﺮﺟﺎﺗ: ﻝﻻ﻿ﺩ, ﺮﺟﺎﺗ, ﺕﺭﺎﺠﺗ
ﻩﺪﻧﺯ: ﻩﺪﻧﺯ
ﻢﯿﺴﻧ: ﺍﻮﻫ
ﯽﻠﯿﻣﺎﻓ-ﺖﺒﺴﻧ: ﻩﺩﺍﺯ-ﻪﻟﺎﺧ
ﻪﺠﯿﺘﻧ-ﺭﺩ: ﺐﯿﺗﺮﺗ-ﻦﯾﺪﺑ
ﮎﺭﺍﺪﺗ: ﻥﺩﺮﮐ-ﯽﻓﺮﻌﻣ, ﻩﺪﺷ-ﻪﺋﺍﺭﺍ, ﻩﺎﻓﺭ, ﺺﯿﺼﺨﺗ, ﻊﺿﻭ
ﺖﺑﺎﺑ-ﺯﺍ: ﻩﺭﺎﺑ-ﺭﺩ, ﻪﺟﻮﺗ
ﺪﯿﻨﮐ-ﺏﺎﺨﺘﻧﺍ: ﻥﺩﺮﻛ-ﺏﺎﺨﺘﻧﺍ, ﻦﺘﻓﺮﮔ
ﺏﺍﺮﺧ: ﻦﺘﻓﺭ-ﻦﯿﺑ-ﺯﺍ
ﻪﺋﺍﺭﺍ: ﻥﺩﺍﺩ, ﻥﺩﺮﮐ-ﯽﻓﺮﻌﻣ
ﻪﺒﻗﺮﺘﻣ-ﺮﯿﻏ: ﻥﺩﺮﮐ-ﺮﯿﮕﻠﻓﺎﻏ
ﻪﻌﻟﺎﻄﻣ-ﺰﯿﻣ: ﺰﯿﻣ, ﯼﺭﺍﺩﺍ-ﺮﺘﻓﺩ
ﻪﭼﻮﮐ: ﻂﺧ, ﺪﻧﺎﺑ
ﯽﮔﺪﻨﯾﺎﻤﻧ: ﻩﺪﻨﯾﺎﻤﻧ, ﻝﺎﺜﻣ
ﻡﺍﺮﺘﺣﺍ-ﻞﺑﺎﻗ: ﺭﺎﺨﺘﻓﺍ
ﺖﯿﻟﻮﺌﺴﻣ-ﺱﺎﺴﺣﺍ: ﻪﻔﯿﻇﻭ, ﺶﻧﺯﺮﺳ
ﺪﯿﻣﺍﺎﻧ: ﯽﺒﻠﻃ-ﻩﺎﺟ, ﻩﺪﻨﻨﮐ-ﺪﯿﻣﺍﺎﻧ
ﺐﺳﺎﻨﻣ: ﻥﺪﺷ-ﻑﺩﺎﺼﻣ, ﺐﺳﺎﻨﻣ
ﺩﺭﺍﺩ-ﯽﮕﺘﺴﺑ: ﯽﮕﺘﺴﺑﺍﻭ, ﻥﺍﺮﮐ
ﻝﻮﻏ: ﯽﻟﺎﻋ, ﻻ﻿ﻮﯿﻫ
ﻢﻬﻓ: ﻦﮐ-ﮎﺭﺩ, ﻥﺩﺮﮐ-ﺐﺣﺎﺼﺗ
ﻥﺪﯿﺳﺭ: ﺎﯿﺑ, ﻥﺪﯿﺳﺭ
ﯽﮔﺩﺎﺳ: ﻩﺩﺎﺳ, ﯽﻨﺗﻭﺮﻓ
ﺰﻴﻳﺎﭘ-ﻞﺼﻓ: ﻁﻮﻘﺳ
ﺐﯾﺎﻏ: ﻡﺪﻋ, ﺭﻭﺩ
ﯽﮕﻨﺗ-ﻝﺩ: ﮏﯾﺭﺎﺗ
ﻥﻮﻨﻈﻣ: ﻥﺰﺑ-ﺱﺪﺣ, ﻥﺩﺮﻛ-ﻚﺷ, ﮎﻮﮑﺸﻣ
ﻦﯿﯿﻌﺗ: ﺺﺨﺸﻣ, ﻢﯿﻤﺼﺗ, ﺵﺭﺍﺰﮔ, ﻒﯾﺮﻌﺗ
ﺱﺎﺳﺍ: ﯼﺎﻨﺑ-ﺮﯾﺯ, ﺕﺎﺣﻼ﻿ﻄﺻﺍ
ﯽﺳﺭﺮﺑ: ﻥﺩﺮﮐ-ﻩﺪﻫﺎﺸﻣ, ﯽﺳﺭﺮﺑ, ﻞﯿﻠﺤﺗ
ﻩﺰﯾﺎﺟ: ﻩﺰﯾﺎﺟ, ﻪﻤﯿﺑ-ﻖﺣ
ﺪﯾﺮﺧ: ﺪﯾﺮﺧ
ﯽﺴﮐ: ﺺﺨﺷ, ﯽﺴﮐ-ﺮﻫ, ﻪﭼﺮﮔ
ﻥﺪﯿﻤﻬﻓ: ﻥﺪﯿﺳﺭ, ﻦﮐ-ﮎﺭﺩ
ﺖﺴﮑﺷ: ﻢﺘﺷ-ﻭ-ﺏﺮﺿ, ﺪﻨﺑ-ﻥﺩﺮﮔ, ﺖﺴﮑﺷ
ﯽﯾﺎﻨﺟ: ﻥﻮﺧ
ﻪﻧﺎﻘﻤﺣﺍ: ﻖﻤﺣﺍ, ﻥﺍﺩﺎﻧ
ﻥﺍﻮﺧﺍﺮﻓ: ﻥﺩﺭﻭﺁ-ﺩﺎﻳ-ﻪﺑ
ﻝﺎﻐﺘﺷﺍ: ﺵﺭﻮﯾ, ﻪﻓﺮﺣ, ﯼﺍ-ﻪﻓﺮﺣ-ﻭ ﯽﻨﻓ, ﺰﯿﻣﺁ-ﺖﻧﻮﺸﺧ
ﻦﺨﺳ: ﻥﺭﺪﻣ, ﺪﯿﻨﮐ-ﺖﺒﺤﺻ
ﯼﺭﺎﮑﻤﻫ: ﮏﻤﮐ, ﻥﺩﺮﮐ-ﺖﯾﺎﻤﺣ, ﯼﺭﺎﮑﻤﻫ
ﺵﻭﺮﻓ: ﺝﺍﺮﺣ, ﺵﻭﺮﻓ, ﻒﯿﻔﺨﺗ
ﻪﻣﺎﻧ-ﺕﻮﻋﺩ: ﻥﺩﺮﻛ-ﺕﻮﻋﺩ, ﻥﺩﺯ-ﮓﻧﺯ
ﺖﺴﭘ: ﻩﺪﻨﺴﺑﺎﻧ, ﻦﯿﯾﺎﭘ, ﺮﺗﺪﺑ
ﺺﯿﺨﺸﺗ: ﻥﺩﺮﮐ-ﺭﺍﺮﻗﺍ, ﺺﯿﺨﺸﺗ
ﺮﯾﻮﺼﺗ: ﺮﯾﻮﺼﺗ
ﺪﻫﺩ-ﯽﻣ-ﺩﺎﻬﻨﺸﯿﭘ: ﺩﺎﻬﻨﺸﯿﭘ, ﺪﯿﻨﮐ-ﺽﺮﻓ
ﯼﺪﯿﻣﺍ-ﺎﻧ: ﯼﺪﯿﻣﺍ-ﺎﻧ, ﯽﺒﻠﻃ-ﻩﺎﺟ, ﺝﻭﺍﺩﺎﭘ, ﻩﺪﻨﻨﮐ-ﺪﯿﻣﺍﺎﻧ, ﻥﺩﺮﻤﺷ
ﺖﺧﺎﺳ: ﺎﻨﺑ
ﺐﺼﻌﺗ: ﻕﺎﯿﺘﺷﺍ, ﯽﺷﻮﮐ-ﺖﺨﺳ
ﻝﻮﺌﺴﻣ: ﻪﻔﯿﻇﻭ
ﻥﺎﻣﺭﺩ: ﻥﺎﻣﺭﺩ, ﺎﻔﺷ, ﻥﺩﺍﺩ-ﺖﻴﻤﻫﺍ
ﻞﻣﺎﺷ: ﻪﻠﻤﺟ-ﺯﺍ, ﻥﺪﺷ-ﻞﺧﺍﺩ, ﻝﻮﻤﺷ, ﻦﮐ-ﮎﺭﺩ, ﺍﻮﺘﺤﻣ
ﻥﺩﺮﮐ-ﻊﻧﺎﻗ: ﺕﺎﻗﻼ﻿ﻣ, ﯽﺿﺍﺭ, ﺍﻮﺘﺤﻣ, ﻦﺘﺧﺎﺳ-ﺎﻫﺭ
ﺞﻧﺭ: ﺦﻠﺗ
ﻖﻤﺣﺍ: ﻞﺧ, ﻥﺍﺩﺎﻧ, ﻖﻤﺣﺍ
ﺕﺬﻟ: ﺪﯾﺮﺒﺑ-ﺕﺬﻟ
ﻥﺩﺮﮐ-ﻥﺎﻬﻨﭘ: ﻥﺩﺮﮐ-ﯽﻔﺨﻣ
ﺎﻘﯿﻗﺩ: ﺐﺳﺎﻨﻣ, ﻩﺪﺷ-ﺮﭘ
ﻢﯿﻨﮐ-ﺽﺮﻓ: ﻥﺩﺮﻛ-ﺶﻫﺍﻮﺧ, ﺪﯿﻨﮐ-ﺽﺮﻓ, ﻪﺟﻮﺗ
ﻥﺩﺯ-ﻦﯿﻤﺨﺗ: ﯽﺑﺎﯾﺯﺭﺍ, ﻥﺰﺑ-ﺱﺪﺣ
ﺮﯿﺴﻣ: ﺮﯿﺴﻣ
ﻥﺎﻤﻬﻣ: ﺮﻓﺎﺴﻣ, ﻥﺎﻤﻬﻣ, ﻩﺪﻨﻨﮐ-ﻩﺪﻫﺎﺸﻣ
ﺮﯿﻏ: ﻪﻧ
ﻢﯿﺳ: ﻂﺧ
ﺐﻠﻏﺍ: ﺹﻮﺼﺨﺑ, ﯼﺩﺎﯾﺯ-ﺪﺣ-ﺎﺗ
ﻩﺎﮔﺁﺩﻮﺧﺎﻧ: ﻦﺘﻓﺭ-ﻝﺎﺣ-ﺯﺍ
ﻞﺑﺎﻘﺘﻣ: ﺮﮕﯾﺪﮑﯾ, ﺞﯾﺍﺭ
ﯽﺟﺭﺎﺧ: ﺝﺭﺎﺧ, ﯽﺟﺭﺎﺧ
ﻥﺎﻬﺟ: ﻥﺎﻬﯿﮐ, ﻥﺎﻬﺟ
ﺖﻋﺎﺳ: ﺖﻋﺎﺳ
ﻞﻤﻌﻟﺍ-ﺭﻮﺘﺳﺩ: ﻢﯿﻠﻌﺗ, ﺖﻬﺟ, ﯼﺎﻤﻨﻫﺍﺭ-ﻪﭽﺑﺎﺘﮐ
ﻢﺧﺯ: ﻢﺧﺯ, ﺭﺎﻤﯿﺑ, ﺩﺭﺩ
ﻁﺎﺒﻀﻧﺍ: ﻉﻮﺿﻮﻣ
ﯽﻓﺮﻌﻣ: ﻥﺩﺮﮐ-ﯽﻓﺮﻌﻣ, ﻩﺪﺷ-ﻪﺋﺍﺭﺍ, ﻊﯿﻓﺮﺗ, ﺮﮔﺯﺎﻏﺁ, ﻥﺩﺮﻛ-ﺩﺭﺍﻭ
ﻥﺎﺑﺎﯿﺑ: ﺮﯾﻮﮐ
ﻢﮔﺭﺩﺮﺳ: ﯽﺒﺼﻋ, ﯼﺪﯿﻣﺍ-ﺎﻧ
ﺝﺍﻭﺩﺯﺍ-ﻦﺸﺟ: ﻩﺩﺮﮐ-ﺝﺍﻭﺩﺯﺍ
ﯽﮔﺪﻨﯾﺎﻤﻧ: ﻩﺪﻨﯾﺎﻤﻧ, ﺖﻤﺳ, ﺖﻓﺍﺮﻇ, ﺶﺨﺑ
ﻥﺩﺮﮐ-ﺏﺎﺴﺣ-ﯼﺰﯿﭼ ﯼﻭﺭ: ﻦﺘﺷﺍﺩ-ﺩﺎﻘﺘﻋﺍ, ﻪﺒﺳﺎﺤﻣ, ﻥﺩﺮﻤﺷ
ﯽﻌﻄﻗ-ﺮﯿﻏ: ﺪﯾﺩﺮﺗ, ﻥﺍﺯﺮﻟ, ﻢﻬﺒﻣ
ﯼﺩﺰﻣﺎﻧ: ﻝﻮﻐﺸﻣ, ﯼﺩﺰﻣﺎﻧ
ﻒﯿﺜﮐ: ﺮﺸﻧ, ﺖﺷﺭﺩ
ﮏﺷﺰﭘ: ﺮﺘﮐﺩ
ﺶﺷﻮﭘ: ﻩﺪﺷ-ﻩﺩﺍﺩ-ﺶﺷﻮﭘ, ﻝﻮﻤﺷ, ﻒﻘﺳ, ﻥﺩﺮﮐ-ﯼﺪﻨﺑ-ﻪﺘﺴﺑ
ﻕﺩﺎﺻ: ﻕﺩﺎﺻ, ﯽﺘﺳﺍﺮﺑ, ﺺﻟﺎﺧ
ﺱﺎﺴﺣﺍ: ﺱﺎﺴﺣﺍ
ﺹﺎﺧ: ﺹﻮﺼﺨﺑ, ﯽﺻﻮﺼﺧ, ﺱﺎﻨﺷﺭﺎﮐ
ﻪﻧﺎﺧﺮﻓﺎﺴﻣ: ﻞﺘﻫ
ﺖﻔﺳ: ﺖﺨﺳ
ﻥﺩﺮﮐ-ﯽﻫﺍﺮﻤﻫ: ﻥﺩﺮﮐ-ﻝﺎﺒﻧﺩ
ﻩﺮﻤﻧ: ﺖﻣﻼ﻿ﻋ, ﺵﺭﺍﺰﮔ
ﻩﺮﮐﺎﺑ: ﺮﺘﺧﺩ-ﺪﻧﺯﺮﻓ
ﯽﮕﻨﺳﺮﮔ: ﻪﻨﺳﺮﮔ
ﺏﻮﺒﺤﻣ: ﺏﻮﺒﺤﻣ
ﮎﺮﻤﮔ: ﺖﻨﺳ, ﭻﻨﯾﺍ, ﻪﻔﯿﻇﻭ, ﯽﺷﺭﺎﻔﺳ
ﺭﺍﺮﻗ-ﺮﯿﺛﺎﺗ-ﺖﺤﺗ: ﺱﺎﺴﺣﺍ
ﺭﺎﮑﺷ: ﺪﯿﺻ, ﺕﺭﺎﻏ, ﯽﻧﺎﺑﺮﻗ
ﯽﻘﯿﺳﻮﻣ: ﯽﻘﯿﺳﻮﻣ, ﻥﺍﺩ-ﯽﻘﯿﺳﻮﻣ
ﺶﺨﺒﺘﯾﺎﺿﺭ: ﯼﺭﺎﻤﯿﺑ
ﮏﺤﻀﻣ: ﻥﺍﺩﺎﻧ, ﺭﺍﺩ-ﻩﺪﻨﺧ
ﻕﺭﻭ: ﺬﻏﺎﮐ, ﮒﺮﺑ, ﻩﻭﺰﺟ
ﯽﯾﺍﻮﺳﺭ: ﻡﺮﺷ
ﻞﺻﺍ-ﺭﺩ: ﯽﻠﺻﺍ
ﺩﺰﻣ: ﺖﺧﺍﺩﺮﭘ
ﻊﯿﺳﻭ: ﻩﺩﺮﺘﺴﮔ, ﻖﯿﻤﻋ
ﺖﻏﺍﺮﻓ: ﯽﻣﺮﮔﺮﺳ-ﻭ​​-ﺢﯾﺮﻔﺗ, ﯽﻟﺎﺧ, ﻪﺘﺴﺸﻧﺯﺎﺑ, ﺏﺎﺼﻋﺍ-ﺩﺪﻤﺗ
ﻪﻧﺎﭼ: ﺶﯾﺭ
ﺶﺑﺎﺗ: ﻩﺪﻨﻨﮐ-ﻩﺮﯿﺧ-ﺶﺑﺎﺗ, ﮏﺒﺳ, ﺶﺑﺎﺗ, ﻥﺩﺯ-ﻕﺮﺑ
ﺕﺩﺎﺴﺣ: ﺩﻮﺴﺣ
ﻦﻫﺁ-ﻩﺍﺭ: ﻦﻫﺁ-ﻩﺍﺭ, ﺭﺎﻄﻗ
ﺪﻧﻮﭘ: ﺏﺎﺘﮐ
ﯽﻗﺮﺷ: ﻕﺮﺷ
ﺪﻧﻭﺮﻬﺷ: ﯽﻧﺪﻣ
ﺎﯾﺭﺩ-ﻞﺣﺎﺳ: ﻞﺣﺎﺳ
ﺕﺎﯿﺻﻮﺼﺧ: ﺮﺼﻨﻋ, ﻪﺼﺨﺸﻣ, ﯽﮔﮋﯾﻭ
ﻩﺮﯿﺧﺫ: ﻆﻔﺣ, ﺏﺎﺘﮐ
ﺍﺪﺻ-ﻭ-ﺮﺳ: ﺍﺪﺻ-ﻭ-ﺮﺳ
ﺐﯿﺠﻋ: ﺐﻳﺮﻏ-ﻭ-ﺐﻴﺠﻋ
ﮓﺳ-ﺱﺭﺎﭘ: ﺮﺸﻗ, ﺖﺳﻮﭘ
ﺵﺮﯾﺬﭘ: ﯼﺪﻣﺁ-ﺵﻮﺧ, ﻝﻮﺻﻭ-ﻡﻼ﻿ﻋﺍ
ﺵﻮﺧ: ﺪﻨﯾﺎﺷﻮﺧﺎﻧ, ﻉﻮﻧ
ﯼﺭﺍﺪﯿﺑ: ﺭﺍﺪﯿﺑ
ﻥﺩﺮﻛ-ﻖﻴﻘﺤﺗ: ﻞﯿﻠﺤﺗ, ﻥﺩﺮﮐ-ﻮﺠﺘﺴﺟ
ﻩﺎﺷﺩﺎﭘ: ﺭﻮﺗﺍﺮﭙﻣﺍ, ﻩﺎﺷﺩﺎﭘ
ﺵﻮﭘ-ﻦﺗ: ﻪﭼﺭﺎﭘ, ﺱﺎﺒﻟ, ﺎﻫ-ﺱﺎﺒﻟ
ﯼﺭﺎﻤﯿﺑ: ﯼﺭﺎﻤﯿﺑ, ﺭﺎﻤﯿﺑ
ﯽﺧﻮﺷ: ﯽﺧﻮﺷ, ﺰﻨﻃ, ﻩﺪﻨﺧ
ﺢﯿﺿﻮﺗ: ﺢﯿﺿﻮﺗ
ﺰﻠﻓ: ﻥﺪﯿﺸﮐ-ﻮﺗﺍ, ﯽﻧﺪﻌﻣ
ﻞﺣ-ﻩﺍﺭ: ﺖﺑﺎﺛ, ﻢﯿﻤﺼﺗ, ﻩﺪﺑ-ﺏﺍﻮﺟ
ﺕﺎﯿﻧﺎﺧﺩ: ﺭﺎﮕﯿﺳ, ﺩﻭﺩ
ﺩﻮﺟﻭ: ﺭﺍﺰﺑﺍ, ﺪﺣﺍﻭ, ﺭﻮﻀﺣ, ﻥﺎﻣﺯﺎﺳ, ﺖﮐﺮﺷ, ﺺﺨﺷ
ﮎﺮﺗ: ﺖﻤﯾﺰﻋ, ﻥﺪﺷ-ﺕﺮﭘ, ﮎﺮﺗ, ﻦﺘﻓﺭ
ﯽﺨﻠﺗ-ﻪﺑ: ﺦﻠﺗ
ﺰﯿﻣﺁ-ﺢﻠﺻ: ﻡﺍﺭﺁ
ﺏﺮﻄﻀﻣ: ﺲﭘﺍﻮﻟﺩ
ﻦﻓ-ﻭ-ﺕﻮﻓ: ﻥﺩﺮﮐ-ﻡﺍﺪﺨﺘﺳﺍ-ﺯﻮﻣﺍ ﻮﻧ, ﺝﺁ, ﻖﻤﺣﺍ, ﯼﺭﺎﮐ-ﺖﺳﺩ, ﯼﺮﮔ-ﻪﻠﯿﺣ
ﯽﻟﺎﻣ: ﻝﻮﭘ, ﯼﺩﺎﺼﺘﻗﺍ
ﯼﺯﺎﺳ-ﻩﺩﺎﻣﺁ: ﻥﺩﺮﮐ-ﻩﺩﺎﻣﺁ
ﻪﺘﺳﻮﭘ: ﻑﻼ﻿ﻏ, ﺮﺸﻗ, ﺖﺳﻮﭘ
ﻪﻧﻻ﻿: ﻩﺪﻧﺯ, ﺰﯾﺮﭘ
ﺭﻮﺼﺗ: ﺭﻮﺼﺗ, ﻦﮐ-ﮎﺭﺩ, ﺮﮑﻓ
ﺏﺎﺼﺘﻧﺍ: ﯼﺩﺰﻣﺎﻧ, ﻩﺪﻋﻭ
ﯽﺸﮐﺍﻭ: ﺍﺭ, ﯽﺑﺎﯾﺯﺎﺑ, ﻦﺘﻓﺮﮔ
ﻊﻤﺷ: ﮏﺒﺳ, ﻡﻮﻣ
ﻡﺮﺟ: ﻪﻠﻤﺣ, ﻩﺰﺑ-؛ﺖﯾﺎﻨﺟ-؛ﻡﺮﺟ, ﻡﺮﺟ
ﻁﻮﻠﺨﻣ: ﻁﻮﻠﺨﻣ
ﻝﺪﻣ: ﻝﺎﺜﻣ
ﺺﻘﻧ: ﺶﻧﺯﺮﺳ, ﮎﻭﺮﭼ-ﻭ-ﻦﯿﭼ, ﯽﻧﺍﻮﺗﺎﻧ
ﺽﺍﺮﺘﻋﺍ: ﺮﻈﻧ-ﻑﻼ﻿ﺘﺧﺍ, ﺖﻔﻟﺎﺨﻣ, ﺾﻗﺎﻨﺗ
ﺕﺭﺎﻬﻣ: ﺮﻨﻫ, ﯼﺍ-ﻪﻓﺮﺣ-ﻭ ﯽﻨﻓ, ﺕﺭﺎﻬﻣ
ﯽﻬﺟﻮﺗ-ﯽﺑ: ﯽﺷﻮﭘ-ﻢﺸﭼ, ﻪﮐﻭﺮﺘﻣ, ﻑﺬﺣ, ﻢﯾﺮﺤﺗ
ﺎﻫ-ﻩﺩﺍﺩ: ﺕﺎﻋﻼ﻿ﻃﺍ
ﺡﻼ﻿ﺳ: ﺡﻼ﻿ﺳ, ﮓﻨﻔﺗ
ﯽﺗﺭﻮﺻ-ﮓﻧﺭ: ﺥﺮﺳ-ﻞﮔ
ﻩﺪﻨﻨﮐ-ﻩﺩﺎﻔﺘﺳﺍ: ﻩﺭﺎﺑ-ﺭﺩ, ﻊﻔﻨﯾﺫ
ﮒﺭﺰﺑ-ﺎﺑﺎﺑ: ﺪﺟ, ﻩﺪﺟ-ﺎﯾ-ﺪﺟ
null-ﺭﺍﺪﻘﻣ: ﺮﻔﺻ, ﯽﻟﺎﺧ
ﺪﯾﺪﺷ: ﺪﯾﺪﺷ
ﻕﺮﺑ: ﮏﯿﻧﻭﺮﺘﮑﻟﺍ, ﭻﯿﭘ, ﻥﺩﺯ-ﻕﺮﺑ
ﺵﺯﺭﻭ: ﯽﯾﺎﺠﺑﺎﺟ, ﻦﯾﺮﻤﺗ
ﺭﺩﻮﭘ: ﺭﺩﻮﭘ, ﮎﺎﺧ-ﻭ-ﺩﺮﮔ
ﯼﺰﯿﻣﺁ-ﮓﻧﺭ: ﺮﯾﻮﺼﺗ, ﻮﻠﺑﺎﺗ
ﺩﺎﯾﺮﻓ: ﺍﺪﺻ-ﻭ-ﺮﺳ, ﻮﻗﺎﭼ, ﻥﺩﺮﮐ-ﻪﯾﺮﮔ
ﻁﺎﯿﺘﺣﺍ-ﯽﺑ: ﺍﻭﺮﭘ-ﯽﺑ, ﯽﮕﻗﻼ﻿ﻋ-ﯽﺑ
ﻖﺘﺸﻣ: ﻖﺘﺸﻣ
ﻩﺎﮔﺭﺩ: ﺏﺭﺩ
ﺖﺣﺍﺭ: ﻩﺩﺎﺳ, ﯽﻠﻤﻋ, ﺖﺣﺍﺭ, ﯽﻧﺎﺳﺁ-ﻪﺑ, ﺐﺳﺎﻨﻣ
ﻞﯿﻤﯾﺍ: ﺖﺴﭘ-ﻩﺭﺍﺩﺍ, ﻪﻣﺎﻧ
ﮓﻧﺭ: ﮓﻧﺭ
ﻢﯿﻠﺴﺗ: ﺖﻨﺳ
ﺩﺎﺠﯾﺍ: ﻥﺩﺮﮐ-ﯽﻓﺮﻌﻣ, ﺩﺎﺠﯾﺍ, ﺖﺑﺎﺛ
ﻢﯾﻼ﻿ﻣ: ﻡﺮﻧ, ﮏﺒﺳ
ﮓﻧﺭﺩ-ﯽﺑ: ﺭﺎﺑ-ﮏﯾ, ﺐﺳﺎﻨﻣ
ﺶﺨﺑ: ﺶﺨﺑ
ﻦﺘﺷﺍﺩ-ﻕﺎﻘﺤﺘﺳﺍ: ﺵﺯﺭﺍ, ﻥﺪﺷ-ﻂﯾﺍﺮﺷ-ﺪﺟﺍﻭ
ﮎﺮﺗ: ﻪﮐﻭﺮﺘﻣ, ﻥﺪﺷ-ﺭﺍﺪﯾﺪﭘ, ﮎﺮﺗ, ﺐﻟﺎﻗ
ﻦﯿﻤﻀﺗ: ﻥﺩﺍﺩ-ﻥﺎﻨﯿﻤﻃﺍ, ﺖﻧﺎﻤﺿ
ﻪﻨﯿﯾﺁ: ﻪﺸﯿﺷ
ﺡﺮﻃ: ﻪﺌﻃﻮﺗ, ﺡﺮﻃ, ﻥﺎﺘﺳﺍﺩ
ﻻ﻿ﺎﺑ-ﻑﺮﻄﺑ: ﺶﯿﺑ
ﯽﺘﺣﺍﺭﺎﻧ-ﺎﺑ: ﻦﯿﮕﻤﻏ, ﻪﻧﺎﻔﺳﺎﺘﻣ
ﻦﺗﻭﺮﻓ: ﺞﯾﺍﺭ, ﻩﺩﺎﺳ, ﯽﻨﺗﻭﺮﻓ, ﻪﻓﺮﺻ-ﺎﺑ
ﺏﺎﻘﺸﺑ: ﻩﺎﮔﺩﺍﺩ, ﺍﺬﻏ, ﻥﺩﺭﻮﺧ
ﺺﻟﺎﺧ: ﺏﻭ, ﺺﻟﺎﺧ, ﺱﺪﻘﻣ
ﯽﻣﺮﮔ: ﻕﺎﯿﺘﺷﺍ, ﻡﺮﮔ
ﺭﺍﺮﻗ-ﻲﺑ: ﺲﭘﺍﻮﻟﺩ
ﻪﺑﺮﺠﺗ: ﻥﺎﺒﻠﺧ, ﻪﺑﺮﺠﺗ, ﻥﺩﺮﻛ-ﺵﻼ﻿ﺗ
ﺯﻭﺮﻣﺍ: ﺯﻭﺭ
ﻢﯿﻈﻋ: ﮎﺎﻨﺘﺸﺣﻭ, ﯽﻟﺎﻋ, ﻢﯿﻈﻋ, ﺭﺎﯿﺴﺑ
ﺩﻮﺒﻬﺑ: ﺕﺎﺣﻼ﻿ﺻﺍ, ﯼﺯﺎﺳﺯﺎﺑ, ﻦﺘﻓﺭ-ﺶﯿﭘ, ﺩﻮﺒﻬﺑ, ﺎﻔﺷ
ﻉﺍﺰﻧ: ﺮﻈﻧ-ﻑﻼ﻿ﺘﺧﺍ, ﻝﺪﺟ-ﻭ-ﺚﺤﺑ
ﻩﺭﺍﺰﮔ: ﺩﺎﻬﻨﺸﯿﭘ, ﻪﻠﻤﺟ
ﺪﯾﺎﺷ: ﺪﯾﺎﺷ, ﺖﺳﺍ-ﻪﺘﺴﻧﺍﻮﺗ
ﮓﻨﻔﺗ: ﮓﻨﻔﺗ
ﺮﭙﺳ: ﺖﻈﻓﺎﺤﻣ
ﻡﺍﺪﺨﺘﺳﺍ: ﻥﺩﺮﮐ-ﻩﺭﺎﺟﺍ, ﻥﺩﺮﮐ-ﻩﺩﺎﻔﺘﺳﺍ
ﻑﻼ﻿ﺧﺮﺑ: ﻒﻠﺘﺨﻣ
ﻦﺘﻓﺎﯾ-ﺩﻮﺒﻬﺑ: ﯽﯾﻮﺟ-ﻪﻓﺮﺻ, ﯽﺑﺎﯾﺯﺎﺑ, ﺩﻮﺒﻬﺑ
ﺮﺴﻤﻫ: ﻦﻫﺩ-ﺏﺁ, ﺭﺎﮑﻤﻫ, ﺖﺳﻭﺩ
ﻥﺩﺍﺩ-ﺐﯿﺗﺮﺗ: ﺐﯿﺗﺮﺗ, ﻥﺩﺮﮐ-ﯽﻧﻮﻧﺎﻗ, ﻪﺘﻓﺎﯾ-ﻥﺎﻣﺯﺎﺳ
ﻥﻮﯿﺴﯿﻤﮐ: ﻮﻠﺑﺎﺗ, ﻥﻮﯿﺴﯿﻤﮐ
ﻦﺴﻣ: ﯽﻤﯾﺪﻗ
ﺡﻭﺭ: ﺡﻭﺭ
ﯽﺣﻭ: ﻥﺎﯿﺑ
ﻦﺘﺧﺎﻨﺷ-ﺖﯿﻤﺳﺭ-ﻪﺑ: ﻥﺩﺮﮐ-ﺭﺍﺮﻗﺍ, ﺭﺍﺮﻗﺍ
ﺱﺭ-ﮎﺎﺧ: ﻞﮔ, ﻝﺎﺧ
ﻪﻨﺗ: ﻪﻠﯿﺒﻗ, ﻥﺍﺪﻤﭼ, ﻦﯿﺗﻮﭘ
ﺖﯾﺮﯾﺪﻣ: ﺖﯾﺮﯾﺪﻣ, ﯽﮔﺪﻨﻧﺍﺭ
ﻥﺪﻧﺍﺩﺮﮔﺯﺎﺑ: ﻆﻔﺣ, ﺖﺸﮔﺯﺎﺑ, ﺩﻮﺒﻬﺑ, ﯽﺑﺎﯾﺯﺎﺑ
ﺽﺍﺮﺘﻋﺍ: ﺖﻔﻟﺎﺨﻣ, ﺱﺭﺎﻣ
ﻩﺩﻮﺗ: ﻪﻟﺎﺑﺯ, ﻁﺮﺷ, ﺖﯿﻌﻤﺟ
ﻂﺳﻮﺘﻣ-ﺪﺣ-ﺭﺩ: ﻡﻭﺩ, ﻦﺘﺷﺍﺩ-ﺭﻮﻈﻨﻣ
ﻥﺩﺮﮐ-ﯽﺠﻫ: ﻥﻮﺴﻓﺍ, ﯽﺠﻫ
ﻪﻘﻄﻨﻣ: ﻩﺯﻮﺣ, ﯼﺍ-ﻪﻘﻄﻨﻣ, ﺢﻄﺳ
ﯽﻤﺳﺭ: ﯽﻤﺳﺭ
ﺮﮕﺸﯾﺍﺮﯾﻭ: ﻩﺪﻨﺴﯾﻮﻧ, ﺮﺷﺎﻧ
ﻥﺎﻋﺫﺍ: ﺭﺍﺮﻗﺍ, ﻥﺩﺮﮐ-ﺭﺍﺮﻗﺍ
ﻥﺎﻣﺭﺩ: ﻭﺭﺍﺩ, ﻥﺎﻣﺭﺩ, ﺖﺑﺎﺛ
ﻥﺩﺮﮐ-ﻝﺎﺒﻧﺩ: ﻦﺘﺧﺎﺳ-ﺎﻫﺭ, ﺭﻮﺘﯿﻧﺎﻣ, ﻥﺩﺮﮐ-ﺝﺮﺧ, ﻥﺩﺮﮐ-ﻝﺎﺒﻧﺩ
ﺐﻄﻗ: ﻒﺳﺎﺘﻣ, ﻥﻮﺘﺳ, ﻁﺮﻔﻣ, ﻑﺎﻧ
ﯽﺗﺎﯿﺣ: ﻡﺯﻻ﻿, ﻊﻃﺎﻗ, ﺪﯿﻠﮐ
ﺭﻮﻬﻤﺟ-ﺲﯿﺋﺭ: ﺮﺳ
ﺶﺨﺑ: ﻝﺎﺑ, ﯼﺍ-ﻪﻘﻄﻨﻣ, ﺶﺨﺑ
ﻢﻧﺎﺧ: 
ﻥﺩﺮﮐ-ﻖﯾﻮﺸﺗ: ﺐﻠﻗ, ﻕﺎﯿﺘﺷﺍ
ﻩﺪﺷ-ﻞﯾﺪﻌﺗ: ﯽﻘﻄﻨﻣ, ﺖﺳﺭﺩ, ﻪﯿﺟﻮﺗ
ﻥﺩﺮﮐ-ﻦﯿﺴﺤﺗ: ﺶﯾﺎﺘﺳ
ﻩﺩﺮﭘ-ﯽﺑ: ﺎﺤﯾﺮﺻ, ﻦﮐ-ﺯﺎﺑ, ﺡﺎﺘﺘﻓﺍ
ﺡﻼ﻿ﺻﺍ: ﻥﺩﺍﺩ-ﺮﯿﯿﻐﺗ, ﻕﺎﺒﻄﻧﺍ
ﯽﺸﯾﺎﻤﻧ: ﻡﺍﺭﺩ, ﯽﺸﯾﺎﻤﻧ
ﺎﻫ-ﻪﻠﭘ-ﺯﺍ: ﻻ﻿ﺎﺑ-ﺭﺩ, ﺮﺗﺪﺑ
ﻉﻮﻨﺘﻣ: ﻒﻠﺘﺨﻣ
ﻝﻭﺰﻧ: ﺖﻌﯿﺒﻃ
ﺕﺩﺎﺴﺣ: ﺩﻮﺴﺣ
ﺭﺎﺑ: ﻥﺯﻭ, ﺩﺍﮋﻧ, ﺭﺎﺑ, ﻪﻠﯿﺒﻗ
ﺮﻫﺎﻈﺗ: ﻥﺩﺮﮐ-ﻞﻌﺟ, ﻡﺍﺭﺩ
ﯽﻠﺧﺍﺩ: ﯽﻠﺧﺍﺩ
ﻩﺩﺮﭘ: ﻪﻧﺎﻧﺯ-ﺭﺩﺎﭼ, ﺶﯾﺎﻤﻧ-ﻪﺤﻔﺻ
ﻢﻟﺎﺳ: ﺖﻣﻼ﻿ﺳ
ﻢﻬﺒﻣ: ﻢﻬﺒﻣ, ﻥﺩﺍﺩ-ﺭﺍﺮﻗ-ﻉﺎﻌﺸﻟﺍ ﺖﺤﺗ
ﺰﮐﺮﻣ: ﺰﮐﺮﻣ
ﻪﻘﺑﺎﺴﻣ: ﻪﻘﺑﺎﺴﻣ
ﻥﺩﺍﺩ-ﺮﯿﯿﻐﺗ: ﻞﯾﺪﺒﺗ, ﻥﺩﺍﺩ-ﺮﯿﯿﻐﺗ, ﻥﺩﺮﮐ-ﻦﯾﺰﮕﯾﺎﺟ
ﯽﻟﺎﻤﺟﺍ-ﺮﻈﻧ: ﻩﺎﮕﻧ, ﺯﺍﺪﻧﺍ-ﻢﺸﭼ
ﯼﺭﺎﮐ-ﺩﺍﺩﺭﺍﺮﻗ: ﺖﺷﺍﺩﺩﺎﯾ, ﺐﯿﺗﺮﺗ, ﻦﺘﺷﺍﺩ-ﻪﮕﻧ, ﯼﺭﺎﮑﻤﻫ-ﺩﺍﺩﺭﺍﺮﻗ
ﻥﺩﺮﮐ-ﯽﯾﻮﺟ-ﻪﻓﺮﺻ: ﯽﯾﻮﺟ-ﻪﻓﺮﺻ, ﯼﺯﺎﺳ-ﻩﺮﯿﺧﺫ, ﺩﺎﺼﺘﻗﺍ-ﻢﻠﻋ
ﻪﺘﺷﺭ: ﺏﺎﻨﻃ, ﺮﯿﺠﻧﺯ, ﻢﯿﻈﻨﺗ
ﺐﯿﮐﺮﺗ: ﯽﻗﺎﻔﺗﺍ, ﻁﻮﻠﺨﻣ, ﻢﯿﻈﻨﺗ, ﻥﺩﺯ-ﮓﻧﺯ
ﺖﺷﺍﺩﺯﺎﺑ: ﻥﺩﺮﮐ-ﺖﻔﺳ, ﺭﻮﺼﺗ
ﺕﺭﺍﺮﺣ-ﻪﺟﺭﺩ: ﻡﺮﮔ
ﺖﺨﺳ: ﺍﺪﮐﻮﻣ, ﺰﯿﺗ, ﺖﺨﺳ
ﯽﺼﺼﺨﺗ: ﻪﻓﺮﺣ, ﯼﺍ-ﻪﻓﺮﺣ-ﻭ ﯽﻨﻓ
ﺡﻭﺮﺠﻣ: ﺡﻭﺮﺠﻣ, ﯽﮔﺪﯾﺩ-ﺐﯿﺳﺁ
ﯽﮕﯾﺎﺴﻤﻫ: ﻑﺍﺮﻃﺍ, ﻩﺪﻧﺯ, ﯽﻄﯿﺤﻣ-ﺖﺴﯾﺯ
ﻥﺪﯿﺸﮐ-ﺭﺎﮕﯿﺳ: ﺩﻭﺩ, ﺭﺎﮕﯿﺳ
ﯽﮑﺷﺰﭘ: ﺮﺘﮐﺩ
ﻥﺩﺮﮐ-ﻩﺎﮔﺁ: ﻪﻣﺎﻧﺯﻭﺭ
ﻪﺘﺴﺟﺮﺑ: ﺪﻨﺴﭘ-ﻪﻣﺎﻋ, ﻲﻧﺪﻧﺎﻣ-ﺩﺎﻳ-ﻪﺑ, ﻢﻬﻣ, ﺪﯿﻠﮐ, ﻡﺎﻨﮑﯿﻧ
ﻪﺴﺳﻮﻣ: ﻪﺘﻓﺎﯾ-ﻥﺎﻣﺯﺎﺳ, ﺖﮐﺮﺷ, ﻥﺎﻣﺯﺎﺳ
ﻪﺘﺴﺑ: ﻥﺩﺮﮐ-ﯼﺪﻨﺑ-ﻪﺘﺴﺑ, ﻪﺘﺴﺑ, ﯼﺪﻨﺑ-ﻪﺘﺴﺑ
ﻩﻭﺪﻧﺍ-ﻭ-ﻢﻏ: ﺦﻠﺗ, ﯽﺘﺨﺑﺪﺑ, ﺩﺭﺩ, ﻩﻭﺪﻧﺍ-ﻭ-ﻢﻏ
ﺺﺨﺸﻣ-ﺭﻮﻃ-ﻪﺑ: ﺩﻮﻬﺸﻣ, ﻦﮐ-ﺯﺎﺑ, ﺎﺤﯾﺮﺻ
ﻦﺘﻓﺮﮔ: ﻥﺩﺮﮐ-ﺮﯿﺳﺍ, ﻦﺘﻓﺮﮔ, ﺭﻮﺼﺗ
ﻥﺍﻭﺍﺮﻓ: ﯽﻓﺎﮐ, ﻩﺪﻨﺴﺑﺎﻧ
ﺏﺍﻮﺧ-ﻕﺎﺗﺍ: ﻕﺎﺗﺍ
ﺎﻓﺮﺻ: ﻂﻘﻓ, ﻼ﻿ﻣﺎﮐ, ﺱﺪﻘﻣ
ﮎﺮﺘﺸﻣ: ﺞﯾﺍﺭ, ﻁﻮﻠﺨﻣ, ﻥﺩﺯ-ﮓﻧﺯ
ﺪﯿﻨﮐ-ﻪﻌﺟﺍﺮﻣ: ﯽﻋﺎﺟﺭﺍ, ﺕﺭﻮﺸﻣ
ﯽﯾﺎﺳﺎﻨﺷ: ﺖﯾﻮﻫ, ﯽﯾﺎﺳﺎﻨﺷ-ﻞﺑﺎﻗ, ﺖﺑﺎﺛ
ﺖﮑﻤﯿﻧ: ﮏﻧﺎﺑ
ﺕﺎﺠﻧ-ﻭ-ﺩﺍﺪﻣﺍ: ﺩﻮﺒﻬﺑ, ﯽﯾﻮﺟ-ﻪﻓﺮﺻ
ﺪﺣ: ﻥﺍﺮﮐ, ﻥﺩﺮﮐ-ﻩﺎﺗﻮﮐ
ﺭﺎﻈﺘﻧﺍ: ﺭﺎﻈﺘﻧﺍ
ﻪﻣﺎﻧﺮﺑ: ﺡﺮﻃ, ﻪﺴﻠﺟ-ﺭﻮﺘﺳﺩ
ﯽﻗﺮﺑ: ﮏﯿﻧﻭﺮﺘﮑﻟﺍ
ﻩﺯﺎﺑ: ﺖﻗﻮﻣ, ﺢﻳﺮﻔﺗ-ﮓﻧﺯ
ﺐﯿﻘﻌﺗ: ﺪﯿﺻ
ﻝﺎﻐﺷﺍ: ﻦﺘﻓﺮﮔ, ﻥﺩﺮﮐ-ﺐﺣﺎﺼﺗ
ﺐﺷ-ﺱﺎﺒﻟ: ﺖﮐ, ﺱﺎﺒﻟ, ﺖﺳﺍﻮﺧﺩﺍﺩ
ﻞﻔﻗ: ﻪﻌﻠﻗ
ﯼﺩﺎﻬﻨﺸﯿﭘ-ﺡﺮﻃ: ﺩﺎﻬﻨﺸﯿﭘ, ﻪﻠﻤﺟ, ﺡﺮﻃ, ﻪﺠﯿﺘﻧ
ﯽﻟﺎﺤﺷﻮﺧ-ﺎﺑ: ﻝﺎﺤﺷﻮﺧ
ﺐﻗﺎﻌﺘﻣ: ﺪﻌﺑ
ﺏﺮﻄﻀﻣ: ﻥﺍﺯﺮﻟ, ﺪﻨﯾﺎﺷﻮﺧﺎﻧ, ﺲﭘﺍﻮﻟﺩ, ﺖﺨﺳ
ﺶﺸﺧﺭﺩ: ﻩﺪﻨﻨﮐ-ﻩﺮﯿﺧ-ﺶﺑﺎﺗ, ﻥﺩﺯ-ﻕﺮﺑ
ﻩﺎﮕﺘﺳﺩ: ﯽﮑﯿﻧﺎﮑﻣ, ﻦﯿﺷﺎﻣ, ﻡﺰﯿﻧﺎﮑﻣ
ﺏﺍﺬﺟ: ﯽﺴﯿﻃﺎﻨﻐﻣ, ﻢﺳﺭ, ﺏﻮﻠﻄﻣ
ﻝﻮﺼﺤﻣ: ﺕﻻ﻿ﻮﺼﺤﻣ
ﯼﺭﺎﻤﯿﺑ: ﯼﺭﺎﻤﯿﺑ
ﺭﻮﺗﻮﻣ: ﺭﻮﺗﻮﻣ, ﻦﯿﺷﺎﻣ
ﯽﻧﺎﻣﺩﻮﺧ: ﺎﻬﻧﺁ
ﻡﺮﭼ: ﺖﺳﻮﭘ
ﻒﯿﻄﻟ: ﮏﭼﻮﮐ, ﺮﻏﻻ﻿
ﺐﯿﺷ: ﻞﯾﺎﻣ, ﺐﯿﺷ, ﻩﺪﺷ-ﻢﺧ
ﻥﺩﻮﺑ-ﻥﺍﺮﮕﻧ: ﺲﭘﺍﻮﻟﺩ, ﯽﮕﺘﻔﯿﺷ
ﺖﻧﻮﺸﺧ: ﺖﺨﺳ
ﻩﺪﺷ-ﻦﯿﯿﻌﺗ: ﺺﺨﺸﻣ
ﺏﻮﭼ: ﯽﺑﻮﭼ, ﺏﻮﭼ, ﺖﺧﺭﺩ
ﻥﺩﺮﻛ-ﺏﺎﺴﺣ: ﻪﺒﺳﺎﺤﻣ, ﻥﺩﺮﻤﺷ
ﻞﺘﻗ: ﻦﺘﺸﮐ
ﺭﺍﺩ-ﻩﺪﻨﺧ: ﺐﻳﺮﻏ-ﻭ-ﺐﻴﺠﻋ, ﺭﺍﺩ-ﻩﺪﻨﺧ
ﻥﺩﺮﻛ-ﻦﻴﻫﻮﺗ: ﺮﯿﻘﺤﺗ, ﻡﺮﺷ
ﻥﺍﻮﺗﺎﻧ: ﺭﺩﺎﻗ
ﻥﺩﺭﻮﺧ-ﺭﺎﻫﺎﻧ: ﻥﺩﺭﻮﺧ
ﺱﺎﺴﺣ: ﺱﺎﺴﺣ, ﺪﯿﻠﮐ
ﺎﻬﺘﺷﺍ: ﻦﺘﺷﺍﺩ-ﻞﻳﺎﻤﺗ
ﻊﺿﺍﻮﺗ: ﺏﺩﺍ-ﺎﺑ, ﺭﺎﺨﺘﻓﺍ
ﻩﺮﮐ: ﻩﺯﻮﺣ, ﭖﻮﺗ, ﯼﺍ-ﻪﻘﻄﻨﻣ
ﯽﻠﯿﻠﺠﺗ: ﺭﺎﺨﺘﻓﺍ
ﻩﺎﻨﮔ: ﺭﺎﮑﻫﺎﻨﮔ, ﻩﺰﺑ-؛ﺖﯾﺎﻨﺟ-؛ﻡﺮﺟ, ﺶﻧﺯﺮﺳ, ﻩﺎﻨﮔ
ﺬﯾﺬﻟ---ﻩﺰﻤﺷﻮﺧ: ﻢﻌﻃ-ﺵﻮﺧ, ﻢﻌﻃ
ﻡﺪﻨﮔ-ﻪﺷﻮﺧ: ﻪﻣﺎﻋ-ﮓﻨﻫﺮﻓ, ﺕﻼ﻿ﻏ, ﺕﺭﺫ
ﯽﻌﺒﻃ-ﺥﻮﺷ: ﯽﻌﺒﻃ-ﺥﻮﺷ
ﺩﺭﻮﺧﺮﺑ: ﻪﻠﺑﺎﻘﻣ, ﺕﺎﻗﻼ﻿ﻣ, ﺦﯾﺭﺎﺗ
ﺶﯿﻣ-ﻭ-ﮒﺮﮔ: ﻡﺩ-ﻩﺪﯿﭙﺳ
ﮎﺭﺎﭘ: ﻍﺎﺑ
ﺩﺎﺼﺘﻗﺍ: ﯼﺩﺎﺼﺘﻗﺍ, ﺩﺎﺼﺘﻗﺍ-ﻢﻠﻋ
ﻥﺩﺮﮐ-ﺖﻣﻮﮑﺣ: ﺖﯾﺮﯾﺪﻣ, ﻥﻮﻧﺎﻗ, ﺩﺎﺘﺳﺍ
ﻞﯿﮑﺸﺗ: ﺕﻼ﻿ﯿﺼﺤﺗ, ﯼﺪﻨﺑ-ﻝﻮﻣﺮﻓ
ﺮﻏﻻ﻿: ﻞﯾﺎﻣ, ﺮﻏﻻ﻿
ﻥﺩﺯ-ﺭﺩ: ﻎﯾﺭﺩ, ﻪﺑ-ﻥﺩﺯ-ﺖﺳﺩ ﻪﺘﺴﻫﺍ, ﻢﺘﺷ-ﻭ-ﺏﺮﺿ
ﺕﺪﺣﻭ: ﺪﺤﺘﻣ, ﺪﺣﺍﻭ, ﯽﮕﺘﺴﺒﻤﻫ
ﮒﺭﺰﺑ: ﻡﺎﮕﺸﯿﭘ, ﺪﯿﻠﮐ, ﻦﯾﺪﻟﺍﻭ, ﯽﻟﺎﻋ, ﯼﺰﯿﭼ-ﺮﻫ-ﯽﻠﺻﺍ ءﺰﺟ
ﯽﺗﺎﻣﺪﻘﻣ: ﺡﺎﺘﺘﻓﺍ, ﯽﻠﺻﺍ
ﺯﺮﻣ: ﻥﺍﺮﮐ, ﻪﺒﻟ
ﻥﺪﯿﺸﮐ-ﺲﻔﻧ: ﺲﻔﻧ
ﻑﺎﻌﻣ: ﻥﺩﺮﮐ-ﺩﺍﺯﺁ, ﺮﺷ-ﺯﺍ-ﻥﺪﺷ ﺹﻼ﻿ﺧ, ﺶﺨﺒﺑ
ﺪﻨﻤﺗﻭﺮﺛ: ﺪﻨﻤﺗﻭﺮﺛ
ﻡﺎﻬﻟﺍ: ﻪﺑ-ﻥﺩﺍﺩ-ﻩﺰﯿﮕﻧﺍ, ﻥﺪﯿﺸﺨﺑ-ﻡﺎﻬﻟﺍ
ﺲﮐ-ﺮﻫ: ﻪﻤﻫ
ﻥﺍﻭﺍﺮﻓ: ﺪﻨﻤﺗﻭﺮﺛ
ﺵﺎﻘﻧ: ﺪﻨﻣﺮﻨﻫ
ﮏﻨﯿﻋ: ﻪﺸﯿﺷ
ﯼﺯﺍﺪﻧﺍﺮﯿﺗ: ﺲﮑﻋ, ﺪﯿﺻ
ﻦﮔﺍﻭ: ﺭﺎﻄﻗ, ﯽﻗﺮﺑ-ﻦﮔﺍﻭ
ﻥﺩﺍﺩ-ﺽﺮﻗ: ﻥﺩﺍﺩ, ﺭﺎﺒﺘﻋﺍ, ﻝﻮﻗ-ﻞﻘﻧ
ﻦﺘﻓﺮﮔ-ﻩﺪﻬﻌﺑ: ﻉﻭﺮﺷ, ﻡﺎﺠﻧﺍ
ﯽﺑﺍ-ﮎﻮﺧ: ﻪﻘﻠﺣ
ﻥﻮﯿﻧﺎﺣﻭﺭ: ﺶﯿﺸﮐ
ﻩﻮﮐ: ﻥﺩﺮﮐ-ﺐﺼﻧ, ﻥﺩﺍﺩ-ﺶﯾﺍﺰﻓﺍ, ﻪﭙﺗ
ﻪﯾﺍﺭﺁ: ﻥﻮﺘﺳ, ﻢﯿﻈﻨﺗ, ﺐﯿﺗﺮﺗ
ﻪﻠﺠﻣ: ﺕﺎﻋﻮﺒﻄﻣ
ﻦﺸﺧ: ﺖﺨﺳ, ﺍﺪﮐﻮﻣ
ﺩﻮﺟﻭ-ﺎﺑ: ﻪﭼﺮﮔ
ﮓﻨﺗ: ﺍﺪﮐﻮﻣ
ﺯﺍﺪﻧﺍ-ﻢﺸﭼ: ﻮﯾﺭﺎﻨﺳ, ﯽﻄﯿﺤﻣ-ﺖﺴﯾﺯ, ﺯﺍﺪﻧﺍ-ﻢﺸﭼ
ﻥﺩﺮﮐ-ﮎﺮﺗ: ﻪﮐﻭﺮﺘﻣ
ﻪﻧﺍﺪﻨﻣﺮﻨﻫ: ﺮﻨﻫ
ﻩﺪﻤﻋ-ﺭﻮﻃ-ﻪﺑ: ﺹﻮﺼﺨﺑ, ﯼﺩﺎﯾﺯ-ﺪﺣ-ﺎﺗ
ﺭﺍﺩﺎﻓﻭ: ﯼﺭﺍﺩﺎﻓﻭ, ﻕﺩﺎﺻ, ﻥﺎﻤﯾﺍ-ﺎﺑ
ﺐﺳﺎﻨﻣ: ﺲﻧﺎﺠﺘﻣ, ﻥﺪﺷ-ﻑﺩﺎﺼﻣ, ﺐﺳﺎﻨﻣ
ﻪﯿﺻﻮﺗ: ﺖﺤﯿﺼﻧ, ﺭﻭﺎﺸﻣ
ﺕﺎﺒﺛ-ﺎﺑ: ﺩﺎﺠﯾﺍ, ﺺﺨﺸﻣ, ﺩﺭﺍﺪﻧﺎﺘﺳﺍ
ﻦﯾﺮﺘﺸﯿﺑ: ﻦﺘﺧﺎﺳ-ﻪﻨﯿﺸﯿﺑ, ﻁﺮﻔﻣ
ﺐﮑﺗﺮﻣ: ﻩﺪﻋﻭ, ﻡﺎﺠﻧﺍ
ﺩﺭﺍﺬﮔ-ﯽﻣ-ﺮﯿﺛﺎﺗ: ﺮﺛﺍ, ﻦﺘﺷﺍﺬﮔ-ﺮﯿﺛﺎﺗ
ﯽﻧﺎﻘﻫﺩ: ﺭﺍﺩ-ﻪﻋﺭﺰﻣ
ﯽﻬﺟﻮﺗ-ﻞﺑﺎﻗ-ﺭﻮﻄﺑ: ﺭﺎﯿﺴﺑ, ﻢﻬﻣ
ﻥﺩﺮﻛ-ﺪﻳﺪﻤﺗ: ﺕﺎﯿﺋﺰﺟ, ﻥﺩﺮﮐ-ﻦﻬﭘ, ﻂﺴﺑ
ﺎﺼﺨﺷ: ﻪﻧﺎﮔﺍﺪﺟ-ﺭﻮﻃ-ﻪﺑ, ﯽﺻﻮﺼﺧ, ﺩﻮﺧ
ﻕﻼ﻿ﺧﺍ: ﯽﻗﻼ﻿ﺧﺍ
ﺵﺭﻮﺷ: ﯽﺷﺭﻮﺷ, ﺏﻼ﻿ﻘﻧﺍ
ﺦﻧ: ﻂﺧ, ﺶﺧﺮﭼ
ﺲﻣ-ﺰﻠﻓ: ﺞﻧﺮﺑ-ﺰﻠﻓ
ﺦﺳﺎﭘ: ﻞﻤﻌﻟﺍ-ﺲﻜﻋ, ﻩﺪﺑ-ﺏﺍﻮﺟ
ﯼﺭﻮﺗﺍﺮﭙﻣﺍ: ﯽﺘﻨﻄﻠﺳ
ﯽﻟﺎﺧ-ﯼﺎﺟ: ﯽﻟﺎﺧ, ﯽﻟﺎﺧﻮﺗ, ﺪﯿﻔﺳ
ﯽﺋﺰﺟ: ﻡﻭﺩ, ﯽﻤﮐ-ﺭﺍﺪﻘﻣ, ﺶﯿﺧ
ﻪﻠﻣﺎﻌﻣ: ﺕﺭﺎﺠﺗ, ﺖﺒﺳﺎﻨﻣ
ﯽﮕﺘﺴﺧ: ﻪﺘﺴﺧ, ﺩﺍﮋﻧ
ﻦﺘﺷﺍﺪﻧ-ﺖﺳﻭﺩ: ﺮﯿﻘﺤﺗ, ﺕﺮﻔﻧ, ﯽﻠﯿﻣ-ﯽﺑ
ﯽﻌﯿﺒﻃ: ﺞﯾﺍﺭ
ﺡﺮﻃ: ﯽﻠﮐ-ﺡﺮﻃ, ﺡﺮﻃ
ﺖﻠﯿﻀﻓ-ﺎﺑ: ﺍﻮﻘﺗ
ﻝﺎﺣ-ﺮﻫ-ﻪﺑ: ﺩﻮﺟﻭ-ﻦﯾﺍ-ﺎﺑ, ﻼ﻿ﺒﻗ
ﻩﺪﻨﻧﺍﺭ: ﻥﺎﮔﺪﻨﻧﺍﺭ, ﯽﮔﺪﻨﻧﺍﺭ, ﺮﺘﺴﮐﺭﺍ-ﺮﺒﻫﺭ
ﻡﻼ﻿ﻋﺍ: ﺩﻼ﻿ﯿﻣ-ﺯﺍ-ﺪﻌﺑ
ﺩﺍﺯﺎﻣ: ﯽﻓﺎﺿﺍ, ﯽﮕﻧﻭﺰﻓﺍ
ﯽﯾﺍﺪﺟ: ﯽﯾﺍﺪﺟ, ﻪﻠﺻﺎﻓ, ﻢﻫ-ﺯﺍ-ﺍﺪﺟ
ﺭﺎﺟﺰﻧﺍ: ﺮﯿﻘﺤﺗ, ﺭﺎﺟﺰﻧﺍ, ﺕﺮﻔﻧ
ﯽﺘﺳﺭﺩ: ﻥﺎﺴﮑﯾ, ﺐﺳﺎﻨﻣ
ﺖﯿﻌﻤﺟ: ﺖﯿﻌﻤﺟ, ﻡﺮﺟ
ﯼﺭﻭﺮﺿ-ﺮﯿﻏ: ﯽﻨﺘﺨﯾﺭ-ﺭﻭﺩ, ﺪﯾﺎﺑ
ﺰﺧ: ﺖﺳﻮﭘ, ﺖﮐ
ﻥﺩﺮﻛ-ﻖﻳﻮﺸﺗ: ﻥﺪﯿﺸﺨﺑ-ﻡﺎﻬﻟﺍ, ﺭﺎﺸﻓ
ﻡﺍﺮﺘﺣﺍ: ﻥﺩﺮﮐ-ﻩﺭﺎﺟﺍ
ﻥﺩﺮﺑ-ﻦﯿﺑ-ﺯﺍ: ﻥﺩﺍﺩ-ﺶﻫﺎﻛ, ﺮﺷ-ﺯﺍ-ﻥﺪﺷ ﺹﻼ﻿ﺧ, ﺶﺨﺒﺑ
ﻥﻮﻧﺎﻗ: ﻥﺩﺮﮐ-ﯽﻧﻮﻧﺎﻗ, ﻥﻮﻧﺎﻗ, ﻪﻨﻨﻘﻣ-ﻩﻮﻗ
ﻩﮊﻭﺮﭘ: ﺡﺮﻃ
ﯼﺮﭘ-ﻭ-ﻦﺟ: ﻪﺘﺷﺮﻓ, ﯽﺑﺁ, ﻼ﻿ﯾﻭ
ﻦﺘﻓﺮﮔ-ﻪﺠﯿﺘﻧ: ﻦﺘﺷﺍﺩ-ﻪﮕﻧ, ﻪﺠﯿﺘﻧ
ﺲﻧﺎﺷ-ﺵﻮﺧ: ﻝﺎﺤﺷﻮﺧ
ﻥﺩﺮﮐ-ﭗﻠﺷ-ﭗﻠﺷ: ﻮﻧﺍﺯ, ﺪﻨﺒﺸﯿﭘ, ﺩﺮﮔ
ﻥﺩﺮﺑ-ﻦﯿﺑ-ﺯﺍ: ﺕﺭﺎﻏ, ﯽﻫﺎﺒﺗ, ﻥﺩﺮﮐ-ﻪﻄﺴﻔﺳ
ﻝﻮﺌﺴﻣ: ﯽﻧﺎﺳﺁ-ﻪﺑ, ﻞﯾﺎﻤﺗ, ﺱﺎﺴﺣ
ﺮﮑﻔﺘﻣ: ﻖﯿﻗﺩ, ﺲﭘﺍﻮﻟﺩ, ﺎﻧﺍﺩ
ﺏﻮﻠﻄﻣ: ﺲﻧﺎﺠﺘﻣ, ﻥﺩﺮﮐ-ﻢﺧ, ﺏﻮﻠﻄﻣ
ﻊﻠﻗ: ﮏﻧﺎﺑ
ﻪﺘﺴﺑﺍﻭ: ﯽﮕﺘﺴﺑﺍﻭ, ﻪﺘﺴﺑﺍﻭ, ﺪﻨﻣﺭﺎﮐ
ﻢﮑﺣ: ﻥﺩﺍﺩ-ﻥﺎﻨﯿﻤﻃﺍ, ﻪﯿﺟﻮﺗ, ﺖﺷﺍﺩﺩﺎﯾ
ﺖﯾﺎﮑﺷ: ﺪﯿﻔﺳ
ﺩﺍﺩﺭﺍﺮﻗ: ﺖﺷﺍﺩﺩﺎﯾ, ﯼﺭﺎﮑﻤﻫ-ﺩﺍﺩﺭﺍﺮﻗ
ﻪﯾﻭﺍﺯ: ﻪﺷﻮﮔ, ﯽﻌﻠﺿ-ﺪﻨﭼ
ﻩﺩﺮﺘﺴﮔ-ﺭﻮﻃ-ﻪﺑ: ﻩﺩﺮﺘﺴﮔ, ﺭﺎﯿﺴﺑ, ﯽﻠﮐ-ﺭﻮﻄﺑ, ﯼﺩﺎﯾﺯ-ﺪﺣ-ﺎﺗ
ﻭﺎﮔ: ﻭﺎﮔ
ﺐﺼﻌﺗ: ﺕﺮﻔﻧ
ﻥﺍﻮﯾﺍ: ﻦﻟﺎﺳ, ﻦﮑﻟﺎﺑ
ﻩﺪﻨﻨﮐ-ﺮﯿﮕﻠﻓﺎﻏ: ﺐﻳﺮﻏ-ﻭ-ﺐﻴﺠﻋ, ﻥﺩﺮﮐ-ﺕﺎﻣ, ﻥﺩﺮﮐ-ﺮﯿﮕﻠﻓﺎﻏ, ﻪﺟﻮﺗ-ﻞﺑﺎﻗ
ﺎﻤﻨﺑﺁ: ﻊﺒﻨﻣ
ﺐﺳﺎﻨﻣ: ﺐﺳﺎﻨﻣ, ﺖﺳﺍﻮﺧﺩﺍﺩ, ﺭﺍﻮﺘﺳﺍ
ﻦﺌﻤﻄﻣ: ﺖﻋﺎﺠﺷ, ﺮﻄﺧ-ﯽﺑ, ﻦﺘﺷﺍﺩ-ﺩﺎﻘﺘﻋﺍ
ﻮﻀﻋ: ﺭﺍﺰﺑﺍ, ﻮﻀﻋ, ﺮﺼﻨﻋ, ﻥﺪﺑ
ﺏﺎﺨﺘﻧﺍ: ﻥﺩﺮﻛ-ﺏﺎﺨﺘﻧﺍ, ﯼﺩﺰﻣﺎﻧ, ﺏﺎﺨﺘﻧﺍ
ﺖﺒﯿﻫ: ﺭﺎﺟﺰﻧﺍ, ﺱﺮﺗ
ﻥﺩﺮﻛ-ﻪﺴﻳﺎﻘﻣ: ﻪﺴﯾﺎﻘﻣ
ﻁﺎﺒﺗﺭﺍ: ﻥﺩﺮﮐ-ﺖﻔﺳ, ﺏﻼ﻿ﻗ, ﻂﺑﺍﻭﺭ, ﻩﺍﺮﻤﻫ
ﺽﺮﻓ: ﻦﺘﺷﺍﺩ-ﺩﺎﻘﺘﻋﺍ, ﻥﺰﺑ-ﺱﺪﺣ, ﺪﯿﻨﮐ-ﺽﺮﻓ, ﻪﺟﻮﺗ
ﻢﮔ: ﻩﺪﺷ-ﻢﮐ
ﺯﻭﺭ-ﺪﻣ: ﻥﺭﺪﻣ, ﺎﺒﯾﺯ
ﺖﺒﺜﻣ: ﺖﺒﺜﻣ
ﻝﻻ﻿ﺪﺘﺳﺍ: ﻪﺸﯾﺪﻧﺍ, ﻝﺪﺟ-ﻭ-ﺚﺤﺑ
ﻥﺪﺷ-ﻢﺣﺍﺰﻣ: ﯽﺒﺼﻋ, ﺰﯿﻣﺁ-ﺖﻧﻮﺸﺧ, ﻥﺩﺮﮐ-ﻪﻠﺧﺍﺪﻣ, ﻩﺪﻨﻫﺩ-ﺭﺍﺯﺁ
ﮏﯾﺮﺷ: ﺮﺘﺧﺩ-ﺖﺳﻭﺩ, ﺞﯾﺍﺭ, ﻥﺍﺭﺍﺪﻣﺎﻬﺳ
ﻦﻤﺠﻧﺍ: ﯽﮕﺘﺳﻮﯿﭘ, ﻪﺟﻮﺗ
ﻩﺩﺍﺯ-ﺮﻫﺍﻮﺧ: ﺭﺩﺍﺮﺑ-ﺎﯾ-ﺮﻫﺍﻮﺧ ﺮﺴﭘ, ﻩﻮﻧ
ﯽﻧﺪﺑ: ﯽﮑﯾﮊﻮﻟﻮﯾﺰﯿﻓ, ﻥﺪﺑ
ﻩﺪﮑﺸﻧﺍﺩ: ﺞﻟﺎﮐ, ﻞﯾﺭﻮﺘﮐﺎﻓ
ﭖﻮﺗ: ﭖﻮﺗ, ﻪﻧﺎﺨﭘﻮﺗ, ﮓﻨﻔﺗ
ﯽﻧﺍﺮﯿﺘﺸﮐ: ﯽﺘﺸﮐ, ﻪﻧﺎﻧﺯ-ﺭﺩﺎﭼ
ﺪﻨﻤﺷﻮﻫ: ﺎﻧﺍﺩ
ﺩﺮﺧ: ﻪﻘﻠﺣ, ﯽﻬﯾﺪﺑ, ﯽﻤﮐ-ﺭﺍﺪﻘﻣ
ﻁﺎﯿﺘﺣﺍ: ﺭﺍﺪﺸﻫ, ﻥﺩﺍﺩ-ﺖﻴﻤﻫﺍ
ﯽﻄﺧ-ﻪﺨﺴﻧ: ﻪﺤﯾﻻ﻿
ﻮﺠﮕﻨﺟ: ﻥﺎﻣﺮﻬﻗ
ﻊﯾﺎﻣ: ﺏﺍ
ﻡﻮﻬﻔﻣ: ﺭﻮﺼﺗ, ﯽﻨﻤﺿ-ﺖﻟﻻ﻿ﺩ
ﻩﮋﻳﻭ-ﻪﺑ: ﺹﻮﺼﺨﺑ
ﺵﺮﭘ: ﺯﺍﻭﺮﭘ, ﺺﻗﺭ, ﻪﻨﺷﺎﭘ, ﯽﯾﻮﮔ-ﻑﺍﺰﮔ
ﻞﯿﻣ-ﯽﺑ: ﺪﺼﻗ
ﯽﻓﺎﺿﺍ: ﯽﻓﺎﺿﺍ
ﺮﯿﻗ: ﻭﺭ-ﻩﺩﺎﻴﭘ, ﻦﺤﻟ, ﻪﻧ
ﺎﭘ-ﻭ-ﺖﺳﺩ ﯽﺑ: ﻩﺪﻨﺴﺑﺎﻧ, ﺐﻳﺮﻏ-ﻭ-ﺐﻴﺠﻋ
ﯽﻧﺍﺩﺭﺪﻗ: ﻥﺩﺯ-ﻒﮐ, ﺪﯾﺮﺒﺑ-ﺕﺬﻟ
ﻥﺪﻧﺎﻣ-ﻩﺪﻧﺯ: ﻩﺪﻧﺯ, ﻥﺩﺮﮐ-ﺖﻣﺎﻗﺍ
ﻪﺻﻼ﻿ﺧ-ﺕﺭﻮﺻ-ﻪﺑ: ﻒﻔﺨﻣ, ﻩﺎﺗﻮﮐ-ﺪﻗ
ﺞﻧﺮﺑ: ﺞﻧﺮﺑ-ﺰﻠﻓ
ﺩﺮﻣ: ﺺﺨﺷ
ﺭﺎﺘﻓﺭ: ﻪﺼﺨﺸﻣ, ﺭﺎﺘﻓﺭ
ﺫﺎﺨﺗﺍ: ﺪﯿﻨﮐ-ﺽﺮﻓ, ﻦﺘﻓﺮﮔ
ﺐﺗﺮﻣ-ﺭﻮﻃ-ﻪﺑ: ﻊﻗﺍﻮﻣ-ﺮﺘﺸﯿﺑ, ﺭﺮﮑﻣ, ﻲﻤﺋﺍﺩ, ﺐﺳﺎﻨﻣ
ﯽﺳﺭﺮﺑ-ﻭ-ﻖﯿﻘﺤﺗ: ﺮﮕﺷﻭﺎﮐ, ﻥﺩﺮﮐ-ﻮﺠﺘﺴﺟ
ﻪﻃﻭﺮﺸﻣ: ﻲﺳﺎﺳﺍ-ﻥﻮﻧﺎﻗ
ﻦﯾﺮﺧﺁ: ﻪﺘﺷﺬﮔ
ﺩﺮﮔﺎﺷ: ﻮﺠﺸﻧﺍﺩ
ﻼ﻿ﻣﺎﮐ: ﻼ﻿ﻣﺎﮐ
ﻩﺩﺭﻮﺧ-ﭻﯿﭘ: ﻩﺪﺷ-ﻢﺧ
ﻦﺘﺷﺍﺩ-ﺕﻭﺎﻔﺗ: ﻢﻫ-ﺯﺍ-ﺍﺪﺟ, ﺕﻭﺎﻔﺗ, ﻒﻠﺘﺨﻣ
ﻪﻌﺟﺎﻓ: ﯽﻫﺎﺒﺗ
ﻁﺮﺷ: ﻁﺮﺷ, ﺖﯿﻌﺿﻭ, ﺩﺭ
ﻡﺎﺧ: ﻩﺪﻧﺯ, ﻊﺒﻨﻣ, ﺖﺷﺭﺩ, ﺰﺒﺳ
ﻢﺘﺴﯿﺳ-ﻪﺑ-ﺩﻭﺭﻭ: ﻥﺪﺷ-ﻞﺧﺍﺩ, ﺖﺒﺛ, ﻩﺎﮕﺷﺎﺑ
ﻱﺯﺍﻮﻧ-ﻥﺎﻤﻬﻣ: ﻩﺪﻨﺸﺨﺑ
ﯼﺭﺎﮔ: ﺭﺎﻄﻗ, ﯽﻗﺮﺑ-ﻦﮔﺍﻭ
ﺩﺎﺸﮔ-ﻭ-ﺪﻨﻠﺑ ﺱﺎﺒﻟ: ﺱﺎﺒﻟ
ﻥﺩﺮﮐ-ﻝﻮﻐﺸﻣ: ﻪﺘﺴﺑﺍﻭ, ﻥﺩﺮﮐ-ﻩﺩﺎﻔﺘﺳﺍ, ﻥﺩﺮﮐ-ﻩﺭﺎﺟﺍ, ﻆﻔﺣ
ﻪﻠﮔ: ﻪﻠﮔ
ﯼﺭﻭﺁ-ﻊﻤﺟ: ﻥﺩﺮﮐ-ﻊﻤﺟ
ﻪﺑﺎﺗ-ﯽﻫﺎﻣ: ﻥﺍﺪﻠﮔ
ﻪﻠﻤﺣ: ﻪﻠﻤﺣ, ﺵﺭﻮﯾ
ﻥﺩﺍﺩ-ﺐﯾﺮﻓ: ﻖﻤﺣﺍ, ﻥﺩﺮﮐ-ﺖﻧﺎﯿﺧ
ﯼﺭﺍﺩﺍﺰﻋ: ﻩﻭﺪﻧﺍ-ﻭ-ﻢﻏ
ﻥﺪﯿﺸﮐ-ﺭﺎﻨﮐ: ﺮﺷ-ﺯﺍ-ﻥﺪﺷ ﺹﻼ﻿ﺧ, ﻢﺳﺭ, ﻪﺘﺴﺸﻧﺯﺎﺑ
ﮓﻨﻫﺍ: ﻪﻧﺍﺮﺗ, ﯽﻧﻮﻣﺭﺎﻫ
ﺖﻘﻔﺷ: ﯽﻟﺪﮑﯾ, ﻢﺣﺮﺗ
ﻥﺩﺮﮐ-ﻥﺎﻬﻨﭘ: ﻥﺩﺮﮐ-ﯽﻔﺨﻣ
ﯽﺴﯾﻮﻧﻭﺭ: ﻪﺨﺴﻧ
ﺪﻨﺳ: ﻞﯾﺎﻓ
ﻪﯾﺎﺴﻤﻫ: ﻑﺍﺮﻃﺍ
ﻥﺩﺮﮐ-ﺩﻭﺪﺴﻣ: ﻥﺩﺮﮐ-ﯼﺮﯿﮔﻮﻠﺟ, ﻢﺠﺣ
ﺪﻬﻌﺗ: ﻪﻔﯿﻇﻭ
ﺶﻫﺎﮐ: ﺭﺎﮑﻧﺍ, ﻁﻮﻘﺳ
ﺐﻠﻃ-ﻩﺎﺟ: ﯽﺒﻠﻃ-ﻩﺎﺟ
ﻞﯿﻄﻌﺗ-ﺯﻭﺭ: ﺕﻼ﻿ﯿﻄﻌﺗ, ﻦﺸﺟ
ﺖﺸﻣ: ﻝﻭﺍ
ﺏﺎﻘﻋ: ﻦﯿﻫﺎﺷ, ﺕﺍﻭﺍﺮﮐ
ﺰﯿﻣﺁ-ﺭﺎﺨﺘﻓﺍ: ﺭﺎﺨﺘﻓﺍ
ﻪﺟﻮﺗ-ﻞﺑﺎﻗ: ﻡﺯﻻ﻿, ﻢﻬﻣ, ﻪﺟﻮﺗ-ﻞﺑﺎﻗ
ﻢﮐﺍﺮﺘﻣ: ﺭﻮﺟ-ﻭ-ﻊﻤﺟ, ﻢﯿﺨﺿ
ﻥﺎﺘﺳﺍﺩ: ﻥﺎﻣﺭ, ﻞﯿﺨﺗ, ﻥﺎﺘﺳﺍﺩ
ﻪﯿﺻﻮﺗ: ﺩﺎﻬﻨﺸﯿﭘ, ﻥﺩﺮﮐ-ﯽﻓﺮﻌﻣ, ﺖﺤﯿﺼﻧ
ﯽﺷﺯﻮﻣﺁ: ﺕﻼ﻿ﯿﺼﺤﺗ
ﻻ﻿ﺎﺑ-ﻑﺮﻄﺑ: ﺶﯿﺑ, ﻻ﻿ﺎﺑ-ﺭﺩ
ﺥﺎﺷ: ﺕﺭﺫ
ﻕﻭﺪﻨﺻ: ﻪﺒﻌﺟ, ﺖﺨﺘﯾﺎﭘ-،ﻪﯾﺎﻣﺮﺳ
ﻝﺰﻨﻣ: ﻪﺒﻠﮐ, ﻞﯾﺎﻓ, ﻦﯿﺑﺎﮐ
ﺱﺎﺒﻟ: ﺱﺎﺒﻟ, ﺖﺳﺍﻮﺧﺩﺍﺩ, ﯽﺷﺭﺎﻔﺳ
ﻪﯾﺍﺮﮐ: ﻥﺩﺮﮐ-ﻩﺭﺎﺟﺍ, ﻦﺘﻓﺭ, ﻪﺸﻘﻧ
ﺪﯿﺠﻤﺗ-ﻭ-ﻖﯾﻮﺸﺗ: ﻥﺩﺯ-ﻒﮐ, ﺐﯾﻮﺼﺗ
ﯼﺭﻭﺁﺩﺎﯾ: ﻥﺩﺭﻭﺁ-ﺩﺎﻳ-ﻪﺑ, ﻪﯿﺒﺷ
ﺶﻟﺎﺑ: ﻪﻧﺎﺧﺩﻭﺭ
ﯽﯾﺎﺟ-ﭻﯿﻫ: ﻪﻄﻘﻧ
ﺪﺴﺟ: ﻥﺪﺑ
ﺖﯿﻫﺎﻣ: ﻝﻮﻠﺳ, ﺩﻮﺟﻮﻣ
ﯼﺪﻨﻠﺑ: ﺪﻨﺗ-ﺐﯿﺷ
ﻩﺯﻮﺣ: ﻩﺯﻮﺣ, ﻥﺎﻬﺟ
ﻪﻠﭘ-ﻩﺍﺭ: ﺎﻫ-ﻪﻠﭘ, ﺱﺎﯿﻘﻣ
ﻖﻓﺍﻮﺗ: ﺖﺷﺍﺩﺩﺎﯾ, ﺭﻮﺟ-ﻭ-ﻊﻤﺟ, ﺖﺳﺍﻮﺧﺩﺍﺩ, ﻥﺪﺷ-ﻑﺩﺎﺼﻣ, ﯼﺭﺎﮑﻤﻫ-ﺩﺍﺩﺭﺍﺮﻗ
ﯼﺭﻮﺗ: ﺦﯿﻣ, ﺪﻣﺁﺭﺩ
ﻩﻭﮋﭘ-ﺶﻧﺍﺩ: ﻮﺠﺸﻧﺍﺩ, ﺪﻨﻤﺸﻧﺍﺩ
ﺶﻛ-ﻂﺧ: ﮎﻭﺩ, ﺭﺍﺪﻧﺎﻣﺮﻓ
ﻪﻧﺍﻮﯾﺩ: ﻞﺧ, ﻖﻤﺣﺍ
ﻥﺩﺮﮐ-ﻡﺮﮔﺮﺳ: ﯼﺪﻣﺁ-ﺵﻮﺧ, ﻥﺩﺮﮐ-ﺮﯿﺤﺘﻣ-ﻭ ﺕﺎﻣ, ﯽﻣﺮﮔﺮﺳ-ﻭ​​-ﺢﯾﺮﻔﺗ
ﯽﺳﺮﭘ-ﻝﺍﻮﺣﺍ-ﻭ ﻡﻼ﻿ﺳ: ﯼﺪﻣﺁ-ﺵﻮﺧ, ﻝﺎﺘﺴﭘ-ﺕﺭﺎﮐ
ﻪﻧﺎﻧﺯ: ﻥﺯ
ﻻ﻿ﻮﯿﻫ: ﻻ﻿ﻮﯿﻫ, ﮎﺎﻨﺘﺸﺣﻭ
ﻥﺎﮑﻣﺍ: ﺕﺍﺰﯿﻬﺠﺗ
ﺕﺭﺎﻏ: ﺖﻗﺮﺳ, ﺕﺭﺎﻏ
ﻥﺎﺑﺩﺮﻧ: ﺎﻫ-ﻪﻠﭘ, ﺮﺘﺴﮐﺭﺍ-ﺮﺒﻫﺭ, ﺱﺎﯿﻘﻣ, ﻪﺳﺭﺪﻣ
ﻥﺎﯾﺎﭘ: ﻪﺘﺷﺬﮔ
ﻥﺩﺮﮐ-ﻢﯿﺴﻘﺗ: ﺕﻭﺎﻔﺗ, ﻊﯾﺯﻮﺗ
ﯽﻧﺩﺮﮑﻧ-ﺭﻭﺎﺑ: ﺐﻳﺮﻏ-ﻭ-ﺐﻴﺠﻋ, ﻩﺮﻈﺘﻨﻣ-ﺮﯿﻏ
ﺱﻮﻗ: ﻢﯿﻈﻌﺗ
ﺐﺨﺘﻨﻣ: ﺏﺎﺨﺘﻧﺍ, ﻥﺩﺮﻛ-ﺏﺎﺨﺘﻧﺍ
ﯽﺘﻟﺎﺠﺧ: ﯽﯾﻭﺮﻤﮐ, ﻡﺮﺷ
ﻪﻣ: ﺭﺎﺒﻏ
ﯽﮕﻧﺭ: ﮓﻧﺭ
ﻥﺩﺍﺩ-ﺭﺍﺪﺸﻫ: ﺭﺍﺪﺸﻫ, ﻥﺩﺮﮐ-ﺭﺍﺩﺍﻭ
ﻖﻤﻋ-ﻢﮐ: ﻖﯿﻤﻋ
ﻖﯾﻮﺸﺗ: ﮎﺮﺤﻣ, ﯽﺘﺣﺍﺭ
ﻪﯾﻭﺭ-ﯽﺑ: ﺞﯾﺍﺭ, ﻩﺮﻈﺘﻨﻣ-ﺮﯿﻏ
ﻪﻧﺎﻗﺩﺎﺻ: ﯼﺭﺍﺩﺎﻓﻭ, ﻥﺎﻤﯾﺍ-ﺎﺑ, ﺐﺳﺎﻨﻣ
ﻝﺎﻘﺘﻧﺍ: ﻪﻤﺟﺮﺗ
ﯽﺳﺎﺳﺍ: ﯼﺎﻨﺑ-ﺮﯾﺯ, ﯼﺰﯿﭼ-ﺮﻫ-ﯽﻠﺻﺍ ءﺰﺟ
ﻪﺘﺴﺑ: ﻪﺘﺴﺑ, ﺮﺒﯿﻓ
ﺰﯿﮕﻧﺍ-ﻢﻏ: ﮎﺎﻨﺘﺸﺣﻭ
ﯽﻨﯿﺑﺯﺎﺑ: ﺮﻈﻧ-ﺪﯾﺪﺠﺗ, ﺩﺎﻘﺘﻧﺍ
ﯽﮐﺎﻨﺘﺸﺣﻭ: ﮎﺎﻨﺘﺸﺣﻭ, ﺭﺎﯿﺴﺑ, ﺮﺗﺪﺑ
ﺰﭘ-ﻭ-ﺖﺨﭘ: ﻦﺘﺨﭘ, ﻪﻧﺎﺧﺰﭙﺷﺁ
ﺵﺭﻮﺷ: ﯽﺷﺭﻮﺷ, ﺏﻼ﻿ﻘﻧﺍ
ﻥﺩﺮﮐ-ﺮﺘﻬﺑ: ﺖﺑﺎﺛ, ﺎﻔﺷ
ﻥﺩﺮﮐ-ﺏﺍﺮﺧ: ﻦﺘﻓﺭ-ﻦﯿﺑ-ﺯﺍ
ﻥﺩﺮﻛ-ﻊﻧﺎﻗ: ﻥﺩﺮﮐ-ﺪﻋﺎﻘﺘﻣ, ﻥﺩﺍﺩ-ﻥﺎﻨﯿﻤﻃﺍ
ﻪﺳﺎﮐ: ﻥﺎﺠﻨﻓ
ﺮﯾﻮﺼﺗ: ﻝﺎﺜﻣ, ﺮﯾﻮﺼﺗ
ﺐﺼﻋ: ﺪﯾﺭﻭ, ﺖﻋﺎﺠﺷ, ﯽﺒﺼﻋ
ﻩﺮﯿﺧ: ﺖﺑﺎﺛ
ﻡﻮﻠﻌﻣ: ﻦﺘﺴﻧﺍﺩ, ﻥﺩﺍﺩ-ﻥﺎﻨﯿﻤﻃﺍ, ﺺﺨﺸﻣ, ﯽﺳﺭﺮﺑ, ﺖﺑﺎﺛ
ﻭﺮﮔ: ﻥﺩﺍﺩ-ﻥﺎﻨﯿﻤﻃﺍ, ﻩﺪﻋﻭ, ﻥﺎﮔﻭﺮﮔ, ﺖﻧﺎﻤﺿ, ﻭﺮﮔ
ﻥﺩﺭﻭﺁ-ﺖﺳﺪﺑ: ﺖﻣﺪﺧ
ﺪﯿﻨﮐ-ﺏﺎﺨﺘﻧﺍ: ﻥﺩﺮﻛ-ﺏﺎﺨﺘﻧﺍ
ﯽﺘﻌﻨﺻ: ﯼﺯﺎﺳ-ﯽﺘﻌﻨﺻ, ﺖﻌﻨﺻ
ﺮﯿﺴﻔﺗ: ﻪﻤﺟﺮﺗ
ﺶﻟﺎﭼ: ﻥﺩﺯ-ﮓﻧﺯ
ﻉﻮﻨﻤﻣ: ﻥﺩﺮﮐ-ﯼﺮﯿﮔﻮﻠﺟ, ﺭﺎﮑﻧﺍ
ﻉﻮﺿﻮﻣ: ﻒﯿﺗﻮﻣ, ﻉﻮﺿﻮﻣ
ﺵﺮﯾﺬﭘ: ﻝﻮﺻﻭ-ﻡﻼ﻿ﻋﺍ
ﺮﺨﺘﺳﺍ: ﺮﺨﺘﺳﺍ, ﻝﺍﺩﻮﮔ
ﺲﻧﺍﺮﻔﻨﮐ: ﻪﺴﻠﺟ, ﮊﺎﺘﻧﻮﻣ
ﯼﺮﺑﺍﺮﺑ: ﺱﺎﯿﻗ, ﻝﺩﺎﻌﺗ, ﯼﺯﺭﺍ-ﻢﻫ, ﻪﻟﺩﺎﻌﻣ
ﺍﺮﯿﺧﺍ: ﻮﺌﻧ, ﯽﮔﺯﺎﺗ-ﻪﺑ, ﻥﺎﻣﺭ
ﻑﺍﺮﻃﺍ-ﻂﯿﺤﻣ: ﯽﻄﯿﺤﻣ-ﺖﺴﯾﺯ, ﻑﺍﺮﻃﺍ
ﻢﺟﺎﻬﺗ: ﻪﻠﻤﺣ, ﺵﺭﻮﯾ
ﻮﮕﻟﺍ: ﻝﺎﺜﻣ, ﺭﺎﺑ-ﮏﯾ, ﺩﺭﺍﺪﻧﺎﺘﺳﺍ, ﻥﺪﺷ-ﻞﻴﻜﺸﺗ
ﻦﺘﺧﺎﺳ-ﺭﺎﮑﺷﺁ: ﻥﺩﺮﮐ-ﺵﺎﻓ, ﻥﺩﺮﮐ-ﺖﻧﺎﯿﺧ
ﻥﺩﺮﮐ-ﻑﺮﻃﺮﺑ: ﻞﺷ, ﺖﺑﺎﺛ
ﻥﺩﺮﮐ-ﺖﺤﯿﺼﻧ: ﻪﺒﻄﺧ
ﮒﺭﺰﺑ-ﺭﺩﺎﻣ: ﺱﻭﺮﻋ-ﻩﺯﺎﺗ, ﻩﺪﺟ-ﺎﯾ-ﺪﺟ
ﻢﺸﭘ: ﻪﺒﻨﭘ
ﻥﺩﺮﻛ-ﺭﺍﺮﻗﺮﺑ-ﻁﺎﺒﺗﺭﺍ: ﺩﻮﻨﺷ-ﻭ-ﺖﻔﮔ, ﻥﺩﺮﮐ-ﯽﻋﺎﻤﺘﺟﺍ, ﻂﺑﺍﻭﺭ
ﺎﺳﺎﺳﺍ: ﺕﺎﺣﻼ﻿ﻄﺻﺍ
ﺖﻔﻟﺎﺨﻣ: ﺖﻔﻟﺎﺨﻣ
ﻪﻧﻮﻤﻧ: ﻝﺎﺜﻣ
ﻥﺪﯿﺸﮐ: ﻢﺳﺭ, ﯽﭽﯿﻗ
ﻝﻮﺼﺤﻣ: ﯽﻋﺍﺭﺯ-ﺕﻻ﻿ﻮﺼﺤﻣ, ﻥﺩﺮﮐ-ﻭﺭﺩ, ﺵﺮﺑ
ﻖﯿﻗﺩ: ﺐﺳﺎﻨﻣ, ﺭﺩﻮﭘ, ﻖﯿﻗﺩ
ﺭﺮﮑﻣ-ﺪﻣﺁ-ﻭ ﺖﻓﺭ: ﻦﺘﻓﺮﮔ, ﻩﺎﻨﭘ-ﻥﺎﺟ, ﺢﻳﺮﻔﺗ-ﮓﻧﺯ
ﻉﺎﻨﺘﻣﺍ: ﺭﺎﮑﻧﺍ, ﯽﻨﺘﺨﯾﺭ-ﺭﻭﺩ
ﻪﺿﺮﻗ-ﻕﺍﺭﻭﺍ: ﺪﯿﻠﮐ, ﺖﻧﺎﻤﺿ, ﻂﺑﺍﺭ-ﻮﻀﻋ
ﺯﻮﺴﻟﺩ: ﻢﺣﺮﺗ
ﻕﻮﻘﺣ: ﺖﺧﺍﺩﺮﭘ
ﻡﻭﺍﺪﻣ: ﻪﻣﺍﺩﺍ
ﻥﺩﺮﮐ-ﮏﯾﺮﺤﺗ: ﻥﺩﺮﮐ-ﺭﺍﺩﺍﻭ, ﻥﺩﺮﮐ-ﮏﯾﺮﺤﺗ
ﺪﯾﺪﺷ: ﯽﺸﺣﻭ, ﺪﯾﺪﺷ
ﻪﺼﻏ-ﻭ-ﻢﻏ: ﻩﻭﺪﻧﺍ-ﻭ-ﻢﻏ, ﯼﺩﮊﺍﺮﺗ
ﺪﺤﺘﻣ: ﺪﺤﺘﻣ, ﻩﺍﺮﻤﻫ
ﻒﻘﺳ: ﻮﺘﭘ, ﻒﻘﺳ
ﻑﺪﻫ: ﺰﮐﺮﻤﺗ, ﻑﺪﻫ
ﺪﻘﻧ: ﻝﻮﭘ
ﯽﻟﺎﺧ: ﻦﮐ-ﺯﺎﺑ, ﻥﺩﺮﮐ-ﺩﺍﺯﺁ, ﯽﻟﺎﺧ, ﻞﺷ, ﻢﻬﺒﻣ
ﻥﺩﺮﻤﺷ-ﺭﺍﻮﺧ: ﺮﯿﻘﺤﺗ
ﻦﻤﭼ: ﻦﻤﭼ, ﺭﺍﺰﻔﻠﻋ
ﻥﻮﻤﻠﻗﻮﺑ: 
ﻪﯾﺎﺴﻤﻫ: ﻑﺍﺮﻃﺍ
ﯽﯾﺎﻬﻧ: ﻪﺘﺷﺬﮔ, ﻁﺮﻔﻣ, ﺖﯾﺎﻬﻧ-ﺭﺩ, ﯼﺰﯿﭼ-ﺮﻫ-ﯽﻠﺻﺍ ءﺰﺟ
ﻝﺎﺳﺭﺍ: ﻥﺩﺮﮐ-ﺖﻋﺎﻃﺍ, ﻝﺎﺳﺭﺍ
ﺩﻭﺭﻭ: ﻥﺪﺷ-ﻞﺧﺍﺩ
ﻞﻣﺎﮐ: ﻖﯿﻤﻋ, ﻩﺪﺷ-ﺮﭘ
ﺞﯿﻬﻣ: ﻢﺳﺭ, ﻭﺎﮑﺠﻨﮐ
ﻩﺪﻧﺮﺑ: ﺖﯿﻘﻓﻮﻣ
ﺭﺎﮐ-ﻪﻈﻓﺎﺤﻣ: ﺲﮐﻭﺪﺗﺭﺍ, ﺭﺍﺪﻧﺎﻣﺮﻓ
ﻕﺎﺘﺸﻣ: ﻕﺎﯿﺘﺷﺍ, ﺲﭘﺍﻮﻟﺩ
ﻦﯿﯾﺎﭘ-ﻪﻘﺒﻃ: ﻦﯿﯾﺎﭘ
ﺵﻮﺟ: ﻦﺘﺨﭘ, ﻢﺧﺯ
ﯽﯾﺎﺒﯾﺯ: ﯽﯾﺎﺒﯾﺯ, ﻞﮕﺷﻮﺧ
ﺍﺩﺮﻓ: ﺯﻭﺮﯾﺩ
ﺖﺣﺍﺭﺎﻧ: ﺲﭘﺍﻮﻟﺩ, ﺪﻨﯾﺎﺷﻮﺧﺎﻧ
ﻩﺎﮕﺘﺳﺩ: ﺕﺍﺰﯿﻬﺠﺗ
ﺎﻋﺩﺍ: ﻥﺩﺮﮐ-ﺭﺍﺮﺻﺍ
ﻦﺨﺳ: ﻆﻔﻠﺗ, ﻥﺎﯿﺑ
ﻞﯾﺭ: ﻦﻫﺁ-ﻩﺍﺭ, ﺭﺎﻄﻗ
ﺺﻗﺎﻧ: ﻩﺪﺷ-ﺮﭘ, ﯽﻧﺍﻮﺗﺎﻧ, ﺺﻗﺎﻧ
ﻥﺩﺭﻭﺁ-ﺖﺳﺩ: ﺏﺎﺴﺘﮐﺍ, ﻖﺘﺸﻣ, ﺪﯾﺮﺧ
ﻪﻠﻤﺣ: ﺵﺭﻮﯾ, ﻪﻠﻤﺣ, ﺰﯿﻣﺁ-ﺖﻧﻮﺸﺧ
ﺩﺮﺳ-ﺭﻮﻄﺑ: ﺩﺮﺳ
ﯽﻧﺍﺮﻨﺨﺳ: ﻩﺭﻭﺩ
ﻥﺁ-ﺐﺟﻮﻣ-ﻪﺑ: ﻪﮐ-ﯽﯾﺎﺟ
ﮎﺍﺭﺩﺍ: ﺱﺎﺴﺣﺍ, ﻩﺎﮕﻧ, ﺭﻮﺼﺗ
ﻪﻌﺳﻮﺗ: ﻩﺪﺷ-ﺖﺳﺭﺩ-ﻪﻧﺍﺩﺎﺘﺳﺍ
ﺩﺮﮑﻠﻤﻋ: ﻢﺳﺍﺮﻣ, ﺭﺎﮐ, ﺖﯿﻟﺎﻌﻓ
ﻪﻟﻮﻠﮔ: ﺹﺮﻗ, ﺲﮑﻋ, ﭖﻮﺗ
ﻥﺩﺮﮐ-ﺮﯿﺳﺍ-ﻭ ﺭﺎﺘﻓﺮﮔ: ﻥﺩﺮﮐ-ﺖﻔﺳ, ﻥﺍﺮﮐ
ﻥﺎﺴﮑﯾ: ﻥﺎﺴﮑﯾ
ﻪﺟﻮﺗ-ﻞﺑﺎﻗ: ﯽﺸﯾﺎﻤﻧ, ﯽﻟﺎﻋ, ﻢﻬﻣ, ﻪﺟﻮﺗ-ﻞﺑﺎﻗ
ﻢﺠﺣ: ﻡﺮﺟ, ﻩﺯﺍﺪﻧﺍ, ﻢﺠﺣ, ﺭﻮﻣﻮﺗ
ﺕﺪﻣ-ﯽﻧﻻ﻿ﻮﻃ: ﯽﻧﻻ﻿ﻮﻃ, ﻥﺪﻧﺎﻣ-ﺮﻈﺘﻨﻣ
ﺖﯾﺫﺍ: ﮏﯾﺮﺤﺗ, ﺪﻨﯾﺎﺷﻮﺧﺎﻧ
ﻦﯿﮕﻤﻏ: ﯽﺒﺼﻋ, ﻦﯿﮕﻤﻏ
ﻪﺘﺳﺩ: ﻂﺑﺍﺭ-ﻮﻀﻋ, ﺪﻧﺎﺑ
ﮏﺸﺧ-ﻒﻠﻋ: ﻦﻤﭼ, ﯽﻧ
ﻩﺮﻇﺎﻨﻣ: ﺮﻈﻧ-ﻑﻼ﻿ﺘﺧﺍ, ﻝﺪﺟ-ﻭ-ﺚﺤﺑ
ﻥﻮﮑﺳ: ﺕﻮﮑﺳ
ﻲﺋﺰﺟ: ﺎﻨﺜﺘﺳﺍ, ﺶﺨﺑ
ﻭﺎﮔ-ﺖﺷﻮﮔ: ﺖﺷﻮﮔ
ﻥﺩﺮﮐ-ﺪﺤﺘﻣ: ﯽﮕﺘﺴﺒﻤﻫ, ﻪﻨﻫﺩ, ﻥﺩﺍﺩ-ﯽﺘﺷﺁ, ﻥﺩﺮﮐ-ﻞﺻﻭ
ﻪﻐﯿﺗ: ﮒﺮﺑ, ﺮﯿﺸﻤﺷ, ﻮﻗﺎﭼ
ﻪﻧﺎﺧﺭﺎﮐ: ﻪﻧﺎﺧﺭﺎﮐ
null-ﺭﺍﺪﻘﻣ: ﺮﻔﺻ, ﯽﻟﺎﺧ
ﻪﻠﺠﻣ: ﻪﻣﺎﻧﺯﻭﺭ, ﺕﺎﻋﻮﺒﻄﻣ
ﻪﻧﺎﻗﺩﺎﺻ: ﯼﺭﺍﺩﺎﻓﻭ, ﻕﺩﺎﺻ
ﻉﻭﺮﺸﻣ: ﯽﻧﻮﻧﺎﻗ
ﻪﺠﻬﻟ: ﻆﻔﻠﺗ, ﺪﯿﮐﺎﺗ, ﺰﮐﺮﻤﺗ
ﻪﻧﺎﺼﻟﺎﺧ: ﯼﺪﺟ-ﺭﻮﻃ-ﻪﺑ
ﻪﯾﺩﺎﺤﺗﺍ: ﺩﺎﺤﺗﺍ
ﺪﯿﯾﺎﺗ: ﺐﯾﻮﺼﺗ
ﻡﺍﺪﻧﺍ: ﻮﻀﻋ, ﻁﺮﻔﻣ
ﺮﺷﺎﺒﻣ: ﺮﯾﺪﻣ, ﺭﺍﺰﮕﺘﻣﺪﺧ
ﯽﻠﻣﺎﮑﺗ-ﺮﯿﺳ: ﺕﺎﺣﻼ﻿ﺻﺍ, ﯽﻠﻣﺎﮑﺗ
ﯽﺳﺭﺮﺑ: ﯽﺳﺭﺮﺑ, ﻥﺩﺮﮐ-ﻮﺠﺘﺴﺟ
ﺮﺻﺎﻌﻣ: ﻥﺭﺪﻣ
ﯽﯾﺍﻮﺳﺭ: ﺩﺎﺴﻓ
ﻪﻧﺎﻫﺎﮔﺁ: ﺍﺪﻤﻋ
ﻞﺒﻤﺳ: ﯼﺭﺍﺬﮔ-ﻥﺎﺸﻧ, ﺖﺳﮊ
ﯽﯾﻮﺸﺳﺎﺒﻟ: ﻮﺸﺘﺴﺷ, ﯽﯾﻮﺸﮑﺸﺧ
ﻖﯿﻗﺩ: ﺐﺳﺎﻨﻣ, ﺭﺩﻮﭘ, ﻖﯿﻗﺩ
ﻉﻮﻗﻭ: ﻪﺛﺩﺎﺣ, ﺖﺒﺳﺎﻨﻣ
ﺭﻮﺤﻣ: ﻕﺪﻨﺧ, ﻪﻧﺎﺷ, ﺖﺧﺭﺩ
ﻪﻗﺎﺳ: ﮏﺸﺧ, ﻪﻠﯿﺒﻗ, ﻪﺸﯾﺭ
ﺖﮐﺮﺷ: ﺖﮐﺮﺷ, ﻥﺎﻣﺯﺎﺳ
ﺢﯿﺟﺮﺗ: ﺯﺎﯿﺘﻣﺍ, ﻢﻫﺩ-ﯽﻣ-ﺢﯿﺟﺮﺗ, ﺖﯾﺰﻣ, ﻥﺩﺮﻛ-ﺏﺎﺨﺘﻧﺍ
ﻢﯿﻫﺍﻮﺧ-ﯽﻣ: ﻥﺩﺮﮐ-ﺭﺍﺩﺍﻭ, ﻪﺑ-ﻥﺩﺍﺩ-ﻩﺰﯿﮕﻧﺍ, ﻦﺘﺷﺍﺩ-ﻞﻳﺎﻤﺗ
ﺖﺷﺍﺩﺮﺑ: ﻪﻠﺻﺎﻓ
ﺎﻋﺩﺍ: ﺐﯾﻮﺼﺗ, ﺪﯿﮐﺎﺗ
ﺱﺮﺘﺳﺩ-ﺭﺩ: ﺪﯾﺩﺯﺎﺑ, ﻩﺪﺷ-ﺍﺪﯿﭘ
ﯼﺪﻤﮐ: ﯽﻌﺒﻃ-ﺥﻮﺷ
ﻥﺩﺮﮐ-ﺖﯿﭘ-ﻭ ﻂﯿﺧ: ﮓﻧﺭ, ﻥﺎﺠﯿﻫ
ﺪﮐ: ﻁﺎﯿﺣ, ﻥﺩﺭﻭﺍﺭﺩ-ﺰﻣﺭ-ﺕﺭﻮﺼﺑ
ﯽﻓﺎﮐ: ﯽﻓﺎﮐ, ﺐﺳﺎﻨﻣ
ﻑﺎﮑﺷ: ﻊﯾﺯﻮﺗ
ﺱﺎﻨﺷ-ﺦﯾﺭﺎﺗ: ﯽﺨﯾﺭﺎﺗ
ﺕﺪﺷ: ﻢﮐﺍﺮﺗ, ﺩﺍﮋﻧ
ﯽﺳﺍﺮﮐﻮﻣﺩ: ﯼﺭﻮﻬﻤﺟ
ﻩﺪﯿﻘﻋ: ﺭﺍﺮﻗﺍ
ﻪﺑﺫﺎﺟ: ﻥﻮﺴﻓﺍ, ﻦﯿﻣﺯ-ﻪﺑﺫﺎﺟ
ﺕﺮﺴﻨﮐ: ﻩﺭﺍﻮﻨﺸﺟ
ﻦﯿﯾﺎﭘ-ﻪﺑ-ﻭﺭ: ﻦﯿﯾﺎﭘ
ﺰﯾﺭﺎﮐ: ﻝﺎﻧﺎﮐ, ﻪﻟﻮﻟ
ﮓﻧﺭﺩ-ﯽﺑ: ﯼﺩﻭﺯ-ﻪﺑ, ﻥﺩﺮﮐ-ﺎﺿﺎﻘﺗ, ﺯﺮﻓ
ﯼﺰﻧﺮﺑ: ﺞﻧﺮﺑ-ﺰﻠﻓ, ﻱﺍ-ﻩﻮﻬﻗ
ﮎﺎﺷﻮﭘ: ﺎﻫ-ﺱﺎﺒﻟ
ﺖﻣﺍﺪﻧ: ﻦﯿﮕﻤﻏ, ﻢﺣﺮﺗ
ﯼﺭﺎﺼﺤﻧﺍ: ﺭﺎﺼﺤﻧﺍ, ﯽﺻﻮﺼﺧ
ﺮﺑﺭﺎﺑ: ﻥﺪﯿﺷﻮﭘ, ﻞﻣﺎﺣ
ﻩﺮﯿﺗ-ﻂﺧ: ﻂﺧ
ﺭﺍﻮﻧ: ﺪﻧﺎﺑ
ﺖﯾﺎﻬﻧ-ﺭﺩ: ﺖﯾﺎﻬﻧ-ﺭﺩ
ﻢﯿﺗ: ﺮﮐ-ﻩﻭﺮﮔ
ﻥﺍﺮﮔ: ﺰﯾﺰﻋ
ﯽﻫﺪﻧﺎﻣﺮﻓ-ﺰﮐﺮﻣ: ﺩﺎﺘﺳ, ﺰﮐﺮﻣ
ﺩﺎﺣ: ﺰﯿﺗ
ﻞﺠﺧ: ﯽﺒﺼﻋ, ﻡﺮﺷ
ﺪﻧﺯﺮﻓ: ﺎﻫ-ﻪﭽﺑ
ﻪﮑﺒﺷ: ﺏﻭ
ﺢﻄﺳ: ﻩﺪﻧﺮﭘ, ﺢﻄﺳ, ﻦﯿﺷﺎﻣ
ﯼﺍ-ﻩﺯﺍﺪﻧﺍ-ﺎﺗ: ﺶﺨﺑ
ﺭﺎﺨﺘﻓﺍ-ﺎﺑ: ﺭﻭﺮﻏ
ﺱﺍﺮﺗ: ﻦﮑﻟﺎﺑ, ﻒﻘﺳ
ﮓﻨﭼ: ﻦﺘﺷﺍﺩ-ﻪﮕﻧ, ﻡﺍﺩ
ﺭﺎﺠﻔﻧﺍ: ﺭﺎﺠﻔﻧﺍ
ﯽﻣﺎﻈﻧ-ﯼﺎﻫﻭﺮﯿﻧ: ﺶﺗﺭﺍ, ﯽﻣﺎﻈﻧ
ﻢﮑﺤﻣ: ﺍﺪﮐﻮﻣ
ﺕﺍﺯﺎﺠﻣ: ﻢﺣﺮﺗ, ﻪﻠﻤﺟ
ﮎﺎﺧ: ﺖﺑﻮﻃﺭ, ﻉﻮﻓﺪﻣ, ﻞﮔ
ﺮﺼﻋ: ﻞﺼﻓ
ﺮﯿﻔﺳ: ﻝﻮﺳﺭ
ﺩﺍﮋﻧ-ﺡﻼ﻿ﺻﺍ-ﻭ ﺵﺭﻭﺮﭘ: ﻥﺩﺮﮐ-ﺮﯿﺜﮑﺗ, ﻪﻘﺑﺎﺴﻣ
ﻞﺧﺍﺪﺗ: ﻥﺩﺮﮐ-ﻪﻠﺧﺍﺪﻣ, ﯼﺭﻮﺨﻟﺩ, ﻝﻼ﻿ﺘﺧﺍ
ﻞﻣﺎﺷ: ﻥﺩﺮﮐ-ﯽﻃ, ﺍﻮﺘﺤﻣ
ﺵﺮﯾﺬﭘ: ﻝﻮﺒﻗ-ﻞﺑﺎﻗ, ﺐﯾﻮﺼﺗ, ﻝﻮﺻﻭ-ﻡﻼ﻿ﻋﺍ
ﺱﺪﻨﻬﻣ: ﯽﮑﯿﻧﺎﮑﻣ
ﻒﻗﻮﺗ: ﺎﭘ
ﻦﯾﺰﮕﯾﺎﺟ: ﺏﻭﺎﻨﺘﻣ, ﻥﺩﺮﮐ-ﻦﯾﺰﮕﯾﺎﺟ
ﺮﻬﻣ: ﻪﻘﻠﺣ
ﻩﺪﻧﺭﺎﻤﺷ: ﮏﺴﯾﺩ, ﺖﻔﻟﺎﺨﻣ, ﻞﺑﺎﻘﻣ
ﻩﺮﻫﺯ-ﻩﺭﺎﯿﺳ: ﻪﻌﻤﺟ
ﯽﻟﺎﯿﺧ: ﻞﯿﺨﺗ
ﯼﺩﺭﻮﻧ-ﮓﻨﺳ: ﻥﺪﻣﺁ-ﻻ﻿ﺎﺑ, ﻥﺪﯾﺰﺧ
ﻥﺩﺮﻛ-ﺏﺬﺟ: ﻢﺳﺭ, ﻦﺘﺷﺍﺬﮔ-ﺮﯿﺛﺎﺗ
ﺐﯿﺠﻋ: ﻥﺩﺮﮐ-ﺮﯿﮕﻠﻓﺎﻏ, ﻪﺟﻮﺗ-ﻞﺑﺎﻗ
ﺖﺑﺎﻗﺭ: ﺐﯿﻗﺭ
ﻝﺎﺘﺴﯾﺮﮐ: ﻪﺸﯿﺷ
ﺵﻭﺩ: ﻥﺍﻭ, ﻥﺍﺭﺎﺑ
ﯽﻔﺴﻠﻓ: ﻑﻮﺴﻠﯿﻓ, ﻪﻔﺴﻠﻓ
ﺍﺪﺻ-ﻭ-ﺮﺳ ﺮﭘ: ﺍﺪﺻ-ﻭ-ﺮﺳ
ﻩﺎﮕﺘﺳﺩ: ﺕﺍﺰﯿﻬﺠﺗ
ﻞﻘﻧ-ﻭ-ﻞﻤﺣ: ﮏﯿﻓﺍﺮﺗ, ﻞﺗﺎﺷ
ﺖﯾﺎﻬﻧ-ﺭﺩ: ﺖﯾﺎﻬﻧ-ﺭﺩ
ﺭﻮﺟﺪﺑ: ﺭﺎﯿﺴﺑ, ﮎﺎﻨﺘﺸﺣﻭ
ﺮﮑﻔﺗ: ﻥﺩﺮﮐ-ﺲﮑﻌﻨﻣ, ﺱﺎﮑﻌﻧﺍ
ﺪﯿﻟﻮﺗ: ﺖﻌﻨﺻ, ﻥﺩﺮﮐ-ﺪﯿﻟﻮﺗ
ﯽﺘﺣﺍﺭ-ﻪﺑ: ﺖﺣﺍﺭ
ﻩﺎﮕﺸﯾﺎﻤﻧ: ﻩﺎﮕﺸﯾﺎﻤﻧ, ﺵﺭﺍﺰﮔ
ﯼﺯﺭﻭﺎﺸﮐ: ﯼﺯﺭﻭﺎﺸﮐ, ﻪﻋﺭﺰﻣ
ﻮﺠﺘﺴﺟ: ﻥﺩﺮﮐ-ﻮﺠﺘﺴﺟ
ﺵﺮﺘﺴﮔ: ﺕﺎﯿﺋﺰﺟ, ﻥﺩﺮﮐ-ﻦﻬﭘ
ﻝﺍﺪﺟ: ﺾﻗﺎﻨﺗ, ﻝﺪﺟ-ﻭ-ﺚﺤﺑ
ﺎﺒﯾﺮﻘﺗ: ﺎﺒﯾﺮﻘﺗ
ﺮﺳ-ﯼﻻ﻿ﺎﺑ-ﺭﺩ: ﻻ﻿ﺎﺑ-ﺭﺩ
ﻥﺩﺮﮐ-ﺭﺎﻬﻣ: ﯼﺭﺍﺩﺯﺎﺑ, ﻥﺩﺮﮐ-ﯼﺮﯿﮔﻮﻠﺟ, ﯼﺭﺍﺩ-ﻦﺘﺸﯾﻮﺧ, ﻆﻔﺣ
ﻆﻔﺣ: ﯽﯾﻮﺟ-ﻪﻓﺮﺻ, ﻥﺩﺍﺩ-ﺖﻴﻤﻫﺍ, ﻆﻔﺣ
ﻪﻧﺎﺨﯿﻣ: ﺭﺎﺑ
ﻪﻧﺎﺧﺩﻭﺭ-ﻩﺯﻮﺣ: ﻩﺭﺩ, ﺮﺨﺘﺳﺍ, ﯽﯾﻮﺸﻓﺮﻇ-ﮏﻨﯿﺳ
ﯼﺩﻮﻠﻣ: ﻦﺤﻟ
ﻡﺍﺪﺨﺘﺳﺍ: ﻥﺩﺮﮐ-ﻩﺭﺎﺟﺍ
ﻥﺍﺮﮕﻧ: ﺲﭘﺍﻮﻟﺩ, ﯽﺒﺼﻋ
ﻦﺴﻣ-ﺩﺍﺮﻓﺍ: ﻝﺎﺴﻨﻬﮐ, ﯽﻤﯾﺪﻗ
ﻩﺎﮕﺸﻧﺍﺩ: ﺞﻟﺎﮐ
ﻁﺎﺘﺤﻣ: ﻖﯿﻗﺩ
ﯽﻠﺒﻗ: ﻕﺮﺷ, ﺯﺍ-ﻞﺒﻗ
ﺞﻧﺮﻐﺑ: ﻩﺪﯿﭽﯿﭘ, ﺖﺨﺳ, ﻩﺪﺷ-ﺖﺳﺭﺩ-ﻪﻧﺍﺩﺎﺘﺳﺍ
ﯽﻫﺍﻮﺧﺭﺬﻋ: ﻥﺩﺮﮐ-ﯽﻫﺍﻮﺧ-ﺭﺬﻋ, ﻒﺳﺎﺘﻣ
ﻩﺪﯿﺳﺮﺗ: ﻩﺩﺯ-ﺖﺸﺣﻭ, ﺱﺮﺗ
ﻦﯿﺸﻧﺎﺟ: ﺏﻭﺎﻨﺘﻣ, ﯼﺮﻤﺘﺴﻣ, ﻥﺩﺮﮐ-ﻦﯾﺰﮕﯾﺎﺟ
ﻩﺩﺎﻔﺘﺳﺍ: ﻥﺩﺮﮐ-ﻩﺩﺎﻔﺘﺳﺍ
ﻢﯿﻣﺮﺗ: ﯼﺯﺎﺳﺯﺎﺑ, ﺩﻮﺒﻬﺑ, ﯽﺑﺎﯾﺯﺎﺑ
ﻦﯿﭼﺮﭘ: ﺭﺎﺼﺣ
ﯽﻠﺻﺍ: ﺩﺎﺘﺳﺍ, ﯼﺎﻨﺑ-ﺮﯾﺯ, ﯽﻠﺻﺍ, ﯼﺰﯿﭼ-ﺮﻫ-ﯽﻠﺻﺍ ءﺰﺟ
ﻮﺗﺮﭘ: ﻪﻌﺷﺍ
ﺮﻔﺳ: ﺪﯾﺩﺯﺎﺑ, ﺮﻔﺳ
ﺰﯿﻣﺁ-ﻕﺍﺮﻏﺍ: ﮏﻤﻧ
ﻪﺘﺴﯾﺎﺷ: ﻦﺘﺧﺎﺳ-ﺭﺩﺎﻗ, ﺭﺩﺎﻗ
ﯼﺭﻮﻓ: ﯼﺩﻭﺯ-ﻪﺑ, ﻥﺩﺮﮐ-ﻊﯾﺮﺴﺗ
ﺭﺎﯿﺷﻮﻫ: ﺭﺍﺪﺸﻫ, ﺮﻄﺧ-ﮓﻧﺯ, ﺭﺍﺪﯿﺑ
ﺮﻓ: ﻕﺎﺟﺍ
ﻩﺪﺷ-ﺩﺮﮔ: ﺩﺮﮔ
ﯽﻟﻮﻤﻌﻣ: ﺞﯾﺍﺭ
ﻥﺩﺮﮐ-ﻪﺑﻻ﻿: ﻥﺩﺮﻛ-ﺶﻫﺍﻮﺧ, ﻪﯿﺟﻮﺗ
ﺏﺎﻨﻃ: ﺏﺎﻨﻃ
ﺭﺎﻨﮐ-ﺭﺩ: ﺕﺍﺯﺍﻮﻣ-ﻪﺑ, ﺪﻌﺑ, ﯽﮕﺘﺳﻮﯿﭘ
ﻥﺩﺮﮐ-ﺝﺍﺮﺨﺘﺳﺍ: ﻝﻮﻗ-ﻞﻘﻧ, ﻩﻮﯿﻤﺑﺁ
ﺮﺗ-ﮏﺒﺳ: ﮏﺒﺳ
ﺖﻨﯾﺎﭘ: ﻮﺠﺑﺁ
ﻪﻟﻮﻟ: ﻪﻟﻮﻟ
ﻥﺎﺑﺎﯿﺧ: ﺖﺒﺳﺎﻨﻣ
ﺪﻣﺁﺭﺎﮐ: ﺮﻫﺎﻣ, ﺭﺍﺬﮔ-ﺮﻴﺛﺎﺗ, ﺮﺛﺍ
ﻁﻮﻠﺨﻣ: ﻁﻮﻠﺨﻣ, ﻥﺩﺯ-ﻢﻬﺑ
ﻝﻼ﻿ﺘﺧﺍ: ﻝﻼ﻿ﺘﺧﺍ, ﯼﺭﻮﺨﻟﺩ
ﯽﯾﺍﺮﺟﺍ: ﺮﯾﺪﻣ
ﻢﻫﺩ: ﻩﺩ
ﯼﺍ-ﻪﺴﯾﺎﻘﻣ: ﻪﺴﯾﺎﻘﻣ
.ﺢﺒﺻ: ﺢﺒﺻ, ﻕﺍﺮﺑ
ﺲﻔﻗ: ﻪﻌﻠﻗ, ﻝﻮﻠﺳ
ﻥﺍﺪﻧﺯ: ﻥﺍﺪﻧﺯ, ﺮﯿﺠﻧﺯ
ﺮﻫﺎﻣ: ﺮﻫﺎﻣ, ﯼﺮﮔ-ﻪﻠﯿﺣ, ﺭﺩﺎﻗ
ﺩﺎﯾﺮﻓ: ﻥﺩﺮﮐ-ﻪﯾﺮﮔ
ﺵﺯﺎﺳ: ﯼﺭﺎﮑﻤﻫ-ﺩﺍﺩﺭﺍﺮﻗ, ﯽﻧﻮﻣﺭﺎﻫ
ﺕﺎﻤﻬﻣ: ﺲﮑﻋ
ﺭﺎﯿﺘﺳﺩ: ﯽﻣﺎﺣ, ﮏﻤﮐ
ﺮﮑﺸﯿﻧ: ﺏﻮﭼ
ﺚﺤﺑ-ﻭ-ﺮﺟ: ﻮﮕﺘﻔﮔ-ﻭ-ﺚﺤﺑ, ﻥﺩﺮﮐ-ﺭﺍﺮﺻﺍ
ﻖﻄﻨﻣ: ﻝﺪﺟ-ﻭ-ﺚﺤﺑ, ﯽﻘﻄﻨﻣ, ﺖﯿﻧﻼ﻿ﻘﻋ
ﺖﺸﺣﻭ: ﺱﺮﺗ
ﺵﺩﺮﮔ: ﻱﺭﺍﻮﺳ-ﻪﺧﺮﭼﻭﺩ, ﻪﺧﺮﭼ, ﮏﯿﻓﺍﺮﺗ, ﺵﺩﺮﮔ
ﺱﺮﺘﺳﺍ: ﺩﺍﮋﻧ
ﻑﺮﺼﻣ: ﻥﺩﺮﮐ-ﻩﺩﺎﻔﺘﺳﺍ, ﻥﺩﺮﮐ-ﻑﺮﺼﻣ, ﻥﺩﺭﻮﺧ
ﻆﻔﺣ: ﻥﺩﺮﮐ-ﺖﯾﺎﻤﺣ, ﻆﻔﺣ, ﻦﺘﺷﺍﺩ-ﻪﮕﻧ, ﻥﺩﺮﺑ-ﺞﻧﺭ
ﻁﻮﻘﺳ: ﻁﻮﻘﺳ, ﺩﺎﻀﺗ
ﺪﻗﺎﻓ: ﻩﺪﻨﺴﺑﺎﻧ, ﺵﺮﺑ, ﺺﻗﺎﻧ
ﯽﺠﯾﺭﺪﺗ: ﻪﺘﻓﺭ-ﻪﺘﻓﺭ
ﻥﺪﺷ-ﻪﻟ: ﻦﺘﻓﺭ-ﻦﯿﺑ-ﺯﺍ, ﻦﯿﻣﺯ-ﻪﺑﺫﺎﺟ, ﺵﺍﻮﮑﺳﺍ
ﻩﺪﯾﺪﭘ: ﻪﺛﺩﺎﺣ, ﺰﯿﭼ
ﻥﺩﺮﮐ-ﺍﺮﺟﺍ: ﻥﺪﯾﻭﺩ, ﻞﻤﻋ
ﻦﺘﻔﮔ-ﮏﯾﺮﺒﺗ: ﺖﻣﻼ﻿ﺳ, ﯼﺪﻣﺁ-ﺵﻮﺧ, ﮒﺮﮕﺗ
ﺖﻨﻄﻠﺳ: ﯽﺘﻨﻄﻠﺳ, ﯽﮔﮋﯾﻭ
ﻥﺩﺮﻛ-ﺭﺎﺘﻓﺭ: ﻩﺪﻧﺯ
ﻊﻧﺎﻣ: ﻊﻧﺎﻣ, ﻪﻧﺎﺘﺳﺁ
ﯽﻨﺤﻨﻣ: ﻢﯿﻈﻌﺗ
ﻪﯿﮑﺗ: ﻥﺩﺮﻤﺷ
ﯽﺘﺣﺍﺭ: ﯽﻧﺎﺳﺁ-ﻪﺑ, ﯽﺘﺣﺍﺭ
ﻩﺮﺑ: ﺪﻨﻔﺳﻮﮔ, ﻥﺪﯾﺰﺧ
ﯽﻘﻄﻨﻣ: ﯽﻘﻄﻨﻣ
ﯽﯾﺍﺬﻏ-ﻢﯾﮊﺭ: ﺍﺬﻏ
ﯽﯾﺎﻀﻗ: ﻩﺎﮔﺩﺍﺩ, ﯽﻧﻮﻧﺎﻗ
ﯼﺩﺎﻤﺘﻋﺍ-ﯽﺑ: ﻥﺩﺮﻛ-ﻚﺷ, ﯼﺭﺍﺩﺎﻓﻭ
ﺮﭘ: ﺭﺎﻬﺑ, ﻢﺣﺮﺗ
ﻪﻧﺎﺒﻠﻃﻭﺍﺩ: ﺐﻠﻃﻭﺍﺩ
ﺖﮐﺍﮊ: ﺖﮐ, ﺖﮐﺍﮊ
ﺎﻨﺷ: ﺎﻨﺷ
ﺮﯿﮕﻤﺸﭼ: ﻪﺟﻮﺗ-ﻞﺑﺎﻗ
ﺮﯾﺯ-ﺭﺩ: ﻦﯿﯾﺎﭘ, ﺯﺍ-ﺪﻌﺑ
ﯽﻧﺎﺘﺳﺍ: ﯽﯾﺎﺘﺳﻭﺭ, ﻥﺎﺘﺳﺍ
ﻥﺍﺮﺒﺟ: ﻥﺩﺮﮐ-ﻥﺍﺮﺒﺟ, ﯼﺮﻤﺘﺴﻣ
ﺖﻣﺪﺨﺸﯿﭘ: ﺭﺍﺰﮕﺘﻣﺪﺧ
ﺞﯾﻭﺮﺗ: ﺏﺎﺘﺷ, ﻊﯿﻓﺮﺗ, ﺮﺘﺳﺎﻓ, ﺭﺎﺸﻓ, ﺖﮐﺭﺎﺸﻣ
ﻥﺩﺍﺩ-ﺹﺎﺼﺘﺧﺍ: ﺪﺼﻗ
ﺖﻣﻮﺼﺧ: ﻢﺻﺎﺨﺘﻣ
ﻉﺭﺯ-ﻭ-ﺖﺸﮐ: ﻪﻋﺭﺰﻣ, ﻪﻧﺎﺨﻠﮔ
ﻦﺘﺷﺍﺬﮔ-ﺽﺮﻌﻣ-ﺭﺩ: ﯽﻠﮐ-ﺡﺮﻃ, ﻥﺩﺮﮐ-ﺵﺎﻓ, ﻦﮐ-ﺯﺎﺑ
ﻪﻠﺻﻭ: ﻪﻄﻘﻧ, ﯽﮕﺘﺴﺒﻟﺩ
ﻪﻔﻗﻭ: ﺢﻳﺮﻔﺗ-ﮓﻧﺯ, ﯼﺭﻮﺨﻟﺩ
ﺖﺴﺷ: ﭻﻨﯾﺍ
ﯽﺑﻼ﻿ﻘﻧﺍ: ﺏﻼ﻿ﻘﻧﺍ
ﺭﻭﺁ-ﺖﻔﮕﺷ: ﺐﻳﺮﻏ-ﻭ-ﺐﻴﺠﻋ, ﻥﺩﺮﮐ-ﺕﺎﻣ
ﻡﺎﻌﻧﺍ: ﻩﺮﮑﻤﯿﻧ, ﺦﯿﻣ, ﻁﺮﻔﻣ, ﺶﯾﺭ, ﻪﻠﻗ, ﺖﺤﯿﺼﻧ
ﺪﯾﺪﻬﺗ: ﺰﯿﻣﺁ-ﺪﯾﺪﻬﺗ, ﺮﻄﺧ
ﻞﮕﻨﺟ: ﻞﮕﻨﺟ
ﯽﻟﻮﻤﻌﻣ: ﺞﯾﺍﺭ, ﻪﺼﺨﺸﻣ
ﺖﺧﻮﺳ: ﺖﻔﻧ
ﻡﺍﺭﺁ: ﻡﺍﺭﺁ
ﺪﺼﻘﻣ: ﺭﺍﺮﮑﺗ, ﻑﺪﻫ, ﺖﺷﻮﻧﺮﺳ
ﻕﺎﺠﻨﺳ: ﺯﺍﺭ, ﻥﺯﻮﺳ
ﻡﺍﺮﻬﺑ: ﺱﺭﺎﻣ
ﻪﺘﺴﺑﺍﻭ: ﻩﺍﺮﻤﻫ, ﺭﺎﮑﻤﻫ, ﯽﮕﺘﺳﻮﯿﭘ, ﺞﯾﺍﺭ, ﺕﺍﺯﺍﻮﻣ-ﻪﺑ, ﻪﺘﺴﺑﺍﻭ
ﺮﯾﺮﺷ: ﺪﺳﺎﻓ, ﺪﺑ
ﺖﻓﺎﯿﺿ: ﻦﺸﺟ
ﻖﯿﻗﺩ: ﻩﺪﺷ-ﺖﺳﺭﺩ-ﻪﻧﺍﺩﺎﺘﺳﺍ, ﻖﯿﻤﻋ, ﻻ﻿ﻮﻟ, ﺕﺎﯿﺋﺰﺟ, ﻖﯿﻗﺩ
ﺱﺎﺒﻟ-ﺪﻤﮐ: ﻪﻨﯿﺑﺎﮐ
ﻪﻨﻨﻘﻣ: ﻥﺩﺮﮐ-ﯽﻧﻮﻧﺎﻗ, ﻪﻨﻨﻘﻣ-ﻩﻮﻗ
ﻪﯿﺷﺎﺣ: ﻪﺒﻟ, ﻩﺯﻮﺣ
ﻥﺎﻣﺮﻬﻗ: ﻥﺎﻣﺮﻬﻗ
ﺾﺒﻧ: ﻪﺑ-ﻥﺩﺍﺩ-ﻩﺰﯿﮕﻧﺍ
ﻦﺘﺨﯾﺮﮔ: ﻥﺪﯾﻭﺩ, ﻦﺘﻓﺭ-ﺭﺩ
ﺪﻨﺑ: ﻥﺎﯾﺮﺟ, ﺪﻨﺑ
ﺐﯿﮐﺮﺗ: ﯽﮕﺘﺳﻮﯿﭘ, ﻩﺪﯿﭽﯿﭘ
ﻩﺮﮔ: ﻦﺘﺷﺍﺩ-ﻪﮕﻧ, ﻩﺮﮔ
ﻁﺎﺒﺗﺭﺍ: ﻂﺑﺍﻭﺭ, ﺵﺭﺍﺰﮔ, ﻪﺟﻮﺗ
ﯽﮔﺪﻨﯾﺎﻤﻧ: ﻥﺎﻣﺯﺎﺳ, ﺖﮐﺮﺷ, ﯼﺭﺍﺩﺍ-ﺮﺘﻓﺩ
ﺪﻨﺧﺯﻮﭘ: ﺪﻨﺨﺒﻟ, ﻝﻮﺻﺍ-ﻭ-ﺍﺩﺍ
ﺕﺍﺮﻫﺎﻈﺗ: ﺶﯾﺎﻤﻧ, ﺱﺭﺎﻣ
ﯽﮔﺩﺮﺴﻓﺍ: ﻩﻭﺪﻧﺍ-ﻭ-ﻢﻏ
ﻪﯿﻠﻘﻧ-ﻪﻠﯿﺳﻭ: ﻦﯿﺷﺎﻣ
ﻦﺘﻓﺮﮔ-ﺖﻧﺎﻣﺍ: ﺭﺎﺒﺘﻋﺍ, ﻝﻮﻗ-ﻞﻘﻧ
ﻡﺭﻭ: ﻡﺭﻮﺗ
ﻉﻮﺿﻮﻣ: ﻒﯿﺗﻮﻣ, ﻉﻮﺿﻮﻣ, ﻥﺍﻮﻨﻋ
ﻢﮑﺣ: ﻢﯿﻤﺼﺗ, ﻥﻮﻧﺎﻗ
ﻪﺒﻨﺷ: ﻪﺒﻨﺷ-ﺯﻭﺭ
ﺖﯾﻮﻫ-ﺺﯿﺨﺸﺗ: ﯽﯾﺎﺳﺎﻨﺷ-ﻞﺑﺎﻗ, ﺖﯾﻮﻫ, ﻒﯾﺮﻌﺗ
ﺲﮑﻋ: ﺮﯾﻮﺼﺗ, ﺲﮑﻋ
ﺪﺤﺘﻣ: ﺖﺳﻭﺩ, ﯽﺘﺳﻭﺩ, ﺪﺤﺘﻣ
ﻪﻟﺎﺳﺭ: ﺮﯿﺴﻣ, ﻂﺴﺑ, ﻝﺪﺟ-ﻭ-ﺚﺤﺑ
ﻥﺎﺑﻭﺭ: ﺪﻧﺎﺑ, ﺎﻤﻨﯿﺳ-ﻢﻠﯿﻓ
ﻩﻭﻼ﻿ﻌﺑ: ﺶﯿﺑ
ﻑﺎﻔﺷ: ﺖﯿﻓﺎﻔﺷ, ﺩﻮﻬﺸﻣ
ﺮﻄﻋ: ﻮﺑ
ﺖﻤﺣﺯ: ﻞﮑﺸﻣ, ﻥﺩﺮﮐ-ﻪﻠﺧﺍﺪﻣ, ﻩﺪﻨﻫﺩ-ﺭﺍﺯﺁ, ﯼﺭﻮﺨﻟﺩ
ﻂﯾﺍﺮﺷ-ﺪﺟﺍﻭ: ﺭﺩﺎﻗ, ﻥﺪﺷ-ﻂﯾﺍﺮﺷ-ﺪﺟﺍﻭ, ﺮﻫﺎﻣ
ﻪﻟﺎﻘﻣ: ﻪﻟﺎﻘﻣ, ﺵﺭﺍﺰﮔ
ﺭﺍﻮﺳ: ﻪﯿﻟﺍﻮﺷ, ﯼﺭﺍﻮﺳ
ﯽﯾﺎﻬﻨﺗ: ﺎﻬﻨﺗ
ﺖﺳﺩ-ﭻﻣ: ﺖﺳﺩ
ﺰﯾﺭ: ﻡﺮﻧ, ﺮﻏﻻ﻿, ﺖﯾﺎﻬﻧ-ﺭﺩ
null-ﺭﺍﺪﻘﻣ: ﺮﻔﺻ, ﯽﻟﺎﺧ
ﻥﺩﺮﮐ-ﻡﻮﮑﺤﻣ: ﻪﻠﻤﺟ
ﮏﻓ: ﺝﺎﮐ
ﺩﺮﻔﺑ-ﺮﺼﺤﻨﻣ: ﺪﺤﺘﻣ
ﺭﺎﭼﺎﻧ-ﻪﺑ: ﺮﯾﺬﭘﺎﻧ-ﺏﺎﻨﺘﺟﺍ
ﻞﺒﻃ: ﺺﻗﺭ, ﯽﻟﺎﺧ
ﻦﺑ: ﻪﺒﻌﺟ, ﺪﺒﺳ
ﻥﺎﻣﺯ-ﺕﺪﻣ: ﺖﻗﻮﻣ, ﻲﻤﺋﺍﺩ, ﻥﺎﻣﺯ, ﻝﻮﻃ
ﻥﺯﻭ: ﻦﺘﻓﺮﮔ-ﻩﺯﺍﺪﻧﺍ, ﻥﺯﻭ
ﻪﻌﻣﻮﺻ: ﻪﻌﻣﻮﺻ
ﺭﺎﺸﺘﻧﺍ: ﺭﺎﺸﺘﻧﺍ, ﻊﯾﺯﻮﺗ, ﻥﺩﺮﮐ-ﺵﺎﻓ
ﺶﻨﯿﺑ: ﺯﺍﺪﻧﺍ-ﻢﺸﭼ
ﺎﻌﻄﻗ: ﺩﻮﻬﺸﻣ, ﺍﺪﮐﻮﻣ, ﻩﺭﻭﺩ, ﯽﺘﺳﺍﺮﺑ, ﺎﺤﯾﺮﺻ
ﺮﯿﯿﻐﺗ: ﻥﺩﺍﺩ-ﺮﯿﯿﻐﺗ
ﺐﺸﻣﺍ: ﺯﻭﺭ
ﻞﻣﺎﻋ: ﻞﯿﻟﺩ, ﺪﻨﻣﺭﺎﮐ, ﺐﯾﺮﺿ
ﯽﮕﺘﺨﯾﺭ-ﻢﻬﺑ: ﺰﯿﻣﺁ-ﺖﻧﻮﺸﺧ, ﻝﻼ﻿ﺘﺧﺍ, ﯽﺠﯿﮔ
ﻞﻤﻋ: ﻦﯾﺮﻤﺗ, ﻞﻤﻋ
ﺏﺍﺮﺤﻣ: ﺏﺍﺮﺤﻣ
ﻥﺪﺷ-ﮏﭼﻮﮐ: ﻒﻔﺨﻣ, ﻥﺩﺮﮐ-ﻊﻤﺟ
ﻪﻨﯾﺰﻫ: ﻪﻨﯾﺰﻫ, ﻥﺩﺮﮐ-ﻩﺩﺎﻔﺘﺳﺍ, ﻥﺩﺮﮐ-ﺝﺮﺧ
ﻩﺪﻨﻨﮐ-ﻡﺮﮕﻟﺩ: ﺐﻠﻗ, ﻥﺪﯿﺸﺨﺑ-ﻡﺎﻬﻟﺍ
ﻪﺋﺍﺭﺍ: ﻥﺎﯿﺑ, ﻩﺎﮕﺸﯾﺎﻤﻧ, ﺵﺭﺍﺰﮔ, ﺮﺛﺍ
ﻡﺎﺧ: ﺖﺷﺭﺩ, ﺰﺒﺳ
ﻂﯿﻠﺑ: ﻢﭼﺮﭘ, ﻪﺸﻘﻧ
ﺐﻘﻋ-ﻪﺑ: ﺖﺸﮔﺯﺎﺑ
ﺶﻔﮐ: ﺶﻔﮐ, ﻦﯿﺗﻮﭘ
ﺐﻠﻘﺗ: ﻝﺎﯿﺧ
ﺭﺎﺠﻔﻧﺍ: ﺭﺎﺠﻔﻧﺍ
ﯼﺭﺎﺨﺑ: ﺶﮐﺩﻭﺩ
ﻪﺸﯿﺷ: ﻪﺸﯿﺷ, ﯼﺮﻄﺑ, ﭺﺭﺎﭘ, ﻥﺍﺪﻠﮔ
ﺏﺭ: ﺲﺳ
ﺪﺳﺎﻓ: ﻞﺒﻨﺗ, ﺪﺳﺎﻓ, ﺮﯿﻘﻓ
ﺭﺎﺘﻓﺭ: ﻪﺼﺨﺸﻣ, ﺭﺎﺘﻓﺭ
ﻡﺍﻭ: ﺭﺎﺒﺘﻋﺍ, ﻝﻮﻗ-ﻞﻘﻧ
ﻞﯿﻟﺩ-ﯽﺑ: ﯽﻘﻄﻨﻣ, ﻑﺮﺧﺰﻣ
ﺕﻮﻬﺷ: ﯽﺒﻠﻃ-ﻩﺎﺟ
ﻪﻧﻻ﻿ﺎﺳ: ﻝﺎﺳ
ﻊﯾﺎﻣ: ﺏﺍ
ﻪﭽﺑ: ﺎﻫ-ﻪﭽﺑ
ﻪﻧﺍﻮﯾﺩ: ﻞﺧ, ﻖﻤﺣﺍ
ﯽﻧﻮﮕﻧﺮﺳ: ﻦﺘﺨﯾﺭ
ﺖﯿﻘﻓﻮﻣ: ﺖﯿﻘﻓﻮﻣ, ﻪﺒﺗﺭ, ﯼﺭﺍﺩﺮﺑ-ﻩﺮﻬﺑ
ﺽﺮﻓ: ﺪﯿﻨﮐ-ﺽﺮﻓ, ﻞﯿﺨﺗ, ﺍﺮﻫﺎﻇ
ﯽﻫﺎﮑﻓ: ﯽﻌﺒﻃ-ﺥﻮﺷ, ﺭﺍﺩ-ﻩﺪﻨﺧ
ﺪﺟﻭ: ﻕﺎﯿﺘﺷﺍ
ﯽﮕﺘﺴﺸﻧﺯﺎﺑ: ﻪﺘﺴﺸﻧﺯﺎﺑ, ﺎﻔﻌﺘﺳﺍ, ﯽﮕﺘﺴﺸﻧﺯﺎﺑ-ﻕﻮﻘﺣ
ﺲﻠﺠﻣ: ﻪﻨﻨﻘﻣ-ﻩﻮﻗ, ﺎﻨﺳ-ﺲﻠﺠﻣ
ﯼﺭﺍﺮﻄﺿﺍ: ﺲﭘﺍﻮﻟﺩ, ﻥﺍﺮﺤﺑ
ﻪﺘﺴﺑ: ﻥﺩﺮﮐ-ﯼﺪﻨﺑ-ﻪﺘﺴﺑ, ﺶﺨﺑ, ﻪﺘﺴﺑ
ﻮﺸﮐ: ﻪﺒﻌﺟ, ﺎﻫ-ﻪﻠﭘ
ﻢﻬﺳ: ﺖﮐﺭﺎﺸﻣ, ﻁﺮﺷ
ﻥﺩﺍﺩ-ﻁﺎﺒﺗﺭﺍ: ﯽﮕﺘﺴﺒﻟﺩ
ﺕﺍﺮﺟ-ﻭ-ﻝﺩ: ﺖﻋﺎﺠﺷ, ﻥﺩﺮﮐ-ﯼﺫﺎﺧﺍ
ﭖﺎﭼ: ﺭﺎﺸﺘﻧﺍ, ﭖﺎﭼ, ﺕﺎﻋﻮﺒﻄﻣ
ﻊﻓﺍﺪﻣ: ﻞﯿﮐﻭ, ﻪﯿﺟﻮﺗ, ﻊﻓﺍﺪﻣ
ﻂﯿﺤﻣ: ﻮﺟ, ﯽﻄﯿﺤﻣ-ﺖﺴﯾﺯ
ﻥﺩﺮﻛ-ﺪﻴﻳﺎﺗ: ﻥﺩﺮﻛ-ﺖﺑﺎﺛ, ﻥﺩﺍﺩ-ﻥﺎﻨﯿﻤﻃﺍ, ﺖﯾﻮﻘﺗ
ﻡﻼ﻿ﻋﺍ: ﻥﺩﺮﮐ-ﺵﺎﻓ, ﺭﺎﺸﺘﻧﺍ
ﺎﻔﻌﺘﺳﺍ: ﺎﻔﻌﺘﺳﺍ, ﻪﺘﺴﺸﻧﺯﺎﺑ
ﺩﺭ: ﺭﺎﮑﻧﺍ, ﺩﺭ
ﺖﺨﺳ: ﺖﺨﺳ, ﻪﻧﺎﻤﻟﺎﻇ
ﻪﻌﻄﻗ: ﻪﺷﺍﺮﺗ, ﻪﻤﻘﻟ, ﻪﺿﺍﺮﻗ, ﻂﺴﺑ
ﻪﺒﻗﺍﺮﻣ: ﻥﺩﺍﺩ-ﺖﻴﻤﻫﺍ, ﻥﺩﺮﮐ-ﺲﮑﻌﻨﻣ
ﻪﮑﻟ: ﻪﻄﻘﻧ
ﯼﺭﺎﭙﺴﮐﺎﺧ: ﯼﺭﺎﭙﺴﮐﺎﺧ, ﻦﻓﺩ
ﻪﯿﺿﺮﻓ: ﺪﯿﻨﮐ-ﺽﺮﻓ
ﯽﺿﺮﻓ-ﺖﻟﺎﺣ: ﯼﺮﮑﻔﺗ-ﺖﻟﺎﺣ, ﯽﺿﺮﻓ-ﺖﻟﺎﺣ, ﻁﻭﺮﺸﻣ-ﺖﻟﺎﺣ
ﺶﻨﮐﺍﺮﺗ: ﺖﯿﻟﺎﻌﻓ, ﺕﺭﺎﺠﺗ
ﺖﻣﺮﺣ-ﮏﺘﻫ: ﻢﺸﺧ, ﺮﯿﻘﺤﺗ, ﻡﺮﺷ
ﺕﻭﺎﻔﺘﻣ: ﺮﯿﻐﺘﻣ, ﻒﻠﺘﺨﻣ, ﻥﺩﺮﮐ-ﻦﯾﺰﮕﯾﺎﺟ
ﻞﯿﮐﻭ: ﻞﯿﮐﻭ, ﻩﺪﻨﯾﺎﻤﻧ
ﻥﺩﺮﮐ-ﺖﯾﺫﺍ: ﺭﺎﮑﻫﺎﻨﮔ
ﻪﺘﺴﺑ: ﻥﺩﺮﮐ-ﯼﺪﻨﺑ-ﻪﺘﺴﺑ, ﺐﯿﺟ, ﻪﺘﺴﺑ
ﮏﯿﺳﻼ﻿ﮐ: ﮏﯿﺳﻼ﻿ﮐ
ﻪﻋﺭﺰﻣ: ﻪﻋﺭﺰﻣ
ﯼﺎﭘ: ﮏﯿﮐ, PI
ﺖﻗﺩ: ﺖﺳﺭﺩ, ﺖﻗﺩ, ﺍﺪﮐﻮﻣ
ﻥﺩﺮﮐ-ﺕﺮﭘ: ﺐﻟﺎﻗ
ﯽﯾﺎﯾﺭﺩ: ﯽﯾﺎﯾﺭﺩ-ﯼﻭﺮﯿﻧ, ﺎﯾﺭﺩ
ﻩﺪﻨﻧﺍﻮﺧ: ﻩﺪﻨﻧﺍﻮﺧ
ﻕﺮﺑ: ﮏﯿﻧﻭﺮﺘﮑﻟﺍ, ﻥﺎﯾﺮﺟ
ﻪﻧﺎﮕﯿﺑ: ﯽﺟﺭﺎﺧ, ﻥﺎﻤﻬﻣ, ﻦﯿﻣﺯ-ﻂﯿﺤﻣ-ﺯﺍ ﻥﻭﺮﯿﺑ
ﻩﺩﺭﻮﺧ-ﮎﺮﺗ: ﺭﺎﺠﻔﻧﺍ, ﮎﺮﺗ
ﻩﺩﺮﺴﻓﺍ: ﻦﯿﮕﻤﻏ, ﻩﻭﺪﻧﺍ-ﻭ-ﻢﻏ
ﻢﯿﺨﺿ-ﺎﺘﺒﺴﻧ: ﻢﯿﺨﺿ
ﯽﻘﻄﻨﻣ: ﻞﯿﻟﺩ, ﯽﻘﻄﻨﻣ
ﻞﺑﺎﮐ: ﯽﻟﺎﺧﻮﺗ, ﻥﺩﺮﮐ-ﻢﺧ
ﻥﺩﺍﺩ-ﻥﺎﺸﻧ: ﺢﯿﺿﻮﺗ, ﻥﺩﺮﮐ-ﺲﮑﻌﻨﻣ
ﺫﺎﺨﺗﺍ: ﺐﯾﻮﺼﺗ, ﻝﻮﺻﻭ-ﻡﻼ﻿ﻋﺍ
ﻡﺎﻧﺪﺑ: ﻡﺎﻨﮑﯿﻧ
ﻥﺩﺯ-ﺐﯿﺳﺍ: ﯽﮔﺪﯾﺩ-ﺐﯿﺳﺁ
ﺖﺳﺭﺩ: ﺖﻗﺩ, ﺐﺳﺎﻨﻣ, ﺖﺳﺭﺩ
ﻥﺪﯾﺮﭼ: ﺪﯿﺑ, ﺭﺍﺰﻔﻠﻋ
ﻡﺮﮐ: ﮏﺳﺎﻣ, ﻖﯿﻤﻋ
ﻥﺩﺮﮐ-ﺩﺭﻭﺁﺮﺑ: ﯽﺑﺎﯾﺯﺭﺍ, ﻥﺰﺑ-ﺱﺪﺣ
ﮒﺮﺑ-ﻭ-ﺯﺎﺳ: ﻥﺎﻣﺯﺎﺳ, ﺎﻫ-ﺱﺎﺒﻟ, ﺕﺍﺰﯿﻬﺠﺗ, ﺱﺎﺒﻟ
ﺲﻧﺎﺷ-ﺪﺑ: ﻡﺎﮐﺎﻧ, ﻪﻧﺎﻔﺳﺎﺘﻣ
ﻢﺘﺸﻫ: ﺖﺸﻫ
ﻡﺍﺭﺁ: ﯽﺘﺣﺍﺭ, ﺏﺎﺼﻋﺍ-ﺩﺪﻤﺗ, ﻡﺍﺭﺁ
ﺭﻭﺎﺠﻣ: ﺎﺒﯾﺮﻘﺗ, ﻑﺍﺮﻃﺍ
ﺪﺷﺭﺍ: ﺯﺎﺑﺮﺳ-ﻪﻨﻬﮐ, ﻦﯾﺪﻟﺍﻭ, ﺮﺳ
ﻥﺪﻧﺎﺳﺮﺗ: ﺮﻄﺧ-ﮓﻧﺯ
ﯽﺑﺮﻣ: ﯽﺑﺮﻣ
ﺖﻗﺮﺳ: ﺕﺭﺎﻏ, ﺖﻗﺮﺳ
ﺕﺭﺎﺠﺗ: ﺕﺭﺎﺠﺗ, ﯼﺭﺎﺠﺗ
ﻩﺪﺷ-ﺽﺮﻘﻨﻣ: ﻥﺪﺷ-ﺪﯾﺪﭘﺎﻧ
ﻩﺩﻮﺗ: ﻡﺮﺟ, ﻪﭽﯿﻫﺎﻣ, ﻪﻧﺍﺪﻧﺩ
ﯽﻓﺩﺎﺼﺗ: ﯽﻓﺩﺎﺼﺗ, ﺖﻗﻮﻣ, ﯽﻗﺎﻔﺗﺍ, ﻥﺩﺮﮐ-ﺮﯿﮕﻠﻓﺎﻏ
ﻞﺤﻣ: ﻪﻧﺎﺧ, ﻪﻄﻘﻧ, ﺎﻨﺑ, ﻪﻧﺎﺧ-ﻞﺧﺍﺩ-ﺭﺩ
ﻞﯾﻮﺤﺗ: ﻥﺩﺮﮐ-ﯽﻓﺮﻌﻣ
ﯽﻨﺤﻨﻣ: ﻩﺪﺷ-ﻢﺧ, ﻥﺩﺮﮐ-ﻢﺧ
ﻩﺪﻨﻨﮐ-ﺪﯿﻟﻮﺗ: ﻩﺪﻧﺯﺎﺳ, ﻥﺩﺮﮐ-ﺪﯿﻟﻮﺗ
ﻡﺭﻮﺘﻣ: ﻡﺭﻮﺗ
ﺖﺸﮐ: ﺮﺘﺳﺎﻓ, ﻪﻋﺭﺰﻣ
ﺮﯿﯿﻐﺗ: ﻥﺩﺍﺩ-ﺮﯿﯿﻐﺗ, ﺕﻭﺎﻔﺗ
ﻒﯾﺮﺣ: ﺐﯿﻗﺭ, ﺖﻔﻟﺎﺨﻣ
ﻩﻮﻧ: ﻩﻮﻧ, ﺭﺩﺍﺮﺑ-ﺎﯾ-ﺮﻫﺍﻮﺧ ﺮﺴﭘ
ﻦﺧﺎﻧ: ﻦﺧﺎﻧ, ﺦﯿﻣ, ﭻﯿﭘ
ﯽﻫﺍﻮﺧ-ﺮﯿﺧ: ﻩﺪﻨﺸﺨﺑ, ﻩﺎﻓﺭ, ﺍﻮﻘﺗ, ﺖﻓﺍﺮﻇ
ﺖﻗﺩ: ﺖﻗﺩ
ﻪﻧﺎﺸﻧ: ﺖﻣﻼ﻿ﻋ
ﺶﻫﺎﮐ: ﻥﺩﺍﺩ-ﺶﻫﺎﻛ, ﺵﺮﺑ
ﻢﮑﺷ: ﻩﺪﻌﻣ, ﻑﺎﻧ
ﺮﺟﺰﻨﻣ: ﺕﺮﻔﻧ
ﻥﺩﻭﺮﺳ: ﻦﺘﺷﻮﻧ, ﻥﺩﺭﻭﺁ-ﺩﻮﺟﻭ-ﻪﺑ
ﺮﻓﺎﺴﻣ: ﺮﻓﺎﺴﻣ
ﺶﯿﻧ: ﻥﺩﺯ-ﻢﺧﺯ, ﺦﻠﺗ, ﺶﯿﻧ
ﻥﺎﻣﺰﻤﻫ-ﺭﻮﻄﺑ: ﻦﻤﺿ-ﺭﺩ
ﺖﻤﺴﻗ: ﻢﻬﻣ, ﺶﺨﺑ
ﻡﻭﺍﺪﻣ: ﺭﺍﻮﺘﺳﺍ, ﻪﻣﺍﺩﺍ, ﻲﻤﺋﺍﺩ
ﻥﺩﺮﻣ-ﯽﮕﻨﺳﺮﮔ-ﺯﺍ: ﻪﻨﺳﺮﮔ
ﻩﺭﻭﺎﺸﻣ: ﺕﺭﻮﺸﻣ, ﺖﺤﯿﺼﻧ
ﺵﺮﺗ: ﺪﯿﺳﺍ
ﻂﺧ-ﺭﺍﺩ-ﻂﺧ ﺮﯾﺯ: ﻥﺩﺮﮐ-ﺭﺍﺮﺻﺍ, ﺪﯿﮐﺎﺗ
ﻩﮊﺭ: ﺱﺭﺎﻣ
ﯽﻨﻤﯾﺍ-ﻩﻼ﻿ﮐ: ﻩﻼ﻿ﮐ
ﻡﻼ﻿ﻋﺍ: ﺕﺎﻐﯿﻠﺒﺗ, ﺭﺎﺸﺘﻧﺍ
ﺖﻣﺎﻗﺍ-ﻞﺤﻣ: ﻞﺘﻫ
ﻥﺪﯿﺷﺎﭘ: ﻭﺭﺍﺩ
ﯽﻤﺳﺭ-ﺭﻮﻃ-ﻪﺑ: ﯽﻤﺳﺭ
ﻥﺍﺮﮕﻧ: ﯽﺒﺼﻋ, ﻥﺩﺮﮐ-ﻪﻠﺧﺍﺪﻣ, ﺲﭘﺍﻮﻟﺩ, ﻩﺪﻨﻫﺩ-ﺭﺍﺯﺁ
ﯽﻨﯿﺑ-ﺶﯿﭘ: ﺩﻭﺭ-ﯽﻣ-ﺭﺎﻈﺘﻧﺍ, ﺭﺎﻈﺘﻧﺍ
ﻪﺟﺭﺩ: ﻞﭘ, ﺐﯾﺮﺿ, ﻪﺒﺗﺭ, ﯽﺑﺎﯾﺯﺭﺍ, ﻪﺟﺭﺩ
ﻉﻮﻓﺪﻣ: ﻉﻮﻓﺪﻣ, ﯽﻟﺪﻨﺻ
ﻪﯿﺟﻮﺗ: ﻪﯿﺟﻮﺗ
ﯽﺟﺭﺎﺧ: ﯽﺟﺭﺎﺧ, ﻥﺎﻤﻬﻣ
ﻞﻘﻧ-ﻭ-ﻞﻤﺣ: ﮏﯿﻓﺍﺮﺗ, ﻞﺗﺎﺷ
ﺐﻠﻄﻣ-ﮎﺭﺩ: ﻦﮐ-ﮎﺭﺩ
ﺮﯾﺪﻣ: ﺮﯾﺪﻣ, ﺮﺳ
ﯽﻧﺎﻣﺯ: ﺖﻗﻮﻣ, ﻥﺎﻣﺯ
ﻪﻧﺎﻔﯾﺮﻇ: ﻞﮕﺷﻮﺧ
ﯼﺍﺮﺟﺍ: ﻞﯿﻤﺤﺗ, ﻥﺩﺮﮐ-ﺮﯾﺰﮔﺎﻧ, ﻦﺘﺧﺎﺳ-ﺭﺩﺎﻗ, ﺲﯿﻠﭘ
ﻊﻣﺎﺟ: ﻖﯿﻤﻋ, ﻩﺪﺷ-ﺮﭘ
ﻥﺩﺮﮐ-ﺪﯾﺪﻬﺗ: ﺰﯿﻣﺁ-ﺪﯾﺪﻬﺗ
ﯽﻗﺮﺘﻣ: ﻦﺘﻓﺭ-ﺶﯿﭘ, ﻝﺎﮑﯾﺩﺍﺭ
ﻊﺑﺎﻨﻣ: ﻊﺒﻨﻣ
ﻥﺩﺮﮐ-ﺩﻭﺪﺤﻣ: ﺩﻭﺪﺤﻣ, ﻥﺩﺮﮐ-ﺐﺣﺎﺼﺗ, ﻥﺩﺮﮐ-ﻩﺎﺗﻮﮐ, ﻥﺩﺍﺩ-ﺶﻫﺎﻛ
ﻦﺘﻔﮔ-ﮏﯾﺮﺒﺗ: ﺶﯾﺎﺘﺳ
ﻪﻤﯿﺑ: ﺮﻄﺧ-ﯽﺑ
ﻦﯿﯿﻌﺗ: ﻢﺸﭼ
ﻥﺩﺮﮐ-ﻊﻄﻗ: ﻊﻧﺎﻣ, ﺵﺮﺑ, ﻥﺩﺮﮐ-ﻪﻠﺧﺍﺪﻣ, ﻥﺩﺮﮐ-ﺍﺪﺟ, ﺢﻳﺮﻔﺗ-ﮓﻧﺯ
ﻥﺩﺮﮐ-ﺏﻮﮐﺮﺳ: ﻥﺩﺮﮐ-ﻢﺘﺳ, ﻥﺩﺮﮐ-ﯼﺮﯿﮔﻮﻠﺟ
ﻪﯾﻻ﻿: ﻥﻮﺘﺳ
ﺪﯿﻠﮐ: ﮎﺭﺪﻣ, ﺪﯿﻠﮐ
ﻥﺍﺪﻧﺩ: ﺎﻬﻧﺍﺪﻧﺩ, ﮏﺷﺰﭙﻧﺍﺪﻧﺩ, ﻪﻧﺍﺪﻧﺩ
ﺖﻧﺎﻤﺿ: ﻥﺩﺍﺩ-ﻥﺎﻨﯿﻤﻃﺍ, ﺖﻧﺎﻤﺿ
ﺵﻭﺭ: ﺪﻨﯾﺁﺮﻓ, ﻡﺰﯿﻧﺎﮑﻣ, ﻞﻤﻋ, ﺵﻭﺭ
ﻪﯿﺻﻮﺗ: ﺖﺤﯿﺼﻧ
ﻑﺎﮑﺷ: ﺢﻳﺮﻔﺗ-ﮓﻧﺯ, ﺡﺎﺘﺘﻓﺍ
ﺪﻨﻧﺎﺳﺮﯿﻣ-ﺍﺭ-ﻡﻮﻬﻔﻣ ﻦﯾﺍ: ﻦﺘﺷﺍﺩ-ﺭﻮﻈﻨﻣ
ﻪﻤﯿﻤﺿ: ﻪﺘﺴﺑﺍﻭ, ﻥﺩﺮﮐ-ﻞﺼﺘﻣ-ﻢﻫﺎﺑ, ﻥﺩﺮﮐ-ﺖﻔﺳ
ﺖﻟﺎﺣ: ﺖﺳﮊ, ﺺﺧﺎﺷ, ﺖﯿﻌﻗﻮﻣ, ﻥﺩﺎﺘﺴﯾﺍ
ﻪﻋﻮﻤﺠﻣ: ﻝﺎﺑ, ﻢﯿﻈﻨﺗ, ﯽﻧﻮﮑﺴﻣ-ﻥﺎﻤﺗﺭﺎﭘﺁ
ﺮﻫﺍﻮﺟ: ﺞﻨﮔ, ﻥﺪﺷ-ﺎﻓﻮﮑﺷ
ﯽﻔﻃﺎﻋ: ﺱﺎﺴﺣﺍ, ﯽﺗﺎﺳﺎﺴﺣﺍ, ﺱﺎﺴﺣ
ﻦﺘﺑ: ﯽﺸﯾﺎﻤﻧ, ﺭﺍﻮﺘﺳﺍ
ﻦﺘﺨﯿﻣﺁ: ﺩﺎﺤﺗﺍ, ﯽﮕﺘﺳﻮﯿﭘ
ﺝﻭﺍ: ﻪﻠﻗ
ﻝﻮﭘ-ﺪﺣﺍﻭ: ﻝﻮﭘ, ﻪﮑﺳ
ﻑﺪﻫ: ﻑﺪﻫ, ﺰﮐﺮﻤﺗ
ﺩﻮﺑﺩﺎﯾ: ﻪﻈﻓﺎﺣ, ﺭﺍﺪﺸﻫ
ﻪﻧﺎﮔﺍﺪﺟ-ﺕﺭﻮﺼﺑ: ﻢﻫ-ﺯﺍ-ﺍﺪﺟ, ﺕﻭﺎﻔﺗ, ﻪﻧﺎﮔﺍﺪﺟ-ﺭﻮﻃ-ﻪﺑ, ﺎﻬﻨﺗ
ﯽﻨﯿﺳ: ﮏﺴﯾﺩ
ﯽﻘﻓﺍ: ﻝﺩﺎﻌﺗ
ﺭﻮﺸﻨﻣ: ﻲﺳﺎﺳﺍ-ﻥﻮﻧﺎﻗ, ﺬﻏﺎﮐ, ﻥﺩﺮﮐ-ﻩﺭﺎﺟﺍ
ﺩﺭﻮﻣ: ﺕﻻ﻿ﻮﺼﺤﻣ, ﻪﻟﺎﻘﻣ, ﺮﺼﻨﻋ, ﺍﺪﺻ, ﻉﻮﻧ, ﺖﯿﻌﻗﻮﻣ
ﻪﻌﺳﻮﺗ: ﺕﺎﯿﺋﺰﺟ, ﻥﺩﺮﮐ-ﻦﻬﭘ
ﭻﯿﭘ: ﭻﯿﭘ, ﺶﺧﺮﭼ, ﺰﻨﻃ
ﯽﺘﻨﺳ: ﺖﻨﺳ, ﮏﯿﺳﻼ﻿ﮐ
ﻞﻣﺎﺷ: ﻪﻠﻤﺟ-ﺯﺍ, ﻝﻮﻤﺷ, ﺍﻮﺘﺤﻣ
ﻝﺍﻭﺭ: ﺞﯾﺍﺭ, ﻡﺰﯿﻧﺎﮑﻣ
ﻥﺩﺮﻛ-ﻞﺣ: ﻥﺩﺯ-ﻢﺨﺷ, ﻞﺷ, ﺖﺑﺎﺛ
ﻥﺩﺮﮐ-ﺍﻮﻏﺍ: ﻦﺘﺧﺍﺪﻧﺍ-ﺖﺳﺩ-ﺍﺭ ﯽﺴﮐ, ﻥﺩﺮﮐ-ﺭﺍﺩﺍﻭ
ﻖﻓﻮﻣﺎﻧ: ﺖﺴﮑﺷ
ﺭﺍﺪﻤﺘﺳﺎﯿﺳ: ﯽﺳﺎﯿﺳ
ﮏﻫﻼ﻿ﮐ: ﻒﻘﺳ
ﺾﻘﻧ: ﯽﮔﺪﯾﺩ-ﺐﯿﺳﺁ
ﻝﺎﺼﺗﺍ: ﯽﺒﯿﺗﺮﺗ, ﺭﻮﺒﻋ
ﺲﻴﺋﺭ: ﮏﻟﺎﻣ, ﺮﯾﺪﻣ, ﺎﻣﺮﻓﺭﺎﮐ, ﺮﺳ, ﺩﺯﺩ
ﺭﺍﺰﻓﺍ-ﺖﺨﺳ: ﺕﺍﺰﯿﻬﺠﺗ
ﻪﺘﺷﺭ: ﻞﺣﺎﺳ, ﺪﻧﺎﺑ
ﺯﺮﻣ: ﻪﺒﻟ, ﻩﺮﺨﺻ, ﺐﻟ
ﻻ﻿ﺎﮐ: ﺕﺭﺎﺠﺗ, ﺕﻻ﻿ﻮﺼﺤﻣ
ﺭﻭﺩ: ﻢﻫ-ﺯﺍ-ﺍﺪﺟ, ﺭﻭﺩ, ﺭﻭﺩ-ﻩﺍﺭ-ﺯﺍ
ﻩﺎﻨﭘ: ﻥﺎﺘﺳﺭﺎﻤﯿﺑ, ﻩﺎﻨﭘ-ﻥﺎﺟ
ﺪﯿﯾﺄﺗ: ﻥﺩﺮﻛ-ﺖﺑﺎﺛ, ﻥﺩﺍﺩ-ﻥﺎﻨﯿﻤﻃﺍ
ﻪﻣﺎﻧﺮﺑ: ﺰﯿﻣ, ﻢﯾﻮﻘﺗ, ﯽﻧﺎﻣﺯﺎﺳ-ﺕﺭﺎﭼ, ﻊﺿﻭ
ﺮﮕﻨﺳ: ﻕﺪﻨﺧ
ﯼﺭﺍﺩﺮﻬﺷ: ﻥﺎﺘﺳﺮﻬﺷ
ﺵﺭﻮﺷ: ﻥﺩﺯ-ﻢﻬﺑ
ﻥﺩﺍﺩ-ﺕﺩﺎﻬﺷ: ﻥﺩﺮﻛ-ﺖﺑﺎﺛ
ﯼﺭﺩﺎﻣ: ﻪﻠﻣﺎﺣ, ﺭﺩﺎﻣ
ﯼﺯﺎﺳ-ﻪﻤﺴﺠﻣ: ﻪﻤﺴﺠﻣ
ﻢﻌﻃ: ﻢﻌﻃ
ﮎﺭﺎﻣ: ﯼﺎﻤﻨﻫﺍﺭ-ﻪﭽﺑﺎﺘﮐ, ﺖﻣﻼ﻿ﻋ
ﻪﺷﻮﺗ: ﻥﺍﺪﻤﭼ
ﻪﻟﺎﺑﺯ: ﻑﺮﺧﺰﻣ, ﻪﺿﺍﺮﻗ, ﻪﻟﺎﺑﺯ
ﺭﺍﺰﺑﺍ: ﺭﺍﺰﺑﺍ
ﺝﺮﻣ-ﻭ-ﺝﺮﻫ: ﻝﻼ﻿ﺘﺧﺍ, ﯽﺠﯿﮔ
ﯽﻧﻮﻧﺎﻗ-ﺩﺮﮕﯿﭘ: ﺖﺳﺍﻮﺧﺩﺍﺩ
ﻥﺎﻣﺯ: ﯽﺒﺼﻋ, ﻥﺎﻣﺯ
ﻍﺮﻣ: ﻪﺟﻮﺟ
ﺰﯿﻤﺗ-ﻭ-ﺮﺗ: ﺖﻨﯾﺯ, ﻥﺩﺍﺩ-ﺶﻫﺎﻛ, ﺵﺮﺑ
ﻁﺎﯿﺘﺣﺍ-ﺎﺑ: ﺎﻧﺍﺩ
ﻥﺩﺮﮐ-ﻪﯾﺮﮔ: ﻥﺩﺮﮐ-ﻪﯾﺮﮔ
ﺶﯾﻮﮔ: ﯽﻧﺎﺘﺴﻬﻟ
ﯽﯾﺍﺪﺘﺑﺍ: ﯼﺎﻨﺑ-ﺮﯾﺯ
ﺭﺎﺑ: ﻥﺍﺪﻤﭼ, ﺭﺎﺑ, ﻥﻮﯿﻣﺎﮐ
ﻥﺩﺮﮐ-ﮎﺎﭘ: ﺖﺸﮔﺮﺑ-ﻭ-ﺖﻓﺭ
ﺭﺎﮑﻧﺍ: ﺭﺎﮑﻧﺍ
ﻦﯿﻣﺯ-ﺮﯾﺯ: ﺯﺍﺭ
ﻂﺳﺍﻭ-ﺪﺣ: ﯽﺳﺭﺮﺑ
ﻝﻮﻣﺮﻓ: ﻪﻟﺩﺎﻌﻣ, ﺕﺎﻋﻮﺒﻄﻣ
ﻥﺩﺍﺩ-ﺐﯾﺮﻓ: ﻖﻤﺣﺍ, ﯼﺭﺎﮐ-ﺖﺳﺩ
ﺩﺎﯾﺯ-ﺪﺷ-ﻭ ﺪﻣﺍ: ﻎﯾﺭﺩ, ﺭﺎﺟﺰﻧﺍ
ﻡﺎﻧ-ﺖﺒﺛ: ﺖﺳﺮﻬﻓ, ﺖﺒﺛ
ﻦﯿﻌﻣ-ﺎﻧ: ﻢﻬﺒﻣ, aorist
ﺩﺍﺯﺎﻣ: ﯽﻓﺎﺿﺍ
ﺯﺮﻟ: ﻩﺯﺮﻟ
ﺖﻓﺎﺑ: ﻥﺎﻣﺯﺎﺳ, ﺏﻭ, ﻪﭼﺭﺎﭘ
ﺲﯾﻮﻧ-ﺶﯿﭘ: ﯽﻠﮐ-ﺡﺮﻃ
ﯼﺯﺎﺑ-ﺏﺎﺒﺳﺍ: ﮏﺳﻭﺮﻋ, ﯼﺯﺎﺑ, ﺭﺎﻤﻗ
ﻪﻠﭘ: ﺎﻫ-ﻪﻠﭘ, ﺱﺎﯿﻘﻣ
ﻝﺎﻘﺘﻧﺍ: ﺖﻧﻮﻔﻋ, ﻥﺩﺍﺩ-ﺮﯿﯿﻐﺗ, ﯼﺪﻌﺘﻣ, ﺭﻮﺒﻋ
ﻪﻤﮐﺩ: ﺪﯿﻠﮐ
ﻥﺎﺑﺮﻬﻣﺎﻧ: ﺏﺩﺍ-ﯽﺑ
ﻪﻣﺎﻧﺮﺑ: ﺡﺮﻃ, ﻪﺴﻠﺟ-ﺭﻮﺘﺳﺩ
ﺪﯿﻟﻮﺗ: ﯼﺯﺎﺳ-ﯽﺘﻌﻨﺻ, ﻪﻧﺎﺧﺭﺎﮐ, ﻥﺩﺮﮐ-ﺪﯿﻟﻮﺗ
ﻪﻘﻄﻨﻣ: ﻩﺯﻮﺣ, ﯼﺍ-ﻪﻘﻄﻨﻣ, ﺪﻧﺎﺑ
ﻦﯿﻤﻬﻧ: ﺮﻔﻧ-ﻪﻧ
ﻞﮑﻟﺍ: ﺏﺍﺮﺷ
ﺺﯾﺮﺣ: ﯽﺒﻠﻃ-ﻩﺎﺟ, ﺯﺁ-ﻭ-ﺹﺮﺣ
ﻥﺩﺮﮐ-ﺖﯾﺍﺪﻫ: ﺖﯾﺮﯾﺪﻣ
ﺫﻮﻔﻧ: ﺭﺍﺬﮔ-ﺮﻴﺛﺎﺗ, ﺫﻮﻔﻧ
ﻪﻃﺎﺣﺍ: ﻪﻘﯾ, ﻩﺮﺻﺎﺤﻣ
ﻥﺪﺷ-ﻕﺮﻏ: ﯽﯾﻮﺸﻓﺮﻇ-ﮏﻨﯿﺳ, ﻪﺷﻮﮔ
ﺵﺰﻐﻟ: ﺵﺰﻐﻟ
ﻕﺎﭼ-ﻭ-ﻪﺘﺨﻠﺷ: ﻥﺪﻣﺁ-ﻻ﻿ﺎﺑ, ﻥﺎﻧ, ﮎﻮﺧ
ﺐﻟﺎﻏ: ﯽﻟﺎﻋ, ﺵﺭﻮﯾ
ﯼﺮﺒﻫﺭ: ﺐﺗﺍﺮﻣ-ﻪﻠﺴﻠﺳ, ﯼﺎﻤﻨﻫﺍﺭ-ﻪﭽﺑﺎﺘﮐ
ﺕﺍﺮﻃﺎﺧ-ﺮﺘﻓﺩ: ﻪﻣﺎﻧﺯﻭﺭ, ﻢﯾﻮﻘﺗ
ﻦﺘﻓﺮﮔ-ﻦﺸﺟ: ﻥﺩﺮﮐ-ﺪﻋﺎﻘﺘﻣ
ﻦﺘﻓﺮﮔ-ﺩﺍﺮﯾﺍ: ﻥﺎﺠﯿﻫ, ﺍﺪﺻ-ﻭ-ﺮﺳ, ﻩﺪﻨﻫﺩ-ﺭﺍﺯﺁ, ﯽﺠﯿﮔ
ﻡﺎﻘﻣ-ﻢﺋﺎﻗ: ﻩﺪﻨﯾﺎﻤﻧ, ﺏﻭﺎﻨﺘﻣ
ﻞﯿﺒﻣﻮﺗﺍ: ﺭﻮﺗﻮﻣ
ﺡﻼ﻿ﺻﺍ: ﺮﻈﻧ-ﺪﯾﺪﺠﺗ, ﻥﺩﺍﺩ-ﺮﯿﯿﻐﺗ
ﯼﺩﻮﻤﻋ: ﻥﺩﺎﺘﺴﯾﺍ, ﯽﻟﻮﻃ
ﯽﻓﺎﮐ: ﻩﺪﻨﺴﺑﺎﻧ, ﯽﻓﺎﮐ
ﯽﺘﻨﻌﻟ: ﺮﻏﻻ﻿
ﺝﺎﺘﻨﺘﺳﺍ: ﻥﺰﺑ-ﺱﺪﺣ, ﻪﺠﯿﺘﻧ
ﯽﻃﺎﺒﻨﺘﺳﺍ-ﺖﻟﺎﺣ: ﯽﺋﺎﻘﻟﺍ-ﺖﻟﺎﺣ
ﺕﺎﻐﯿﻠﺒﺗ: ﺩﻼ﻿ﯿﻣ-ﺯﺍ-ﺪﻌﺑ, ﯼﺭﺎﺠﺗ, ﺕﺎﻐﯿﻠﺒﺗ
ﯼﺩﺯﺩ: ﺖﻗﺮﺳ, ﻥﺩﺮﮐ-ﯽﻨﯿﭼ-ﻪﺷﻮﺧ
ﺩﻮﺨﺑ-ﺩﻮﺧ: ﻩﺰﯾﺮﻏ, ﻩﺍﻮﺨﻟﺩ
ﺭﺍﺰﺑﺍ: ﻥﺎﻣﺯﺎﺳ, ﻥﺩﺮﮐ-ﻩﺩﺎﻔﺘﺳﺍ, ﺭﺍﺰﺑﺍ
ﻝﺎﺼﺗﺍ: ﻥﺩﺮﮐ-ﺖﻔﺳ, ﺏﻼ﻿ﻗ, ﻥﺩﺮﮐ-ﻞﺼﺘﻣ-ﻢﻫﺎﺑ, ﻥﺩﺮﮐ-ﻞﺻﻭ
ﻦﯿﯾﺎﭘ-ﻪﺑ-ﻭﺭ: ﻦﯿﯾﺎﭘ
ﻪﻠﺧﺍﺪﻣ: ﻥﺩﺮﮐ-ﻪﻠﺧﺍﺪﻣ
ﺎﯿﺣﺍ: ﯼﺎﯿﺣﺍ, ﺩﻮﺒﻬﺑ
ﺖﻧﺮﺘﻨﯾﺍ: ﺕﺭﺎﺠﺗ
ﯽﻤﺴﺟ-ﻅﺎﺤﻟ-ﺯﺍ: ﮏﯾﺰﯿﻓ, ﻥﺪﺑ
ﻪﻄﻘﻧ: ﻪﻄﻘﻧ
ﻩﺪﻨﻫﺩ-ﻥﺎﮑﺗ: ﻥﺪﺷ-ﻪﮐﻮﺷ
ﻪﻧﺎﺧﺎﺘﺴﮔ: ﺏﺩﺍ-ﯽﺑ
ﻝﺩﺎﻌﺘﻣ: ﺭﺍﻮﺘﺳﺍ
ﺺﺧﺎﺷ: ﻥﺍﻮﺗ, ﺖﺳﺮﻬﻓ, ﺺﺧﺎﺷ
ﻝﺎﻘﺘﻧﺍ: ﻝﺎﺳﺭﺍ, ﻊﯾﺯﻮﺗ
ﯼﻭﺭ-ﺮﺑ: ﻻ﻿ﺎﺑ-ﺭﺩ, ﺝﺭﺎﺧ, ﻮﻠﺟ-ﻪﺑ
ﻥﺩﺯ-ﭗﮔ: ﺪﯿﻨﮐ-ﺖﺒﺤﺻ, ﻡﺎﻗﺭﺍ
ﺎﺑﺮﻬﮐ: ﺩﺭﺯ-ﮓﻧﺭ
ﻦﺗ: ﻦﺤﻟ
ﺭﺍﻮﻤﻫ: ﺖﺣﺍﺭ
ﺶﻨﺗ: ﺩﺍﮋﻧ, ﻥﺎﺠﯿﻫ
ﮓﻨﻬﻧ: ﺏﺎﺨﺘﻧﺍ
ﯽﻤﺳ: ﻢﺳ
ﺯﺎﯿﺘﻣﺍ: ﻥﺩﺍﺩ-ﻥﺎﮑﺗ, ﺯﺎﯿﺘﻣﺍ, ﻒﯿﻔﺨﺗ
ﺮﮔﺭﺎﮐ: ﺪﻨﻣﺭﺎﮐ
ﺐﯿﺷ: ﺐﯿﺷ, ﺝﻭﺩﺰﻣ
ﺖﻟﺍﻮﺗ: ﻪﻨﯿﺑﺎﮐ
ﻦﯿﻫﻮﺗ: ﻪﻠﻤﺣ, ﻩﺰﺑ-؛ﺖﯾﺎﻨﺟ-؛ﻡﺮﺟ
ﻪﻨﯿﮐ: ﺕﺮﻔﻧ, ﻡﺎﻘﺘﻧﺍ
ﯽﯾﺎﺒﯿﮑﺷ: ﺮﺒﺻ, ﺖﻋﺎﺠﺷ
ﯽﻨﯿﺑ-ﺶﯿﭘ: ﺪﯿﻣﺍ, ﺭﺎﻈﺘﻧﺍ
ﻢﺘﯾﺭ: ﻢﺘﺷ-ﻭ-ﺏﺮﺿ
ﺵﻮﻣ: ﺱﻭﺎﻣ
ﻥﺩﻮﺑ-ﻖﺑﺎﻄﻣ: ﺕﺎﺒﺗﺎﮑﻣ, ﺖﺳﺍﻮﺧﺩﺍﺩ, ﺐﺳﺎﻨﻣ, ﻩﺪﺑ-ﺏﺍﻮﺟ
ﺖﺷﺍﺩﺯﺎﺑ: ﻥﺩﺮﮐ-ﯼﺮﯿﮔﻮﻠﺟ, ﻥﺩﺮﮐ-ﺐﺣﺎﺼﺗ, ﻆﻔﺣ
ﺮﯿﺴﻔﺗ: ﺢﯿﺿﻮﺗ
ﻦﻟﺎﺳ: ﻦﻟﺎﺳ
ﻞﻤﻋ: ﯼﺭﺎﮐ-ﺖﺳﺩ, ﺭﺎﮐ, ﻥﺪﯾﻭﺩ, ﻞﻤﻋ
ﯽﺸﮐ-ﻩﺯ: ﻥﺪﺷ-ﻩﺮﻄﻗ-ﻩﺮﻄﻗ, ﻥﺪﯾﻭﺩ
ﻪﻤﺣﺰﻟﺍ-ﻖﺣ: ﺖﺧﺍﺩﺮﭘ
ﻩﺪﻨﻧﺯ-ﻭ-ﺪﻨﺗ: ﺕﺮﻔﻧ, ﺪﺑ, ﺪﻨﯾﺎﺷﻮﺧﺎﻧ, ﻩﺪﻨﻨﮐ-ﺪﯿﻣﺍﺎﻧ, ﺖﺷﺯ
ﻥﺎﺘﺳﺮﺒﻗ: ﯼﺭﺎﭙﺴﮐﺎﺧ
ﭻﮔ: ﭻﮔ
ﺮﯿﺷ: ﻪﻟﻮﻟ, ﺮﯿﺷ
ﺩﺭ: ﻪﺴﯿﮐ, ﯽﺷﻮﭘ-ﻢﺸﭼ, ﺭﺎﮑﻧﺍ, ﺩﺭ, ﻥﺩﺍﺩ-ﺰﯿﻤﺗ, ﯽﮕﻧﻭﺰﻓﺍ, ﺶﺨﺒﺑ
ﮏﯾﺮﺤﺗ: ﻥﺎﺠﯿﻫ, ﮏﯾﺮﺤﺗ
ﻦﺘﺷﺍﺩ-ﺖﻣﺎﻗﺍ: ﻥﺩﺮﮐ-ﺖﻣﺎﻗﺍ, ﻩﺪﻧﺯ
ﻦﯿﯾﺰﺗ: ﺖﻨﯾﺯ
ﻪﺠﻨﭘ: ﻪﺠﻨﭘ-ﮎﻮﻧ, ﺎﭘ, ﺖﺸﮕﻧﺍ, ﻪﺠﻨﭘ
ﺰﺠﻋ: ﯽﻧﺍﻮﺗﺎﻧ, ﻒﻌﺿ
ﻥﺩﺮﮐ-ﻉﺍﺮﺘﺧﺍ: ﻉﺍﺮﺘﺧﺍ
ﻥﺩﺮﻛ-ﻒﻳﺮﻌﺗ: ﻩﺪﻧﺮﯿﮔ-ﻢﯿﻤﺼﺗ, ﻩﺪﺷ-ﺖﺳﺭﺩ-ﻪﻧﺍﺩﺎﺘﺳﺍ, ﻥﺩﺮﮐ-ﻒﯿﺻﻮﺗ
ﺮﺼﺤﻨﻣ: ﺩﻭﺪﺤﻣ, ﻥﺍﺮﮐ
ﻪﺠﻨﮔ: ﻪﻨﯿﺑﺎﮐ, ﻪﭽﻗﺎﺗ
ﻥﺩﺮﮐ-ﺭﺍﺩ-ﻪﻧﺍﺪﻧﺩ: ﻪﭽﻗﺎﺗ
ﺖﺳﺮﭘﺮﺳ: ﺮﺘﺴﮐﺭﺍ-ﺮﺒﻫﺭ, ﺱﺭﺯﺎﺑ
ﻪﺋﺍﺭﺍ: ﻥﺩﺮﮐ-ﯽﻓﺮﻌﻣ, ﺶﯾﺎﻤﻧ, ﻩﺎﮕﺸﯾﺎﻤﻧ, ﻊﯿﻓﺮﺗ
ﮏﯿﺘﺳﻻ﻿: ﭖﻮﺗ, ﻥﺎﺴﺸﮐ
ﻥﺩﺮﮐ-ﻡﻭﺮﺤﻣ: ﻥﺩﺮﮐ-ﻡﻭﺮﺤﻣ, ﻥﺩﺮﮐ-ﻑﺬﺣ, ﻥﺩﺍﺩ-ﺰﯿﻤﺗ
ﺯﺎﺘﻤﻣ: ﺯﺎﯿﺘﻣﺍ
ﻦﯿﺸﻧ-ﻪﺷﻮﮔ: ﻪﻧﺍﺪﻫﺍﺯ
ﺵﺍﺮﺧ: ﺵﺍﺮﺧ, ﻉﻭﺮﺷ
ﭻﯿﭘ: ﭻﯿﭘ
ﻒﺸﮐ: ﻥﺩﺮﮐ-ﻩﺪﻫﺎﺸﻣ, ﯼﺭﺍﺩﺮﺑ-ﻩﺮﻬﺑ
ﻥﺩﺮﮐ-ﻪﻤﯿﺑ: ﻥﺩﺍﺩ-ﻥﺎﻨﯿﻤﻃﺍ
ﺭﺪﻨﻠﯿﺳ: ﮏﺴﯾﺩ
ﻪﺻﻼ﻿ﺧ: ﯽﻠﮐ-ﺡﺮﻃ, ﻩﺪﯿﮑﭼ
ﺪﯿﻌﺑ: ﻝﺎﻤﺘﺣﺍ
ﻡﺎﺣﺩﺯﺍ: ﻪﻠﮔ, ﺮﺴﭘ-ﺪﻧﺯﺮﻓ
ﯽﻟﻮﺻﺍ: ﻡﺰﯿﻧﺎﮑﻣ
ﺎﺒﯾﺮﻘﺗ: ﯽﺘﺳﺍﺮﺑ, ﺎﺒﯾﺮﻘﺗ, ﯽﻠﻤﻋ
ﻩﺪﻨﻫﺩ-ﺵﺭﺎﻔﺳ: ﯽﺷﺭﺎﻔﺳ, ﻥﺎﻤﻬﻣ
ﺖﺳﺮﻬﻓ: ﺖﺳﺮﻬﻓ, ﺰﯿﻣ
ﯽﻤﯿﺷ-ﻢﻠﻋ: ﯽﯾﺎﯿﻤﯿﺷ
ﻦﺘﺨﭘ: ﻥﺎﻧ, ﻦﺘﺨﭘ
ﻥﺩﺮﮐ-ﺥﺍﺭﻮﺳ: ﻥﺩﺯ-ﻢﺧﺯ, ﺫﻮﻔﻧ, ﻥﺩﺮﮐ-ﺥﺍﺭﻮﺳ-ﻪﺘﻣ ﺎﺑ, ﻥﺩﺮﮐ-ﺥﺍﺭﻮﺳ
ﻥﺩﻮﺑﺭ: ﻥﺩﺍﺩ-ﺮﺟ, ﻥﺩﺮﮐ-ﺐﺣﺎﺼﺗ, ﯽﯾﺎﺑﺭ-ﻡﺩﺁ
ﯼﺯﺍﺪﻧﺍ-ﻩﺍﺭ: ﻦﺘﺨﯾﺭ-ﻥﻭﺮﯿﺑ, ﺐﻟﺎﻗ
ﯼﺯﺭﻭﺎﺸﮐ: ﯼﺯﺭﻭﺎﺸﮐ
ﺮﮕﯾﺯﺎﺑ: ﺮﮕﯾﺯﺎﺑ
ﺮﺗﺎﺌﺗ: ﺮﺗﺎﺌﺗ, ﻦﻟﺎﺳ
ﻭﺭﺍﺩ: ﻭﺭﺍﺩ
ﺮﻀﻣ: ﺮﺗﺪﺑ, ﺭﺮﺿ, ﺱﻮﮑﻌﻣ, ﯽﻔﻨﻣ, ﺭﻭﺁ-ﻥﺎﯾﺯ
ﺕﺎﺒﻧ: ﻉﺎﻨﻌﻧ, ﺕﻼ﻿ﮑﺷ, ﻦﯾﺮﯿﺷ
ﺮﯿﻤﺧ: ﻢﯿﻈﻨﺗ, ﺪﻨﺑ-ﻥﺩﺮﮔ
ﻡﻮﮑﺤﻣ: ﻡﺍﺩ, ﻥﺩﺮﮐ-ﻪﯿﺒﻨﺗ, ﺭﺎﮑﻫﺎﻨﮔ
ﯽﺳﺭﺮﺑ: ﺮﮕﺷﻭﺎﮐ, ﻥﺩﺮﮐ-ﻩﺪﻫﺎﺸﻣ, ﯽﺳﺭﺮﺑ
ﻪﺘﺴﺑ: ﻥﺩﺮﮐ-ﯼﺪﻨﺑ-ﻪﺘﺴﺑ, ﻢﯿﻈﻨﺗ, ﻪﺘﺴﺑ
ﻥﺪﯾﺰﺧ: ﻥﺪﯾﺰﺧ, ﻥﺪﺷ-ﻻ﻿ﻭﺩ-ﺱﺮﺗ ﺯﺍ
ﯽﻧﺎﻬﮔﺎﻧ-ﻭ-ﻢﮑﺤﻣ ﻪﺑﺮﺿ: ﭖﺎﭘ, ﮏﯿﻠﮐ, ﺮﯾﻮﺼﺗ, ﺪﻣ-ﻭ-ﺭﺰﺟ, ﯼﺩﻭﺯ-ﻪﺑ
ﮏﯿﺘﺳﻻ﻿: ﻦﯿﻨﺟ, ﻪﻘﻠﺣ
ﻪﺟﻮﺗ-ﻞﺑﺎﻗ: ﻪﺟﻮﺗ-ﻞﺑﺎﻗ, ﺩﻮﻬﺸﻣ
ﻪﺘﺴﻫ: ﯼﺎﻨﺑ-ﺮﯾﺯ
ﻒﻠﺳ: ﺪﺟ
ﻪﺑﺎﺸﻣ-ﺭﻮﻃ-ﻪﺑ: ﺐﯿﺗﺮﺗ-ﻦﯿﻤﻫ-ﻪﺑ, ﻥﺎﺴﮑﯾ
ﺪﺳ: ﮎﺎﺧ-ﻭ-ﺩﺮﮔ
ﻩﺪﻧﺰﻐﻟ: ﺵﺰﻐﻟ
ﯽﻧﻮﮔﺮﮔﺩ: ﻥﺩﺍﺩ-ﺮﯿﯿﻐﺗ
ﻪﯿﺷﺎﺣ: ﻪﺒﻟ
ﻞﺤﻣ: ﺖﯿﻌﻗﻮﻣ, ﻪﻄﻘﻧ
ﻪﺷﻮﺧ: ﻁﻼ﻿ﺘﺧﺍ, ﻡﺮﺟ, ﺪﻧﺎﺑ
ﻝﻮﻗ-ﻞﻘﻧ: ﻝﻮﻗ-ﻞﻘﻧ
ﻒﯿﻗﻮﺗ: ﯽﺷﻮﮐ-ﺖﺨﺳ, ﻥﺩﺍﺩ-ﺖﻴﻤﻫﺍ
ﻞﻤﺘﺤﻣ: ﻝﻮﺒﻗ-ﻞﺑﺎﻗ
ﺏﺎﺗﺮﭘ: ﺐﻟﺎﻗ
ﻪﻠﭘ: ﺝﺁ
ﺰﮐﺮﻤﺗ: ﯽﮕﺘﺷﺎﺒﻧﺍ, ﺰﮐﺮﻤﺗ
ﯽﺘﺳﺩ: ﯽﻠﻤﻋ, ﺖﺣﺍﺭ
ﻪﻤﻌﻃ: ﻢﻌﻃ, ﺮﮔﺯﺎﻏﺁ
ﻉﻮﻨﺘﻣ: ﻒﻠﺘﺨﻣ
ﻪﮑﺗ: ﻪﺷﺍﺮﺗ, ﮏﺴﯾﺩ, ﻪﻤﻘﻟ
ﻪﺘﻣ: ﻥﺩﺮﮐ-ﺥﺍﺭﻮﺳ-ﻪﺘﻣ ﺎﺑ, ﯼﺭﺎﻔﺣ
ﺦﺳﺎﭘ: ﻞﻤﻌﻟﺍ-ﺲﻜﻋ, ﺩﺍﺩﺮﺘﺳﺍ, ﻩﺪﺑ-ﺏﺍﻮﺟ
ﺮﯿﻣﻭ-ﮒﺮﻣ: ﮒﺮﻣ
ﺯﺮﻫ-ﻒﻠﻋ: ﻦﻤﭼ
ﯽﺒﺴﻧ-ﺭﻮﻃ-ﻪﺑ: ﻢﺠﺣ
ﯽﺿﺎﯾﺭ: ﺕﺎﯿﺿﺎﯾﺭ, ﯽﺷﺯﺭﻭ
ﯽﻗﻼ﻿ﺧﺍ-ﺮﻈﻧ-ﺯﺍ: ﯽﻗﻼ﻿ﺧﺍ
ﻥﺩﺯ-ﺲﻔﻧ-ﺲﻔﻧ: ﻩﺁ, ﺲﻔﻧ
ﻪﻘﺑﺎﺴﻣ: ﻪﻘﺑﺎﺴﻣ
ﺍﻭﺰﻧﺍ: ﯽﯾﺍﺪﺟ, ﻢﻫ-ﺯﺍ-ﺍﺪﺟ
ﺖﻗﻭ-ﺪﻨﭼ: ﺎﻬﺘﻗﻭ-ﯽﻀﻌﺑ
ﻎﻟﺎﺑ: ﻎﻟﺎﺑ
ﯽﺘﺨﺳ: ﺦﻠﺗ, ﯽﺘﺨﺑﺪﺑ, ﻞﮑﺸﻣ, ﯼﺭﻮﺨﻟﺩ
ﻪﻌﯾﺎﺷ: ﺱﺎﺳﺍ-ﯽﺑ-ﺕﺎﻌﯾﺎﺷ, ﺍﺪﺻ
ﺮﺑﺍﺮﺑ-ﺭﺩ-ﺖﻣﻭﺎﻘﻣ: ﻆﻔﺣ, ﻞﻤﺤﺗ, ﻪﺘﺷﺬﮔ
ﺮﺘﻫﺯﺎﺗ: ﻥﺍﻮﺟ
ﯽﮔﺪﻨﻓﺎﺑ: ﻩﺮﮔ
ﻢﯿﻘﺘﺴﻣ-ﺮﯿﻏ: ﻢﯿﻘﺘﺴﻣ-ﺭﻮﻃ-ﻪﺑ
ﻪﻘﺑﺎﺳ: ﻝﺎﺜﻣ
ﻭﺮﻫﺍﺭ: ﻪﻌﺷﺍ, ﻦﻟﺎﺳ, ﺭﻮﺒﻋ
ﺾﻗﺎﻨﺗ: ﺾﻗﺎﻨﺗ, ﺭﺎﮑﻧﺍ
ﻥﺩﺭﻭﺍ-ﺭﺩ-ﻭﺮﮔ ﺯﺍ: ﯽﯾﻮﺟ-ﻪﻓﺮﺻ, ﻥﺩﺮﮐ-ﻥﺍﺮﺒﺟ
ﻩﺎﮔﺭﺬﮔ: ﺮﯿﺴﻣ, ﻩﺩﺎﯿﭘ-ﺮﺑﺎﻋ-ﻂﺧ
ﻩﺪﻧﺩ: ﺕﺍﺰﯿﻬﺠﺗ, ﺎﻬﻧﺍﺪﻧﺩ, ﻩﺪﻧﺩ, ﻥﺪﯾﻭﺩ
ﻦﺸﺟ: ﻦﺸﺟ
ﻡﺮﻧ-ﻭ-ﻡﺮﮔ: ﻡﺮﮔ, ﺖﺣﺍﺭ
ﺮﺸﻧ-ﻭ-ﭖﺎﭼ: ﺭﺎﺸﺘﻧﺍ, ﻊﯾﺯﻮﺗ
ﯼﺮﺘﺸﻣ: ﻥﺎﻤﻬﻣ, ﺭﺍﺪﯾﺮﺧ
ﻪﭽﯿﻟﺎﻗ: ﺵﺮﻓ, ﻪﻘﺒﻃ, ﻮﺘﭘ
ﻢﯿﺴﻘﺗ: ﻥﺩﺮﻤﺷ
ﺯﺍﺪﻧﺍ-ﻢﺸﭼ: ﻩﺎﮕﻧ, ﺯﺍﺪﻧﺍ-ﻢﺸﭼ
ﯽﯾﺎﺒﯾﺯ: ﯽﯾﺎﺒﯾﺯ
ﺯﺍ-ﻥﺪﺷ-ﻦﯿﮕﻤﺸﺧ: ﺕﺮﻔﻧ
ﺖﻟﺎﺣ: ﺩﺎﻬﻨﺸﯿﭘ, ﻥﺩﺮﮐ-ﺭﺍﺩﺍﻭ, ﻥﺩﺎﺘﺴﯾﺍ
ﺖﻋﺎﻨﻗ: ﯽﺿﺍﺭ
ﻢﺴﯿﻧﺎﮔﺭﺍ: ﺩﻮﺟﻮﻣ
ﻡﻮﻬﻔﻣﺎﻧ: ﻦﮐ-ﮎﺭﺩ
ﺪﮐﻮﻣ: ﺪﯿﮐﺎﺗ
ﺮﻬﻇ: ﺮﻬﻇ-ﺯﺍ-ﺪﻌﺑ, ﺏﻮﻨﺟ
ﻖﺒﻧﺯ: ﻥﺪﻧﺍﻮﺧ
ﻢﺳﺍ: nominalization, ﻡﺎﻧ
ﻮﺷﺎﺗ: ﻥﺩﺮﮐ-ﺎﺗ, ﻩﺪﺷ-ﻢﺧ
ﺪﯿﻔﻣ: ﮏﻤﮐ
ﻪﻣﺍﺩﺍ: ﻥﺩﺮﮐ-ﺭﺍﺮﺻﺍ, ﻪﻣﺍﺩﺍ, ﻪﺘﺷﺬﮔ
ﺰﯾﺮﭘ: ﺝﻭﺮﺧ, ﺰﯾﺮﭘ, ﺖﻤﯾﺰﻋ
ﻥﺩﺮﺑ-ﺙﺭﺍ: ﺙﺭﺍﻭ
ﺖﻋﺮﺳ: ﺖﻋﺮﺳ, ﻥﺩﺮﮐ-ﻊﯾﺮﺴﺗ
ﻦﯿﻫﻮﺗ: ﯽﻫﺎﻔﺷ
ﺩﻮﺒﻤﮐ: ﻩﺪﻨﺴﺑﺎﻧ, ﺵﺮﺑ, ﻑﺬﺣ, ﺺﻗﺎﻧ
ﻥﺎﻨﯿﻤﻃﺍ: ﻥﺩﺍﺩ-ﻥﺎﻨﯿﻤﻃﺍ
ﻪﻧﺎﻔﺼﻨﻣ-ﺮﯿﻏ: ﺖﺳﺭﺩ
ﺮﯾﺯ: ﻥﺩﺮﮐ-ﻦﯾﺰﮕﯾﺎﺟ
ﻞﻄﺳ: ﻪﮑﺸﺑ, ﻖﺷﺎﻗ
ﻥﺎﻣﺯﺎﺳ: ﻥﺎﻣﺯﺎﺳ
ﻝﻭﺍ-ﻪﺟﺭﺩ-ﺭﺩ: ﺹﻮﺼﺨﺑ
ﺕﺎﻔﯾﺮﺸﺗ: ﻢﺳﺍﺮﻣ, ﺕﺩﺎﺒﻋ
ﻥﺍﺭ: ﻥﻮﺒﻣﺍﮊ, ﺎﭘ
ﯽﺘﺧﺭ-ﺎﺟ: ﺎﻫ-ﺱﺎﺒﻟ, ﻪﻨﯿﺑﺎﮐ
ﺖﻓﺎﺑ: ﻥﺎﻣﺯﺎﺳ
ﺶﮐﺮﺳ: ﺪﯾﺪﺷ
ﺏﺍﺩﺮﻣ: ﻕﻼ﻿ﺗﺎﺑ
ﺮﺒﺧ-ﯽﺑ: ﻥﺍﺩﺎﻧ
ﻪﯿﻟﻭﺍ: ﺡﺎﺘﺘﻓﺍ, ﯽﻠﺻﺍ, ﻉﻭﺮﺷ, ﻝﻭﺍ, ﻪﯿﻟﻭﺍ
ﻞﻗﺍﺪﺣ: ﻦﯾﺮﺘﻤﮐ
ﺡﻼ﻿ﺻﺍ: ﺕﺎﺣﻼ﻿ﺻﺍ, ﺮﻈﻧ-ﺪﯾﺪﺠﺗ, ﯼﺯﺎﺳﺯﺎﺑ
ﻥﺩﺮﮐ-ﯽﺷﻮﭘ-ﻢﺸﭼ: ﯽﺷﻮﭘ-ﻢﺸﭼ, ﻥﺩﺮﮐ-ﺵﻮﻣﺍﺮﻓ
ﻝﻮﻘﻟﺍ-ﻖﻔﺘﻣ: ﺪﺤﺘﻣ
ﻦﺑﺮﮐ: ﮓﻨﺳ-ﻝﺎﻏﺯ
ﭻﯿﭘ-ﻢﯿﺳ: ﻞﯾﺎﻓ, ﻝﻭﺭ, ﺪﻌﺠﻣ
ﺩﺮﺗ: ﻩﺪﻨﻨﮑﺷ, ﺰﯿﺗ
ﻥﺎﮔﮊﺍﻭ: ﺖﻐﻟ-ﮓﻨﻫﺮﻓ
ﻥﺩﺯ-ﻡﺪﻗ: ﻥﺩﻮﺑ-ﻥﺍﺩﺮﮔﺮﺳ
ﻡﺍﺪﻧﺍ-ﺐﺳﺎﻨﺗ: ﻦﯾﺮﻤﺗ, ﮏﯿﺘﺳﺎﻨﻤﯾﮊ, ﺖﯿﻌﺿﻭ
ﺖﯿﻠﻣ: ﻡﺰﯿﻟﺎﻧﻮﯿﺳﺎﻧ, ﯽﻠﻣ
ﻢﻌﻃ: ﻢﻌﻃ
ﺖﯿﻤﻫﺍ-ﯽﺑ: ﻡﺯﻻ﻿, ﯽﻬﯾﺪﺑ, ﻂﺒﺗﺮﻣ-ﺮﯿﻏ
ﺖﺸﻣ: ﻢﺘﺷ-ﻭ-ﺏﺮﺿ
ﻦﺘﺷﺍﺩﺮﺑ-ﺪﻨﻠﺑ-ﯼﺎﻫ ﻡﺎﮔ: ﻦﺘﻓﺭ-ﺶﯿﭘ, ﺝﺁ
ﺭﻮﺤﻣ: ﻪﻧﺎﺷ, ﭖﺎﭼ
ﺶﺨﺑ-ﺖﯾﺎﺿﺭ: ﯼﺭﺎﻤﯿﺑ, ﯽﺿﺍﺭ
ﺩﺎﻤﺘﻋﺍ-ﻞﺑﺎﻗ: ﻥﺎﻤﯾﺍ-ﺎﺑ
ﺭﻭﺁ-ﺵﺪﻨﭼ: ﺕﺮﻔﻧ, ﺖﺷﺯ
ﯽﻗﻼ﻿ﺧﺍ: ﯽﻗﻼ﻿ﺧﺍ
ﻁﻮﻘﺳ: ﻁﻮﻘﺳ
ﻦﺳﻮﮐ: ﻪﻧﺎﺧﺩﻭﺭ
ﻥﺩﺮﮐ-ﺕﺎﻣ: ﺭﺩ-ﻥﺩﺮﺑ-ﺖﺳﺩ, ﻦﺘﻓﺭ-ﻦﯿﺑ-ﺯﺍ, ﻥﺩﺮﮐ-ﺕﺎﻣ, ﺖﺴﮑﺷ, ﺭﺎﺴﻣﺮﺷ
ﻩﺭﻮﻄﺳﺍ: ﻥﺎﺘﺳﺍﺩ, ﻪﻧﺎﺴﻓﺍ
ﺖﯿﮑﻟﺎﻣ: ﯽﮔﮋﯾﻭ
ﻥﺪﻧﺎﺳﺮﺗ: ﻩﺩﺯ-ﺖﺸﺣﻭ, ﮎﺎﻨﺘﺸﺣﻭ, ﺱﺮﺗ
ﺰﻣﺮﺗ: ﺢﻳﺮﻔﺗ-ﮓﻧﺯ
ﻩﺮﻬﻣ: ﺕﺎﺑﻮﺒﺣ, ﻪﻧﺍﺩ
ﻥﺩﺮﮐ-ﮒﺭﺰﺑ: ﻡﺭﻮﺗ, ﻥﺩﺍﺩ-ﺶﯾﺍﺰﻓﺍ
ﯼﺪﯿﺷﺭﻮﺧ: ﺏﺎﺘﻓﺍ-ﺭﻮﻧ
ﺭﺎﻘﻨﻣ: ﺐﻟ, ﺪﺣﺍﻭ
ﻩﺭﺎﺟﺍ: ﯽﯾﺎﺗ-ﻪﺳ-ﻪﺘﺳﺩ, ﻥﺩﺮﮐ-ﻩﺭﺎﺟﺍ
ﺖﺒﺴﻧ: ﻂﺑﺍﻭﺭ, ﻪﺴﯾﺎﻘﻣ, ﺱﺎﯿﻘﻣ, ﺵﺭﺍﺰﮔ, ﺱﺎﯿﻗ
ﻪﻧﺎﺷ: ﻮﻣ-ﻢﻠﻗ, ﻪﻧﺎﺷ, ﺱﺍﺮﻟﺍ-ﻂﺧ
ﻥﺩﺮﮐ-ﻪﻤﺟﺮﺗ: ﻪﻤﺟﺮﺗ, ﺮﮕﻨﻠﺗ
ﺢﯾﺮﻔﺗ: ﯽﻣﺮﮔﺮﺳ-ﻭ​​-ﺢﯾﺮﻔﺗ, ﺕﻼ﻿ﯿﻄﻌﺗ, ﺏﺎﺼﻋﺍ-ﺩﺪﻤﺗ
ﺱﻮﻫ-ﻭ-ﯼﻮﻫ: ﮓﻧﺭ
ﻪﻧﻮﻤﻧ: ﻝﺎﺜﻣ, ﻥﺩﺮﻛ-ﺵﻼ﻿ﺗ
ﻊﻤﺟ: ﻡﺮﺟ
ﻞﻤﻋ-ﺭﺎﮑﺘﺑﺍ: ﺡﺮﻃ, ﻥﺩﺮﻛ-ﺵﻼ﻿ﺗ
ﻪﻟﮊ: ﺎﺑﺮﻣ, ﺮﯿﺷ
ﺝﺮﻣ-ﻭ-ﺝﺮﻫ: ﻝﻼ﻿ﺘﺧﺍ
ﻞﯾﺎﻓﻭﺮﭘ: ﯽﻠﮐ-ﺡﺮﻃ, ﻞﯾﺎﻓ, ﯽﺘﻧﺮﺘﻨﯾﺍ-ﺖﯾﺎﺳ
ﯽﯾﺍﺭﺍﺩ: ﻝﻮﭘ
ﯽﺳﺎﺳﺍ: ﯼﺎﻨﺑ-ﺮﯾﺯ, ﯼﺰﯿﭼ-ﺮﻫ-ﯽﻠﺻﺍ ءﺰﺟ
ﻥﺩﺮﮐ-ﺩﺮﻃ: ﻪﻟﺎﺑﺯ, ﺵﺭﻮﯾ
ﯽﮑﯾﺮﺘﮑﻟﺍ: ﮏﯿﻧﻭﺮﺘﮑﻟﺍ
ﻥﺎﻫﺎﯿﮔ-ﮒﺮﺑ-ﻭ ﺥﺎﺷ: ﻦﻤﭼ
ﻖﻧﻭﺭ: ﻥﺪﺷ-ﺎﻓﻮﮑﺷ
ﻪﺑﺎﺸﺗ: ﺱﺎﯿﻗ, ﻪﯿﺒﺷ, ﯽﮕﺘﺴﺒﻤﻫ
ﯽﺻﻮﺼﺧ-ﻢﯾﺮﺣ: ﯽﺻﻮﺼﺧ
ﻪﺻﺮﻋ: ﻩﺯﻮﺣ
ﺮﻓﺎﺴﻣ: ﺮﻓﺎﺴﻣ
ﻩﺭﺫ: ﻢﺗﺍ, ﻪﻧﺍﺩ
ﯽﺗﺍﺫ: ﯽﻠﺻﺍ
ﻦﮐﺎﺳ: ﻦﮐﺎﺳ
ﺕﻮﻠﻓ: ﺕﻮﺳ
ﻞﺜﻣ-ﺪﯿﻟﻮﺗ: ﯼﺭﻭﺭﺎﺑ
ﻝﻮﻃ: ﻝﻮﻃ
ﺩﻻ﻿ﺎﺳ: ﻮﻫﺎﮐ, ﺕﺭﺪﻗ
ﮓﻧﺭ: ﮓﻧﺭ
ﻥﺩﺍﺩ-ﻥﺎﺸﻧ: ﻥﺩﺮﻛ-ﺖﺑﺎﺛ
ﻕﻼ﻿ﺧﺍ-ﻝﻮﺻﺍ: ﯽﻗﻼ﻿ﺧﺍ
ﺎﻤﺳﺭ: ﯽﻤﺳﺭ
ﻥﺩﺮﮐ-ﮏﯾﺮﺤﺗ: ﻥﺩﺮﮐ-ﻪﻠﺧﺍﺪﻣ, ﻩﺪﻨﻫﺩ-ﺭﺍﺯﺁ, ﻦﺘﺧﺍﺪﻧﺍ-ﺖﺳﺩ-ﺍﺭ ﯽﺴﮐ, ﻥﺩﺮﮐ-ﮏﯾﺮﺤﺗ, ﻥﺩﺮﮐ-ﺥﺍﺭﻮﺳ-ﻪﺘﻣ ﺎﺑ
ﻥﺩﺭﻮﺧ-ﺮﺳ: ﺵﺰﻐﻟ
ﯽﮔﮋﯾﻭ: ﻪﺼﺨﺸﻣ, ﯽﮔﮋﯾﻭ, ﻂﺴﺑ
ﺯﺎﺴﮕﻨﻫﺁ: ﻥﺍﺩ-ﯽﻘﯿﺳﻮﻣ
ﻝﺎﺒﺗﻮﻓ: ﻥﺩﺯ-ﺪﮕﻟ
ﺖﮐﺭﺎﺸﻣ: ﯼﺭﺎﮑﻤﻫ, ﺩﺎﺤﺗﺍ, ﺖﮐﺭﺎﺸﻣ
ﻪﻣﺍﺩﺍ: ﻪﻣﺍﺩﺍ
ﯽﻌﯿﺒﻃ-ﺮﯿﻏ: ﻩﺮﻈﺘﻨﻣ-ﺮﯿﻏ, ﻞﺧ
ﻪﻟﺎﺒﻧﺩ: ﺮﯿﺠﻧﺯ
ﺭﺎﺸﻓ: ﺭﺎﺸﻓ
ﺎﺑ-ﺩﺭﻮﺧﺮﺑ: ﻥﺩﺮﮐ-ﺐﺣﺎﺼﺗ, ﻪﻠﺑﺎﻘﻣ, ﺕﺍﺰﯿﻬﺠﺗ
ﻥﺩﺮﮐ-ﺩﻭﺪﺤﻣ: ﯼﺭﺍﺩﺯﺎﺑ, ﻭﺭ-ﻩﺩﺎﻴﭘ, ﯼﺭﺍﺩ-ﻦﺘﺸﯾﻮﺧ
ﺕﺎﻐﯿﻠﺒﺗ: ﺩﻼ﻿ﯿﻣ-ﺯﺍ-ﺪﻌﺑ, ﺕﺎﻐﯿﻠﺒﺗ
ﺏﺎﺴﺣ-ﺯﺍ-ﺖﺷﺍﺩﺮﺑ: ﺖﻓﺮﺴﭘ, ﺰﯾﺮﭘ, ﻪﺠﯿﺘﻧ
ﻦﻫﺭ: ﻥﺎﮔﻭﺮﮔ, ﺭﺎﺒﺘﻋﺍ, ﻭﺮﮔ
ﻞﻤﺤﺗ: ﺮﺒﺻ, ﻞﻤﺤﺗ
ﻥﺩﺮﮐ-ﺏﻮﮐﺮﺳ: ﻥﺩﺮﮐ-ﯼﺮﯿﮔﻮﻠﺟ, ﻥﺩﺮﮐ-ﻢﺘﺳ
ﺮﺴﻤﻫ: ﺮﻫﻮﺷ
ﺮﺒﺘﻌﻣ: ﺭﺍﺬﮔ-ﺮﻴﺛﺎﺗ
ﻪﮑﻠﻓ-ﺮﯿﺷ: ﻥﻭ
ﺭﺎﺘﺧﺎﺳ: ﻥﺩﺭﻭﺁ-ﺩﻮﺟﻭ-ﻪﺑ, ﺎﻨﺑ, ﯼﺪﻨﺑ-ﻝﻮﻣﺮﻓ, ﺯﺎﻓ
ﺭﺎﺨﺑ: ﺭﺎﺨﺑ, ﺮﻫﻮﺷ-ﻭ-ﻥﺯ
ﺵﺎﻔﺧ: ﺏﻮﭼ, ﻩﺎﮕﺷﺎﺑ, ﻮﻠﺟ-ﻪﺑ
ﺾﻗﺎﻨﺘﻣ: ﺾﻗﺎﻨﺗ, ﻂﺒﺗﺮﻣ-ﺮﯿﻏ, ﺩﺎﻀﺘﻣ
ﮏﯿﺗﺎﻣﻮﺗﺍ: ﻢﯿﻘﺘﺴﻣ-ﺭﻮﻃ-ﻪﺑ
ﺢﯾﺮﺻ: ﻦﮐ-ﺯﺎﺑ, ﺖﯿﻓﺎﻔﺷ, ﻞﺻﺍ
ﺮﺛﻮﻣ-ﺭﻮﻃ-ﻪﺑ: ﺭﺍﺬﮔ-ﺮﻴﺛﺎﺗ, ﺮﺛﺍ
ﺩﺎﻤﺘﻋﺍ: ﯽﮕﺘﺴﺑﺍﻭ
ﯽﺳﺭﺯﺎﺑ: ﻥﺩﺮﮐ-ﻩﺪﻫﺎﺸﻣ, ﯽﺳﺭﺮﺑ, ﺵﺩﺮﮔ, ﻞﯿﻠﺤﺗ
ﺐﯿﺠﻋ: ﺐﻳﺮﻏ-ﻭ-ﺐﻴﺠﻋ, ﻩﺮﻈﺘﻨﻣ-ﺮﯿﻏ
ﻞﻘﻧ-ﻭ-ﻞﻤﺣ: ﻢﺳﺭ, ﺕﺭﺎﻏ
ﺭﻭﺁ-ﻡﺮﺷ: ﻡﺮﺷ, ﺭﺎﺴﻣﺮﺷ
ﻝﺎﻌﻓ-ﺮﯿﻏ: ﯽﻧﺍﻮﺗﺎﻧ, ﻝﺎﻌﻓ-ﺮﯿﻏ
ﺮﺒﮑﺘﻣ: ﺭﻭﺮﻏ
ﻪﻘﻠﺣ: ﺪﻌﺠﻣ, ﻪﻘﻠﺣ
ﺮﻫﻮﮔ: ﮓﻨﺳ, ﻥﺪﺷ-ﺎﻓﻮﮑﺷ
ﺩﺮﮕﻟﺎﺳ: ﺪﻟﻮﺗ-ﺯﻭﺭ
ﺭﺎﺒﺘﻋﺍ: ﺭﺎﺒﺘﻋﺍ
ﯼﺭﺎﮕﻧﺍ-ﻞﻬﺳ: ﻑﺬﺣ, ﺮﯿﻘﺤﺗ, ﯽﮕﻗﻼ﻿ﻋ-ﯽﺑ
-ﺩﻮﺧ: ﯽﺻﻮﺼﺧ
ﺾﯿﻌﺒﺗ: ﺎﻨﺜﺘﺳﺍ, ﻥﺩﺍﺩ-ﺰﯿﻤﺗ
ﯼﺎﻫﺭﺎﻗ: ﻩﺭﺎﻗ
ﻑﺪﻫ: ﻑﺪﻫ
ﻪﻓﺮﻏ: ﻩﺎﮕﺷﻭﺮﻓ, ﻥﺩﺎﺘﺴﯾﺍ
ﯼﺭﺍﺬﮔ-ﻪﯾﺎﻣﺮﺳ: ﯼﺭﺍﺬﮔ-ﻪﯾﺎﻣﺮﺳ
ﯽﯾﺎﯾﺭﺩ-ﺮﻔﺳ: ﯽﺘﺸﮐ
ﻊﻤﺠﺗ: ﯽﮕﺘﺴﺒﻤﻫ, ﻞﻤﻋ
ﻪﻌﯾﺎﺷ: ﺱﺎﺳﺍ-ﯽﺑ-ﺕﺎﻌﯾﺎﺷ, ﺍﺪﺻ
ﻪﻧﻻ﻿ﺎﻌﻓ: ﯼﺪﺟ-ﺭﻮﻃ-ﻪﺑ
ﯽﺳﺭﺮﺑ: ﯽﺳﺭﺮﺑ
ﻪﭘﻮﮐ: ﯽﻧﻮﮑﺴﻣ-ﻥﺎﻤﺗﺭﺎﭘﺁ
ﺹﺎﺧ-ﺭﻮﻃ-ﻪﺑ: ﺹﻮﺼﺨﺑ
ﺭﺎﺠﻔﻧﺍ: ﭖﺎﭘ, ﺭﺎﺠﻔﻧﺍ, ﺲﮑﻋ
ﻉﻮﻤﺠﻣ: ﺖﺷﺭﺩ, ﺞﯾﺍﺭ
ﺮﺴﮐ: ﺶﺨﺑ, ﻁﺮﺷ
ﯽﻧﻮﻧﺎﻗ-ﺮﯿﻏ: ﯽﻧﻮﻧﺎﻗ-ﺮﯿﻏ, ﯽﺸﺣﻭ
ﻥﺩﺮﮐ-ﻞﺣ: ﻥﺩﺮﮐ-ﻑﺬﺣ, ﻝﻮﻠﺤﻣ, ﻝﻼ﻿ﺣ
ﻝﺩﺎﻌﺗ: ﻝﺩﺎﻌﺗ
ﻑﺎﺸﺘﮐﺍ: ﺮﮕﺷﻭﺎﮐ, ﻞﯿﻠﺤﺗ
ﺯﺎﯿﭘ: ﻢﯿﻈﻌﺗ
ﯽﮕﺘﺴﺑﺍﻭ: ﺱﺎﯿﻗ, ﯽﮕﺘﺴﺒﻤﻫ, ﯽﮕﺘﺴﺑﺍﻭ
ﺐﻠﻘﺘﻣ: ﻥﺎﻤﯾﺍ-ﺎﺑ
ﺩﺭﻮﺧﺮﺑ: ﺩﺎﻀﺗ, ﻥﺪﺷ-ﻪﮐﻮﺷ, ﻥﺩﺮﮐ-ﻪﻠﺧﺍﺪﻣ
ﯽﺘﺣﺍﺭ-ﯽﻟﺪﻨﺻ: ﯽﻟﺪﻨﺻ, ﻪﭘﺎﻧﺎﮐ
ﺮﯿﻤﺧ: ﺭﺩﻮﭘ, ﻡﺮﺟ, ﺮﻤﺨﻣ, ﮏﯿﮐ
ﻮﺷ-ﺭﺍﻮﺳ: ﻥﺩﺮﮐ-ﻞﺻﻭ
ﯽﺷﻮﻬﯿﺑ: ﺯﺍﺪﻧﺍ-ﻢﺸﭼ
ﻥﺪﺷ-ﺩﺮﻃ: ﺭﺎﮑﻧﺍ, ﯽﻨﺘﺨﯾﺭ-ﺭﻭﺩ
ﺲﻧﺎﯾﺭﺍﻭ: ﺕﻭﺎﻔﺗ, ﺐﺳﺎﻨﻣ, ﺾﻗﺎﻨﺗ
ﺏﺬﺟ: ﺖﺳﻮﭘ
ﯽﻌﻤﺟ: ﻡﺮﺟ
ﻊﻗﻮﻤﺑ: ﻥﺎﻣﺯ
ﻪﻠﻤﺣ: ﻪﻠﻤﺣ
ﺝﺍﺮﺧﺍ: ﻪﺴﯿﮐ, ﯽﮕﻧﻭﺰﻓﺍ
ﻪﻈﺣﻼ﻿ﻣ-ﻞﺑﺎﻗ-ﺭﻮﻃ ﻪﺑ: ﯼﺩﺎﯾﺯ-ﺪﺣ-ﺎﺗ
ﯽﺑﺮﺠﺗ: ﻥﺎﺒﻠﺧ
ﻢﻠﯿﻓ: ﺎﻤﻨﯿﺳ-ﻢﻠﯿﻓ, ﻥﻮﯾﺰﯾﻮﻠﺗ, ﺮﯾﻮﺼﺗ
ﺕﺎﻐﯿﻠﺒﺗ: ﺕﺎﻐﯿﻠﺒﺗ, ﻊﯿﻓﺮﺗ, ﺩﻼ﻿ﯿﻣ-ﺯﺍ-ﺪﻌﺑ
ﻥﺩﺍﺩ-ﻪﻌﺳﻮﺗ: ﻥﺩﺮﮐ-ﻦﻬﭘ, ﺕﺎﯿﺋﺰﺟ
ﻥﺩﺮﮐ-ﺰﯿﺧ-ﻭ ﺖﺴﺟ: ﻥﺩﺭﻮﺧ-ﻮﻠﺗ-ﻮﻠﺗ, ﻁﻮﻘﺳ, ﺐﯿﺷ, ﺎﻫ-ﺱﺎﺒﻟ
ﻞﻌﺟ: ﻥﺩﺭﻭﺁ-ﺩﻮﺟﻭ-ﻪﺑ, ﺭﺩ-ﻥﺩﺮﺑ-ﺖﺳﺩ
ﻞﯿﺴﻓ: ﺖﻔﻧ, ﯽﺳﺎﻨﺷ-ﻥﺎﺘﺳﺎﺑ
ﺖﯾﺩﻭﺪﺤﻣ: ﻊﻧﺎﻣ, ﺕﺍﺭﺮﻘﻣ, ﯼﺭﺍﺩ-ﻦﺘﺸﯾﻮﺧ
ﻩﺰﻣ: ﻕﺎﯿﺘﺷﺍ, ﻪﯾﻭﺩﺍ, ﻪﺑﺮﺠﺗ, ﻢﻌﻃ, ﺖﺳﻮﭘ
ﺪﻨﺴﭘ-ﻞﮑﺸﻣ: ﻩﺪﻨﻫﺩ-ﺭﺍﺯﺁ
ﻩﺪﮑﻫﺩ: ﺮﻬﺷ-ﻪﻣﻮﺣ, ﻩﺪﮑﻫﺩ
ﺵﺮﻏ: ﻥﺪﺷ-ﺎﻓﻮﮑﺷ, ﯽﯾﻮﮔ-ﻑﺍﺰﮔ, ﺭﺎﺠﻔﻧﺍ
ﺮﯿﺜﮑﺗ: ﻪﺨﺴﻧ, ﻥﺩﺮﮐ-ﺪﯿﻠﻘﺗ
ﻩﺮﮕﻨﮐ: ﮊﺎﺘﻧﻮﻣ
ﺭﻮﮕﻧﺍ: ﺏﺍﺮﺷ
ﻩﺎﮔﺭﺎﮐ: ﻩﺎﮔﺭﺎﮐ, ﺭﺎﻨﯿﻤﺳ
ﻥﺩﺮﮐ-ﻝﻭﺰﻧ: ﻥﺩﺍﺩ-ﺶﻫﺎﻛ, ﺵﺮﺑ, ﻁﻮﻘﺳ
ﻆﻔﻠﺗ: ﻆﻔﻠﺗ
ﯼﺭﻭﺍﺩ: ﻢﯿﻤﺼﺗ, ﻪﻠﻤﺟ, ﻥﻮﻧﺎﻗ, ﯽﺿﺎﻗ, ﻩﺎﮔﺩﺍﺩ-ﻦﯾﺍ-ﺖﯿﺣﻼ﻿ﺻ, ﻥﺍﺮﺤﺑ
ﻦﺘﺷﺍﺩ-ﺰﮐﺮﻤﺗ: ﻖﯿﻗﺩ, ﺰﮐﺮﻤﺗ
ﻥﺩﺮﮐ-ﻞﻃﺎﺑ: ﻥﺩﺮﮐ-ﺵﺎﻓ, ﺖﺸﮔﺯﺎﺑ
ﯽﺘﺸﮐ: ﯽﻧﺎﺑﺩﺎﺑ-ﻖﯾﺎﻗ, ﯽﺘﺸﮐ
ﺖﺳﺍﺭ-ﺮﺳ: ﻩﺩﺎﺳ, ﻢﯿﻘﺘﺴﻣ-ﺭﻮﻃ-ﻪﺑ, ﯽﻧﺎﺳﺁ-ﻪﺑ, ﺖﯿﻓﺎﻔﺷ, ﯽﻄﺧ
ﻉﺎﻔﺗﺭﺍ: ﻝﻮﻃ
ﻥﺩﺮﮐ-ﯽﻨﻌﻣ: ﺶﯾﺎﻤﻧ, ﻦﺘﺷﺍﺩ-ﺭﻮﻈﻨﻣ
ﺕﺍﺭﺩﺎﺻ: ﺝﻭﺮﺧ
ﻒﻠﺨﺘﻣ: ﺭﺍﺩ-ﻪﻟﺎﺒﻧﺩ-ﻩﺭﺎﺘﺳ, ﺭﺎﮑﻫﺎﻨﮔ
ﺩﺭ: ﺖﻔﻟﺎﺨﻣ, ﺩﺭ
ﻝﺩﺎﻌﺗ: ﺮﻫﻮﺷ-ﻭ-ﻥﺯ, ﻝﺩﺎﻌﺗ
ﻥﺩﺮﺑ-ﻥﺎﯿﻣ-ﺯﺍ: ﻥﺩﺮﮐ-ﻑﺬﺣ
ﻥﺩﺮﮐ-ﻢﯿﻈﻨﺗ: ﺮﻈﻧ-ﺪﯾﺪﺠﺗ, ﺖﺑﺎﺛ, ﻕﺎﺒﻄﻧﺍ
ﺖﯾﻮﻀﻋ: ﻮﻀﻋ
ﻩﺯﺍﺪﻧﺍ: ﻦﺘﻓﺮﮔ-ﻩﺯﺍﺪﻧﺍ, ﺱﺎﯿﻘﻣ, ﻩﺯﺍﺪﻧﺍ, ﺮﻏﻻ﻿, ﺺﺧﺎﺷ
ﻥﺩﺮﻛ-ﻞﻤﺤﺗ: ﺶﺨﺒﺑ
ﻥﺍﺭ-ﻞﺼﻔﻣ: ﻦﯾﺮﺳ, ﺮﻤﮐ-ﺭﻭﺩ
ﻥﺪﯿﺒﺴﭼ: ﻥﺩﺮﮐ-ﻝﺎﺒﻧﺩ, ﻥﺩﺮﮐ-ﻞﺻﻭ, ﺏﻮﭼ, ﻆﻔﺣ
ﻥﺪﻧﺎﺸﻧ-ﺐﻘﻋ: ﻥﺩﺮﮐ-ﯼﺮﯿﮔﻮﻠﺟ
ﻡﺍﺭﺁ-ﺎﻧ: ﻝﻼ﻿ﺘﺧﺍ
ﺖﻔﻋ: ﺖﻗﺩ, ﺹﻮﻠﺧ
ﻞﺷ: ﺏﺎﺼﻋﺍ-ﺩﺪﻤﺗ, ﻞﺷ
ﺽﺎﺒﻘﻧﺍ: ﯽﯾﻭﺮﻤﮐ
ﺭﺎﮕﻧ-ﻪﻣﺎﻧﺯﻭﺭ: ﺭﺎﮕﻧﺮﺒﺧ
ﻪﻧﺎﺸﻧ: ﻩﺎﮕﺸﯾﺎﻤﻧ
ﻪﺧﺮﭼﻭﺩ: ﻱﺭﺍﻮﺳ-ﻪﺧﺮﭼﻭﺩ, ﻪﺧﺮﭼ
ﺮﯿﻗ: ﻭﺭ-ﻩﺩﺎﻴﭘ
ﭻﯿﭘﺭﺎﻣ: ﺶﺧﺮﭼ
ﺮﯿﺴﻔﺗ: ﻦﺴﮐﺍﻭ, ﻒﯾﺮﻌﺗ
ﻝﺎﻘﺘﻧﺍ: ﺖﻧﻮﻔﻋ
ﯼﺍﺭ-ﻪﻗﺭﻭ: ﺍﺪﺻ, ﺏﺎﺨﺘﻧﺍ
ﻩﻮﻘﻟﺎﺑ: ﺭﺩﺎﻗ
ﻂﯾﺍﺮﺷ-ﺪﺟﺍﻭ: ﺭﺩﺎﻗ, ﺖﺳﺭﺩ, ﻥﺪﺷ-ﻂﯾﺍﺮﺷ-ﺪﺟﺍﻭ, ﺐﺳﺎﻨﻣ
ﻪﻘﻠﺣ: ﻱﺭﺍﻮﺳ-ﻪﺧﺮﭼﻭﺩ, ﻻ﻿ﻮﻟ, ﻪﻘﻠﺣ
ﺮﮔﺭﺎﮐ: ﺪﻨﻣﺭﺎﮐ
ﺭﺍﺮﻗ-ﯽﻧﻮﻧﺎﻗ-ﺩﺮﮕﯿﭘ ﺖﺤﺗ: ﺶﻧﺯﺮﺳ
ﺯﻮﺠﻣ: ﻩﺯﺎﺟﺍ
ﻥﺩﺮﮐ-ﮎﺮﺗ: ﻪﯿﻠﺨﺗ
ﺲﻔﻧ: ﻥﺎﺷﺩﻮﺧ, ﺲﻔﻧ
ﺖﺟ: ﻦﺘﺧﺍﺪﻧﺍ-ﻥﻭﺮﯿﺑ, ﻩﺪﻧﺮﭘ, ﻥﺎﯾﺮﺟ
ﺾﻘﻧ: ﯽﻧﺎﻣﺮﻓﺎﻧ, ﺵﺮﺑ
ﺩﺎﺘﻌﻣ: ﯽﮕﺘﺴﺑﺍﻭ
ءﺎﻘﺑ: ﺮﻤﻋ-ﻝﻮﻃ, ﺭﺍﺩﺍﺪﺻ-ﻑﺮﺣ
ﯽﮔﺩﺯ-ﺦﯾ: ﻩﺩﺯ-ﺦﯾ
ﺖﻓﺎﺑ: ﻩﺮﮔ
ﺖﻗﻭ: ﺩﺎﺠﯾﺍ, ﻊﻔﻨﯾﺫ
ﯽﮕﻗﻼ﻿ﻋ-ﯽﺑ: ﯽﮕﻗﻼ﻿ﻋ-ﯽﺑ
ﻥﺩﺍﺩ-ﻥﺎﻣﺯﺎﺳ: ﻥﺎﻣﺯﺎﺳ, ﻥﺩﺮﮐ-ﻩﺩﺎﻣﺁ, ﻥﺩﺮﮐ-ﯽﻧﻮﻧﺎﻗ, ﻪﺘﻓﺎﯾ-ﻥﺎﻣﺯﺎﺳ
ﻻ﻿ﺎﻤﺘﺣﺍ: ﺪﯾﺎﺷ, ﺍﺮﻫﺎﻇ
ﺮﺗﻭ: ﯼﺭﺎﮑﻤﻫ-ﺩﺍﺩﺭﺍﺮﻗ
ﻦﺘﻓﺮﮔ-ﻥﻮﺧ: ﻥﻮﺧ, ﻦﯿﻧﻮﺧ
ﻒﺸﮐ: ﻩﺪﺷ-ﺍﺪﯿﭘ, ﻥﺩﺮﮐ-ﻮﺠﺘﺴﺟ, ﻥﺩﺮﮐ-ﺵﺎﻓ
ﻥﺪﯿﺑﻮﮐ-ﻢﻫﺭﺩ: ﻦﺘﻓﺭ-ﻦﯿﺑ-ﺯﺍ, ﺢﻳﺮﻔﺗ-ﮓﻧﺯ
ﻥﺩﺮﮐ-ﻞﯿﻬﺴﺗ: ﺏﺎﺘﺷ, ﺮﺘﺳﺎﻓ, ﺖﮐﺭﺎﺸﻣ
ﺲﻧﺎﮐﺮﻓ: ﻪﺧﺮﭼ, ﻎﯾﺭﺩ
ﻥﺩﺯ-ﻪﯿﺨﺑ: ﯽﮔﺪﻧﺯﻭﺩ
ﺎﻤﻨﻫﺍﺭ-ﺖﺳﺮﻬﻓ: ﮎﺭﺪﻣ
ﻥﺩﺮﮐ-ﻪﮑﺗ: ﺶﯿﻧ, ﺵﺮﺑ, ﮏﯿﺘﺳﺍ
ﺶﯾﺎﻣﺮﮔ: ﻡﺮﮔ
ﻩﺩﺮﺴﻓﺍ: ﻩﺪﻨﻨﮐ-ﺪﯿﻣﺍﺎﻧ, ﻦﯿﮕﻤﻏ
ﺎﺗﺩﻮﮐ: ﺏﻼ﻿ﻘﻧﺍ, ﺲﮑﻋ, ﻪﺑﺮﺿ
ﻥﺎﺑﺮﻬﻣ: ﻢﺣﺮﺗ
ﺯﺍﺩﺮﭘ-ﻩﺪﯾﺍ: ﯼﺮﮑﻓ
ﻪﺟﺩﻮﺑ: ﻝﺩﺎﻌﺗ
ﯽﻧﺪﻣ: ﯽﻧﺪﻣ, ﯼﺮﻬﺷ
ﻥﺩﺍﺩ-ﺭﺍﺮﻗ: ﻥﺪﺷ-ﻞﺧﺍﺩ, ﻥﺩﺍﺩ-ﺶﯾﺍﺰﻓﺍ
ﻥﺩﺮﮐ-ﺮﮑﻔﺗ: ﻥﺩﺮﮐ-ﺲﮑﻌﻨﻣ, ﺮﮑﻓ
ﺮﯾﺬﭘ-ﻑﺎﻄﻌﻧﺍ: ﻩﺩﺎﺳ, ﻥﺩﺮﮐ-ﻢﺧ, ﻥﺎﺴﺸﮐ
ﮓﻨﺳ-ﻪﺘﺨﺗ: ﻮﻠﺑﺎﺗ, ﺹﺮﻗ, ﻕﺎﺟﺍ
ﺖﯿﺣﻼ﻿ﺻ: ﺩﺍﺪﻌﺘﺳﺍ, ﻥﺪﺷ-ﻂﯾﺍﺮﺷ-ﺪﺟﺍﻭ
ﭻﯿﺋﻮﺳ: ﺱﻮﮑﻌﻣ, ﻞﯾﺪﺒﺗ, ﺪﯿﻠﮐ
ﻪﻟﻮﺣ: ﻪﭼﺭﺎﭘ
ﻪﻫﺩ: ﻩﺩ, ﻦﺘﺷﺍﺩ-ﻪﮕﻧ
ﻦﯾﺪﻨﭼ: ﻒﻠﺘﺨﻣ, ﺶﯿﺑ
ﯼﺪﻨﺑ-ﻢﺧﺯ-ﺭﺍﻮﻧ: ﺲﺳ, ﻥﺩﺮﮐ-ﺖﻔﺳ
ﺐﺗﺮﻣ: ﻪﺘﻓﺭ-ﻭ-ﻪﺘﺴﺷ
ﻥﺩﺯ-ﻒﮐ: ﻪﺑ-ﻥﺩﺯ-ﺖﺳﺩ ﻪﺘﺴﻫﺍ, ﻥﺩﺯ-ﻒﮐ
ﺍﺮﻓﺍ: ﺖﺳﺩ-ﻒﻛ
ﺶﮐ-ﻦﺷ: ﺖﺸﮔﺮﺑ-ﻭ-ﺖﻓﺭ
ﯽﭼﻮﭘ: ﯽﻟﺎﺧ
ﺰﻐﻣ: ﺖﻔﻧ, ﺰﻐﻣ, ﻭﺪﮐ
ﻑﻼ﻿ﻏ: ﺖﮐ, ﻪﻣﺎﻧ-ﺖﻛﺎﭘ, ﻑﻼ﻿ﻏ
ﻥﺪﺷ-ﺏﺬﺟ: ﯼﺭﺍﺩﺮﺑ-ﻩﺮﻬﺑ, ﻥﺩﺯ-ﮏﻣ, ﻦﺘﻓﺮﯾﺬﭘ
ﯽﻨﯿﺑ-ﺶﯿﭘ: ﯽﻨﯿﺑ-ﺶﯿﭘ-ﻞﺑﺎﻗ, ﻥﺰﺑ-ﺱﺪﺣ
ﺵﺯﻮﻣﺁ: ﺕﻼ﻿ﯿﺼﺤﺗ, ﺭﺎﻄﻗ, ﻢﯿﻠﻌﺗ
ﻮﺟ-ﻭ-ﺱﺮﭘ: ﺮﮕﺷﻭﺎﮐ, ﻥﺩﺮﮐ-ﺎﺿﺎﻘﺗ, ﻥﺩﺮﮐ-ﻮﺠﺘﺴﺟ
ﻪﻄﻠﺳ: ﻥﻮﻧﺎﻗ
ﯽﻨﯾﺪﻟﺍﻭ: ﻦﯾﺪﻟﺍﻭ
ﻥﺩﺮﮐ-ﺖﮐﺮﺷ: ﺎﺘﻟﺩ, ﻥﺩﺮﮐ-ﻞﺻﻭ, ﻝﻮﻐﺸﻣ
ﺭﻮﺴﻧﺎﺳﺁ: ﻥﺩﺮﮐ-ﺪﻨﻠﺑ
ﯽﺒﻧﺎﺟ: ﺖﻤﺳ
ﻥﺩﺎﺘﻓﺍ-ﻖﯾﻮﻌﺗ-ﻪﺑ: ﻦﺘﺧﺍﺪﻧﺍ-ﺮﯿﺧﺎﺗ
ﺕﺮﻔﻧ: ﺮﯿﻘﺤﺗ, ﺕﺮﻔﻧ
ﻪﺘﺴﻫ: ﯽﻤﺗﺍ, ﻝﻮﻠﺳ, ﻦﯿﻨﺟ
ﻩﺭﺎﻌﺘﺳﺍ: ﻝﺎﺜﻣ
ﮏﭼﻮﮐ: ﯽﻤﮐ-ﺭﺍﺪﻘﻣ, ﮏﭼﻮﮐ
ﺐﻤﺑ: ﻪﺒﻤﻠﺗ
ﻪﻧﺍﺪﻘﺘﻨﻣ: ﻖﯿﻤﻋ, ﺪﻘﺘﻨﻣ
ﮓﻧﺯ: ﻥﺩﺮﮐ-ﯽﻃ
ﻭﺭﺯﺭ: ﻆﻔﺣ, ﻥﺩﺮﮐ-ﺐﺣﺎﺼﺗ
ﻦﺘﺧﻭﺩ: ﯽﮔﺪﻧﺯﻭﺩ
ﻥﺍﺩ-ﯽﻤﯿﺷ: ﯽﯾﺎﯿﻤﯿﺷ
ﻦﻟﺎﺳ: ﺢﻳﺮﻔﺗ-ﮓﻧﺯ, ﻦﻟﺎﺳ
ﻉﻭﺮﺷ: ﻉﻭﺮﺷ, ﺵﺭﻮﯾ, ﻪﻠﻤﺣ
ﻪﺟﺮﯿﺷ: ﺐﯿﺷ
ﻪﻧﺎﺘﺳﻭﺩ-ﺮﯿﻏ: ﻢﺻﺎﺨﺘﻣ
ﯼﺭﺎﻤﺷﺮﺳ: ﻪﺒﺳﺎﺤﻣ
ﻡﻮﮑﺤﻣ: ﻥﺩﺮﮐ-ﻢﻬﺘﻣ, ﻪﻠﻤﺟ
ﮎﺭﺬﺑ: ﯽﻧﺎﺘﮐ-ﻪﭼﺭﺎﭘ
ﻥﺩﺮﮐ-ﻖﻠﻌﻣ: ﻥﺩﺮﮐ-ﯼﺮﯿﮔﻮﻠﺟ
ﻥﺩﺯ-ﯽﻠﯿﺳ: ﻢﺘﺷ-ﻭ-ﺏﺮﺿ
ﺵﺎﺑ-ﻡﻭﺭﺁ: ﺏﺎﺼﻋﺍ-ﺩﺪﻤﺗ
ﻪﻘﺷﺎﻌﻣ: ﻁﺎﯿﺣ
ﻻ﻿ﺎﮐ: ﺕﻻ﻿ﻮﺼﺤﻣ
ﯽﮕﺘﺳﻮﯿﭘ: ﯽﮕﺘﺳﻮﯿﭘ
ﻞﺑﺎﻘﺘﻣ: ﻝﺩﺎﺒﺗ, ﯽﮕﻧﻭﺭﺍﻭ
ﻪﺨﺴﻧ: ﻭﺭﺍﺩ, ﻪﺨﺴﻧ
ﺏﺎﺒﺣ: ﻒﮐ
ﻞﯿﺑ: ﮎﺮﺒﻧﺍ, ﻭﺭﺎﭘ
ﻩﺩﺎﻔﺘﺳﺍ: ﯼﺭﺍﺩﺮﺑ-ﻩﺮﻬﺑ, ﻥﺩﺮﮐ-ﻩﺩﺎﻔﺘﺳﺍ, ﻥﺩﺮﮐ-ﺝﺮﺧ, ﻪﻨﻫﺩ, ﻥﺩﺮﮐ-ﻑﺮﺼﻣ
ﻡﺍﻭﺩ-ﺎﺑ: ﯽﻧﻻ﻿ﻮﻃ
ﺐﺴﻧ-ﻭ-ﻞﺻﺍ: ﺎﻨﺷﺁ
ﯼﻭﺭ-ﺰﻠﻓ: ﯽﯾﻮﺸﻓﺮﻇ-ﮏﻨﯿﺳ
ﻪﮐ-ﻡﺍﺪﮐ-ﺮﻫ: ﻪﭼ-ﺮﻫ, ﻪﮐ
ﺩﻭﺪﺤﻣ: ﺩﻭﺪﺤﻣ, ﺖﯾﺎﻬﻧ-ﺭﺩ, ﺪﯿﺳﺭ-ﻥﺎﯾﺎﭘ-ﻪﺑ
ﯽﮑﻤﮐ: ﯽﻣﺎﺣ, ﺯﺪﯾﺍ
ﺵﻼ﻿ﺗ: ﻒﯾﺮﺤﺗ, ﻥﺩﺮﮐ-ﻩﺯﺭﺎﺒﻣ, ﻪﺑﺮﺿ
ﯽﻫﺎﮕﺸﻧﺍﺩ: ﺕﻼ﻿ﯿﺼﺤﺗ
ﮏﯿﺘﺳﻻ﻿: ﻦﯿﻨﺟ, ﻪﻘﻠﺣ
ﻩﺪﻨﻨﻛ-ﻑﺮﺼﻣ: ﻥﺩﺮﮐ-ﻩﺩﺎﻔﺘﺳﺍ
ﺭﺎﺒﺘﻋﺍ: ﺵﺯﺭﺍ, ﺭﺎﺒﺘﻋﺍ
ﺎﺒﯾﺮﻘﺗ: ﺎﺒﯾﺮﻘﺗ, ﯽﺒﯾﺮﻘﺗ
ﯽﻨﺘﻓﺎﺑ: ﻩﺮﮔ
ﭗﮑﺳﻭﺮﮑﯿﻣ: ﭖﻮﮑﺴﻠﺗ
ﯽﻣﺎﻈﻧ-ﺮﯿﻏ: ﯽﻧﺪﻣ
ﻪﻤﺴﺗ: ﯽﯾﺎﺗ-ﻪﺳ-ﻪﺘﺳﺩ, ﺏﺎﻨﻃ
ﻦﯾﺩﺎﻤﻧ: ﺖﺳﮊ, ﺖﯾﻮﻫ
ﻕﺎﺒﻄﻧﺍ: ﻕﺎﺒﻄﻧﺍ, ﻪﻠﺑﺎﻘﻣ, ﻥﺩﺮﮐ-ﯽﺴﯾﻮﻧﻭﺭ
ﻝﺎﻤﺘﺣﺍ: ﻝﺎﻤﺘﺣﺍ, ﺭﺩﺎﻗ
ﯽﻨﻫﺫ: ﯽﻨﻫﺫ
ﺮﯿﻤﺿ: ﻥﺍﺪﺟﻭ
ﻩﺎﺒﺘﺷﺍ: ﻩﺎﺒﺘﺷﺍ, ﻩﺩﺎﻔﺘﺳﺍ-ﻮﺳ
ﻥﺩﺮﮐ-ﺩﺮﺴﻟﺩ: ﺭﺎﺴﻣﺮﺷ, ﯽﺒﻠﻃ-ﻩﺎﺟ
ﺩﺭﺍﻭ-ﻩﺯﺎﺗ: ﻥﺎﻤﻬﻣ
ﺖﯾﺎﻬﻧ-ﯽﺑ: ﺭﺪﺼﻣ
ﮏﯿﻓﺍﺮﮔ: ﯽﻧﺎﻣﺯﺎﺳ-ﺕﺭﺎﭼ
ﻞﮑﺷ: ﻞﮑﺷ, ﺮﯾﻮﺼﺗ
ﺭﺍﻮﯾﺩ-ﺭﺩ-ﯽﮕﺘﻓﺭ ﻮﺗ: ﺭﺍﻮﺘﺳﺍ, ﺪﯿﻠﮐ
ﺪﯿﻣﺍ-ﺎﻧ: ﻩﺪﻨﻨﮐ-ﺪﯿﻣﺍﺎﻧ, ﻥﺩﺮﮐ-ﺖﻧﺎﯿﺧ, ﺖﺴﮑﺷ
ﺡﺮﻃ: ﺡﺮﻃ, ﺶﯾﺎﻤﻧ
ﯽﯾﺎﻫﺭ: ﻪﯿﻠﺨﺗ, ﺕﺎﺠﻧ
ﻞﻤﻌﻟﺍ-ﺭﻮﺘﺳﺩ: ﮎﺮﺤﻣ
ﻥﺩﺍﺩ-ﯼﺍﺭ-ﻖﺣ: ﺯﺎﯿﺘﻣﺍ
ﺲﻧﺎﺠﺘﻣﺎﻧ: ﻑﺮﺧﺰﻣ, ﻂﺒﺗﺮﻣ-ﺮﯿﻏ, ﻩﺪﻨﺴﺑﺎﻧ
ﺶﺧﺮﭼ: ﻪﺧﺮﭼ, ﺏﻼ﻿ﻘﻧﺍ, ﺶﺧﺮﭼ
ﻩﺮﯿﮕﺘﺳﺩ: ﻪﻧﺍﻮﺟ
ﺮﺘﻣ: ﻦﺘﻓﺮﮔ-ﻩﺯﺍﺪﻧﺍ
ﺖﯾﺩﻭﺪﺤﻣ: ﻥﺍﺮﮐ, ﯼﺭﺍﺩ-ﻦﺘﺸﯾﻮﺧ, ﺕﺍﺭﺮﻘﻣ
ﯼﺪﻨﺑ-ﻪﺘﺳﺩ: ﻉﺎﻤﺘﺟﺍ, ﻪﺒﺗﺭ
ﯼﺩﺍﮋﻧ: ﻪﻘﺑﺎﺴﻣ, ﯽﺘﺳﺮﭘ-ﺩﺍﮋﻧ
ﯽﻨﯾﺰﮕﯾﺎﺟ: ﯼﺎﺠﺑ, ﻥﺩﺮﮐ-ﻦﯾﺰﮕﯾﺎﺟ, ﻥﺩﺍﺩ-ﺮﯿﯿﻐﺗ
ﯼﺭﻭﺁﻮﻧ: ﻉﺍﺮﺘﺧﺍ
ﺎﺑ-ﻥﺪﺷ-ﻭﺮﺑﻭﺭ: ﻪﻠﺑﺎﻘﻣ
ﻥﺩﺮﮐ-ﻊﻨﻣ: ﺭﺎﮑﻧﺍ
ﯽﺘﻨﯾﺯ: ﺖﻨﯾﺯ
ﻭﺮﻫﺍﺭ: ﻥﺩﺮﮐ-ﺭﺍﺩﺍﻭ, ﻦﻟﺎﺳ
ﺏﺎﺗﺮﭘ: ﺐﻟﺎﻗ, ﺪﻌﺠﻣ
ﺭﺎﻣﻮﻃ: ﺏﺎﺘﮐ, ﻝﻭﺭ, ﺪﻌﺠﻣ
ﮏﯿﻧﺎﮑﻣ: ﯽﮑﯿﻧﺎﮑﻣ, ﺮﮔ-ﺖﻌﻨﺻ
ﺯﻭﺎﺠﺗ: ﻪﻠﻤﺣ, ﺰﯿﻣﺁ-ﺖﻧﻮﺸﺧ, ﺯﻭﺎﺠﺗ
ﯽﻫ: ﺩﻭﺭﺩ, ﯼﺪﻣﺁ-ﺵﻮﺧ
ﯼﺮﯿﮔ-ﻩﺯﺍﺪﻧﺍ: ﻦﺘﻓﺮﮔ-ﻩﺯﺍﺪﻧﺍ
ﺖﺑﺎﻗﺭ: ﻦﺘﻓﺮﮔ-ﯽﺘﺸﮐ, ﺐﯿﻗﺭ
ﻩﺎﮕﺸﻧﺍﺩ: ﺞﻟﺎﮐ
ﺭﺎﮐ-ﻩﺯﺎﺗ: ﻥﺩﺮﮐ-ﻡﺍﺪﺨﺘﺳﺍ-ﺯﻮﻣﺍ ﻮﻧ, ﺕﻭﺍﺮﻃ-ﺎﺑ
ﻩﺪﺷ-ﺍﺪﺟ: ﻕﻼ﻿ﻃ
ﺕﺎﯿﻨﺒﻟ: ﺮﯿﺷ
ﻥﺰﺨﻣ: ﻥﺰﺨﻣ
ﻥﺩﺮﻛ-ﺪﻳﺮﺧ: ﻩﺎﮕﺷﻭﺮﻓ, ﺕﺭﺎﺠﺗ
ﯽﻨﻤﺿ: ﺭﺍﻮﺘﺳﺍ
ﮏﯾﮋﺗﺍﺮﺘﺳﺍ: ﯼﮋﺗﺍﺮﺘﺳﺍ
ﺐﻟﺎﻗ: ﻪﻧﺎﻤﯿﭘ, ﻥﺪﺷ-ﻞﻴﻜﺸﺗ, ﭖﺎﭼ, ﺐﻟﺎﻗ
ﻦﯾﺮﻤﺗ: ﻦﯾﺮﻤﺗ, ﺭﺍﺮﮑﺗ
ﺭﺍﺮﺻﺍ: ﻥﺩﺮﮐ-ﺭﺍﺮﺻﺍ
ﻞﺒﻗ: ﺯﺍ-ﻞﺒﻗ
ﻪﻤﯿﻧ: ﯽﻄﺳﻭ-ﻥﻭﺮﻗ, ﻩﺍﺭ-ﻪﻤﯿﻧ, ﺮﻤﮐ-ﺭﻭﺩ
ﺖﺴﯾﺭﻮﺗ: ﺮﻓﺎﺴﻣ, ﯼﺩﺮﮕﻧﺎﻬﺟ
ﻪﺑﺎﺷﻮﻧ: ﻥﺪﯿﺷﻮﻧ
ﻪﺟﻮﺘﻣ: ﻖﯿﻗﺩ
ﻥﺎﯿﺑ: ﺢﯿﺿﻮﺗ, ﻥﺎﯿﺑ
ﻩﺭﺎﺑﻭﺩ: ﻊﻗﻮﻣ-ﻥﻭﺍ, ﺖﺸﮔﺯﺎﺑ
ﺡﻼ﻿ﺻﺍ: ﺮﻈﻧ-ﺪﯾﺪﺠﺗ, ﻥﺩﺍﺩ-ﺮﯿﯿﻐﺗ, ﻥﺩﺮﮐ-ﻦﯾﺰﮕﯾﺎﺟ, ﻥﺩﺮﮐ-ﻞﺼﺘﻣ-ﻢﻫﺎﺑ, ﺕﺎﺣﻼ﻿ﺻﺍ
ﺭﺍﺩﻮﻤﻧ: ﯽﻧﺎﻣﺯﺎﺳ-ﺕﺭﺎﭼ, ﻪﺸﻘﻧ
ﯽﺳﺎﯿﻗ-ﺎﯾ-ﯽﯾﺍﺮﻘﺘﺳﺍ ﺖﻟﺎﺣ: ﯽﺋﺎﻘﻟﺍ-ﺖﻟﺎﺣ
ﻥﺩﺮﮐ-ﻝﺎﻤﯾﺎﭘ: ﻥﺩﺮﮐ-ﻢﺘﺳ
ﺭﺎﯿﺳ: ﻦﻔﻠﺗ, ﻝﻮﻠﺳ
ﻥﺩﺮﺑ-ﻻ﻿ﺎﺑ: ﻊﯿﻓﺮﺗ, ﻥﺩﺮﮐ-ﺪﻨﻠﺑ
ﺩﺍﺪﺿﺍ: ﺾﻗﺎﻨﺗ
ﻪﻐﻟﺎﺒﻣ: ﮏﻤﻧ, ﻦﺘﺧﺎﺳ-ﻪﻨﯿﺸﯿﺑ
ﺎﻫ-ﺵﺯﺭﻭ: ﺩﺭﺯ-ﮓﻧﺭ
ﻒﺻ: ﺖﻣﻼ﻿ﻋ, ﺭﻮﺒﻋ-ﺰﻣﺭ, ﺏﻮﭼ
ﻩﺪﻧﻭﺩ: ﻦﻟﺎﺳ
ﻩﺮﮐﺍﺬﻣ: ﺪﯿﻨﮐ-ﺖﺒﺤﺻ, ﻮﮕﺘﻔﮔ-ﻭ-ﺚﺤﺑ
ﻢﯾﮊﺭ: ﻥﻮﻧﺎﻗ
ﻞﻤﺤﺗ: ﺭﺎﺑﺩﺮﺑ, ﻞﻤﺤﺗ
ﻪﻨﯾﺰﮔ: ﺏﻭﺎﻨﺘﻣ, ﺭﺎﯿﺧ
ﯽﺒﯿﻠﺻ-ﮓﻨﺟ: ﯽﯾﺎﺠﺑﺎﺟ
ﻥﺪﺷ-ﺮﯿﮔﺍﺮﻓ: ﯼﺩﮊﺍﺮﺗ, ﻪﻤﺟﺮﺗ
ﮏﯿﻨﮑﺗ: ﯽﻨﻓ, ﺵﻭﺭ, ﯽﺳﺪﻨﻬﻣ, ﺕﺍﺰﯿﻬﺠﺗ
ﻪﻧﺎﯾﺎﭘ: ﺖﯾﺎﻬﻧ-ﺭﺩ
ﻞﯿﺼﺤﺘﻟﺍ-ﻍﺭﺎﻓ: ﻥﺩﺮﮐ-ﯽﻃ
ﺪﯿﻟﻮﺗ: ﻪﻨﯾﺰﻫ, ﻪﺠﯿﺘﻧ, ﺭﺎﺸﺘﻧﺍ, ﺖﻤﯾﺰﻋ, ﯼﺭﻭ-ﻩﺮﻬﺑ, ﺝﻭﺮﺧ
ﻥﺩﺍﺩ-ﺭﺍﺮﻗ: ﻪﻄﻘﻧ
ﺽﺮﻓ-ﺶﯿﭘ-ﺭﻮﻃ ﻪﺑ: ﻑﺬﺣ, ﺩﺭﺍﺪﻧﺎﺘﺳﺍ
ﻪﻨﯿﻣﺯ: ﯽﻄﯿﺤﻣ-ﺖﺴﯾﺯ, ﻪﻨﺤﺻ, ﯽﻨﻤﺿ-ﺖﻟﻻ﻿ﺩ
ﻑﻼ﻿ﺘﺋﺍ: ﺩﺎﺤﺗﺍ
ﺐﯿﻋ: ﺶﻧﺯﺮﺳ, ﻩﺎﺒﺘﺷﺍ, ﯽﻧﺍﻮﺗﺎﻧ, ﺭﺮﺿ
ﻥﺩﺮﮐ-ﺭﺍﺬﮔﺍﻭ: ﻥﺩﺮﮐ-ﺭﺍﺮﻗﺍ
ﺶﺨﭘ: ﺭﺎﺸﺘﻧﺍ, ﻝﺎﺳﺭﺍ
ﯼﺮﯿﮔ-ﻩﺭﺎﻤﺷ: ﻥﺩﺮﻛ-ﺏﺎﺨﺘﻧﺍ, ﻪﻘﻠﺣ, ﻥﺩﺮﮐ-ﻊﻤﺟ
ﻉﻮﯿﺷ: ﺪﻨﺴﭘ-ﻪﻣﺎﻋ
ﻩﺪﻨﯾﺍﺰﻓ-ﺭﻮﻃ-ﻪﺑ: ﻪﻤﻫ
ﻞﯾﺪﺒﺗ: ﻥﺩﺍﺩ-ﺮﯿﯿﻐﺗ, ﻞﯾﺪﺒﺗ
ﮎﺩﺎﺑﺩﺎﺑ: ﺎﻫﺩﮊﺍ
ﻢﻬﺒﻣ: ﻢﻬﺒﻣ, ﺾﻗﺎﻨﺗ
ﻪﻓﺎﮐ: ﻩﻮﻬﻗ, ﺭﺎﺑ
ﻩﺰﯾﺎﺟ: ﻩﺰﯾﺎﺟ, ﻪﻤﯿﺑ-ﻖﺣ, ﻥﺩﺮﮐ-ﺭﺍﺮﻗﺍ
ﺐﺴﭼﺮﺑ: ﻩﺎﮔﺭﺎﮐ, ﺖﻣﻼ﻿ﻋ
ﺐﯾﻮﺼﺗ: ﺐﯾﻮﺼﺗ, ﻥﺩﺮﮐ-ﺭﺍﺮﻗﺍ
ﯼﺪﻧﻭﺎﺸﯾﻮﺧ: ﺱﺎﯿﻗ, ﺖﺴﯿﻟﺎﯿﺳﻮﺳ
ﻦﯿﺑ-ﻊﻗﺍﻭ: ﯽﺘﺳﺍﺮﺑ
ﻩﺪﻧﺰﺧ: ﺭﺎﻣ
ﻝﺰﻨﻣ-ﺯﺍ-ﺝﺭﺎﺧ: ﺝﺭﺎﺧ, ﻦﮐ-ﺯﺎﺑ
ﯽﺳﺎﯿﺳ: ﯽﺳﺎﯿﺳ
ﻩﺪﻧﺎﻣ-ﯽﻗﺎﺑ: ﯽﻗﺎﺑ, ﯽﻨﺘﺨﯾﺭ-ﺭﻭﺩ
ﺭﺍﻮﻧ: ﺖﺳﺎﮐ, ﺪﻧﺎﺑ, ﺎﻤﻨﯿﺳ-ﻢﻠﯿﻓ
ﺏﻮﻠﻄﻣ-ﻭ-ﻦﯾﺮﯿﺷ: ﻡﺮﻧ, ﻦﯾﺮﯿﺷ
ﯽﻫﺎﻔﺷ: ﯽﻫﺎﻔﺷ, ﺐﻟ
ﻥﺪﯿﺸﯾﺪﻧﺍ: ﻥﺰﺑ-ﺱﺪﺣ
ﻦﺘﺧﺍﺪﻧﺍ-ﻥﻭﺮﯿﺑ: ﻦﺘﺧﺍﺪﻧﺍ-ﻥﻭﺮﯿﺑ, ﻪﯿﻠﺨﺗ
ﻥﺩﺮﮐ-ﺭﺍﺩ-ﻪﮑﻟ: ﻪﻄﻘﻧ, ﯽﻧﺍﻮﺗﺎﻧ
ﺰﯿﺧ-ﻭ-ﺖﺴﺟ: ﺺﻗﺭ, ﻥﺩﺮﮐ-ﺝﺮﺧ
ﻥﺍﻮﯿﻟ: ﻥﺎﺠﻨﻓ, ﻝﻮﺻﺍ-ﻭ-ﺍﺩﺍ
ﻩﻮﮔ: ﺦﯿﻣ, ﻁﺮﺷ, ﻪﺷﻮﮔ
ﺖﯿﻓﺎﻌﻣ: ﻒﯿﻔﺨﺗ, ﺎﻨﺜﺘﺳﺍ, ﯽﮕﻧﻭﺰﻓﺍ
ﻞﻤﺣ-ﻞﺑﺎﻗ: ﯽﻤﮐ-ﺭﺍﺪﻘﻣ
ﯼﺪﻨﺑ-ﻪﺘﺴﺑ-ﺬﻏﺎﮐ: ﯼﺪﻨﺑ-ﻪﺘﺴﺑ, ﻥﺩﺮﮐ-ﯼﺪﻨﺑ-ﻪﺘﺴﺑ
ﯽﮔﺪﻨﺸﺧﺭﺩ: ﺩﺍﺪﻌﺘﺳﺍ, ﯽﯾﺎﺒﯾﺯ, ﻩﺪﻨﻨﮐ-ﻩﺮﯿﺧ-ﺶﺑﺎﺗ
ﻪﻟﺎﺑ: ﻭﺭﺎﭘ, ﻪﻟﺎﺑ
ﺮﻏﺮﻏ: ﻥﺩﺮﮐ-ﻪﻣﺰﻣﺯ
ﺕﻮﺗ: ﺰﻣﺮﻗ-ﻪﺑ-ﻞﯾﺎﻣ ﺥﺮﺳ
ﺕﺮﺟﺎﻬﻣ: ﭺﻮﮐ
ﻥﺩﺯ-ﻞﯿﺑ-ﺞﮐ: ﻥﺩﺯ-ﻢﺨﺷ
ﻲﺣﺍﺮﺟ-ﻞﻤﻋ: ﺡﺍﺮﺟ
ﻦﺘﺷﺎﺒﻧﺍ: ﯽﮕﺘﺷﺎﺒﻧﺍ, ﯽﮑﻧﺎﺑ-ﻩﺩﺮﭙﺳ, ﻥﺩﺮﮐ-ﻊﻤﺟ
ﻥﺩﺍﺩ-ﺕﺭﻮﻗ: ﻉﻮﻓﺪﻣ, ﻪﻟﻮﻟ
ﻢﮑﺷ: ﻩﺪﻌﻣ
ﻡﻮﻬﻔﻣ: ﯽﻨﻤﺿ-ﺖﻟﻻ﻿ﺩ, ﻝﻮﻤﺷ, ﻪﺠﯿﺘﻧ
ﻩﺰﯿﮕﻧﺍ: ﮎﺮﺤﻣ
ﺭﺎﭼﺍ: ﯽﺘﺷﻮﮔ-ﭻﯿﭘ, ﺪﯿﻠﮐ
ﺮﻬﺷ-ﻪﻣﻮﺣ: ﯽﯾﺎﺘﺳﻭﺭ, ﺮﻬﺷ-ﻪﻣﻮﺣ, ﻩﺯﻮﺣ, ﻩﺪﮑﻫﺩ
ﺶﻫﺎﮐ: ﻦﺘﻓﺭ-ﻦﯿﺑ-ﺯﺍ, ﻥﺩﺍﺩ-ﺶﻫﺎﻛ
ﯽﻣﻮﺑ: ﺖﻌﯿﺒﻃ, ﯽﻠﺻﺍ, ﻦﮐﺎﺳ
ﻪﺘﺸﭘ: ﻪﻟﺎﺑﺯ, ﺱﺍﺮﻟﺍ-ﻂﺧ, ﺶﮐﺩﻭﺩ
ﮏﺴﯾﺩ: ﮏﺴﯾﺩ
ﺪﻧﻭﺭ: ﺭﺎﺘﻓﺭ, ﺖﻬﺟ, ﻩﺪﺷ-ﻢﺧ, ﻊﺿﻭ, ﯽﮔﺪﻧﺍﺭ
ﮒﺭﺰﺑ-ﯼﺎﻫ-ﺖﮐﺮﺷ: ﺖﮐﺮﺷ, ﺞﯾﺍﺭ
ﻥﺩﺮﮐ-ﻪﺋﺮﺒﺗ: ﺮﺷ-ﺯﺍ-ﻥﺪﺷ ﺹﻼ﻿ﺧ
ﺕﺎﺒﺛ-ﯽﺑ: ﻥﺍﺯﺮﻟ, ﯼﺭﺍﺪﯾﺎﭘﺎﻧ
ﺭﺎﮔﺯﺎﺳ: ﺭﺍﻮﺘﺳﺍ, ﺕﺍﺯﺍﻮﻣ-ﻪﺑ, ﺲﻧﺎﺠﺘﻣ
ﻦﻔﻠﺗ: ﻦﻔﻠﺗ
ءﻼ﻿ﺧ: ﯽﻟﺎﺧ
ﻦﺘﻓﺮﮔ: ﻥﺩﺯ-ﻢﺧﺯ, ﻦﺘﻓﺮﮔ, ﻥﺩﺮﮐ-ﺐﺣﺎﺼﺗ
ﺞﻨﺸﺗ: ﻪﻟﺰﻟﺯ, ﺭﺎﺠﻔﻧﺍ
ﺮﺑ-ﺮﺳ-ﻪﻠﺻﻮﺣ: ﻪﻠﺻﻮﺣ-ﯽﺑ, ﻥﺩﺮﮐ-ﺥﺍﺭﻮﺳ-ﻪﺘﻣ ﺎﺑ, ﻩﺪﻨﻫﺩ-ﺭﺍﺯﺁ
ﻡﺎﻘﻣ: ﻢﯿﻈﻨﺗ, ﻝﻮﭘ-ﻒﯿﮐ
ﻑﺎﮑﺷ: ﮎﺮﺗ
ﺽﺭﺍﻮﻋ: ﺯﺎﺳ-ﻞﮑﺸﻣ, ﺽﺭﺍﻮﻋ
ﻪﻠﺧﺍﺪﻣ: ﻥﺩﺮﮐ-ﻪﻠﺧﺍﺪﻣ
ﯽﺒﻄﻗ: ﺶﺒﻄﻗ, ﻁﺮﻔﻣ
ﻩﺪﻨﯾﺎﻤﻧ: ﻩﺪﻨﯾﺎﻤﻧ, ﻝﻮﺳﺭ
ﻩﺩﺍﺭﺍ: ﻩﺩﺍﺭﺍ-ﯼﻭﺮﯿﻧ, ﻦﺘﺷﺍﺩ-ﻞﻳﺎﻤﺗ
ﯽﻨﯿﺑ-ﺶﯿﭘ: ﯽﻨﯿﺑ-ﺶﯿﭘ-ﻞﺑﺎﻗ, ﻥﺰﺑ-ﺱﺪﺣ
ﯽﻨﯿﺑ-ﺵﻮﺧ: ﺪﯿﻣﺍ, ﻦﺘﺷﺍﺩ-ﺩﺎﻘﺘﻋﺍ
ﻥﺪﻨﮐ-ﺖﺳﻮﭘ: ﺖﺳﻮﭘ, ﻑﻼ﻿ﻏ, ﺮﺸﻗ
ﻥﺩﺮﻛ-ﻚﺣ: ﺶﯿﻧ
ﺭﻭﺎﻨﺷ: ﺭﻭﺎﻨﺷ, ﻦﺘﻓﺮﮔ-ﺝﻭﺍ, ﻎﯾﺭﺩ
ﺶﺨﺑ: ﻩﺯﻮﺣ, ﺖﻌﻨﺻ, ﯼﺍ-ﻪﻘﻄﻨﻣ, ﺶﺨﺑ
ﯽﮔﺩﺍﻮﻧﺎﺧ-ﻡﺎﻧ: ﻡﺎﻧ, ﺎﻬﻧﺁ
ﻪﺴﺳﻮﻣ: ﻪﺘﻓﺎﯾ-ﻥﺎﻣﺯﺎﺳ, ﺖﮐﺮﺷ, ﻥﺎﻣﺯﺎﺳ
ﺕﺭﻭﺮﺿ: ﺲﭘﺍﻮﻟﺩ
ﺶﺨﺑ-ﺕﺬﻟ: ﻉﻮﻧ
ﻥﺪﻧﺎﺳﺮﺗ: ﻥﺩﺮﮐ-ﯼﺮﯿﮔﻮﻠﺟ
ﯽﻔﻧ: ﺭﺎﮑﻧﺍ
ﻩﺪﻧﺮﺑ: ﺖﯿﻘﻓﻮﻣ
ﺐﮐﺮﻣ: ﻁﻮﻠﺨﻣ
ﺮﯿﺛﺄﺗ: ﺮﺛﺍ, ﺩﺎﻀﺗ
ﺮﺒﯿﻓ: ﺮﺒﯿﻓ
ﻪﻋﺮﺟ: ﻊﻠﺑ
ﯼﺮﺼﺑ: ﯼﺮﺼﺑ, ﻪﻨﺤﺻ
ﻪﺠﻨﭘ: ﻪﺠﻨﭘ
ﯽﮐﺎﺷ: ﺮﮕﯾﺯﺎﺑ, ﻞﻣﺎﺣ, ﻞﯿﻟﺩ
ﺮﺑ-ﻥﺩﺮﮐ-ﯼﺯﻮﺴﻟﺩ: ﻢﺣﺮﺗ
ﻥﺩﺮﮐ-ﻩﺍﺮﻤﮔ: ﻒﯾﺮﺤﺗ, ﻥﺩﺮﮐ-ﺕﺎﻣ, ﻖﻤﺣﺍ
ﺖﺳﺍ-ﻩﺩﺮﮐ-ﻉﻮﻨﻤﻣ: ﯼﺭﺍﺩﺯﺎﺑ, ﻥﺩﺮﮐ-ﯼﺮﯿﮔﻮﻠﺟ, ﺭﺎﮑﻧﺍ
ﺮﮕﯾﺯﺎﺑ: ﺮﮕﯾﺯﺎﺑ, ﺪﻨﻣﺮﻨﻫ, ﻦﮑﯾﺯﺎﺑ
ﻪﻘﺑﺎﺴﻣ: ﻪﻘﺑﺎﺴﻣ
ﺯﺎﯿﻧ: ﻥﺩﺮﮐ-ﺎﺿﺎﻘﺗ, ﺖﯿﻌﺿﻭ
ﯼﺎﻬﻨﻣ: ﻦﯾﺮﺘﻤﮐ
ﻢﻫﺮﺑ-ﻭ-ﻢﻫﺭﺩ: ﺍﻭﺮﭘ-ﯽﺑ
ﯽﻧﻮﻔﻋ: ﺖﻧﻮﻔﻋ
ﺪﯿﮐﺎﺗ: ﻥﺩﺮﮐ-ﺭﺍﺮﺻﺍ, ﺪﯿﮐﺎﺗ
ﺭﺍﻮﻠﺷ: ﺭﺍﻮﻠﺷ
ﻥﺩﺮﮐ-ﺞﯿﮔ: ﻝﺯﺎﭘ, ﻥﺩﺮﮐ-ﺕﺎﻣ, ﺭﺎﺴﻣﺮﺷ
ﻥﺩﺍﺩ-ﺹﺎﺼﺘﺧﺍ: ﺐﻠﻃﻭﺍﺩ, ﺪﺼﻗ
ﯽﺣﺍﺮﺟ: ﺡﺍﺮﺟ
ﯽﯾﻮﮕﻘﺣ: ﺖﯿﻌﻗﺍﻭ, ﺖﻗﺩ
ﻡﺪﺻ-ﮏﯾ: ﺪﺻ
ﺐﯿﺷ: ﺪﻨﺗ-ﺐﯿﺷ, ﺐﯿﺷ, ﻩﺪﺷ-ﻢﺧ
ﮏﯾﺩﺰﻧ: ﺎﺒﯾﺮﻘﺗ, ﯼﺩﻭﺯ-ﻪﺑ, ﻑﺍﺮﻃﺍ
ﻝﻮﻤﻌﻣ-ﺭﻮﻃ-ﻪﺑ: ﺞﯾﺍﺭ, ﻊﻗﺍﻮﻣ-ﺮﺘﺸﯿﺑ, ﯽﻠﮐ-ﺭﻮﻄﺑ, ﻞﯾﺎﻤﺗ
ﻩﺪﻨﻨﮐ-ﺞﯿﮔ: ﺾﻗﺎﻨﺗ, ﻝﺯﺎﭘ, ﯽﺠﯿﮔ
ﺖﺒﺴﻧ-ﻪﺑ: ﻪﺴﯾﺎﻘﻣ-ﻞﺑﺎﻗ, ﻝﺩﺎﻌﺗ
ﻥﺩﻮﺑ-ﻒﻟﺎﺨﻣ: ﺮﻈﻧ-ﻑﻼ﻿ﺘﺧﺍ
ﮏﯾﺮﺤﺗ: ﻢﺸﺧ, ﻥﺩﺮﮐ-ﻪﻠﺧﺍﺪﻣ, ﻦﺘﺧﺍﺪﻧﺍ-ﺖﺳﺩ-ﺍﺭ ﯽﺴﮐ, ﮏﯾﺮﺤﺗ
ﻪﺘﺴﺟﺮﺑ: ﺮﺘﻬﺑ, ﻪﺟﻮﺗ-ﻞﺑﺎﻗ
ﻉﻭﺮﺷ: ﻉﻭﺮﺷ
ﺵﺭﺎﺑ: ﻥﺩﺮﮐ-ﻊﯾﺮﺴﺗ
ﻥﺩﺮﮐ-ﻩﺩﺯ-ﺖﺸﺣﻭ: ﺮﻄﺧ-ﮓﻧﺯ
ﯽﻣﺮﮔﺮﺳ: ﯽﻣﺮﮔﺮﺳ-ﻭ​​-ﺢﯾﺮﻔﺗ
ﯼﺭﻮﺘﺳﺩ: ﻥﺎﺑﺯ-ﺭﻮﺘﺳﺩ
ﯼﺩﺪﻋ: ﺩﺪﻋ, ﻝﺎﺘﯿﺠﯾﺩ
ﺭﺎﯿﻌﻣ: ﺩﺭﺍﺪﻧﺎﺘﺳﺍ
ﯽﻨﯿﺑ-ﺶﯿﭘ: ﯽﻨﯿﺑ-ﺶﯿﭘ-ﻞﺑﺎﻗ, ﻥﺰﺑ-ﺱﺪﺣ
ﻥﺩﺮﮐ-ﺩﺭ: ﺭﺎﮑﻧﺍ
ﺐﯾﺮﻏ-ﻭ-ﺐﯿﺠﻋ: ﯽﺟﺭﺎﺧ, ﺐﻳﺮﻏ-ﻭ-ﺐﻴﺠﻋ
ﺯﺎﯿﭘ: ﭗﻣﻻ﻿
ﻥﺩﺮﺑ-ﻻ﻿ﺎﺑ: ﻥﺩﺮﮐ-ﻦﻬﭘ, ﻥﺩﺍﺩ-ﺶﯾﺍﺰﻓﺍ, ﻦﺘﺧﺎﺳ-ﻪﻨﯿﺸﯿﺑ, ﺎﻔﺷ
ﻡﺎﻏﺩﺍ: ﻥﺪﺷ-ﺏﻭﺫ, ﻥﺩﺯ-ﮓﻧﺯ
ﯼﺍﺭ: ﺏﺎﺨﺘﻧﺍ
ﺪﻌﺘﺴﻣ: ﺩﺍﺪﻌﺘﺳﺍ, ﺮﻫﺎﻣ
ﻥﺪﺷ-ﻡﺮﮔ: ﻥﺪﺷ-ﺏﻭﺫ
ﺖﺳﺍﺭ: ﻂﺴﺑ, ﺖﺑﺎﺛ
ﻥﺩﺮﮐ-ﻦﯿﺋﺰﺗ: ﺖﻨﯾﺯ
ﯼﺭﻮﻬﻤﺟ-ﺖﺳﺎﯾﺭ: ﺖﺳﺎﯾﺭ
ﻩﺩﺎﺟ-ﺯﺍﺪﻧﺍ-ﺖﺳﺩ: ﺱﺭﺎﻧ, ﻥﺩﺮﮐ-ﺮﯿﺜﮑﺗ, ﻥﺩﺯ-ﺪﮕﻟ, ﻪﻧﺍﺪﻧﺩ, ﺭﻮﻣﻮﺗ
ﻢﻳﻮﮔ-ﻲﻣ-ﻚﻳﺮﺒﺗ: ﺶﯾﺎﺘﺳ
ﻦﮑﺳﺍ: ﺖﺸﮔﺮﺑ-ﻭ-ﺖﻓﺭ
ﻥﺩﺎﻬﻧ-ﻡﺎﻧ: ﻦﺘﺧﺎﺳ-ﺭﺩﺎﻗ, ﺖﺳﺭﺩ
ﯼﺪﻨﺑ-ﻁﺮﺷ: ﺖﯿﻌﺿﻭ
ﯽﻨﻓ-ﻅﺎﺤﻟ-ﺯﺍ: ﯽﻨﻓ, ﯽﺳﺪﻨﻬﻣ
ﯽﺑﺮﺠﺗ: ﻪﺑﺮﺠﺗ
ﻦﺘﺷﺍﺩ-ﻂﻠﺴﺗ: ﺩﺎﺘﺳﺍ
ﺕﺎﻐﯿﻠﺒﺗ: ﺩﻼ﻿ﯿﻣ-ﺯﺍ-ﺪﻌﺑ, ﺕﺎﻐﯿﻠﺒﺗ
ﺭﺎﺸﺘﻧﺍ: ﻊﯾﺯﻮﺗ, ﺭﺎﺸﺘﻧﺍ
ﻥﺪﻧﺍﺮﭼ: ﺵﺍﺮﺧ
ﺖﯿﮐ: ﺕﺍﺰﯿﻬﺠﺗ, ﻪﺒﻌﺟ, ﻢﯿﻈﻨﺗ
ﺺﺼﺨﺘﻣ: ﺮﺘﮐﺩ, ﯽﺑﺮﻣ
ﻥﺩﺭﻮﺧ-ﺲﯿﺧ: ﻥﺩﺯ-ﮏﻣ, ﺐﯿﺷ
ﺖﻇﺎﻔﺣ: ﺖﻈﻓﺎﺤﻣ, ﯽﯾﻮﺟ-ﻪﻓﺮﺻ, ﻥﺩﺍﺩ-ﺖﻴﻤﻫﺍ
ﻞﮔ-ﻭ-ﻦﺠﻟ: ﻞﮔ, ﻭﺭ-ﻩﺩﺎﻴﭘ, ﻥﺪﯿﻧﺎﮑﭼ
ﺰﯿﮕﻧﺍﺮﺑ-ﺶﻟﺎﭼ: ﺖﺨﺳ
ﯽﮔﺩﻮﻟﺍ: ﻩﺩﻮﻟﺁ, ﺩﺎﺴﻓ
ﯽﯾﺎﯿﻤﯿﺷ-ﺩﺍﻮﻣ: ﯽﯾﺎﯿﻤﯿﺷ
ﻪﺘﺳﺩ: ﻪﻠﮔ, ﻪﺑ-ﻥﺩﺍﺩ-ﻩﺰﯿﮕﻧﺍ, ﻢﺠﺣ
ﺭﺩﺎﻣ: ﺭﺩﺎﻣ
ﮎﺎﻨﺳﺮﺗ: ﮎﺎﻨﺘﺸﺣﻭ, ﺰﯿﻣﺁ-ﺪﯾﺪﻬﺗ
ﺺﺼﺨﺘﻣ: ﺱﺎﻨﺷﺭﺎﮐ
ﻦﺘﺷﺍﺩ-ﻕﺎﯿﺘﺷﺍ: ﻦﺘﺷﺍﺩ-ﻞﻳﺎﻤﺗ
ﻡﺎﻤﺣ: ﻥﺍﻭ
ﺭﺎﻤﻗ: ﺭﺎﻤﻗ, ﯼﺯﺎﺑ, ﺍﺮﺟﺎﻣ
ﻝﺍﺮﮕﺘﻧﺍ: ﻡﺯﻻ﻿, ﻪﭼﺭﺎﭙﮑﯾ
ﻥﺩﺮﺑ-ﻦﯿﺑ-ﺯﺍ: ﺮﺷ-ﺯﺍ-ﻥﺪﺷ ﺹﻼ﻿ﺧ, ﻥﺩﺮﮐ-ﻑﺬﺣ
ﺩﻮﺨﻧ: ﺕﺎﺑﻮﺒﺣ
ﻪﻤﯿﻤﺿ: ﯽﮕﺘﺴﺒﻟﺩ, ﯽﻓﺎﺿﺍ, ﯼﺮﻤﺘﺴﻣ
ﻥﺩﺭﻭﺍ-ﺭﺩ-ﺵﺩﺮﮔ ﻪﺑ: ﻊﯾﺯﻮﺗ
ﻞﻣﺎﺷ: ﺪﺤﺘﻣ
ﻩﺪﻨﺷﻭﺮﻓ: ﻝﻻ﻿ﺩ
ﻥﺩﺮﮐ-ﺖﯾﺫﺍ: ﯽﺒﺼﻋ, ﻥﺩﺮﮐ-ﻪﻠﺧﺍﺪﻣ, ﺱﺍﻮﺳﻭ
ﻥﺪﺷ-ﺮﺠﻔﻨﻣ: ﺭﺎﺠﻔﻧﺍ
ﯼﻭﺎﮑﺠﻨﮐ: ﯼﻭﺎﮑﺠﻨﮐ-ﺲﺣ, ﻡﺮﻫﺍ
ﺖﺸﻧ: ﺖﺸﻧ, ﻦﺘﺨﯾﺭ
ﻥﺎﮕﯾﺍﺭ: ﻥﺩﺮﮐ-ﺩﺍﺯﺁ
ءﺰﺟ: ﺮﺼﻨﻋ
ﺩﻮﺒﻤﮐ: ﻦﮐ-ﺯﺎﺑ
ﻩﺪﻨﻨﻛ-ﺖﺣﺍﺭﺎﻧ: ﯽﺒﺼﻋ, ﻩﺪﻨﻫﺩ-ﺭﺍﺯﺁ, ﺪﻨﯾﺎﺷﻮﺧﺎﻧ, ﻦﯿﮕﻤﻏ, ﻝﻼ﻿ﺘﺧﺍ
ﻦﮑﺴﻣ: ﻪﻧﺎﺧ
ﯽﺴﮑﻋ: ﺯﺎﻓ, ﺮﯾﻮﺼﺗ, ﺱﺎﮑﻋ
ﺕﺎﻓﺁ: ﻩﺮﺸﺣ
ﺹﺮﻗ: ﺹﺮﻗ
ﺮﺿﺎﺣ-ﻝﺎﺣ-ﺭﺩ: ﺮﺿﺎﺣ
ﺎﻫ-ﻪﻧﺎﺳﺭ: ﺕﺎﻋﻮﺒﻄﻣ
ﻪﺑﺍﺮﺧ: ﯽﻫﺎﺒﺗ
ﻢﺴﺟ: ﻥﺪﺑ, ﻢﯿﻈﻨﺗ
ﻮﻨﻣ: ﺖﺳﺮﻬﻓ
ﯽﮕﺘﺴﮑﺷ: ﮎﺮﺗ
ﻦﻤﺠﻧﺍ: ﻮﮑﺳ, ﻥﺩﺮﮐ-ﺥﺍﺭﻮﺳ-ﻪﺘﻣ ﺎﺑ, ﻩﺎﮔﺩﺍﺩ
ﺖﮐﺮﺣ: ﺖﻋﺮﺳ, ﻪﺑ-ﻥﺩﺍﺩ-ﻩﺰﯿﮕﻧﺍ
ﺞﮐ: ﺩﻮﻋ, ﻩﺪﺷ-ﻢﺧ
ﯽﺷﺎﮐ: ﺮﺟﺁ
ﺏﺎﺘﮐ-ﻪﺴﻔﻗ: ﻪﻧﺎﺨﺑﺎﺘﮐ, ﯽﺷﻭﺮﻔﺑﺎﺘﮐ
ﻪﺒﺳﺎﺤﻣ: ﻪﺒﺳﺎﺤﻣ
ﻩﺪﻨﻨﻛ-ﻪﻴﻬﺗ: ﻩﺪﻧﺯﺎﺳ
ﯽﻟﻮﭘ: ﻝﻮﭘ
ﺪﺸﮐ-ﯽﻣ-ﺮﯾﻮﺼﺗ ﻪﺑ: ﻥﺩﺮﮐ-ﻒﯿﺻﻮﺗ, ﻥﺩﺮﮐ-ﺲﮑﻌﻨﻣ, ﻥﺩﺮﮐ-ﯽﻓﺮﻌﻣ
ﻡﺭﻮﺗ: ﻡﺭﻮﺗ
ﯼﺍ-ﻪﯿﺷﺎﺣ: ﻪﺒﻟ
ﯼﺰﺘﻧﺎﻓ: ﻞﯿﺨﺗ
ﻥﺩﺮﺑ-ﻞﯿﻠﺤﺗ: ﻦﺘﻓﺭ-ﻦﯿﺑ-ﺯﺍ
ﻢﺠﺴﻨﻣ: ﺍﺪﮐﻮﻣ, ﯽﮕﺘﺳﻮﯿﭘ, ﺭﺍﻮﺘﺳﺍ
ﺎﺳﺎﺳﺍ: ﺕﺎﺣﻼ﻿ﻄﺻﺍ
ﯼﺪﻤﻋ: ﺍﺪﻤﻋ
ﻩﺪﻧﺎﻣﺯﺎﺑ: ﻩﺩﺍﻮﻧﺎﺧ
ﺭﺎﺷ: ﻪﻧﺎﺧﺩﻭﺭ, ﻥﺎﯾﺮﺟ
ﯽﺘﺑﺎﻗﺭ: ﺐﯿﻗﺭ
ﺕﺍﺮﻫﺍﻮﺟ: ﺖﻨﯾﺯ
ﯽﻠﮑﻟﺍ: ﺖﺴﻣ, ﺏﺍﺮﺷ
ﻥﺪﺷ-ﻞﺋﺎﻗ-ﺾﯿﻌﺒﺗ: ﻥﺩﺍﺩ-ﺰﯿﻤﺗ
ﺐﻠﻃ-ﮓﻨﺟ: ﻝﺎﮑﯾﺩﺍﺭ, ﯽﺘﺴﯾﺭﻭﺮﺗ, ﯽﻣﺎﻈﻧ
ﻥﺩﺮﮐ-ﺡﻼ﻿ﺳ-ﻊﻠﺧ: ﺡﻼ﻿ﺳ
ﯽﺗﺎﯿﺣ: ﻡﺯﻻ﻿, ﻊﻃﺎﻗ
ﯼﺭﺍﺬﮔﺍﻭ: ﺭﺎﮐ, ﻦﯾﺮﻤﺗ, ﻪﻔﯿﻇﻭ, ﺺﯿﺼﺨﺗ
ﻪﯿﻤﻬﺳ: ﺯﺎﯿﺘﻣﺍ, ﺺﯿﺼﺨﺗ, ﯽﻣﻮﺘﻧﺍﻮﮐ
ﯼﺭﺎﻔﺣ: ﻝﺍﺩﻮﮔ, ﯼﺭﺎﻔﺣ
ﻢﯿﺴﻠﮐ: ﻥﺩﺯ-ﺪﮕﻟ
ﺖﺷﺍﺪﮔﺭﺰﺑ: ﻥﺩﺮﮐ-ﺪﻋﺎﻘﺘﻣ
ﯽﺨﯾﺭﺎﺗ: ﯽﺨﯾﺭﺎﺗ
ﻡﻼ﻿ﺳ: ﺩﻭﺭﺩ, ﯼﺪﻣﺁ-ﺵﻮﺧ, ﺕﺎﺠﻧ
ﻑﺬﺣ: ﺮﺷ-ﺯﺍ-ﻥﺪﺷ ﺹﻼ﻿ﺧ, ﻑﺬﺣ, ﻥﺩﺮﮐ-ﻑﺬﺣ
ﻩﺪﺷ-ﻪﺘﺴﺑ-ﻢﮑﺤﻣ: ﻪﺘﻓﺭ-ﻭ-ﻪﺘﺴﺷ
ﺶﺨﺑ-ﺶﻣﺍﺭﺁ: ﯽﺘﺣﺍﺭ, ﺖﺣﺍﺭ, ﺏﺎﺼﻋﺍ-ﺩﺪﻤﺗ
ﯽﺸﺨﺑﺮﺛﺍ: ﺭﺍﺬﮔ-ﺮﻴﺛﺎﺗ, ﺮﺛﺍ, ﺕﺭﺎﻬﻣ
ﺮﯾﺬﭘ-ﺐﯿﺳﺁ: ﺱﺎﺴﺣ
ﺭﺎﮑﺷﺯﺭﻭ: ﯽﺷﺯﺭﻭ
ﻩﺍﺭ-ﻩﺍﺭ-ﻪﭼﺭﺎﭘ: ﻩﺍﺭ-ﻩﺍﺭ, ﻂﺧ, ﺪﻧﺎﺑ, ﺎﻤﻨﯿﺳ-ﻢﻠﯿﻓ
ﻮﻠﺟ: ﮏﺳﺎﻣ, ﺯﺍﺪﻧﺍ-ﻢﺸﭼ
ﭗﯿﻠﮐ: ﯼﺰﯿﭼ-ﺮﻫ-ﯽﻠﺻﺍ ءﺰﺟ, ﮎﺮﺒﻧﺍ
ﻪﯿﻟﻭﺍ-ﻪﻧﻮﻤﻧ: ﻝﺎﺜﻣ, ﯽﻠﺻﺍ
ﻑﺍﺮﺤﻧﺍ: ﻪﻠﺑﺎﻘﻣ, ﻥﺩﺮﮐ-ﻥﺍﺮﺒﺟ, ﻑﺍﺮﺤﻧﺍ
null-ﺭﺍﺪﻘﻣ: ﺮﻔﺻ, ﯽﻟﺎﺧ
ﻥﺩﺮﮐ-ﺩﻭﺪﺤﻣ: ﻥﺩﺮﮐ-ﯼﺮﯿﮔﻮﻠﺟ, ﻥﺩﺮﮐ-ﻩﺎﺗﻮﮐ, ﻥﺩﺍﺩ-ﺶﻫﺎﻛ
ﮏﯿﺗ: ﺖﻣﻼ﻿ﻋ, ﺶﭙﺷ
ﻩﺮﻤﺧ: ﻥﺰﺨﻣ
ﺯﻭﺎﺠﺗ: ﺯﻭﺎﺠﺗ
null-ﺭﺍﺪﻘﻣ: ﺮﻔﺻ, ﯽﻟﺎﺧ
ﻁﻭﺮﺸﻣ: ﻪﺘﺴﺑﺍﻭ
ﯽﮕﻨﻫﺮﻓ: ﮓﻨﻫﺮﻓ
ﯼﮊﻮﻟﻮﻨﮑﺗ: ﯽﻨﻓ, ﺕﺍﺰﯿﻬﺠﺗ
ﯽﺑﺎﯾ-ﺭﺍﺯﺎﺑ: ﺕﺭﺎﺠﺗ
ﺕﺍﻭﺍﺮﮐ: ﺕﺍﻭﺍﺮﮐ
ﯼﺩﺎﺼﺘﻗﺍ-ﺮﻈﻧ-ﺯﺍ: ﯼﺩﺎﺼﺘﻗﺍ
ﺮﯾﺪﻣ: ﺮﯾﺪﻣ, ﯽﻟﻮﺘﻣ
ﻥﺪﯿﺸﮐ-ﺮﯾﻮﺼﺗ: ﻥﺩﺮﮐ-ﻒﯿﺻﻮﺗ, ﻥﺩﺮﮐ-ﯽﻓﺮﻌﻣ
ﻩﻮﻧ: ﻩﻮﻧ, ﺭﺩﺍﺮﺑ-ﺎﯾ-ﺮﻫﺍﻮﺧ ﺮﺴﭘ
ﻭﺩ: ﻭﺩ, ﺮﻫﻮﺷ-ﻭ-ﻥﺯ, ﻮﻠﻗﻭﺩ
ﺰﺘﻨﺳ: ﯽﻠﺻﺍ, ﻥﺩﺮﮐ-ﺐﺼﻧ, ﻢﯿﻈﻨﺗ
ﺺﺼﺨﺗ: ﯼﺍ-ﻪﻓﺮﺣ-ﻭ ﯽﻨﻓ, ﻪﺼﺨﺸﻣ
ﺐﯿﺠﻋ-ﻭ-ﺐﯾﺮﻏ: ﺐﻳﺮﻏ-ﻭ-ﺐﻴﺠﻋ
ﻩﺪﻨﻨﮐ-ﺖﺳﺍﻮﺧﺭﺩ: ﺩﺰﻣﺎﻧ
ﯽﻧﺎﺑﺯ: ﻥﺎﺑﺯ, ﯽﺳﺎﻨﺷ-ﻥﺎﺑﺯ
ﯽﮐﺍﺭﻮﺧ-ﭺﺭﺎﻗ: ﻪﺒﻨﭘ-ﺏﻮﭼ, ﺞﻨﻔﺳﺍ
ﻲﻳﺍﻮﻠﺣ-ﻭﺪﻛ: ﺵﺍﻮﮑﺳﺍ, ﻭﺪﮐ
ﻥﺩﺮﺑ-ﻻ﻿ﺎﺑ: ﻥﺩﺮﮐ-ﺪﻨﻠﺑ, ﻥﺪﻣﺁ-ﻻ﻿ﺎﺑ, ﻦﺘﻓﺭ-ﺶﯿﭘ
ﻩﺩﺎﻌﻟﺍ-ﻕﻮﻓ: ﻩﺮﻈﺘﻨﻣ-ﺮﯿﻏ, ﮏﺗ, ﻩﺩﺎﻌﻟﺍ-ﻕﻮﻓ
ﺎﯾﻮﭘ: ﺕﺭﺪﻗ
ﻥﺩﺮﮐ-ﺮﻈﻧ-ﺪﯾﺪﺠﺗ: ﺮﻈﻧ-ﺪﯾﺪﺠﺗ, ﺖﺑﺎﺛ, ﯽﺳﺭﺮﺑ
ﻦﺘﺴﮑﺷ-ﻢﻫﺭﺩ: ﯽﯾﺍﺪﺟ, ﻁﻮﻘﺳ, ﻞﯿﻠﺤﺗ
ﻩﺪﻨﻨﮐ-ﻪﺘﺴﺧ: ﻪﺘﺴﺧ
ﺲﯾﺩﺮﭘ: ﺞﻟﺎﮐ, ﻪﺳﺭﺪﻣ
ﻪﻣﺎﻧ-ﻥﺎﯾﺎﭘ: ﻪﻣﺎﻧ-ﻥﺎﯾﺎﭘ
ﯼﺭﺎﻣﺁ: ﻡﺎﻗﺭﺍ, ﯼﺭﺎﻣﺁ
ﻪﻟﻮﻣﺮﻓ-ﻭ-ﻦﯾﻭﺪﺗ: ﻥﺩﺮﮐ-ﻩﺩﺎﻣﺁ, ﯼﺪﻨﺑ-ﻝﻮﻣﺮﻓ
ﭻﯾﻭﺪﻧﺎﺳ: ﻥﺎﻧ
null-ﺭﺍﺪﻘﻣ: ﺮﻔﺻ, ﯽﻟﺎﺧ
ﮏﯾﺮﺤﺗ: ﺏﺎﺘﺷ, ﻥﺎﺠﯿﻫ, ﮏﯾﺮﺤﺗ
ﺭﻮﺴﻧﺎﺳ: ﯽﭼﺭﻮﺴﻧﺎﺳ, ﺕﺍﺭﺮﻘﻣ
ﻥﺩﺮﮐ-ﺰﻬﺠﻣ: ﻩﺪﻨﻨﮐ-ﻞﯿﻤﮑﺗ
ﻥﺩﺮﮐ-ﺩﺰﻣﺎﻧ: ﯼﺩﺰﻣﺎﻧ, ﺩﺎﻬﻨﺸﯿﭘ
ﻥﺩﺮﮐ-ﻮﻐﻟ: ﻥﺩﺮﮐ-ﻑﺬﺣ, ﻪﺿﺍﺮﻗ, ﯼﺪﯿﻣﺍ-ﺎﻧ
ﺮﺘﻣ: ﻦﺘﻓﺮﮔ-ﻩﺯﺍﺪﻧﺍ
ﻥﺩﺮﮐ-ﻩﺩﺮﺴﻓﺍ: ﻥﺩﺮﮐ-ﻢﺘﺳ
ﺎﻗﺁ: ﺎﻗﺁ, ﺩﺎﺘﺳﺍ
ﯼﺯﺎﺳﺯﺎﺑ: ﯼﺯﺎﺳﺯﺎﺑ, ﺩﻮﺒﻬﺑ
ﯼﺭﻭﺍﺩ: ﻥﻮﻧﺎﻗ, ﯽﺿﺎﻗ
ﯽﻤﺗﺍ: ﻢﺗﺍ, ﯽﻤﺗﺍ
ﺰﯿﮕﻧﺍﺮﺑ-ﺚﺤﺑ: ﺾﻗﺎﻨﺗ
ﻪﺘﻓﺮﺸﯿﭘ: ﻩﺪﯿﭽﯿﭘ, ﻥﺭﺪﻣ
ﯽﻧﺎﻬﮔﺎﻧ-ﺶﺸﮐ-ﺎﯾ ﺖﮐﺮﺣ: ﻦﺘﺧﺍﺪﻧﺍ-ﻻ﻿ﺎﺑ-ﺍﺭ ﻪﻧﺎﺷ
ﺐﺳﺎﻨﻣ-ﺎﻧ: ﻂﺒﺗﺮﻣ-ﺮﯿﻏ, ﻩﺪﻨﺴﺑﺎﻧ
ﺏﻮﺳﺭ: ﻥﺩﺮﮐ-ﻊﯾﺮﺴﺗ
ﺶﻧﺯﺮﺳ: ﺮﯿﻘﺤﺗ, ﺶﻧﺯﺮﺳ
ﺮﮕﯾﺩ-ﻉﻮﻧ: ﻒﻠﺘﺨﻣ
ﻥﺩﺮﮐ-ﺩﺎﻘﺘﻧﺍ: ﺩﺎﻘﺘﻧﺍ
ﯽﮕﺘﺴﺧ: ﻪﻠﺻﻮﺣ-ﯽﺑ, ﯼﺭﻮﺨﻟﺩ, ﯽﺘﺨﺑﺪﺑ
ﻥﺩﺮﮐ-ﯼﺭﺎﮑﻤﻫ: ﯼﺭﺎﮑﻤﻫ, ﯽﮕﺘﺳﻮﯿﭘ
ﻞﯿﻠﺤﺗ-ﻭ-ﻪﯾﺰﺠﺗ: ﻞﯿﻠﺤﺗ, ﺮﮕﻠﯿﻠﺤﺗ
ﻥﺍﺭﺎﺑ-ﺵﺭﺎﺑ: ﻥﺍﺭﺎﺑ
ﻪﻧﺍﻮﺟ: ﻪﻧﺍﻮﺟ
ﺎﻤﯿﭘﺍﻮﻫ: ﻩﺪﻧﺮﭘ
ﺪﻨﺗ: ﺰﯿﺗ
ﯼﺮﯾﺬﭘ-ﻑﺎﻄﻌﻧﺍ: ﯽﻋﺎﺠﺗﺭﺍ-ﺖﯿﻠﺑﺎﻗ
ﮏﺷﻮﻣ: ﮏﺷﻮﻣ
ﺪﯿﻗ: ﻪﻣﺎﻧ-ﺖﻛﺎﭘ
ﯽﺗﺎﺒﺛ-ﯽﺑ: ﻥﺍﺯﺮﻟ
ﺖﯿﻣﻭﺮﺤﻣ: ﻥﺩﺮﮐ-ﻡﻭﺮﺤﻣ, ﺭﺮﺿ
ﻥﺪﺷ-ﻻ﻿ﻭﺩ: ﻥﺩﺯ-ﻪﻤﺗﺎﺒﻤﭼ
ﺪﯿﻟﻮﺗ: ﻥﺩﺮﮐ-ﺪﯿﻟﻮﺗ, ﻥﺩﺭﻭﺁ-ﺩﻮﺟﻭ-ﻪﺑ
ﺐﯾﺮﻘﺗ: ﯽﺒﯾﺮﻘﺗ, ﺵﻭﺭ, ﯽﯾﺍﺮﮕﻤﻫ
ﻪﯿﺣﻭﺭ: ﺭﺍﺪﯿﺑ, ﯽﻗﻼ﻿ﺧﺍ, ﯽﻨﻫﺫ
ﻦﯿﺑ-ﺵﻮﺧ: ﺪﯿﻣﺍ, ﻦﺘﺷﺍﺩ-ﺩﺎﻘﺘﻋﺍ
ﻥﺩﺮﮐ-ﯼﺪﻨﺑ-ﻪﺘﺳﺩ: ﯼﺪﻨﺑ-ﻢﯿﺴﻘﺗ, ﻊﯾﺯﻮﺗ
ﯽﻠﯿﺼﺤﺗ-ﻪﻣﺎﻧﺮﺑ: ﻩﺭﻭﺩ, ﻪﺴﻠﺟ-ﺭﻮﺘﺳﺩ
ﻪﻧﺎﺧ-ﺯﺍ-ﻥﻭﺮﯿﺑ: ﺝﺭﺎﺧ
ﻥﺩﺍﺩ-ﻥﺎﺸﻧ-ﺶﻨﮐﺍﻭ: ﻞﻤﻌﻟﺍ-ﺲﻜﻋ, ﻞﻌﻓ
ﻂﺧ: ﻮﯾﺭﺎﻨﺳ, ﻂﺧ, ﺱﺪﻘﻣ-ﺏﺎﺘﮐ
ﺪﯾﺪﻬﺗ: ﻥﺩﺮﮐ-ﯼﺫﺎﺧﺍ
ﻩﺰﯾﺎﺟ: ﻩﺰﯾﺎﺟ, ﻪﻤﯿﺑ-ﻖﺣ
ﯽﯾﺍﺭﺍﺩ: ﯽﮔﮋﯾﻭ, ﺭﻮﻀﺣ, ﺖﯾﺰﻣ, ﺖﺨﺘﯾﺎﭘ-،ﻪﯾﺎﻣﺮﺳ
ﯼﺮﯾﺬﭘ-ﺮﯿﯿﻐﺗ: ﺕﻭﺎﻔﺗ
ﻡﺎﻬﺑﺍ: ﻢﻬﺒﻣ, ﺾﻗﺎﻨﺗ, ﺪﯾﺩﺮﺗ
null-ﺭﺍﺪﻘﻣ: ﺮﻔﺻ, ﯽﻟﺎﺧ
ﯽﺜﻨﺧ: ﯽﺜﻨﺧ
ﺺﻘﻧ: ﺭﺎﺴﻣﺮﺷ, ﻊﻧﺎﻣ, ﯽﻧﺍﻮﺗﺎﻧ, ﺭﺮﺿ
ﯽﺳﺎﮑﻋ: ﺮﯾﻮﺼﺗ
ﺩﻮﺒﻤﮐ: ﺵﺮﺑ, ﻡﺪﻋ
ﯽﯾﺎﺟ-ﻪﺑﺎﺟ: ﻥﺩﺮﮐ-ﻦﯾﺰﮕﯾﺎﺟ
ﭺﺭﺎﻗ: ﯼﺮﺘﮐﺎﺑ, ﺞﻨﻔﺳﺍ, ﻪﺒﻨﭘ-ﺏﻮﭼ
ﯼﺪﻨﺑ-ﻪﻠﻤﺟ: ﯼﺪﻨﺑ-ﻝﻮﻣﺮﻓ, ﻦﺘﻣ
ﺕﺎﻤﻠﭙﯾﺩ: ﮏﯿﺗﺎﻤﻠﭙﯾﺩ, ﻝﻮﺳﺭ
ﺯﺎﻏﺁ: ﻥﺩﺮﮐ-ﯽﻓﺮﻌﻣ
ﻡﺎﻏﺩﺍ: ﻪﻨﻫﺩ
ﻦﺘﺴﮑﺷ: ﺢﻳﺮﻔﺗ-ﮓﻧﺯ
ﻕﺎﺸﻨﺘﺳﺍ: ﻥﺪﯿﺸﺨﺑ-ﻡﺎﻬﻟﺍ
ﻩﺮﻗﺮﻗ: ﺶﻘﻧ
ﺮﻏﻻ﻿: ﺮﻏﻻ﻿
ﻩﺪﻨﻫﺩ-ﯼﺍﺭ: ﯽﺗﺎﺑﺎﺨﺘﻧﺍ-ﻩﺯﻮﺣ
ﻥﻮﯿﺳﺍﺭﺪﻓ: ﻝﺍﺭﺪﻓ
ﮎﺮﺤﺗ: ﯽﯾﺎﺠﺑﺎﺟ
ﻥﺩﺮﮐ-ﯽﻟﺎﺧ: ﻪﯿﻠﺨﺗ
ﺖﻧﻮﮑﺳ-ﻞﺤﻣ: ﻩﺎﻨﭘ-ﻥﺎﺟ
ﻥﺪﯿﺸﮐ-ﻥﻭﺮﯿﺑ: ﻥﺩﺯ-ﻢﻬﺑ, ﻥﺩﺮﮐ-ﺭﺍﺩﺍﻭ
ﻥﺩﺮﮐ-ﻖﯿﻗﺭ: ﺮﻏﻻ﻿
ﯽﻈﻓﺎﺣﺍﺪﺧ: ﻆﻓﺎﺣﺍﺪﺧ, ﯽﻈﻓﺎﺣﺍﺪﺧ
ﻥﺩﺮﮐ-ﺏﺍﺮﺧ: ﻦﺘﻓﺭ-ﻦﯿﺑ-ﺯﺍ
ﻮﺤﻧ: ﯽﮕﺘﺴﺸﻧﺯﺎﺑ-ﻕﻮﻘﺣ
ﺐﺳﺍ-ﻞﻌﻧ: ﺐﺳﺍ
ﺝﺎﺟﻮﻋﺍ: ﻑﺍﺮﺤﻧﺍ, ﻒﯾﺮﺤﺗ
ﻥﺩﺯ-ﻢﻬﺑ-ﺕﺪﺷ ﺎﺑ: ﻢﺘﺷ-ﻭ-ﺏﺮﺿ
ﻁﻮﺑﺮﻣ: ﺭﺍﻮﺘﺳﺍ, ﺐﺳﺎﻨﻣ, ﻩﺍﺮﻤﻫ
ﯽﻌﺑﺎﺗ: ﯽﻠﻤﻋ, ﺭﺎﮐ
ﻥﺩﺮﮐ-ﺎﺠﺑﺎﺟ: ﻥﺩﺮﮐ-ﻦﯾﺰﮕﯾﺎﺟ, ﻦﺘﺧﺍﺪﻧﺍ-ﻥﻭﺮﯿﺑ, ﻥﺩﺍﺩ-ﻥﺎﮑﺗ
ﯼﺭﺎﺘﺨﻣﺩﻮﺧ: ﻝﻼ﻿ﻘﺘﺳﺍ
ﻦﻔﻌﺗ: ﻮﺑ
ﮏﯿﮑﻔﺗ: ﻥﺩﺍﺩ-ﺰﯿﻤﺗ
ﯽﺳﺮﺘﺳﺩ: ﺏﺎﺴﺘﮐﺍ
ﯽﺳﺎﻨﺷﺭﺎﮐ: ﻮﺠﺸﻧﺍﺩ
ﻑﺍﺮﮔ: ﯽﻧﺎﻣﺯﺎﺳ-ﺕﺭﺎﭼ, ﻪﺸﻘﻧ
ﻥﺩﺮﮐ-ﺏﻭﺬﺠﻣ: ﻥﺩﺮﮐ-ﺮﯿﺳﺍ, ﻦﺘﺧﺍﺪﻧﺍ-ﺖﺳﺩ-ﺍﺭ ﯽﺴﮐ
ﺏﺍﺬﺟ: ﻞﮕﺷﻮﺧ, ﻦﯾﺮﯿﺷ
ﯽﻤﮑﺷ: ﻩﺪﻌﻣ
ﺩﺍﻮﺳ: ﺕﻼ﻿ﯿﺼﺤﺗ
ﯽﺒﯿﮐﺮﺗ: ﯽﻋﻮﻨﺼﻣ
ﯽﺑﺮﻣ: ﯽﺑﺮﻣ
ﻭﺮﺴﻨﮐ: ﯼﺯﺎﺳ-ﻩﺮﯿﺧﺫ, ﯽﯾﻮﺟ-ﻪﻓﺮﺻ, ﺖﻈﻓﺎﺤﻣ, ﻆﻔﺣ
ﻪﻟﺎﺑﺯ: ﻪﺿﺍﺮﻗ, ﻪﻟﺎﺑﺯ, ﯽﻨﺘﺨﯾﺭ-ﺭﻭﺩ
ﺲﮑﻋ: ﺮﯾﻮﺼﺗ, ﺲﮑﻋ
ﯽﺳﺭﺩ-ﺏﺎﺘﮐ: ﯼﺎﻤﻨﻫﺍﺭ-ﻪﭽﺑﺎﺘﮐ, ﺏﺎﺘﮐ
ﻥﺩﺮﮐ-ﯽﮑﯾ: ﺖﯾﻮﻘﺗ
ﺩﻭﺪﺤﻣ: ﻥﺩﺮﮐ-ﺮﯾﺰﮔﺎﻧ, ﺩﻭﺪﺤﻣ, ﻥﺩﺮﮐ-ﯼﺫﺎﺧﺍ
ﻥﺍﺩﺩﺎﺼﺘﻗﺍ: ﯼﺩﺎﺼﺘﻗﺍ
ﯽﻧﺍﻮﻠﻬﭘ: ﯽﺷﺯﺭﻭ, ﻦﯾﺮﻤﺗ
ﻥﺩﺭﻮﺧ-ﻝﻮﻟ: ﻝﻮﺻﺍ-ﻭ-ﺍﺩﺍ
ﺪﯾ: ﯽﻧﺪﻌﻣ
ﻩﺩﻮﻟﺁ: ﺖﻧﻮﻔﻋ, ﻩﺩﻮﻟﺁ
ﺡﺍﺮﻃ: ﺺﺨﺸﻣ
ﻥﺩﺮﮐ-ﻥﺎﻬﻨﭘ: ﺢﺷﺮﺗ, ﻥﺩﺮﮐ-ﯽﻔﺨﻣ, ﻦﺘﺧﺍﺪﻧﺍ-ﻥﻭﺮﯿﺑ, ﺯﺍﺭ, ﻥﺩﺍﺩ-ﺰﯿﻤﺗ
ﺝﺎﻨﻔﺳﺍ: ﺮﺘﺳﺎﻓ, ﻮﻫﺎﮐ
ﺪﯾﺪﺷ: ﻁﺮﻔﻣ, ﺪﯾﺪﺷ
ﻩﺪﻨﻨﮐ-ﺪﻋﺎﻘﺘﻣ: ﯽﺸﯾﺎﻤﻧ
ﺭﺎﮐ-ﺯﺎﻏﺍ: ﻝﻭﺍ, ﻉﻭﺮﺷ
ﻡﺭﺍﺰﻫ: ﺭﺍﺰﻫ
ﯽﻠﺧﺍﺩ: ﯽﻠﺧﺍﺩ, ﻖﯿﻤﻋ, ﻪﻧﺎﺧ-ﻞﺧﺍﺩ-ﺭﺩ, ﻩﺪﺷ-ﻩﺩﺍﺩ-ﺶﺷﻮﭘ
ﻝﺎﻄﺑﺍ: ﻥﺩﺮﮐ-ﻡﻭﺮﺤﻣ
ﻪﻨﻣﺍﺩ: ﻩﺯﺍﺪﻧﺍ
ﺪﻌﺑ: ﺖﻬﺟ, ﺯﺍ-ﺪﻌﺑ, ﯼﺪﻌﺑ, ﺪﻌﺑ
ﺱﺪﻘﻣ-ﺏﺎﺘﮐ: ﺱﺪﻘﻣ-ﺏﺎﺘﮐ
ﺮﺘﺳﻮﭘ: ﻢﭼﺮﭘ, ﺏﻭ
ﻥﺪﯿﺸﺨﺑ-ﺖﻋﺮﺳ: ﻥﺩﺮﮐ-ﻊﯾﺮﺴﺗ
ﺪﯾﺪﺸﺗ: ﺖﯾﻮﻘﺗ, ﻩﺪﻨﻨﮐﺪﯾﺪﺸﺗ
ﻦﯿﻨﺟ-ﻂﻘﺳ: ﻦﯿﻨﺟ-ﻂﻘﺳ
ﻻ﻿ﻮﻤﻌﻣ: ﯽﻠﮐ-ﺭﻮﻄﺑ, ﺞﯾﺍﺭ, ﻊﻗﺍﻮﻣ-ﺮﺘﺸﯿﺑ, ﻞﯾﺎﻤﺗ
ﺪﻬﻌﺗ: ﻩﺪﻋﻭ
ﻒﺻ: ﻡﺩ, ﺐﯿﺗﺮﺗ
ﺏﻼ﻿ﻗ: ﯼﺰﯿﭼ-ﺮﻫ-ﯽﻠﺻﺍ ءﺰﺟ, ﺞﻧﺭﺁ, ﺏﻼ﻿ﻗ, ﯽﻣﺎﺣ, ﻥﺩﺮﮐ-ﺖﯾﺎﻤﺣ
ﻖﺑﺎﺳ: ﯽﻤﯾﺪﻗ
ﺱﻮﮑﻌﻣ: ﺱﻮﮑﻌﻣ, ﯽﮕﻧﻭﺭﺍﻭ
ﻥﺪﺷ-ﺭﺎﺨﺑ: ﻥﺪﺷ-ﺏﻭﺫ, ﻩﺯﺎﯿﻤﺧ
ﯼﺩﺭﻮﻧﺍﻮﻫ: ﻮﺟ, ﺍﻮﻫ, ﺯﺍﻭﺮﭘ
ﻁﺎﺒﺗﺭﺍ: ﻪﺴﯾﺎﻘﻣ
ﯽﻣﻮﻗ: ﺖﺴﯿﻟﺎﻧﻮﯿﺳﺎﻧ, ﯽﻠﻣ
ﻥﺩﺮﮐ-ﻩﺪﯾﺮﺑ-ﻩﺪﯾﺮﺑ: ﺵﺮﺑ, ﻥﺩﺍﺩ-ﺶﻫﺎﻛ
ﺮﯾﻭﺰﺗ-ﻭ-ﻪﻠﯿﺣ ﯼﻭﺭ: ﯼﺮﮔ-ﻪﻠﯿﺣ, ﻩﺪﺷ-ﺖﺳﺭﺩ-ﻪﻧﺍﺩﺎﺘﺳﺍ, ﻩﺪﯿﭽﯿﭘ, ﺖﺨﺳ
ﺕﺎﯿﺻﻮﺼﺧ: ﻥﺩﺮﮐ-ﻒﯿﺻﻮﺗ, ﻪﺼﺨﺸﻣ
ﻥﺩﻮﻤﻧ-ﻪﻓﺎﺿﺍ: ﻥﺩﺮﮐ-ﻞﺼﺘﻣ-ﻢﻫﺎﺑ, ﺕﺍﺯﺍﻮﻣ-ﻪﺑ
ﻝﻮﮑﻟﻮﻣ: ﯽﻟﻮﮑﻟﻮﻣ
ﯼﺪﻨﺑ-ﺮﮑﯿﭘ: ﻊﺿﻭ, ﯼﺭﺎﺘﺧﺎﺳ, ﮊﺎﺘﻧﻮﻣ
ﻞﺑﺎﻘﺘﻣ-ﺮﺛﺍ: ﺪﯿﻨﮐ-ﺖﺒﺤﺻ, ﻭ-ﻒﮐ
ﯽﻤﮐ: ﻢﺠﺣ
ﯽﯾﺍﺮﮔ-ﻥﻭﺭﺩ: ﺮﮕﻧ-ﻪﺘﺷﺬﮔ
ﻕﺮﺷ: ﻕﺮﺷ
ﻪﻔﻄﻧ: ﻪﻧﺍﺩ
ﺪﯿﯾﺎﺗ: ﻥﺩﺮﮐ-ﺖﯾﺎﻤﺣ, ﻥﺩﺮﮐ-ﺭﺍﺮﻗﺍ, ﺐﯾﻮﺼﺗ
ﺮﯿﻏ: ﻪﻧ-ﻭ, ﻪﻧ
ﺭﺎﺒﺘﻋﺍ: ﯼﺭﺍﺩﺎﻓﻭ, ﻥﺎﻨﯿﻤﻃﺍ-ﺖﯿﻠﺑﺎﻗ, ﺭﺎﺒﺘﻋﺍ
ﯼﺭﺎﮑﺑﺍﺮﺧ: ﯽﻫﺎﺒﺗ
ﻑﺍﺮﺤﻧﺍ: ﯽﮔﺪﻧﺍﺭ, ﻑﺍﺮﺤﻧﺍ
ﻖﯾﺭﺰﺗ: ﻥﺯﻮﺳ
ﻝﺪﻨﺻ: ﯽﺘﺣﺍﺭ-ﺶﻔﮐ, ﺶﻔﮐ
ﻪﮑﺗ: ﻪﺷﺍﺮﺗ, ﺪﻨﺑ, ﻂﺴﺑ
ﻥﻮﯾﺰﯾﻮﻠﺗ: ﻥﻮﯾﺰﯾﻮﻠﺗ
ﺕﺎﺑﻮﺒﺣ: ﺕﻼ﻿ﻏ, ﺕﺎﺑﻮﺒﺣ
ﻑﺮﻇ: ﺭﺍﺰﺑﺍ, ﻥﺰﺨﻣ, ﻥﺍﺪﻠﮔ
ﺕﺮﺟﺎﻬﻣ: ﭺﻮﮐ, ﻥﺩﻮﺑ-ﻥﺍﺩﺮﮔﺮﺳ
ﻥﺎﮔﮊﺍﻭ: ﺕﺎﺣﻼ﻿ﻄﺻﺍ
ﻪﯿﺑﺎﺨﺘﻧﺍ-ﻩﺯﻮﺣ: ﯽﺗﺎﺑﺎﺨﺘﻧﺍ-ﻩﺯﻮﺣ
ﻥﺩﺮﮐ-ﮎﺎﭘ: ﻥﺩﺮﮐ-ﻑﺬﺣ, ﻦﺘﻓﺭ-ﻦﯿﺑ-ﺯﺍ
ﻥﺩﺮﮐ-ﺖﻃﺎﺳﻭ: ﻥﺩﺍﺩ-ﯽﺘﺷﺁ
ﯼﺭﺍﺩ-ﻪﯾﺎﻣﺮﺳ: ﺭﺍﺩ-ﻪﯾﺎﻣﺮﺳ
ﯽﮑﺳﺍ: ﻥﺩﺮﮐ-ﯼﺯﺎﺑ-ﺖﯿﮑﺳﺍ
ﮎﺮﻤﮔ-ﺯﺍ-ﻻ﻿ﺎﮐ ﺺﯿﺧﺮﺗ: ﺭﺎﻤﻗ, ﻩﺯﺎﺟﺍ
ﯽﺑﺎﺨﺘﻧﺍ: ﻥﺩﺮﻛ-ﺏﺎﺨﺘﻧﺍ
ﺎﺘﺴﯾﺍ: ﺩﺭﺍﺪﻧﺎﺘﺳﺍ
ﺍﺮﮕﻤﻫ: ﺕﺎﻗﻼ﻿ﻣ, ﯽﯾﺍﺮﮕﻤﻫ, ﺰﮐﺮﻤﺗ
ﯽﯾﺎﺒﻔﻟﺍ: ﺎﺒﻔﻟﺍ
ﯽﻧﺎﻬﺟ: ﻲﻠﻠﻤﻟﺍ-ﻦﻴﺑ, ﻥﺎﻬﺟ
ﻪﺤﻧﺎﺳ: ﯽﻧﺎﺑﺮﻗ
ﻪﺷﺎﺑ: ﻥﺎﺴﮑﯾ, ﺖﺑﺎﺛ, ﺭﺎﯿﺴﺑ
ﯽﻠﻤﻋ: ﯽﻠﻤﻋ
ﺭﻭﺍﺩ: ﻥﻮﻧﺎﻗ, ﯽﺿﺎﻗ
ﻞﯿﺴﻧﺍﺮﻔﯾﺩ: ﺕﻭﺎﻔﺗ
ﻥﺩﺍﺩ-ﻥﻭﺮﯿﺑ: ﻦﺘﺨﯾﺭ-ﻥﻭﺮﯿﺑ, ﺲﻔﻧ
ﻪﺿﻮﺣ: ﺏﺍ
ﯽﻧﺩﺮﮐ-ﺐﺼﻧ-ﻡﺯﺍﻮﻟ: ﻕﺎﺒﻄﻧﺍ, ﺕﺍﺰﯿﻬﺠﺗ
ﺐﺼﻧ: ﻥﺩﺮﮐ-ﺐﺼﻧ, ﺩﺎﺠﯾﺍ, ﻪﺘﺴﺑ
ﺪﯾﺪﺸﺗ: ﺵﺎﻌﺗﺭﺍ
ﯽﺘﻨﺳ-ﺭﻮﻃ-ﻪﺑ: ﺖﻨﺳ
ﺱﺭﺩ-ﺱﻼ﻿ﮐ: ﺭﺍﺪﻣ
ﻞﮑﺗﻭﺮﭘ: ﯼﺭﺎﮑﻤﻫ-ﺩﺍﺩﺭﺍﺮﻗ
ﻪﻠﺿﺎﻓ-ﻭ-ﻪﻌﻣﺎﺟ ﺏﺎﺴﺣ: ﻪﺒﺳﺎﺤﻣ, ﻪﺤﯾﻻ﻿
ﻡﺮﮔ: ﻡﺮﮔ, ﻦﻤﭼ
ﻦﯾﺰﻨﺑ: ﻞﯿﺋﻭﺯﺎﮔ
ﻥﺎﺸﮑﻬﮐ: ﯽﮑﻠﻓ-ﺕﺭﻮﺻ
ﻥﺍﻮﺟﻮﻧ: ﻥﺍﻮﺟ
ﻥﺩﺮﮐ-ﻁﻮﻠﺨﻣ: ﻞﮑﺸﻣ
ﻡﻮﯾﺩﺍﺭ: ﻮﯾﺩﺍﺭ
ﻖﯿﻗﺭ: ﺮﻏﻻ﻿
ﺎﻤﯿﭘﺍﻮﻫ: ﻩﺪﻧﺮﭘ
ﻝﺍﺪﭘ: ﺝﺁ
ﺩﻭﺪﺣ-ﺭﺩ: ﺎﺒﯾﺮﻘﺗ, ﻩﺭﺎﺑ-ﺭﺩ
ﻩﻮﻗ-ﻍﺍﺮﭼ: ﯽﺳﺪﻋ
ﻥﺍﺪﻤﭼ: ﻪﺒﻌﺟ, ﻥﺍﺪﻤﭼ
ﻪﻟﺩﺎﺒﻣ: ﻝﺩﺎﺒﺗ
ﯼﺭﺎﯿﺘﺧﺍ: ﯽﺷﺭﺎﻔﺳ
ﺲﯾﺮﺗﺎﻣ: ﻩﺪﻌﻣ
ﺮﯾﻮﺼﺗ: ﻪﻧﺎﺷ, ﺮﯾﻮﺼﺗ
ﺶﯿﭘ: ﻕﺮﺷ, ﺯﺍ-ﻞﺒﻗ, ﺭﺍﺰﻔﻠﻋ
ﯽﻬﮔﺁ: ﺩﻼ﻿ﯿﻣ-ﺯﺍ-ﺪﻌﺑ
ﻥﺩﺮﮐ-ﺲﺣ-ﯽﺑ: ﻥﺩﺮﮐ-ﺕﺎﻣ
ﻉﻮﻗﻭ: ﻪﺛﺩﺎﺣ, ﺐﯿﺷ
ﯽﻧﻮﮕﻧﺮﺳ: ﻦﺘﺨﯾﺭ, ﺐﻠﻗ
ﯽﺴﺣ: ﺱﺎﺴﺣﺍ, ﯽﺗﺎﺳﺎﺴﺣﺍ
ﻉﺎﻤﺟﺍ: ﯼﺭﺎﮑﻤﻫ-ﺩﺍﺩﺭﺍﺮﻗ
ﻥﺩﺮﮐ-ﺕﺭﺎﻈﻧ: ﺖﯾﺮﯾﺪﻣ, ﺭﻮﺘﯿﻧﺎﻣ, ﺲﯿﻠﭘ
ﺪﻧﻮﯿﭘ: ﺏﻭﺎﻨﺘﻣ
ﻡﻮﯿﻨﯿﻣﻮﻟﺁ: ﻡﻮﯿﻨﯿﻣﻮﻟﺁ
ﻥﺎﺳﻮﻧ: ﻥﺎﺳﻮﻧ
ﯼﺯﺎﺳ-ﻪﯿﺒﺷ: ﻥﺩﺮﮐ-ﺪﯿﻠﻘﺗ, ﻥﺩﺮﮐ-ﻞﻌﺟ
ﻥﺩﺮﮐ-ﻩﺪﯿﭽﯿﭘ: ﻩﺪﯿﭽﯿﭘ
ﯽﺑﺮﻣ: ﺭﻭﺎﺸﻣ, ﯽﺑﺮﻣ
ﻑﺎﮑﺷ: ﺡﺎﺘﺘﻓﺍ
ﺥﺭ: ﻍﻼ﻿ﮐ, ﺝﺮﺑ, ﻪﻌﻠﻗ, ﮓﻨﻔﺗ
ﻥﺩﺮﮐ-ﯼﺭﺎﮑﺘﺳﺩ: ﯼﺭﺎﮐ-ﺖﺳﺩ, ﻥﺩﺯ-ﻢﻬﺑ
ﺭﺍﻮﺧ-ﻩﺎﯿﮔ: ﯼﺰﺒﺳ
ﺭﺎﺠﻨﻫ: ﺕﺎﺼﺨﺸﻣ, ﺩﺭﺍﺪﻧﺎﺘﺳﺍ, ﻥﻮﻧﺎﻗ
ﻭﺮﺘﻣ: ﻞﻧﻮﺗ
ﯽﺴﻔﻨﺗ: ﺲﻔﻧ
ﯼﺯﺎﺳ-ﻪﯿﺒﺷ: ﻥﺩﺮﮐ-ﺪﯿﻠﻘﺗ
ﮓﻧﺮﺳ: ﻥﺯﻮﺳ
ﺶﻬﺟ: ﻥﺩﺍﺩ-ﺮﯿﯿﻐﺗ, ﻞﯾﺪﺒﺗ
ﯼﺭﺍﻮﻠﺷ-ﺮﯾﺯ: ﯼﺭﺍﻮﻠﺷ-ﺮﯾﺯ, ﯽﻧﺎﺘﮐ-ﻪﭼﺭﺎﭘ
ﻞﺒﻬﻣ: ﺰﻣﺮﻗ-ﻪﺑ-ﻞﯾﺎﻣ ﺥﺮﺳ
ﻕﺍﺮﺘﻓﺍ: ﻥﺩﺍﺩ-ﺰﯿﻤﺗ, ﺕﻭﺎﻔﺗ
ﯽﻠﺼﻓ: ﻞﺼﻓ
ﯽﯾﺎﺘﺳﻭﺭ: ﯽﯾﺎﺘﺳﻭﺭ
ﺪﺠﻨﮐ: ﻝﺎﺧ
ءﺎﻤﻏﺍ: ﻝﻮﮔﺮﯾﻭ
ﻥﺩﺮﮐ-ﺱﻮﮑﻌﻣ: ﯽﮕﻧﻭﺭﺍﻭ, ﺱﻮﮑﻌﻣ
ﺖﺳﺮﭘﺮﺳ: ﻩﺪﻨﻨﮐ-ﻩﺪﻫﺎﺸﻣ, ﯼﺎﻤﻨﻫﺍﺭ-ﻪﭽﺑﺎﺘﮐ
ﻥﺩﺮﮐ-ﺭﺎﻨﮐ-ﺮﺑ: ﻦﺘﺧﺍﺪﻧﺍ-ﻥﻭﺮﯿﺑ
ﯽﺳﺮﺑﺎﺴﺣ: ﯽﺳﺭﺮﺑ, ﺮﻈﻧ-ﺪﯾﺪﺠﺗ
ﯼﻭﺭ-ﻩﺩﺎﯿﭘ: ﻦﺘﻓﺮﮔ-ﺝﻭﺍ, ﻥﺩﻮﺑ-ﻥﺍﺩﺮﮔﺮﺳ, ﻥﺩﺮﮐ-ﺪﻨﻠﺑ
ﻥﺎﮑﻣ: ﻪﻄﻘﻧ
ﯼﺩﺎﺼﺘﻗﺍ-ﻥﺍﺮﺤﺑ: ﺩﺎﺼﺘﻗﺍ-ﻢﻠﻋ
ﺕﺭﺎﻏ: ﺕﺭﺎﻏ
ﺭﺎﻌﺷ: ﺭﻮﺒﻋ-ﺰﻣﺭ
ﻦﯿﻨﺟ: ﻦﯿﻨﺟ
ﻡﺎﻏﺩﺍ: ﯼﺭﺎﮑﻤﻫ, ﻝﻮﻤﺷ
ﯽﻧﺍﻮﻏﺭﺍ: ﺶﻔﻨﺑ-ﮓﻧﺭ, ﯼﺍ-ﻩﺯﻭﺮﯿﻓ
ﻥﺪﻧﺎﺳﺭ-ﻞﻗﺍﺪﺣ-ﻪﺑ: ﻦﯾﺮﺘﻤﮐ, ﻥﺩﺍﺩ-ﺶﻫﺎﻛ
ﯽﻧﻮﮑﺴﻣ: ﻩﺎﻨﭘ-ﻥﺎﺟ
ﺩﺪﻋ: ﻝﺎﺘﯿﺠﯾﺩ, ﺩﺪﻋ
ﻩﺰﻣ-ﺭﻮﺷ: ﮏﻤﻧ
null-ﺭﺍﺪﻘﻣ: ﺮﻔﺻ, ﯽﻟﺎﺧ
ﺯﺍﺩﺮﭘ-ﻪﯾﺮﻈﻧ: ﻪﯾﺮﻈﻧ
ﻡﻮﯾﺭﺍﻮﮐﺁ: ﯽﻫﺎﻣ
ﺶﺸﮐ: ﺩﺭ
ﺕﺎﺠﻧ-ﺮﺘﭼ: ﺮﺘﭼ
ﺮﺘﻤﻬﻣ: ﻡﺯﻻ﻿
ﯽﻠﮐ-ﺭﻮﻃ-ﻪﺑ: ﯽﻠﮐ-ﺭﻮﻄﺑ, ﻪﻤﻫ, ﺞﯾﺍﺭ
ﻥﺪﺷ-ﺪﺳﺎﻓ: ﻥﺪﺷ-ﺪﺳﺎﻓ
null-ﺭﺍﺪﻘﻣ: ﺮﻔﺻ, ﯽﻟﺎﺧ
ﯽﺴﻨﺟ-ﺕﻼ﻿ﯾﺎﻤﺗ: ﯽﺴﻨﺟ
ﻩﺮﻗﺮﻗ: ﻢﺠﺣ, ﻥﺩﺮﮐ-ﯼﺪﻨﺑ-ﻪﺘﺴﺑ
ﺎﺗﺪﻤﻋ: ﯼﺩﺎﯾﺯ-ﺪﺣ-ﺎﺗ
ﮎﺎﻨﺒﺴﭼ: ﻩﺪﻨﺒﺴﭼ
ﻩﺩﻭﺭ: ﻩﺩﻭﺭ-ﻭ-ﻝﺩ
ﯽﺳﺎﻨﺷ-ﻥﺎﺘﺳﺎﺑ: ﯽﺳﺎﻨﺷ-ﻥﺎﺘﺳﺎﺑ
ﻲﻨﻴﻣﺯ-ﻡﺍﺩﺎﺑ: ﺕﺎﺑﻮﺒﺣ
ﻝﺪﺑ: ﯼﺮﻤﺘﺴﻣ
ﺯﺎﮔ-ﻕﺎﺟﺍ: ﻕﺎﺟﺍ, ﻪﻧﺎﺧﺰﭙﺷﺁ
ﺭﺍﻮﻠﺷ: ﺭﺍﻮﻠﺷ
ﺺﺧﺎﺷ: ﺩﺭﺍﺪﻧﺎﺘﺳﺍ, ﺺﺧﺎﺷ
ﯽﻠﮐ-ﺪﯾﺩ: ﯽﻠﮐ-ﺡﺮﻃ
ﯽﻔﯿﮐ: ﻪﺼﺨﺸﻣ
ﮏﻨﯿﻋ: ﻪﺸﯿﺷ
ﮏﯿﺘﻧﮊ: ﯽﮑﯾﮊﻮﻟﻮﻓﺭﻮﻣ, ﮏﯿﺘﻧﮊ, ﻥﮊ
ﻩﺪﻨﻨﮐ-ﺖﮐﺮﺷ: ﻥﺩﺮﮐ-ﻞﺻﻭ, ﺶﻘﻧ, ﯽﻔﺻﻭ-ﻪﺟﻭ
ﻪﻋﻮﻤﺠﻣ: ﺩﺍﺪﻌﺘﺳﺍ, ﺭﺍﺰﻓﺍ-ﻡﺮﻧ
ﻥﺪﻧﺎﺧﺮﭼ: ﻪﺧﺮﭼ, ﺶﺧﺮﭼ
ﺡﺮﻃ: ﻥﺎﻣﺯﺎﺳ, ﺡﺮﻃ, ﻊﺿﻭ
ﺪﻨﺳ: ﻦﯿﮔﻼ﻿ﭘ, ﻝﻮﺻﻭ-ﻡﻼ﻿ﻋﺍ
ﻪﯿﻀﻗ: ﻪﻠﻤﺟ, ﻪﯾﺮﻈﻧ, ﻞﺻﺍ
ﯽﺘﺧﺎﻨﺷ: ﺺﯿﺨﺸﺗ
ﻥﺩﺮﮐ-ﺢﯾﺮﺼﺗ: ﻩﺪﺷ-ﺖﺳﺭﺩ-ﻪﻧﺍﺩﺎﺘﺳﺍ, ﺢﯿﺿﻮﺗ
ﯽﻤﺳ: ﻢﺳ
ﺪﯿﮐﺎﺗ: ﺪﯿﮐﺎﺗ
ﻢﻠﻗ: ﻥﺯﻮﺳ
ﺩﻮﮐﺭ: ﻥﺍﺮﺤﺑ
ﻥﺩﺮﮐ-ﻪﯿﻬﺗ: ﺖﻣﺪﺧ, ﻩﺪﺷ-ﻪﺋﺍﺭﺍ, ﻥﺩﺍﺩ-ﻥﺎﻨﯿﻤﻃﺍ
ﺪﺿ: ﺖﻔﻟﺎﺨﻣ
ﻡﻭﺎﻘﻣ: ﻦﻣﺰﻣ, ﺖﻔﻟﺎﺨﻣ, ﻥﻮﺼﻣ
ﺮﺼﺘﺨﻣ-ﮎﺍﺭﻮﺧ: ﺖﺴﺗ-ﻥﺎﻧ
ﺎﻤﻨﯿﺳ: ﺎﻤﻨﯿﺳ-ﻢﻠﯿﻓ, ﺎﻤﻨﯿﺳ
ﺏﺁ-ﺮﻴﺷ: ﻪﻟﻮﻟ
ﺮﮕﻧﺎﺸﻧ: ﺖﻣﻼ﻿ﻋ
ﯽﻧﻮﻣﺍﺮﯿﭘ: ﻑﺍﺮﻃﺍ, ﯼﺍ-ﻪﻘﻄﻨﻣ
ﻩﺪﻨﻨﮐ-ﺭﺎﻬﻇﺍ: ﺺﺨﺸﻣ, ﯼﺪﻨﺴﻣ, ﺰﯿﻣﺁ-ﺖﻧﻮﺸﺧ, ﻊﻃﺎﻗ, ﻖﺷ-ﻪﻠﮐ
ﻩﺮﮔ: ﻩﺮﮔ
ﻕﺎﭼ: ﻢﯿﺨﺿ
ﻥﺩﺮﮐ-ﻖﯾﺮﻔﺗ: ﻦﺘﺧﺍﺪﻧﺍ-ﻥﻭﺮﯿﺑ, ﻥﺩﺍﺩ-ﺶﻫﺎﻛ, ﻢﺳﺭ, ﻥﺩﺮﮐ-ﻡﻭﺮﺤﻣ
ﻡﺯﻻ﻿: ﻡﺯﻻ﻿
ﭻﯿﭘﺭﺎﻣ: ﻥﻭﺰﻠﺣ, ﺪﻌﺠﻣ
ﯽﻨﯾﺮﯿﺷ: ﺖﯾﻮﮑﺴﯿﺑ, ﮏﯿﮐ
ﻥﺩﺮﮐ-ﺩﺎﺑ: ﻡﺭﻮﺗ
ﮏﯿﻧﻭﺮﺘﮑﻟﺍ: ﮏﯿﻧﻭﺮﺘﮑﻟﺍ
ﯽﺴﯾﻮﻧ-ﺯﺎﺑ: ﻥﺩﺮﮐ-ﯽﺴﯾﻮﻧﻭﺭ
ﻩﺎﮕﺸﯾﺎﻣﺯﺁ: ﻩﺎﮕﺸﯾﺎﻣﺯﺁ
ﯼﺍ-ﻪﻓﺮﺣ: ﻪﻓﺮﺣ, ﯼﺭﺎﺠﺗ, ﯼﺍ-ﻪﻓﺮﺣ-ﻭ ﯽﻨﻓ, ﺭﺎﮐ
ﺐﯿﺷ: ﻞﯾﺎﻣ, ﺐﯿﺷ
ﮓﻧﺭﺎﮕﻧﺭ: ﮓﻧﺭ
ﺶﺷﻮﭘ: ﻩﺪﺷ-ﻩﺩﺍﺩ-ﺶﺷﻮﭘ, ﻦﺴﮐﺍﻭ, ﻥﺩﺍﺩ-ﺖﻴﻤﻫﺍ, ﻮﺘﭘ, ﻒﻘﺳ, ﻪﺟﻮﺗ, ﻢﺠﺣ
ﯼﺮﯿﮔﺭﺩ: ﻥﺩﺮﮐ-ﻞﺻﻭ, ﻝﻮﻤﺷ
ﺖﻬﺟ: ﺖﻬﺟ
ﻦﺘﺧﺎﺳ: ﻥﺩﺭﻭﺁ-ﺩﻮﺟﻭ-ﻪﺑ, ﻥﺩﺮﮐ-ﺪﯿﻟﻮﺗ
ﯽﺗﺭﺍﺮﺣ: ﺖﻔﻧ
ﻪﺸﯿﻠﮐ: ﺎﻨﺜﺘﺳﺍ
ﯼﮊﻮﻟﻮﻨﮑﺗ: ﯽﻨﻓ
ﻩﺪﻧﺎﻣ-ﯽﻗﺎﺑ: ﯽﻗﺎﺑ, ﯽﮕﻧﻭﺰﻓﺍ
ﻥﻮﯿﻣﺎﮐ: ﻥﻮﯿﻣﺎﮐ
ﻩﺎﮕﺷﺯﺭﻭ: ﻩﺯﻮﺣ
ﯽﮕﻨﻫﺎﻤﻫ: ﻥﺩﺮﻛ-ﮓﻨﻫﺎﻤﻫ
ﯼﺮﺘﮐﺎﺑ: ﯼﺮﺘﮐﺎﺑ
ﻂﺑﺍﺭ: ﺵﻭﺭ
ﻥﻮﮑﯿﻠﯿﺳ: PI
ﻥﺩﺮﮐ-ﻆﻔﺣ: ﻪﻈﻓﺎﺣ, ﯽﯾﻮﺟ-ﻪﻓﺮﺻ, ﻥﺩﺭﻭﺁ-ﺩﺎﻳ-ﻪﺑ
ﯽﺼﯿﺨﺸﺗ: ﺺﯿﺨﺸﺗ
ﺱﻭﺭﺩ-ﻞﺼﻓﺮﺳ: ﻩﺪﯿﮑﭼ
ﻝﺎﻘﺘﻧﺍ: ﻂﺧ, ﯽﯾﺎﺑﺭ-ﻡﺩﺁ
ﻥﻮﯿﻠﯿﻣ: ﻥﻮﯿﻠﯿﻣ
ﺵﻭﺮﻓ-ﻩﺩﺮﺧ: ﻝﻻ﻿ﺩ
ﻢﯾﺭﺎﺑ: ﺭﺎﺑ
ﯽﻠﺻﺍ-ﺮﯿﺴﻣ: ﺪﯿﻠﮐ, ﻡﻭﺩ
ﺭﺍﺩ-ﺎﻨﻌﻣ: ﻦﺘﺷﺍﺩ-ﺭﻮﻈﻨﻣ, ﻢﻬﻣ
ﯽﻌﻤﺳ: ﺍﺪﺻ
ﯽﮐﺍﺭﺩﺍ: ﺭﻮﺼﺗ
ﯼﺭﻮﺗ: ﺏﻭ
ﯽﯾﺎﻀﻓ: ﻮﺟ, ﯼﺪﻌﺑ
ﻥﺎﺤﺘﻣﺍ: ﻥﺎﺤﺘﻣﺍ
ﻂﺳﺍﻭﺍ: ﻡﻭﺩ, ﺮﻤﮐ-ﺭﻭﺩ
ﺶﯾﺍﺭﺁ: ﻥﺩﺮﮐ-ﻥﺍﺮﺒﺟ
ﻪﺘﺴﺴﮔ: ﻢﻫ-ﺯﺍ-ﺍﺪﺟ, ﮏﺗ
ﺭﺎﻬﻣ: ﯼﺭﺍﺩﺯﺎﺑ, ﻥﺩﺮﮐ-ﯼﺮﯿﮔﻮﻠﺟ
ﺪﻨﭼ: ﻒﻠﺘﺨﻣ, ﺶﯿﺑ, ﺭﺎﯿﺴﺑ
ﻡﺮﮔ: ﺖﺑﻮﻃﺭ, ﻡﺮﮔ
ﯽﺳﺎﻨﺷ-ﺖﺨﯾﺭ: ﯽﮑﯾﮊﻮﻟﻮﻓﺭﻮﻣ
ﻥﺩﺍﺩ-ﺺﯿﺨﺸﺗ: ﺺﯿﺨﺸﺗ
ﺍﺰﻧﻻ﻿ﻮﻔﻧﺁ: ﺍﺰﻧﺍﻮﻠﻔﻧﺍ
ﮏﯿﻓﺍﺮﮔ: ﯽﻧﺎﻣﺯﺎﺳ-ﺕﺭﺎﭼ
ﺮﻧﻭﺮﮐ-ﻕﻭﺮﻋ: ﯼﺭﺎﻤﯿﺑ
ﻞﻔﮐ: ﻦﯾﺮﺳ, ﻥﻮﺒﻣﺍﮊ
ﯽﻧﺎﮕﯾﺎﺑ: ﻞﯾﺎﻓ
ﻪﻬﺟﺍﻮﻣ: ﻥﺩﺮﮐ-ﻩﺯﺭﺎﺒﻣ, ﺩﺎﻀﺗ, ﻪﺴﯾﺎﻘﻣ
ﯼﺭﺎﺑ: ﻥﻮﯿﻣﺎﮐ
ﻪﻨﯿﻬﺑ: ﻪﻨﯿﻬﺑ, ﯽﻟﺎﻋ
ﺎﺳﺎﺳﺍ: ﺕﺎﺣﻼ﻿ﻄﺻﺍ
ﻩﺰﯿﮕﻧﺍ: ﮎﺮﺤﻣ
ﻪﻀﯿﺑ: ﻍﺮﻣ-ﻢﺨﺗ
ﺩﺮﮔﻮﮔ: ﺩﺮﮔﻮﮔ
ﯽﺗﺎﯿﻠﻤﻋ: ﯼﺭﺎﮐ-ﺖﺳﺩ, ﻞﻤﻋ
ﺮﯿﺴﻣ: ﺭﺍﺪﻣ, ﺮﯿﺴﻣ
ﻁﺎﺒﺗﺭﺍ: ﻩﺍﺮﻤﻫ, ﺖﯿﻤﻫﺍ, ﻂﺑﺍﻭﺭ
ﻪﺧﺮﭼﻭﺩ: ﻱﺭﺍﻮﺳ-ﻪﺧﺮﭼﻭﺩ, ﻪﺧﺮﭼ, ﺥﺮﭼ
ﺩﻮﻤﻨﻫﺭ: ﯽﺸﯾﺎﻤﻧ
ﯽﯾﺎﻤﯿﭘﺍﻮﻫ: ﻩﺪﻧﺮﭘ, ﺍﻮﻫ
ﺮﺘﯿﻟ: ﺮﺘﯿﻟ
ﺖﺴﮑﺷ: ﯼﺪﯿﻣﺍ-ﺎﻧ, ﻥﺪﺷ-ﻪﮐﻮﺷ, ﺖﻓﺮﺴﭘ, ﺖﺴﮑﺷ, ﻊﻧﺎﻣ
ﻥﺩﺮﮐ-ﺪﺤﺘﻣ: ﻪﻨﻫﺩ, ﻥﺩﺍﺩ-ﯽﺘﺷﺁ
ﺖﻟﺎﺣ: ﻥﺩﺎﺘﺴﯾﺍ, ﺖﯿﻌﻗﻮﻣ, ﺪﻨﺑ
ﻞﻗﺍﺪﺣ: ﻦﯾﺮﺘﻤﮐ
ﯼﺎﻬﺧﺮﭼ: ﻱﺭﺍﻮﺳ-ﻪﺧﺮﭼﻭﺩ, ﯼﺎﻫﺭﻭﺩ
ﻪﯾﻻ﻿: ﯽﻟﻮﮑﻟﻮﻣ
ﺏﺁ-ﺮﯾﺯ: ﯽﯾﺎﯾﺭﺩ-ﺮﯾﺯ
ﺺﺼﺨﺗ: ﻪﺑﺮﺠﺗ, ﺕﺭﺎﻬﻣ
null-ﺭﺍﺪﻘﻣ: ﺮﻔﺻ, ﯽﻟﺎﺧ
ﻥﻭﺮﺘﮑﻟﺍ: ﮏﯿﻧﻭﺮﺘﮑﻟﺍ
ﯽﻠﻣﺎﻌﺗ: ﻭ-ﻒﮐ
ﺍﺪﺘﺑﺍ-ﺭﺩ: ﯽﻠﺻﺍ
ﯼﺭﺎﮑﺑﺍﺮﺧ: ﻦﺘﻓﺭ-ﻦﯿﺑ-ﺯﺍ
ﻞﻣﺎﻌﺗ: ﺪﯿﻨﮐ-ﺖﺒﺤﺻ, ﻥﺩﺮﮐ-ﯽﻋﺎﻤﺘﺟﺍ
ﯽﺿﺎﯾﺭ: ﺕﺎﯿﺿﺎﯾﺭ
ﯽﻨﯿﻨﺟ: ﻦﯿﻨﺟ
ﻥﺩﺮﮐ-ﻦﯾﻮﻧ: ﻥﺭﺪﻣ, ﯽﻧﺎﺳﺭ-ﺯﻭﺭ-ﻪﺑ
ﯽﻃﺍﺮﻓﺍ: ﻝﺎﮑﯾﺩﺍﺭ, ﻁﺮﻔﻣ
ﺵﺎﺷ: ﺭﺍﺭﺩﺍ
ﻥﺪﺷ-ﻊﻤﺟ: ﻦﺘﻓﺮﯾﺬﭘ
ﻪﺷﺎﺑ: ﺖﺑﺎﺛ, ﺭﺎﯿﺴﺑ
ﻥﺩﺯ-ﺪﯾﺪﺷﻭ-ﺪﻨﺗ ﻪﺑﺮﺿ: ﺖﻗﺮﺳ
ﺪﻨﻣﺩﻮﺳ: ﺍﺪﻤﻋ
ﻪﻤﯿﻧ: ﻩﺍﺭ-ﻪﻤﯿﻧ, ﺵﻭﺮﻓ, ﻥﺩﺮﮐ-ﺏﺎﯿﺳﺁ, ﺽﺮﻋ
ﯽﺒﺼﻋ: ﯽﺒﺼﻋ
ﻒﻟﺎﺨﻣ: ﺖﻔﻟﺎﺨﻣ
ﺱﺪﻋ: ﯽﺳﺪﻋ
ﻝﺎﻤﯾﺰﮔﻭﺮﭘ: ﺎﺒﯾﺮﻘﺗ
ﯼﺬﻐﻣ-ﻩﺩﺎﻣ: ﯽﻧﺪﻌﻣ, ﺍﺬﻏ
ﺢﺿﺍﻭ-ﺮﯿﻏ: ﻢﻬﺒﻣ, ﺩﻮﻬﺸﻣ
ﻢﺧﺯ: ﻥﺪﺷ-ﻪﮐﻮﺷ, ﯽﮔﺪﯾﺩ-ﺐﯿﺳﺁ, ﻢﺧﺯ
SWOP: ﻝﺩﺎﺒﺗ
ﺭﺍﺩﺮﺑ: ﻞﻣﺎﺣ
ﮏﯿﺘﮐﺎﺗ: ﺵﻭﺭ
ﯽﺑﺎﯾﺯﺭﺍ: ﯽﺑﺎﯾﺯﺭﺍ
null-ﺭﺍﺪﻘﻣ: ﺮﻔﺻ, ﯽﻟﺎﺧ
ﻥﻮﻠﮐ: ﻪﺨﺴﻧ
ﻡﺍﻭﺩ-ﻞﺑﺎﻗ: ﺖﯾﺰﻣ, ﺭﺍﺬﮔ-ﺮﻴﺛﺎﺗ
ﯼﺯﺎﺳ-ﺪﻨﻧﺎﻤﻫ: ﻪﺨﺴﻧ
ﯽﺸﻨﮐﺍﻭ: ﻞﻤﻌﻟﺍ-ﺲﻜﻋ
ﯽﻧﺎﻣﺯ-ﻝﻭﺪﺟ: ﻢﯾﻮﻘﺗ, ﻥﺎﻣﺯ, ﻊﺿﻭ
ﯼﻮﺤﻧ: ﺖﺷﻮﻧﺮﺳ
ﻥﺩﺮﮐ-ﺖﯿﺒﺜﺗ: ﻡﺍﺭﺁ
ﻒﻟﺎﺨﻣ: ﺐﯿﻗﺭ
ﺩﺭﻮﺧﺯﺎﺑ: ﻞﻤﻌﻟﺍ-ﺲﻜﻋ
ﻪﻣﺎﻨﺸﺳﺮﭘ: ﻥﺎﺤﺘﻣﺍ
ﻥﺩﺯ-ﮓﻧﺯ: ﻥﺩﺯ-ﮓﻧﺯ
ﺮﺘﻤﯿﻠﯿﻣ: ﺮﺘﻤﯿﻠﯿﻣ
ﯽﻧﺍﻭﺭ: ﯼﺮﮑﻓ
ﻡﺭﺪﻨﺳ: ﯼﺭﺎﻤﯿﺑ
ﻮﮕﻟﺍ: ﻝﺎﺜﻣ
ﻥﺩﺮﮐ-ﻝﺎﻌﻓ: ﻦﺘﺧﺎﺳ-ﺭﺩﺎﻗ, ﻡﺎﺠﻧﺍ, ﻞﻤﻋ
ﯽﻓﺩﺎﺼﺗ-ﺕﺭﻮﺻ-ﻪﺑ: ﯽﻓﺩﺎﺼﺗ, ﯽﻗﺎﻔﺗﺍ, ﻪﺑ-ﺩﺭﻮﻣ
ﺩﺮﻃ: ﻢﻫ-ﺯﺍ-ﺍﺪﺟ, ﻢﯾﺮﺤﺗ
ﻪﻋﻮﻤﺠﻣ-ﺮﯾﺯ: ﺶﺨﺑ
ﯽﺳﺎﻨﺷ-ﺵﻭﺭ: ﺮﯿﺴﻣ, ﺵﻭﺭ, ﺭﺎﺑ-ﮏﯾ
ﯼﺮﻨﻫ-ﺮﺛﺍ: ﺭﺎﮐ
ﯽﭘ-ﺭﺩ-ﯽﭘ: ﺭﺍﻮﺘﺳﺍ, ﯽﺒﯿﺗﺮﺗ
ﻦﺘﺷﺍﺩ-ﻪﮕﻧ: ﻦﺘﺷﺍﺩ-ﻪﮕﻧ, ﻥﺩﺮﮐ-ﺐﺣﺎﺼﺗ, ﻪﺘﺴﺑ
ﺮﺘﻣﻮﻠﯿﮐ: ﺮﺘﻣﻮﻠﯿﮐ
ﯽﺘﯿﻠﻣ-ﺪﻨﭼ: ﻲﻠﻠﻤﻟﺍ-ﻦﻴﺑ
ﺶﮐ-ﻪﺸﻘﻧ: ﺮﺟﺎﺘﺴﻣ, ﻩﺍﺭ-ﻩﺍﺭ, ﺡﺮﻃ
ﯽﯾﺎﻤﻧ: ﻥﺍﻮﺗ
ﻦﺘﺷﺍﺬﮔ-ﺎﺟ: ﻥﺩﺍﺩ-ﺖﺳﺩ-ﺯﺍ
ﻩﻭﮋﭘ-ﺶﻧﺍﺩ: ﺪﻨﻤﺸﻧﺍﺩ
ﺖﮐﺭﺎﻣ-ﺮﭘﻮﺳ: ﺪﯾﺮﺧ-ﺰﮐﺮﻣ
ﻥﺩﺍﺩ-ﺹﺎﺼﺘﺧﺍ: ﺺﯿﺼﺨﺗ, ﻥﺩﺍﺩ-ﺰﯿﻤﺗ, ﻊﯾﺯﻮﺗ, ﯽﻓﺎﮑﺷ-ﺪﺒﻟﺎﮐ
null-ﺭﺍﺪﻘﻣ: ﺮﻔﺻ, ﯽﻟﺎﺧ
ﻝﺎﺒﺗﻮﻓ: ﻥﺩﺯ-ﺪﮕﻟ
ﻖﺣ: ﺖﺳﺭﺩ, ﺐﺳﺎﻨﻣ
ﯽﻗﺎﺑ: ﯽﻗﺎﺑ, ﯽﻨﺘﺨﯾﺭ-ﺭﻭﺩ
ﺭﺍﺪﯾﺎﭘ: ﺩﺭﺍﺪﻧﺎﺘﺳﺍ
ﯽﯾﺎﻀﻓ-ﻪﻨﯿﻔﺳ: ﻞﺗﺎﺷ
ﯽﺑﺮﺠﺗ: ﻪﺑﺮﺠﺗ
ﯽﯾﺎﻨﻌﻣ: ﯽﻨﻤﺿ-ﺖﻟﻻ﻿ﺩ, ﻉﻮﺿﻮﻣ
ﯼﺩﻮﺧ: ﯽﻠﺧﺍﺩ, ﻮﻀﻋ
ﻦﺗ: ﻦﺤﻟ
ﺪﺣﺍﻭ: ﻪﻧﺎﻤﯿﭘ, ﺪﺣﺍﻭ, ﻢﺠﺣ
ﻢﯾﺰﻧﺁ: ﺮﻤﺨﻣ
ﯽﮔﺪﻧﺯ-ﮏﺒﺳ: ﺮﻤﻋ-ﻝﻮﻃ
ﺎﺘﺳﺎﭘ: ﻡﺮﺟ
ﻩﺎﮕﺑﺍﻮﺧ: ﻩﺎﻨﭘ-ﻥﺎﺟ
ﻥﺍﻮﺟﻮﻧ: ﻥﺍﻮﺟ
ﻪﺘﺴﺟﺮﺑ: ﺖﻣﻼ﻿ﻋ
ﻥﺩﺮﮐ-ﯽﺜﻨﺧ: ﺭﺎﮑﻧﺍ, ﻦﺘﻓﺭ-ﻦﯿﺑ-ﺯﺍ
ﺮﺴﭘ-ﺖﺳﻭﺩ: ﺮﺘﺧﺩ-ﺖﺳﻭﺩ, ﺖﺳﻭﺩ
ﯼﺭﺎﺘﻓﺭ: ﺭﺎﺘﻓﺭ
ﻡﺮﮑﺸﺘﻣ: ﺮﮑﺸﺗ
ﺮﮑﻔﺘﻣ-ﺰﻐﻣ: ﺰﻐﻣ, ﺡﻭﺭ
ﺖﺴﯾﺯ-ﻂﯿﺤﻣ: ﯽﺳﺎﻨﺷ-ﻡﻮﺑ, ﯽﻄﯿﺤﻣ-ﺖﺴﯾﺯ
ﺮﺟﺎﻬﻣ: ﺮﺟﺎﻬﻣ
ﻥﺩﺍﺩﺭﺍﺮﻗ: ﻝﻮﻤﺷ, ﺐﯿﺷ, ﻦﻓﺩ
ﯽﭙﮐﻮﺘﻓ: ﻪﺨﺴﻧ, ﺮﯾﻮﺼﺗ
ﻝﺎﻌﻓ: ﻞﻤﻋ
ﺕﺮﺷ-ﯽﺗ: ﻦﻫﺍﺮﯿﭘ
ﺱﺎﻨﺸﻧﺎﻣﺭﺩ: ﺮﺘﮐﺩ, ﻥﺎﻣﺭﺩ
ﻢﻬﻣ-ﯽﻠﯿﺧ-ﺭﺍﺩ ﻪﯾﺎﻣﺮﺳ: ﻩﺎﺷﺩﺎﭘ
ﯽﮕﺘﺨﯿﮕﻧﺍ: ﻥﺎﺠﯿﻫ
ﻡﺎﮕﻤﻫ: ﯼﺯﺎﺳ-ﻡﺎﮕﻤﻫ
ﯼﺪﯿﺳﺍ: ﺪﯿﺳﺍ
ﯼﻮﻐﻟ: ﺖﻐﻟ-ﮓﻨﻫﺮﻓ, ﻩﮊﺍﻭ
ﺭﺩ-ﻦﺘﺴﮑﺷ: ﺢﻳﺮﻔﺗ-ﮓﻧﺯ
ﯼﺪﻨﺑ-ﻪﻘﺒﻃ: ﯼﺪﻨﺑ-ﻢﯿﺴﻘﺗ
ﺪﺟﻮﻣ-ﻭ-ﻭﺮﺸﯿﭘ: ﻡﺎﮕﺸﯿﭘ
ﺲﯿﺋﺭ: ﺮﺳ
ﻩﻭﺰﺟ: ﻩﻭﺰﺟ
ﮏﯿﺗﺎﻣﺰﯾﺭﺎﮐ: ﻥﻮﺴﻓﺍ
ﻢﯾﺪﻧﺎﮑﺳﺍ: ﻢﯾﺭﻮﻠﺗ
ﺎﻤﻨﻫﺍﺭ: ﯼﺎﻤﻨﻫﺍﺭ-ﻪﭽﺑﺎﺘﮐ
ﻥﺩﺮﮐ-ﺽﺮﻓ: ﺪﯿﻨﮐ-ﺽﺮﻓ, ﺍﺮﻫﺎﻇ
ﻪﻧﺎﺧﺩﺮﺳ: ﻝﺎﭽﺨﯾ
ﺩﺪﺠﻣ-ﯼﺯﺍﺪﻧﺍ-ﻩﺍﺭ: ﻩﺭﺎﺑﻭﺩ-ﻉﻭﺮﺷ
ﯽﻧﺎﻬﮔﺎﻧﻭ-ﺮﮑﺑ-ﺮﮑﻓ: ﺵﺯﺮﻟ, ﻪﺸﯾﺪﻧﺍ
ﺭﺍﺮﮑﺗ: ﻪﺨﺴﻧ, ﻥﺩﺮﮐ-ﺪﯿﻠﻘﺗ, ﺭﺍﺮﮑﺗ
ﯽﻧﺍﺮﮕﻧ-ﻭ-ﺖﺸﺣﻭ ﺱﺎﺴﺣﺍ: ﺱﺮﺗ
ﺲﺑ-ﺶﺗﺁ: ﻪﮐﺭﺎﺘﻣ
ﻩﺎﺒﺘﺷﺍ: ﻑﺬﺣ, ﻩﺎﺒﺘﺷﺍ
ﻥﺩﺮﮐ-ﯽﺘﻌﻨﺻ: ﯼﺯﺎﺳ-ﯽﺘﻌﻨﺻ, ﺖﻌﻨﺻ
ﺭﺩﺍﺮﺑ-ﻭ-ﺮﻫﺍﻮﺧ: ﺭﺩﺍﺮﺑ
ﯼﻮﮕﻨﺨﺳ: ﻮﮔﺪﻨﻠﺑ, ﻩﺪﻨﯾﺎﻤﻧ
ﻥﺩﻮﺑﺭ: ﯽﯾﺎﺑﺭ-ﻡﺩﺁ, ﻥﺩﺯ-ﻢﺨﺷ
ﺰﻠﻓ-ﺮﯿﻏ: ﺰﻠﻓ-ﻪﺒﺷ
ﻩﺪﻧﻭﺩ: ﺍﺰﻧﺍﻮﻠﻔﻧﺍ, ﺖﺑﻮﻃﺭ, ﻥﺪﯾﻭﺩ
ﻞﮑﺷ: ﺖﻬﺟ, ﻞﮑﺷ, ﺖﻤﺳ
ﺐﻧﺎﺟ-ﺯﺍ-ﺩﺭﻮﻣ: 
ﯽﺑﻮﺧ: ﺍﻮﻘﺗ, ﺖﯾﺰﻣ
ﻪﻧﺍﺩﺍﺯﺁ: ﻞﺷ, ﻥﺩﺮﮐ-ﺩﺍﺯﺁ
ﻥﺁ-ﺯﺍ-ﺪﻌﺑ: ﻩﺪﻨﯾﺁ, ﻊﻗﻮﻣ-ﻥﻭﺍ, ﺯﺍ-ﺪﻌﺑ
ﻞﮑﺸﻣ: ﻞﮑﺸﻣ
ﻪﺧﻮﺟ: ﺪﻧﺎﺑ
ﻩﺩﺮﺘﺴﮔ-ﺭﻮﻃ-ﻪﺑ: ﺽﺮﻋ, ﻥﺩﺮﮐ-ﻦﻬﭘ, ﯽﻠﮐ-ﺭﻮﻄﺑ
ﻥﺩﺮﮐ-ﻂﺒﺗﺮﻣ: ﻩﺍﺮﻤﻫ, ﺏﻼ﻿ﻗ
ﺎﺑ-ﻖﺑﺎﻄﻣ: ﺖﺸﮔﺯﺎﺑ
null-ﺭﺍﺪﻘﻣ: ﺮﻔﺻ, ﯽﻟﺎﺧ
ﻪﻣﺎﻨﺸﻫﻭﮋﭘ: ﻩﻭﺰﺟ, ﺕﺎﻋﻼ﻿ﻃﺍ
ﻥﺎﺷﺩﻮﻨﺸﺧﺎﻧ: ﺐﯾﻮﺼﺗ, ﻝﻮﺒﻗ-ﻞﺑﺎﻗ-ﺮﯿﻏ
ﻡﺎﻤﺣ-ﻥﺍﻭ: ﻥﺍﻭ
ﻩﺪﻨﻨﮐ-ﻡﺮﮔﺮﺳ: ﯽﻣﺮﮔﺮﺳ-ﻭ​​-ﺢﯾﺮﻔﺗ, ﻥﺩﺮﮐ-ﺮﯿﺤﺘﻣ-ﻭ ﺕﺎﻣ, ﺭﺍﺩ-ﻩﺪﻨﺧ
ﺯﺍ-ﯼﺍﺪﺟ: ﺰﺠﺑ
ﺝﻭﺮﺧ: ﻥﺪﺷ-ﺭﺍﺪﯾﺪﭘ, ﺝﻭﺮﺧ, ﻥﺪﻣﺁ-ﻻ﻿ﺎﺑ
null-ﺭﺍﺪﻘﻣ: ﺮﻔﺻ, ﯽﻟﺎﺧ
ﻪﻧﻮﮔ: ﯼﺯﺎﺑ
ﺪﯾﺎﺑ: ﺪﯾﺎﺑ, ﻪﻔﯿﻇﻭ
ﯼﺪﺻﺭﺩ: ﺪﺻ-ﺭﺩ
ﯽﯾﺎﻀﻗ-ﯼﻮﻋﺩ: ﺖﺳﺍﻮﺧﺩﺍﺩ
null-ﺭﺍﺪﻘﻣ: ﺮﻔﺻ, ﯽﻟﺎﺧ
ﻖﻳﺮﻃ-ﺯﺍ: ﻥﺩﺮﮐ-ﯽﻃ, ﻻ﻿ﺎﺑ-ﺭﺩ
ﮓﻧﺍﺪﺸﺷ: ﻪﻧﺎﮔ-ﻪﭽﺑ
ﻩﺪﻨﻨﮐ-ﻡﺮﮔﺮﺳ: ﺭﺍﺩ-ﻩﺪﻨﺧ
ﺮﻬﻇ-ﺯﺍ-ﺪﻌﺑ: ﺮﻬﻇ-ﺯﺍ-ﺪﻌﺑ, ﺐﺷ
ﻍﺮﻣ-ﻢﺨﺗ-ﻩﺪﯿﻔﺳ: ﻦﻴﺌﺗﻭﺮﭘ
ﯼﺰﯾﺭ-ﻥﻮﺧ: ﻦﯿﻧﻮﺧ
ﻢﯿﻟﻮﺗ-ﻢﺗﺍ: ﻢﯾﺭﻮﺗ-ﻢﺗﺍ
ﻢﺧ: ﻩﺪﺷ-ﻢﺧ, ﻥﺩﺮﮐ-ﻢﺧ
ﺮﮑﻨﯿﻟ: ﯽﮕﺘﺳﻮﯿﭘ
ﯽﺒﯿﻏﺮﺗ: ﺰﯿﻣﺍ-ﺖﺤﯿﺼﻧ
ﻡﻮﯿﺑﺮﺗ-ﻢﺗﺍ: ﻢﯾﺭﻮﺗ-ﻢﺗﺍ
ﻩﺭﺎﺟﺍ: ﻥﺩﺮﮐ-ﻩﺭﺎﺟﺍ
ﺶﯾﺍﺭﺁ: ﻥﺩﺮﮐ-ﻥﺍﺮﺒﺟ
ﺰﻐﻟ: ﯽﺧﻮﺷ
ﯼﺪﻨﺑﺮﮑﯿﭘ: ﯼﺭﺎﺘﺧﺎﺳ
ﻪﺘﺷﺬﮔ: ﻪﺘﺷﺬﮔ
ﯼﺯﺎﺳﺍﺪﺟ: ﻥﺩﺍﺩ-ﺰﯿﻤﺗ, ﻊﯾﺯﻮﺗ
ﺩﺎﺘﺳﺍ: ﺩﺎﺘﺳﺍ
ﻡﻮﯾﺩﻭﺭ-ﻢﺗﺍ: ﻢﯾﺭﻮﺗ-ﻢﺗﺍ
ﺖﻟﻭﺩ-ﺮﮕﻧﺎﺸﻧ: 
ﺎﻀﻓ-ﺮﮕﻧﺎﺸﻧ: 
ﮏﯿﺗﺍﺮﮐﻭﺭﻮﺑ: ﯼﺭﻻ﻿ﺎﺳ-ﻥﺍﻮﯾﺩ
ﺪﻨﺑﺮﻤﮐ: ﺪﻧﺎﺑ, ﻪﻨﻫﺩ
null-ﺭﺍﺪﻘﻣ: ﺮﻔﺻ, ﯽﻟﺎﺧ
ﻩﺪﻨﺷﻭﺮﻓ: ﻝﻻ﻿ﺩ
null-ﺭﺍﺪﻘﻣ: ﺮﻔﺻ, ﯽﻟﺎﺧ
ﻢﯿﻧﺎﺘﻧﻻ﻿: ﻢﯾﺭﻮﻠﺗ
ﻉﻮﺿﻮﻣ-ﺩﺭﻮﻣ: ﻉﻮﺿﻮﻣ-ﺩﺭﻮﻣ
ﻩﺪﻧﺯﺎﺳ: ﻥﺩﺭﻭﺁ-ﺩﻮﺟﻭ-ﻪﺑ, ﯼﺪﻨﺑ-ﻝﻮﻣﺮﻓ, ﻩﺪﻧﺯﺎﺳ
null-ﺭﺍﺪﻘﻣ: ﺮﻔﺻ, ﯽﻟﺎﺧ
ﻪﻧﺎﻧﺯ: ﻥﺯ
ﺰﯿﻤﻣ: ﺱﺭﺯﺎﺑ, ﺐﺳﺎﺤﻣ
ﻦﻓﻭﺮﮑﯿﻣ: ﮏﭼﻮﮐ
ﺯﺍ-ﺝﺭﺎﺧ: ﺝﺭﺎﺧ, ﺰﺠﺑ
ﻂﺒﺿ: ﻝﻮﻤﺷ, ﺖﺒﺛ
ﺖﺸﮕﻧﺍ-ﺺﺧﺎﺷ: ﺺﺧﺎﺷ
ﺖﯾﺎﻤﺣ: ﯽﻠﯿﺼﺤﺗ-ﺱﺭﻮﺑ, ﻥﺩﺍﺩ-ﺖﻴﻤﻫﺍ
ﻥﺍﺩﺎﻧ: ﻥﺍﺩﺎﻧ
null-ﺭﺍﺪﻘﻣ: ﺮﻔﺻ, ﯽﻟﺎﺧ
ﺩﺭﺍﺪﻧﺎﺘﺳﺍ: ﺕﺎﺼﺨﺸﻣ, ﺩﺭﺍﺪﻧﺎﺘﺳﺍ
ﺖﻋﺎﺳ: ﻪﻄﻘﻧ, ﺖﻋﺎﺳ
ﻪﻧﺎﺧ-ﺐﺣﺎﺻ: ﮏﻟﺎﻣ
ﻖﻘﺤﻣ: ﻩﺪﻧﺮﯿﮔ-ﻢﯿﻤﺼﺗ, ﺪﻨﻤﺸﻧﺍﺩ, ﻩﺎﮔﺍﺭﺎﮐ
ﺩﺎﺸﮔ: ﻪﺘﺧﻮﺳ
null-ﺭﺍﺪﻘﻣ: ﺮﻔﺻ, ﯽﻟﺎﺧ
ﻥﺩﺍﺩ-ﻩﺯﺎﺟﺍ: ﻦﺘﺧﺎﺳ-ﺭﺩﺎﻗ
ﻉﺎﻓﺩ: ﻥﺩﺍﺩ-ﺖﻴﻤﻫﺍ
ﺭﻭﺪﯾﺮﮐ: ﻦﻟﺎﺳ
ﻩﺮﮐﺍﺬﻣ: ﺪﯿﻨﮐ-ﺖﺒﺤﺻ
ﺪﯾﺪﺠﺗ: ﺕﻭﺍﺮﻃ-ﺎﺑ, ﯽﻧﺎﺳﺭ-ﺯﻭﺭ-ﻪﺑ
ﻢﺧ-ﻭ-ﭻﯿﭘ ﺮﭘ: ﻩﺪﺷ-ﻢﺧ
ﺪﻌﺑ: ﻝﻭﺍ, ﺪﻌﺑ, ﻮﻠﺟ-ﻪﺑ
ﺲﻔﻨﺗ: ﻥﻮﺼﻣ, ﺲﻔﻧ
null-ﺭﺍﺪﻘﻣ: ﺮﻔﺻ, ﯽﻟﺎﺧ
ﺖﻓﺮﺸﯿﭘ: ﻦﺘﻓﺭ-ﺶﯿﭘ
ﻡﺯﻻ﻿: ﻡﺯﻻ﻿
ﺖﯾﺎﺿﺭ: ﻕﺎﯿﺘﺷﺍ
ﻊﯿﺳﻭ: ﻥﺩﺮﮐ-ﻦﻬﭘ, ﺽﺮﻋ, ﻩﺩﺮﺘﺴﮔ
ﻡﺯﻻ﻿: ﻡﺯﻻ﻿
ﻪﻠﺑﺎﻘﻣ: ﺩﺎﻀﺘﻣ, ﻪﻠﺑﺎﻘﻣ
ﺐﺠﻌﺘﻣ: ﻥﺪﺷ-ﺮﯿﮕﻠﻓﺎﻏ
ﻪﻌﺟﺍﺮﻣ: ﻥﺩﺮﮐ-ﯽﻓﺮﻌﻣ
ﻞﺴﻧ: ﺎﻨﺷﺁ, ﻩﻮﻧ, ﻞﺴﻧ
ﯽﻨﺘﺴﺑ: ﻡﺮﮐ-ﮓﻧﺭ
ﻉﺎﻌﺷ: ﻪﻌﺷﺍ
ﺎﺑﻭﺎﻨﺘﻣ: ﺕﺭﻮﺻ-ﻦﯾﺍ-ﺮﯿﻏ ﺭﺩ
ﯽﮕﯾﺎﺴﻤﻫ: ﻑﺍﺮﻃﺍ, ﻩﺪﻧﺯ, ﯽﻄﯿﺤﻣ-ﺖﺴﯾﺯ
ﻦﺘﺷﺍﺩ-ﺕﺩﺎﻋ: ﯽﺷﺭﺎﻔﺳ
ﺖﻟﺎﺠﺧ: ﻡﺮﺷ, ﻝﻼ﻿ﺘﺧﺍ
ﯼﺍ-ﻪﻈﺣﻼ﻿ﻣ-ﻞﺑﺎﻗ: ﯼﺩﺎﯾﺯ-ﺪﺣ-ﺎﺗ
ﻩﺯﺎﺗ: ﺕﻭﺍﺮﻃ-ﺎﺑ, ﯽﮔﺯﺎﺗ-ﻪﺑ, ﻪﺸﯾﺭ
ﺺﻗﺭ: ﯼﺯﺎﺑ, ﺺﻗﺭ
null-ﺭﺍﺪﻘﻣ: ﺮﻔﺻ, ﯽﻟﺎﺧ
ﻥﺍﺰﯿﻣ-ﺮﮕﻧﺎﺸﻧ: 
ﯽﻋﺎﻤﺘﺟﺍ-ﺮﮕﻧﺎﺸﻧ: 
ﺩﺎﻘﺘﻧﺍ: ﺩﺎﻘﺘﻧﺍ
ﻡﻮﯾﺪﯿﺑﻭﺭ-ﻢﺗﺍ: ﻢﯾﺭﻮﺗ-ﻢﺗﺍ
ﻩﺯﺭﺎﺒﻣ: ﻥﺩﺮﮐ-ﻩﺯﺭﺎﺒﻣ, ﺩﺎﻀﺗ, ﮓﻨﺟ
ﻥﺩﺮﻛ-ﺖﻳﺎﻜﺷ: ﻩﺭﺎﺑ-ﺭﺩ
null-ﺭﺍﺪﻘﻣ: ﺮﻔﺻ, ﯽﻟﺎﺧ
ﻡﻮﯾﺩﺎﻧﺍﻭ-ﻢﺗﺍ: ﻢﯾﺭﻮﺗ-ﻢﺗﺍ
ﯽﺜﻨﺧ-ﺲﻨﺟ: ﻪﻧﺍﺩﺮﻣ-ﺲﻨﺟ
ﻦﯾﺭﻮﻠﻓ-ﻢﺗﺍ: ﻢﯾﺭﻮﺗ-ﻢﺗﺍ
ﺮﻔﺳ: ﺪﯾﺩﺯﺎﺑ, ﺎﻘﯾﺮﻓﺍ-ﺭﺩ-ﯽﻓﺎﺸﺘﮐﺍ ﺖﺣﺎﯿﺳ, ﺮﻔﺳ
ﻪﻧﺍﺩﺮﻣ: ﺮﻧ
null-ﺭﺍﺪﻘﻣ: ﺮﻔﺻ, ﯽﻟﺎﺧ
ﻪﻌﺳﻮﺗ: ﯽﻠﻣﺎﮑﺗ, ﻦﺘﻓﺭ-ﺶﯿﭘ
ﯽﻠﻤﻋ: ﯽﻠﻤﻋ
ﻦﺘﺴﺑ: ﻪﺘﺴﺑ
ﻥﺩﺯ-ﻑﻻ﻿: ﺵﺎﭘ-ﻭ-ﺖﺨﯾﺭ
ﻪﻧﻭﺭﺍﻭ: ﺖﺸﮔﺯﺎﺑ
ﺮﺿﺎﺣ: ﺮﺿﺎﺣ
null-ﺭﺍﺪﻘﻣ: ﺮﻔﺻ, ﯽﻟﺎﺧ
ﻥﺩﺮﮐ-ﯽﻓﺩﺎﺼﺗ: ﯽﻓﺩﺎﺼﺗ
ﯽﻧﻭﺎﻌﺗ: ﺭﺎﮑﻤﻫ
ﻪﺘﺴﺸﻧﺯﺎﺑ: ﻪﺘﺴﺸﻧﺯﺎﺑ
null-ﺭﺍﺪﻘﻣ: ﺮﻔﺻ, ﯽﻟﺎﺧ
ﻝﺎﺤﺷﻮﺧ: ﻝﺎﺤﺷﻮﺧ, ﺭﺍﺩ-ﻩﺪﻨﺧ, ﻥﺩﺮﮐ-ﺮﯿﺤﺘﻣ-ﻭ ﺕﺎﻣ
ﯽﺒﯾﺮﻘﺗ: ﯽﺒﯾﺮﻘﺗ
ﯽﯾﺎﺗﻭﺩ: ﯽﯾﺎﺗﻭﺩ
ﻞﻤﮑﻣ: ﻩﺪﻨﻨﮐ-ﻞﯿﻤﮑﺗ, ﯽﻓﺎﺿﺍ
ﯽﻃﺎﺒﺗﺭﺍ: ﺕﺎﺒﺗﺎﮑﻣ, ﻑﺮﺣ-ﺮﭘ
null-ﺭﺍﺪﻘﻣ: ﺮﻔﺻ, ﯽﻟﺎﺧ
ﺭﺩ-ﺩﺭﻮﻣ: ﻪﺑ-ﺩﺭﻮﻣ
ﻡﻮﯿﻧﻮﻠﭘ-ﻢﺗﺍ: ﻢﯾﺭﻮﺗ-ﻢﺗﺍ
ﮏﯿﮑﻔﺗ: ﯽﯾﺍﺪﺟ, ﻞﯿﻠﺤﺗ
ﺥﺮﺴﺑ-ﻞﯾﺎﻣ-ﻩﻮﻬﻗ: ﻱﺍ-ﻩﻮﻬﻗ
ﻪﻠﺌﺴﻣ: ﺯﺎﺳ-ﻞﮑﺸﻣ, ﻞﮑﺸﻣ
ﻥﺩﺮﮐ-ﻪﻤﺟﺮﺗ: ﻪﻤﺟﺮﺗ, ﺮﮕﻨﻠﺗ
null-ﺭﺍﺪﻘﻣ: ﺮﻔﺻ, ﯽﻟﺎﺧ
ﻡﻮﯿﻟﺎﺗ-ﻢﺗﺍ: ﻢﯾﺭﻮﺗ-ﻢﺗﺍ
ﻪﺘﺳﺩ: ﻁﻼ﻿ﺘﺧﺍ, ﮏﯿﻠﮐ
ﻥﺎﺳﺁ: ﯽﻧﺎﺳﺁ-ﻪﺑ, ﻩﺩﺎﺳ
ﺮﯾﺪﻣ: ﻩﺪﻨﻨﮐ-ﻞﯿﻬﺴﺗ, ﺮﯾﺪﻣ
ﯽﻋﺎﻤﺘﺟﺍ: ﯽﻋﺎﻤﺘﺟﺍ
ﻖﺑﺎﻄﺗ: ﺖﺳﺍﻮﺧﺩﺍﺩ, ﻥﺪﺷ-ﻑﺩﺎﺼﻣ
ﻑﺩﺎﺼﺗ: ﻪﺛﺩﺎﺣ
ﻪﮐ: ﻪﮐ
ﺐﻟﺎﺟ: ﻢﺳﺭ
ﺲﮑﻋﺮﺑ: ﺱﻮﮑﻌﻣ
ﺶﮐ-ﻒﻠﻋ: ﻢﺳ
null-ﺭﺍﺪﻘﻣ: ﺮﻔﺻ, ﯽﻟﺎﺧ
ﻩﺪﻧﻮﺷ-ﺩﺭﺍﻭ: ﯽﻔﺻﻭ-ﻪﺟﻭ
ﻝﺎﺜﻣ-ﯼﺍﺮﺑ: ﻝﺎﺜﻣ
ﺭﻮﻣﻮﺗ: ﺭﻮﻣﻮﺗ
ﯽﮔﺪﯿﺳﻮﭘ: ﻥﺪﺷ-ﺪﺳﺎﻓ
null-ﺭﺍﺪﻘﻣ: ﺮﻔﺻ, ﯽﻟﺎﺧ
ﯽﺘﻧﺮﺘﻨﯾﺍ-ﺖﯾﺎﺳ: ﯽﺘﻧﺮﺘﻨﯾﺍ-ﺖﯾﺎﺳ
ﻩﺩﺎﻌﻟﺍ-ﻕﻮﻓ: ﻢﯿﻈﻋ, ﺭﺎﯿﺴﺑ, ﻩﺩﺎﻌﻟﺍ-ﻕﻮﻓ
ﺩﻮﺑ-ﺪﻫﺍﻮﺧ: 
ﯽﻠﯿﻣﺎﻓ-ﺖﺒﺴﻧ-ﺩﺭﻮﻣ: ﯽﻠﯿﻣﺎﻓ-ﺖﺒﺴﻧ-ﺩﺭﻮﻣ
ﻑﺪﻫ-ﺩﺭﻮﻣ: ﺪﺼﻘﻣ-ﺩﺭﻮﻣ
ﻥﺩﺍﺩ-ﻥﺍﻭﺎﺗ: ﻥﺩﺮﮐ-ﻥﺍﺮﺒﺟ, ﺖﺧﺍﺩﺮﭘ
ﻥﺩﺍﺩ-ﻡﺎﻨﺷﺩ: ﻩﺎﺒﺘﺷﺍ
ﻦﺘﻓﺎﺑ-ﻭ-ﻥﺪﯿﺑﺎﺗ ﻢﻬﺑ: ﺱﺍﺮﻟﺍ-ﻂﺧ, ﻩﺮﮔ
ﯼﺎﺠﺑ: ﯼﺎﺠﺑ
ﯽﺳﺎﻨﺷ-ﻥﺎﺘﺳﺎﺑ: ﯽﺳﺎﻨﺷ-ﻥﺎﺘﺳﺎﺑ
ﻝﺎﺼﺗﺍ: ﻂﺑﺍﺭ-ﻮﻀﻋ, ﻦﯿﮔﻼ﻿ﭘ, ﯽﮕﺘﺴﺒﻟﺩ, ﺰﯾﺮﭘ
null-ﺭﺍﺪﻘﻣ: ﺮﻔﺻ, ﯽﻟﺎﺧ
ﻢﯿﻤﻌﺗ: ﻥﺩﺍﺩ-ﻢﯿﻤﻌﺗ
ﻡﻮﯿﺘﻧﻭﺮﺘﺳﺍ-ﻢﺗﺍ: ﻢﯾﺭﻮﺗ-ﻢﺗﺍ
ﻢﯿﻨﺗﻭﺭ-ﻢﺗﺍ: ﻢﯾﺭﻮﺗ-ﻢﺗﺍ
ﯼﺎﻨﺜﺘﺳﺍ-ﻪﺑ: ﺰﺠﺑ
null-ﺭﺍﺪﻘﻣ: ﺮﻔﺻ, ﯽﻟﺎﺧ
ﯽﻨﯿﺸﻧ-ﺐﻘﻋ: ﻥﺪﺷ-ﺕﺮﭘ, ﺖﻓﺮﺴﭘ, ﻪﺘﺴﺸﻧﺯﺎﺑ
ﻪﺘﺴﺸﻧﺯﺎﺑ: ﻪﺘﺴﺸﻧﺯﺎﺑ
ﺮﮕﯾﺩ-ﯽﮑﯾ: ﺮﮕﯾﺪﮑﯾ, ﺮﮕﯾﺩ
ﻦﻬﭘ: ﻩﺩﺮﺘﺴﮔ
ﻪﺒﺳﺎﺤﻣ: ﻪﺒﺳﺎﺤﻣ, ﺮﺗﻮﯿﭙﻣﺎﮐ, ﺏﺎﺴﺣ-ﻦﯿﺷﺎﻣ
ﺕﺭﺎﺠﺗ-ﺺﺨﺷ: ﺮﺟﺎﺗ
ﮒﺍﺩ-ﺕﺎﻫ: ﺲﯿﺳﻮﺳ
ﻂﻠﺴﺗ: ﺮﺛﺍ, ﺕﺭﺪﻗ, ﺖﯾﺰﻣ
ﻥﺩﺮﮐ-ﻡﺎﻤﺗ-ﺍﺭ ﻝﻮﻗ ﻞﻘﻧ: ﻝﻮﻗ-ﻞﻘﻧ
ﻪﯿﻟﺎﻓﺎﻀﻣ-ﺩﺭﻮﻣ: ﻪﯿﻟﺍ-ﻑﺎﻀﻣ-ﺖﻟﺎﺣ ﺩﺭﻮﻣ, ﻪﯿﻟﺎﻓﺎﻀﻣ-ﺩﺭﻮﻣ
ﯽﮑﯿﺘﻧﮊ: ﻥﮊ, ﮏﯿﺘﻧﮊ
ﯽﻘﯾﺪﺼﺗ: ﻥﺩﺍﺩ-ﻥﺎﮑﺗ, ﻡﺮﻧ
ﻢﯿﻘﺘﺴﻣ-ﺮﯿﻏ-ﻑﺪﻫ: ﻢﯿﻘﺘﺴﻣ-ﻑﺪﻫ
ﻥﺍﺮﮔ-ﺖﻟﺎﺣ: ﻥﺍﺮﮔ-ﺖﻟﺎﺣ
ﻥﺩﺮﮐ-ﺭﺎﮐ: ﻦﯾﺮﻤﺗ, ﺭﺎﮐ, ﻩﺪﺷ-ﺖﺳﺭﺩ-ﻪﻧﺍﺩﺎﺘﺳﺍ
ﯽﺼﺨﺸﻣ-ﺯﺮﻣ-ﻭ ﺪﺣ: ﺩﻭﺪﺤﻣ, ﻢﻫ-ﺯﺍ-ﺍﺪﺟ
ﻒﻟﺎﺨﻣ: ﺱﻮﮑﻌﻣ, ﺖﻔﻟﺎﺨﻣ, ﻞﺑﺎﻘﻣ, ﯽﮕﻧﻭﺭﺍﻭ, ﺩﺎﻀﺘﻣ
ﻦﺘﻓﺭ-ﻻ﻿ﺎﺑ: ﻥﺪﻣﺁ-ﻻ﻿ﺎﺑ
ﻩﺩﺎﻌﻟﺍ-ﻕﻮﻓ: ﻩﺮﻈﺘﻨﻣ-ﺮﯿﻏ, ﻩﺩﺎﻌﻟﺍ-ﻕﻮﻓ
null-ﺭﺍﺪﻘﻣ: ﺮﻔﺻ, ﯽﻟﺎﺧ
ﻥﺪﺷ-ﻪﺘﺴﺑ: ﻪﺘﺴﺑ, ﯽﺟﺎﺴﻧ
ﻥﺍﺯﺭﺍ: ﻥﺍﺯﺭﺍ
ﯽﺷﺎﻘﻧ-ﻡﻮﺑ: ﻪﭼﺭﺎﭘ, ﺏﻭ
ﻩﺩﺮﮐ-ﻞﯿﺼﺤﺗ: ﺕﻼ﻿ﯿﺼﺤﺗ, ﺏﺩﺍ-ﺎﺑ
ﯽﺸﺣﻭ-ﺕﺎﻧﺍﻮﯿﺣ: ﺖﻌﯿﺒﻃ, ﯽﺸﺣﻭ
ﻒﻟﺎﺨﻣ: ﺖﻔﻟﺎﺨﻣ, ﻞﺑﺎﻘﻣ, ﯼﻮﺳ-ﻪﺑ
null-ﺭﺍﺪﻘﻣ: ﺮﻔﺻ, ﯽﻟﺎﺧ
ﻥﺪﯾﻭﺎﮐ: ﯼﺭﺎﻔﺣ
ﯽﻧﻮﻔﻋ: ﺖﻧﻮﻔﻋ
null-ﺭﺍﺪﻘﻣ: ﺮﻔﺻ, ﯽﻟﺎﺧ
ﺢﻠﺴﻣ: ﺡﻼ﻿ﺳ
ﻝﺎﺜﻣ-ﻥﺍﻮﻨﻋ-ﻪﺑ: ﯽﻨﻌﯾ
ﺲﮑﭽﯿﻫ: ﯽﭼ-ﭻﯿﻫ
ﻥﺩﺭﻮﺧ-ﻢﺴﻗ: ﺪﻨﮔﻮﺳ, ﺮﯿﮕﯾﺎﺟ
ﯽﻃﻭﺮﺨﻣ: ﺮﻏﻻ﻿, ﻁﻭﺮﺨﻣ
ﻩﺪﻨﻨﮐ-ﻡﺮﮔﺮﺳ: ﯽﻣﺮﮔﺮﺳ-ﻭ​​-ﺢﯾﺮﻔﺗ, ﺪﻨﻣﺮﻨﻫ
.ﻩﺮﯿﻏ-ﻭ: 
ﺯﺍ-،-ﺍﺪﺟ ﻢﻫ ﺯﺍ: ﺰﺠﺑ
ﻞﺻﺎﻓ-ﺪﺣ: ﯽﻠﮐ-ﺡﺮﻃ, ﯽﻄﯿﺤﻣ-ﺖﺴﯾﺯ, ﻥﺪﺷ-ﻞﻴﻜﺸﺗ
ﻩﺍﺮﻤﻫ-ﻦﻔﻠﺗ: ﻩﺍﺮﻤﻫ-ﻦﻔﻠﺗ, ﻝﻮﻠﺳ
ﻥﺩﺍﺩ-ﺖﺳﺩ-ﺯﺍ: ﺵﺮﺑ, ﻥﺩﺍﺩ-ﺖﺳﺩ-ﺯﺍ, ﻥﺩﺮﮐ-ﺝﺮﺧ
ﻩﺪﻨﻫﺩ-ﺭﺍﺪﺸﻫ: ﮎﺎﻨﺘﺸﺣﻭ, ﺲﭘﺍﻮﻟﺩ
ﻩﺪﻨﯾﺁ: ﻩﺪﻨﯾﺁ
ﯽﻃﺮﺷ-ﻪﺟﻭ-ﺖﻟﺎﺣ: ﻁﻭﺮﺸﻣ-ﺖﻟﺎﺣ, ﯽﯾﺎﻨﻤﺗ-ﺖﻟﺎﺣ
ﺪﯾﺎﺑ: ﺪﯾﺎﺑ
ﺭﻮﺗﻮﻣ: ﺖﻠﻜﻴﺳ-ﺭﻮﺗﻮﻣ, ﺭﻮﺗﻮﻣ
ﯼﺭﺎﺒﺘﻋﺍ-ﺕﺭﺎﮐ: ﺭﺎﺒﺘﻋﺍ
null-ﺭﺍﺪﻘﻣ: ﺮﻔﺻ, ﯽﻟﺎﺧ
ﯽﻣﻮﻤﻋ: ﻡﺩﺮﻣ-ﻡﻮﻤﻋ
ﻩﺍﺮﻤﻫ-ﻦﻔﻠﺗ: ﻩﺍﺮﻤﻫ-ﻦﻔﻠﺗ, ﻝﻮﻠﺳ
null-ﺭﺍﺪﻘﻣ: ﺮﻔﺻ, ﯽﻟﺎﺧ
ﻩﺩﻭﺭ: ﻩﺩﻭﺭ-ﻭ-ﻝﺩ
ﺵﺮﺘﺴﮔ: ﻊﯾﺯﻮﺗ, ﻥﺩﺮﮐ-ﺶﺨﭘ, ﻥﺩﺮﮐ-ﻑﺮﺼﻣ
ﻥﺩﺮﮐ-ﺝﺍﺮﺧﺍ: ﻦﺘﺧﺍﺪﻧﺍ-ﻥﻭﺮﯿﺑ
ﺖﺒﺴﻧ: ﻁﺮﺷ, ﺶﺨﺑ, ﯽﻣﻮﺘﻧﺍﻮﮐ
ﺖﯿﺣﻼ﻿ﺻ: ﺕﺭﺎﻬﻣ, ﻩﺎﮔﺩﺍﺩ-ﻦﯾﺍ-ﺖﯿﺣﻼ﻿ﺻ
ﮏﻠﻣ-ﺐﺣﺎﺻ: ﻪﺘﺷﺮﻓ
ﻪﻓﺎﺿﺍ-ﻑﺮﺣ-ﺩﺭﻮﻣ: 
ﺺﯿﺼﺨﺗ: ﺺﯿﺼﺨﺗ, ﻡﺎﻬﺳ-ﺩﻮﺳ, ﯼﺮﻤﺘﺴﻣ
ﻩﺪﻨﻨﮐ-ﻥﺍﺮﮕﻧ: ﺲﭘﺍﻮﻟﺩ
ﺏﻮﺧ-ﯽﻠﯿﺧ: ﻥﺎﺴﮑﯾ, ﺭﺎﯿﺴﺑ
ءﺍﺮﺟﺍ: ﻥﺩﺮﮐ-ﺮﯾﺰﮔﺎﻧ
ﺭﺍﺰﻓﺍ-ﻡﺮﻧ-ﺕﺭﺎﺒﻋ: ﺭﺍﺰﻓﺍ-ﻡﺮﻧ-ﻪﻠﻤﺟ
ﻩﺪﻧﺮﯿﮔ: ﻩﺪﻧﺮﯿﮔ
ﻖﯾﺭﺰﺗ: ﻥﺩﺮﮐ-ﯽﻓﺮﻌﻣ
ﻩﺪﻨﻨﮐ-ﻩﺮﯿﺧ: ﻥﺩﺮﮐ-ﺕﺎﻣ, ﻪﺟﻮﺗ-ﻞﺑﺎﻗ
ﻪﻓﺮﺳ: ﻥﺩﺮﮐ-ﻪﻓﺮﺳ
ﺐﻨﺟ: ﺪﻌﺑ
