ﺭﺪﺼﻣ: ﺖﻳﺎﻬﻧ-ﻲﺑ, ﺖﯾﺎﻬﻧ-ﯽﺑ
ﯽﻠﻋﺎﻓ-ﺩﺭﻮﻣ: 
ﯽﻣﺎﻬﺗﺍ-ﺩﺭﻮﻣ: 
ﻉﻮﺿﻮﻣ-ﺩﺭﻮﻣ: ﻉﻮﺿﻮﻣ-ﺩﺭﻮﻣ
ﻦﯾﺪﻟﺍﻭ: ﯽﻨﯾﺪﻟﺍﻭ, ﮒﺭﺰﺑ, ﺪﺷﺭﺍ
ﺭﺪﭘ: ﺭﺪﭘ
ﺭﺩﺎﻣ: ﺭﺩﺎﻣ, ﺭﺩﺎﻣ, ﯼﺭﺩﺎﻣ
ﺩﻭﺭﺩ: ﻆﻓﺎﺣ-ﺍﺪﺧ, ﻡﻼ﻿ﺳ, ﯽﻫ
ﺪﺟ: ﻒﻠﺳ, ﮒﺭﺰﺑ-ﺎﺑﺎﺑ
ﻩﺪﺟ-ﺎﯾ-ﺪﺟ: ﮒﺭﺰﺑ-ﺎﺑﺎﺑ, ﮒﺭﺰﺑ-ﺭﺩﺎﻣ
ﻪﻨﺳﺮﮔ: ﯽﮕﻨﺳﺮﮔ, ﻥﺩﺮﻣ-ﯽﮕﻨﺳﺮﮔ-ﺯﺍ
ﻪﯿﻟﺍ-ﻑﺎﻀﻣ-ﺖﻟﺎﺣ ﺩﺭﻮﻣ: ﻪﯿﻟﺎﻓﺎﻀﻣ-ﺩﺭﻮﻣ
ﺖﻔﺻ: 
ﻭ: ﻉﻮﻤﺠﻣ, ﻂﺳﻮﺗ
ﻦﻣ-ﻪﺑ: ﻡﺩﻮﺧ, ﻦﻣ, ﻦﻣ, ﺎﻣ
ﺎﻤﺷ: ﺎﻬﻧﺁ, ﻮﺗ, ﻮﺗ
ﺎﻣ: ﺎﻣ, ﺎﻣ, ﺎﻣ-ﻝﺎﻣ
IT: ﻭﺍ, ﻪﮐ, ﻭﺍ, ﻦﯾﺍ, ﺎﻬﻨﯾﺍ
ﺪﺼﻘﻣ-ﺩﺭﻮﻣ: ﻑﺪﻫ-ﺩﺭﻮﻣ
ﯽﻟﻮﻌﻔﻣ-ﺖﻟﺎﺣ-ﺩﺭﻮﻣ: 
ﯽﻠﺧﺍﺩ-ﻪﻨﯿﻣﺯ: 
ﺺﺨﺷ-ﻪﻨﯿﻣﺯ: 
ﻪﺘﺴﺑﺍﻭ-ﺪﻨﺑ: 
perfective-ﻪﺒﻨﺟ: 
ﻪﺘﺷﺬﮔ-ﺖﻔﺳ: 
ﻪﻧﺍﺩﺮﻣ-ﺲﻨﺟ: ﯽﺜﻨﺧ-ﺲﻨﺟ
comitative-ﺩﺭﻮﻣ: 
ﺮﺿﺎﺣ-ﺖﻔﺳ: 
benefactive-ﺩﺭﻮﻣ: 
essive-ﺩﺭﻮﻣ: 
ﻪﻧ: ﺮﯿﺧ, ﺮﯿﻏ, ﯽﺘﺨﺳ-ﻪﺑ, ﻥﺍﻮﺗﺎﻧ, ﺮﯿﻏ, ﺮﯿﻗ
ﻥﺁ: ﻥﺎﺷ, ﺩﻮﺧ, ﻭﺍ, ﺍﺭ-ﻭﺍ, ﻥﺁ, ﻭﺍ-..., ﺯﺍ
ﺢﻄﺳ-ﻪﻨﯿﻣﺯ: 
adpositional-ﺩﺭﻮﻣ: 
ﻞﺤﻣ-ﺩﺭﻮﻣ: 
ﺎﻀﻓ-ﻪﻨﯿﻣﺯ: 
ﺮﯿﺴﻣ-ﺩﺭﻮﻣ: 
ﻪﻠﯿﺳﻭ-ﺩﺭﻮﻣ: 
ﻪﮐ: ﯽﺴﮐ-ﻪﭼ, ﻪﻟﺰﻨﻣ-ﻪﺑ, ﻪﮐ, ﺮﻫ, ﮏﯾ-ﭻﯿﻫ, ﻪﮐ, ﻪﮐ, ﻪﮐ, ﯽﭼ, ﺮﻫ, ﻪﮐ-ﻡﺍﺪﮐ-ﺮﻫ
ﯽﺸﺳﺮﭘ-ﺖﻟﺎﺣ: 
ﻭ-ﺎﯾ: 
ﺎﯾ-ﺩﺮﻓ-ﻪﺑ ﺮﺼﺤﻨﻣ: 
ﻊﺒﻨﻣ-ﺩﺭﻮﻣ: 
ﻊﻓﺍﺭ-ﺩﺭﻮﻣ: 
ﯽﺸﯾﺎﻤﻧ: ﺪﻣﺎﺟ, ﻪﺟﻮﺗ-ﻞﺑﺎﻗ, ﻦﺘﺑ, ﻩﺪﻨﻨﮐ-ﺪﻋﺎﻘﺘﻣ, ﺩﻮﻤﻨﻫﺭ, ﯽﺸﯾﺎﻤﻧ
ﺎﻣﺍ: ﻥﻮﻨﮐﺎﺗ, ﺎﻣﺍ
ﻪﻤﻫ: ﺲﮐ-ﺮﻫ, ﯽﺴﮐ-ﺮﻫ, ﻊﻤﺟ, ﻡﺎﻤﺗ, ﯽﻠﮐ-ﺭﻮﻃ-ﻪﺑ, ﻡﺎﻤﺗ, ﯼﺰﯿﭼ-ﺮﻫ, ﺮﻫ, ﻩﺪﻨﯾﺍﺰﻓ-ﺭﻮﻃ-ﻪﺑ
ﻪﻧﺎﻧﺯ-ﺲﻨﺟ: 
ﺎﻬﻧﺁ: ﺎﻬﻧﺁ, ﻭﺍ, ﻥﺁ, ﻥﺎﺷ, ﯽﻧﺎﻣﺩﻮﺧ, ﯽﮔﺩﺍﻮﻧﺎﺧ-ﻡﺎﻧ, ﺎﻬﻨﯾﺍ
ﻊﻤﺟ-ﺩﺪﻋ: 
ﮏﯾ: ﺎﻬﻨﺗ, , ﻪﺑ, ﺲﮐ-ﯽﺑ
ﻩﺪﻨﯾﺁ-ﺖﻔﺳ: 
ﯽﻋﺎﻤﺘﺟﺍ-ﻪﻨﯿﻣﺯ: 
ﯽﻧﺎﻣﺯ-ﻪﭼ: ﻪﮐ-ﻥﺎﻣﺯ-ﺮﻫ
ﺏﻮﯿﻌﻣ-ﻪﺒﻨﺟ: 
ﺎﺠﻧﺁ: 
ﻁﻭﺮﺸﻣ-ﺖﻟﺎﺣ: ﯽﻃﺮﺷ-ﻪﺟﻭ-ﺖﻟﺎﺣ, ﯽﺿﺮﻓ-ﺖﻟﺎﺣ
ﺶﯿﺑ: ﺮﺑ-ﻎﻟﺎﺑ, ﻦﯾﺮﺘﺸﯿﺑ, ﺮﺘﺸﯿﺑ, ﺮﺗﺍﺮﻓ, ﻻ﻿ﺎﺑ-ﻑﺮﻄﺑ, ﻻ﻿ﺎﺑ-ﻑﺮﻄﺑ, ﺪﻨﭼ, ﻪﺑ-ﺖﺒﺴﻧ, ﺎﺘﺒﺴﻧ, ﻦﯿﻨﭽﻤﻫ, ﻦﯾﺍ-ﺮﺑ-ﻩﻭﻼ﻿ﻋ, ﻩﻭﻼ﻿ﻌﺑ, ﺯﻮﻨﻫ, ﻥﻮﻨﮐﺎﺗ, ﯼﺮﮕﯾﺩ, ﺪﻨﭼ, ﻦﯾﺪﻨﭼ
ﺝﺭﺎﺧ: ﺯﺍ-ﺝﺭﺎﺧ, ﯽﻧﻭﺮﯿﺑ, ﯽﺟﺭﺎﺧ, ﻝﺰﻨﻣ-ﺯﺍ-ﺝﺭﺎﺧ, ﻪﻧﺎﺧ-ﺯﺍ-ﻥﻭﺮﯿﺑ, ﺵﻮﻣﺎﺧ, ﺯﺍ-ﺝﺭﺎﺧ, ﺮﺗﺍﺮﻓ, ﻻ﻿ﺎﺑ, ﺮﺑ, ﯼﻭﺭ-ﺮﺑ
ﯽﻠﯿﻣﺎﻓ-ﺖﺒﺴﻧ-ﺩﺭﻮﻣ: ﯽﻠﯿﻣﺎﻓ-ﺖﺒﺴﻧ-ﺩﺭﻮﻣ
ﯽﻃﺎﺒﻨﺘﺳﺍ-ﺩﺭﻮﻣ: 
ﻡﺎﺠﻧﺍ: ﻦﺘﺧﺎﺳ, ﻥﺩﺍﺩ-ﻡﺎﺠﻧﺍ, ﻦﺘﻓﺮﮔ-ﻩﺪﻬﻌﺑ, ﻪﺋﺍﺭﺍ, ﻥﺩﺮﮐ-ﻝﺎﻌﻓ, ﺩﺍﺩ-ﻡﺎﺠﻧﺍ, ﺐﮑﺗﺮﻣ
ﺩﻮﻤﻨﻫﺭ-ﺖﻟﺎﺣ: ﻩﺪﻨﻫﺩ-ﻥﺎﺸﻧ-ﺖﻟﺎﺣ
deontic-ﺖﻟﺎﺣ: 
ﻝﺍﻮﺳ-ﻪﻤﻠﮐ: 
ﻂﺑﺍﺭ-ﻮﻀﻋ: ﻝﺎﺼﺗﺍ, ﻪﺿﺮﻗ-ﻕﺍﺭﻭﺍ, ﻪﺘﺳﺩ
ﺺﺨﺷ: ﻥﺎﺴﻧﺍ, ﺎﻫ-ﻥﺎﺴﻧﺍ, ﯼﺩﺮﻓ, ﯽﺴﮐ, ﯽﺴﮐ, ﺩﺮﻣ, ﻥﺎﺴﻧﺍ, ﺕﺭﻮﺻ, ﻥﺎﻫﺩ, ﺩﻮﺟﻭ
ﺮﻧ: ﻪﻧﺍﺩﺮﻣ, ﻩﺭﺎﺷﺍ, ﺎﻗﺁ, ﻥﺎﺴﻧﺍ
ﺖﺳﺍ-ﻪﺘﺴﻧﺍﻮﺗ: ﻥﺍﻮﺗ-ﯽﻣ, ﻦﮑﻤﻣ, ﻻ﻿ﺎﻤﺘﺣﺍ, ﺪﯾﺎﺷ
ﺮﮕﯾﺩ: ﯼﺮﮕﯾﺩ, ﯽﻗﺎﺑ, ﻦﯿﻣﻭﺩ, ﺮﮕﯾﺩ, ﻒﻠﺘﺨﻣ, ﺮﮕﯾﺩ-ﯽﮑﯾ
ﺩﺪﻋ: ﻥﺍﺰﯿﻣ, ﻉﻮﻤﺠﻣ, ﻞﮑﺷ, ﯼﺩﺪﻋ, ﺩﺪﻋ, ﺭﺍﺪﻘﻣ
ﺭﺎﯿﺴﺑ: ﯼﺩﺎﯾﺯ-ﺪﺣ-ﺎﺗ, ﯽﻠﯿﺧ, ﺭﻮﺟﺪﺑ, ﺭﺎﯿﺴﺑ, ﻢﻫ, ﯽﮐﺎﻨﺘﺸﺣﻭ, ﻩﺩﺮﺘﺴﮔ-ﺭﻮﻃ-ﻪﺑ, ﺭﺎﯿﺴﺑ, ﺎﻌﻗﺍﻭ, ﺪﺑ, ﻢﯿﻈﻋ, ﯽﻬﺟﻮﺗ-ﻞﺑﺎﻗ-ﺭﻮﻄﺑ, ﺭﺎﯿﺴﺑ, ﺪﻨﭼ, ﻩﺩﺎﻌﻟﺍ-ﻕﻮﻓ, ﻦﯾﺮﺘﺸﯿﺑ, ﻼ﻿ﻣﺎﮐ, ﻪﻧﺎﻔﺼﻨﻣ, ﺭﺎﯿﺴﺑ, ﺭﺎﯿﺴﺑ, ﻪﺷﺎﺑ, ﻪﺷﺎﺑ, ﺏﻮﺧ-ﯽﻠﯿﺧ
ﻥﺎﻣﺯ: ﻦﯿﺣ-ﺭﺩ, ﻪﻈﺤﻟ, ﻥﺎﯾﺮﺟ-ﺭﺩ, ﻊﻗﻮﻤﺑ, ﻥﺎﻣﺯ-ﺕﺪﻣ, ﯽﻧﺎﻣﺯ, ﻥﺎﻣﺯ, ﯽﻧﺎﻣﺯ-ﻝﻭﺪﺟ, ﯽﻧﺎﻣﺯ-ﻩﺭﻭﺩ, ﺍﻮﻫ
ﻥﺎﻣﺯ-ﻪﻨﯿﻣﺯ: 
ﯽﻧﺎﻣﺯ-ﺩﺭﻮﻣ: 
ﻩﺭﺎﺑ-ﺭﺩ: ﺖﺑﺎﺑ-ﺯﺍ, ﻩﺭﺎﺑ-ﺭﺩ, ﺎﺒﯾﺮﻘﺗ, ﺩﻭﺪﺣ-ﺭﺩ, ﺯﺍ, ﻂﺳﻮﺗ, ﻪﺑ-ﺖﺒﺴﻧ, ﻑﺍﺮﻃﺍ-ﺭﺩ, ﯼﺍﺮﺑ, ﻩﺪﻨﻨﮐ-ﻩﺩﺎﻔﺘﺳﺍ, ﻥﺩﺮﻛ-ﺖﻳﺎﻜﺷ, ﺮﺑ
ﯽﺘﻓﺮﻌﻣ-ﺖﻟﺎﺣ: 
ﻂﻘﻓ: ﻂﻘﻓ, ﺎﻬﻨﺗ, ﻩﺩﺎﺳ-ﻥﺎﺑﺯ-ﻪﺑ, ﻥﺩﺮﻛ-ﻩﺭﺎﺷﺍ, ﺾﺤﻣ, ﺎﻓﺮﺻ, ﺩﻭﺪﺤﻣ
ﯽﻤﮐ-ﺭﺍﺪﻘﻣ: ﮏﭼﻮﮐ, ﮏﭼﻮﮐ, ﮎﺪﻧﺍ, ﯽﻤﮐ, ﻩﺭﺫ, ﯽﺋﺰﺟ, ﺩﺮﺧ, ﮏﭼﻮﮐ, ﻞﻤﺣ-ﻞﺑﺎﻗ, ﺭﺎﻤﺷ-ﺖﺸﮕﻧﺍ
ﻊﻗﻮﻣ-ﻥﻭﺍ: ﻮﻧ-ﺯﺍ, ﻩﺭﺎﺑﻭﺩ, ﻪﻠﺑ, ﻥﻮﭼ, ﺶﯿﭘ, ﺪﻌﺑ, ﻥﺁ-ﺯﺍ-ﺪﻌﺑ
ﺰﯿﻣﺍ-ﺖﺤﯿﺼﻧ-ﺖﻟﺎﺣ: 
ﺮﮕﻧ-ﻪﺘﺷﺬﮔ-ﻪﺒﻨﺟ: 
ﯽﻟﺎﻋ: ﮒﺭﺰﺑ, ﮒﺭﺰﺑ, ﺐﯿﺠﻧ, ﯼﺪﺟ, ﻊﯿﺳﻭ, ﺪﻨﻠﺑ-ﯼﺍﺪﺻ-ﺎﺑ, ﻢﯿﻈﻋ, ﻝﻮﻏ, ﻢﯿﻈﻋ, ﺐﻟﺎﻏ, ﺏﻮﺧ, ﺏﻮﺧ, ﻪﺟﻮﺗ-ﻞﺑﺎﻗ, ﮒﺭﺰﺑ, ﻪﺟﻮﺗ-ﻞﺑﺎﻗ, ﺰﯿﮕﻧﺍ-ﺖﻔﮕﺷ, ﯽﻟﺎﻋ, ﻪﻨﯿﻬﺑ, ﮒﺭﺰﺑ, ﮒﺭﺰﺑ, ﻞﻣﺎﮐ, ﻪﺟﻮﺗ-ﺐﻟﺎﺟ, ﻥﺎﺸﺧﺭﺩ
volitive-ﺖﻟﺎﺣ: 
ﺯﺍ-ﻞﺒﻗ: ﯽﻠﺒﻗ, ﺶﯿﭘ, ﺶﯿﭘ, ﻞﺒﻗ, ﻪﮑﻨﯾﺍ-ﺎﺗ, ﻮﻠﺟ, ﻖﺑﺎﺳ, ﺮﺑﺍﺮﺑ-ﺭﺩ
ﺪﯾﺎﺑ: ﺪﯾﺎﺑ, ﺎﻣﻭﺰﻟ, ﯼﺭﻭﺮﺿ-ﺮﯿﻏ, ﺪﯾﺎﺑ, ﻦﺘﺷﺍﺩ-ﻡﺯﻻ﻿, ﺪﯾﺎﺑ, ﺪﯾﺎﺑ, ﺪﯿﻫﺍﻮﺧ-ﯽﻣ, ﻪﺑ
ﻭﺩ: ﻭﺩ, ﻭﺩ-ﺮﻫ
ﻥﺪﯾﺩ: ﻦﮐ-ﻩﺎﮕﻧ, ﺯﺍﺪﻧﺍ-ﻢﺸﭼ, ﻩﺮﻈﻨﻣ, ﻉﻼ﻿ﻃﺍ, ﮎﺭﺩ, ﻥﺩﺮﮐ-ﺎﺷﺎﻤﺗ
ﻦﺘﺴﻧﺍﺩ: ﻡﻮﻠﻌﻣ, ﻊﻠﻄﻣ, ﺵﺯﻮﻣﺁ, ﻢﭼﺮﭘ, ﺖﯾﻭﺭ-ﻞﺑﺎﻗ
ﻦﯿﯾﺎﭘ: ﻦﯿﯾﺎﭘ-ﻪﺑ-ﻭﺭ, ﻦﯿﯾﺎﭘ-ﻪﺑ-ﻭﺭ, ﺮﯾﺯ, ﺮﯾﺯ-ﺭﺩ, ﺮﯾﺯ-ﺭﺩ, ﺮﯾﺯ-ﺭﺩ, ﺮﺘﻤﮐ, ﻦﯿﯾﺎﭘ, ﺖﺴﭘ, ﻦﯿﯾﺎﭘ-ﻪﻘﺒﻃ
ﺯﺍ-ﺪﻌﺑ: ﺐﻘﻋ, ﺮﺑ, ﺖﺴﭘ, ﺪﻌﺑ, ﺪﻌﺑ, ﻥﺁ-ﺯﺍ-ﺪﻌﺑ, ﻥﺁ-ﺯﺍ-ﺪﻌﺑ, ﻥﺩﺮﮐ-ﻝﺎﺒﻧﺩ, ﻪﺘﺷﺬﮔ, ﺮﯾﺯ-ﺭﺩ, ﺮﯾﺯ-ﺭﺩ
ﻝﻭﺍ: ﺭﺎﮐ-ﺯﺎﻏﺍ, ﻪﯿﻟﻭﺍ, ﻥﻮﭼ, ﺪﻌﺑ, ﺖﺸﻣ
ﺩﻮﺧ: ﺩﻮﺧ, ﺕﺩﻮﺧ, ﯼﺍﺭﺍﺩ, ﺎﺼﺨﺷ, ﺩﻮﺧ, ﺩﻮﺧ, ﺩﻮﺧ
ﻝﺎﻘﺘﻧﺍ-ﻞﺑﺎﻗ-ﻦﺘﺷﺍﺩ ﺭﺎﯿﺘﺧﺍ ﺭﺩ: 
ﺰﮔﺮﻫ: ﻪﺸﯿﻤﻫ
ﺍﺰﺠﺘﯾﻻ﻿-ﻦﺘﺷﺍﺩ-ﺭﺎﯿﺘﺧﺍ ﺭﺩ: 
ﯽﻤﯾﺪﻗ: ﺪﺷ-ﻩﺩﺎﻔﺘﺳﺍ, ﯽﻧﺎﺘﺳﺎﺑ, ﻦﺴﻣ, ﻦﺴﻣ-ﺩﺍﺮﻓﺍ, ﻖﺑﺎﺳ, ﻖﺑﺎﺳ, ﻖﺑﺎﺳ, ﻦﺳ
ﯽﺗﺭﻮﺸﻣ-ﺖﻟﺎﺣ: 
ﺯﻭﺭ: ﻪﻧﺍﺯﻭﺭ, ﺯﻭﺮﻣﺍ, ﺐﺸﻣﺍ
ﻪﮐ-ﯽﯾﺎﺟ: ﻪﮐ-ﺎﺠﮐ-ﺮﻫ, ﻥﺁ-ﺐﺟﻮﻣ-ﻪﺑ, ﻥﺩﺍﺩ-ﯼﺎﺟ
ﺎﯿﺑ: ﻪﺑ, ﻪﺑ-ﻥﺪﯿﺳﺭ, ﺩﻭﺭﻭ, ﻥﺪﯿﺳﺭ, ﻥﺪﺷ, ﺵﻭﺭ, ﻦﺘﺳﻮﯿﭘ-ﻉﻮﻗﻭ-ﻪﺑ
ﺮﯿﺴﻣ: ﺵﻭﺭ, ﯽﺳﺎﻨﺷ-ﺵﻭﺭ, ﯼﺎﻨﻌﻣ-ﻪﺑ, ﺮﯿﺴﻣ, ﺮﯿﺴﻣ, ﻪﻟﺎﺳﺭ, ﻩﺎﮔﺭﺬﮔ, ﻪﻟﺎﺒﻧﺩ, ﺵﻭﺭ, ﻩﺩﺎﺟ, ﻥﺎﺑﺎﯿﺧ, ﺪﻨﻗ, ﺮﯿﺴﻣ, ﺮﯿﺴﻣ, ﺕﺩﺎﻋ
ﺭﺎﮐ: ﺭﺎﮐ, ﯼﺭﺍﺬﮔﺍﻭ, ﻝﺎﻌﻓ, ﻪﻔﯿﻇﻭ, ﺭﺎﮐ, ﺭﺎﮐ, ﯼﺍ-ﻪﻓﺮﺣ, ﺩﺮﮑﻠﻤﻋ, ﻞﻤﻋ, ﯽﻌﺑﺎﺗ, ﺕﺭﺎﺠﺗ, ﻞﻤﻋ, ﻥﺩﺮﮐ-ﺭﺎﮐ, ﻡﺍﺪﺨﺘﺳﺍ, ﯼﺍ-ﻪﻓﺮﺣ, ﻥﺩﺮﮐ-ﺭﺎﮐ, ﯼﺮﻨﻫ-ﺮﺛﺍ
ﺭﺍﺩﺍﺪﺻ-ﻑﺮﺣ: ﻑﻭﺮﻌﻣ, ﯽﮔﺪﻧﺯ, ءﺎﻘﺑ
ﻦﺘﻓﺭ: ﻦﺘﻓﺭ-ﻩﺍﺭ, ﻪﯾﺍﺮﮐ, ﮎﺮﺗ
perlative-ﺩﺭﻮﻣ: 
ﯽﻗﺮﺘﻣ-ﻪﺒﻨﺟ: 
ﯽﻧﻻ﻿ﻮﻃ: ﺕﺪﻣ-ﯽﻧﻻ﻿ﻮﻃ, ﻡﺍﻭﺩ-ﺎﺑ, ﺪﻨﻠﺑ, ﻩﺍﺮﻤﻫ
ﻦﺘﻔﮔ: ﯼﺭﺎﺘﻔﮔ, ﻪﺑ, ﻦﺘﻔﮔ-ﻦﺨﺳ
ﻪﻧﻮﮕﭼ: ﺪﻨﻧﺎﻣ, ﻪﻟﺰﻨﻣ-ﻪﺑ, ﻪﺑ-ﺖﺒﺴﻧ
ﯽﺘﺣ: ﻦﯿﻨﭽﻤﻫ, ﻢﻫ, ﻪﮑﻨﯾﺍ-ﺎﺗ, ﻦﯾﺍ-ﺮﺑ-ﻩﻭﻼ﻿ﻋ, ﻢﻫ
ﺖﺸﮔﺯﺎﺑ: ﺖﺸﭘ, ﺐﻘﻋ, ﺐﻘﻋ-ﻪﺑ, ﻪﻧﻭﺭﺍﻭ, ﺖﺸﮔﺮﺑ, ﻩﺭﺎﺑﻭﺩ, ﻥﺪﻧﺍﺩﺮﮔﺯﺎﺑ, ﻥﺩﺮﮐ-ﻞﻃﺎﺑ, ﻮﻧ-ﺯﺍ, ﻥﺩﺮﮐ-ﺭﺍﺮﮑﺗ, ﺶﯿﭘ, ﺎﺑ-ﻖﺑﺎﻄﻣ
ﺎﺠﻨﯾﺍ: 
ﺮﮑﻓ: ﺮﮑﻔﺗ, ﺮﮑﻓ, ﻦﺘﻓﺮﮔ-ﺮﻈﻧ-ﺭﺩ, ﻦﮐ-ﺭﻮﺼﺗ, ﺭﻮﺼﺗ, ﻥﺩﺮﮐ-ﺮﮑﻔﺗ, ﺍﺭ, ﺪﻧﻮﺷ-ﯽﻣ-ﻩﺪﯿﻣﺎﻧ, ﻦﻫﺫ
ﻥﺎﺴﮑﯾ: ﻥﺎﺴﮑﯾ, ﻢﻫ-ﻪﯿﺒﺷ, ﺮﺑﺍﺮﺑ, ﻝﺩﺎﻌﻣ, ﯽﺘﺳﺭﺩ, ﻪﺷﺎﺑ, ﺏﻮﺧ-ﯽﻠﯿﺧ, ﺩﻮﺧ, ﻥﺎﺴﮑﯾ-ﺭﻮﻃ-ﻪﺑ, ﻪﺑﺎﺸﻣ-ﺭﻮﻃ-ﻪﺑ
ﻪﺘﺷﺬﮔ: ﻥﺎﯾﺎﭘ, ﯽﻣﻭﺩ, ﯽﯾﺎﻬﻧ, ﯽﯾﺎﻬﻧ, ﺮﮕﯾﺩ, ﯼﺮﮕﯾﺩ, ﻦﯾﺮﺧﺁ, ﺮﯿﺧﺍ, ﻥﺎﯾﺎﭘ, ﻪﺘﺷﺬﮔ, ﻪﺘﺷﺬﮔ, ﻞﻤﺤﺗ, ﺮﺑﺍﺮﺑ-ﺭﺩ-ﺖﻣﻭﺎﻘﻣ, ﻥﺩﺍﺩ-ﺭﺍﺮﻗ, ﻪﻣﺍﺩﺍ
ﺭﻭﺩ: ﺭﺎﯿﺴﺑ, ﺭﻭﺩ, ﺵﻮﻣﺎﺧ, ﺍﺪﺟ, ﺭﻭﺩ, ﺩﺮﮐ-ﮎﺮﺗ, ﻥﺩﺮﮐ-ﮎﺮﺗ, ﺐﯾﺎﻏ
ﺮﯾﺯ-ﻪﻨﯿﻣﺯ: 
ﻦﺘﻓﺮﮔ: ﺭﺮﮑﻣ-ﺪﻣﺁ-ﻭ ﺖﻓﺭ, ﻝﺎﻐﺷﺍ, ﯽﺸﮐﺍﻭ, ﺫﺎﺨﺗﺍ, ﻦﺘﻓﺮﮔ, ﻦﺘﻓﺮﮔ, ﻥﺩﺮﻛ-ﺖﻓﺎﻳﺭﺩ, ﺪﯿﻨﮐ-ﺏﺎﺨﺘﻧﺍ, ﻦﺘﻓﺮﮔ, ﻦﺘﻓﺮﮔ, ﺪﯿﻨﮐ-ﺪﯿﯾﺎﺗ, ﻥﺩﺭﻭﺁ-ﺖﺳﺩ-ﻪﺑ, ﮊﺭﺎﺷ
ﻩﺪﺷ-ﺍﺪﯿﭘ: ﻥﺩﺮﮐ-ﺍﺪﯿﭘ, ﻥﺩﺮﻛ-ﻒﺸﻛ, ﻒﺸﮐ, ﻒﺸﮐ, ﺱﺮﺘﺳﺩ-ﺭﺩ
ﺖﺳﺩ: ﻭﺯﺎﺑ, ﺖﺳﺩ-ﭻﻣ
ﻥﺍﻮﺟ: ﻥﺎﻧﺍﻮﺟ, ﺮﺘﻫﺯﺎﺗ, ﻥﺍﻮﺟﻮﻧ, ﻥﺍﻮﺟﻮﻧ, ﺪﯾﺪﺟ
ﻪﭼﺮﮔ: ﻪﻜﻨﻳﺍ-ﺎﺑ, ﻑﺎﺻﻭﺍ-ﻦﯾﺍ-ﺎﺑ, ﺪﺷ-ﺖﺳﺭﺩ, ﺖﮐﺮﺷ, ﺪﻣﺎﺟ, ﻢﮑﺤﻣ, ﺩﻮﺟﻭ-ﺎﺑ, ﺎﻣﺍ, ﯽﺴﮐ
ﻥﺩﺍﺩ: ﻥﺩﺍﺩ-ﺽﺮﻗ, ﺪﻨﮐ-ﯽﻣ-ﻢﻫﺍﺮﻓ, ﺩﺎﻬﻨﺸﯿﭘ, ﻥﺩﺭﻭﺁ-ﻢﻫﺍﺮﻓ, ﻪﺋﺍﺭﺍ, ﻪﺋﺍﺭﺍ, ﻦﺘﺷﺍﺩ-ﺖﻋﺎﻄﺘﺳﺍ, ﻥﺩﺍﺩ-ﺭﺍﺮﻗ, ﻥﺩﺮﮐ-ﺍﺪﻫﺍ, ﺪﯿﻫﺩ-ﻩﺯﺎﺟﺍ
ﺍﺪﺧ: 
delative-ﺩﺭﻮﻣ: 
ﯽﭼ-ﭻﯿﻫ: ﯼﺰﯿﭼ-ﻪﯾ, ءﯽﺷ, ﺲﮑﭽﯿﻫ, ﻱﺰﻴﭼ-ﺮﻫ, ﭻﯿﻫ, ﺲﻛ-ﭻﻴﻫ
ﺖﺳﺭﺩ: ﺖﻔﺟ, ﺖﺳﺭﺩ, ﺖﻗﺩ, ﻪﻧﻻ﻿ﺩﺎﻋ, ﺖﻟﺍﺪﻋ, ﻩﺪﺷ-ﻞﯾﺪﻌﺗ, ﻪﻧﺎﻔﺼﻨﻣ-ﺮﯿﻏ, ﻂﯾﺍﺮﺷ-ﺪﺟﺍﻭ, ﻖﺣ, ﻥﻮﻧﺎﻗ, ﺖﺳﺭﺩ, ﺖﺳﺭﺩ, ﯽﻀﻌﺑ, ﻢﺸﭼ-ﯼﻭﺭ-ﻪﺑ, ﻥﺩﺎﻬﻧ-ﻡﺎﻧ, ﻲﺑﻮﺧ-ﻪﺑ
ﺭﺎﺑ-ﮏﯾ: ﻪﻠﺻﺎﻓﻼ﻿ﺑ, ﮓﻧﺭﺩ-ﯽﺑ, ﺵﻭﺭ, ﻮﮕﻟﺍ, ﯽﺳﺎﻨﺷ-ﺵﻭﺭ, ﻮﻧ-ﺯﺍ
semelfactive-ﻪﺒﻨﺟ: 
ﺶﺨﺑ: ﺶﺨﺑ, ﯼﺍ-ﻩﺯﺍﺪﻧﺍ-ﺎﺗ, ﺶﺨﺑ, ﯼﺪﺣﺎﺗ, ﻪﺘﺴﺑ, ﺮﺴﮐ, ﻢﻬﺳ, ﻩﺭﺫ, ﻪﻌﻄﻗ, ﺭﻮﺒﻋ, ﻪﻋﻮﻤﺠﻣ-ﺮﯾﺯ, ﻞﺼﻓ, ﺶﺨﺑ, ﺖﻤﺴﻗ, ﻲﺋﺰﺟ, ﺶﺨﺑ, ﺶﺨﺑ, ﺶﺨﺑ, ﺖﺒﺴﻧ, ﯽﮔﺪﻨﯾﺎﻤﻧ
ﻩﺭﺍ: 
ﻪﻧﺎﺧ: ﻪﻧﺎﺧ, ﻞﺤﻣ, ﺪﺒﻌﻣ, ﻦﮑﺴﻣ, ﻝﺰﻨﻣ-ﻡﺯﺍﻮﻟ
ﻥﺎﻬﺟ: ﻩﺯﻮﺣ, ﯽﻧﺎﻬﺟ, ﻥﺎﻬﺟ
ﺮﺳ: ﻥﺍﻮﻨﻋ, ﯽﻠﺻﺍ, ﺲﯿﺋﺭ, ﻞﺼﻓ, ﺮﺒﻫﺭ, ﺭﻮﻬﻤﺟ-ﺲﯿﺋﺭ, ﺲﯿﺋﺭ, ﺮﯾﺪﻣ, ﺲﻴﺋﺭ, ﺪﺷﺭﺍ, ﻢﻠﻗ
ﻪﺳ: ﻡﻮﺳ
ﻮﺌﻧ: ﺪﯾﺪﺟ, ﺍﺮﯿﺧﺍ
ﺰﮐﺮﻤﺗ: ﻩﺪﺷ-ﻪﺘﻓﺮﮔ-ﺮﻈﻧ ﺭﺩ, ﻦﺘﻓﺮﮔ-ﻪﻧﺎﺸﻧ, ﻑﺪﻫ, ﻑﺪﻫ, ﻦﺘﺷﺍﺩ-ﺰﮐﺮﻤﺗ, ﻪﺟﻮﺗ, ﺰﮐﺮﻤﺗ, ﻪﺠﻬﻟ, ﺍﺮﮕﻤﻫ
ﻖﺸﻋ: ﺖﺒﺤﻣ, ﻪﻗﺪﺻ, ﺪﻨﻧﺎﻣ
ﻪﺸﯿﻤﻫ: ﻪﺸﯿﻤﻫ-ﯼﺍﺮﺑ, ﻡﻭﺍﺪﻣ-ﺭﻮﻃ-ﻪﺑ, ﻪﺸﯿﻤﻫ, ﻝﻮﻤﻌﻣ
ﺐﺷ: ﺐﺷ, ﻡﺎﺷ, ﺮﻬﻇ-ﺯﺍ-ﺪﻌﺑ
ﮏﺗ-ﮏﺗ: ﺮﻫ-ﺭﺩ, ﺮﻫ, ﺮﻫ
ﻩﺎﺷﺩﺎﭘ: ﺖﻨﻄﻠﺳ, ﺪﻧﻭﺍﺪﺧ, ﻩﺎﺷﺩﺎﭘ, ﻢﻬﻣ-ﯽﻠﯿﺧ-ﺭﺍﺩ ﻪﯾﺎﻣﺮﺳ
ﻦﯿﺑ: ﻥﺎﯿﻣ-ﺭﺩ, ﻥﺎﯿﻣ-ﺭﺩ, ﺯﺍ
ﺐﻠﻗ: ﻥﺩﺮﮐ-ﻖﯾﻮﺸﺗ, ﻩﺪﻨﻨﮐ-ﻡﺮﮕﻟﺩ, ﯽﻧﻮﮕﻧﺮﺳ
paucal-ﺩﺪﻋ: 
ﺍﺮﯾﺯ: ﺯﺍ-ﯽﺷﺎﻧ, ﻥﻮﭼ, ﺩﺭﻮﻣ, ﺩﻮﺷ-ﯽﻣ-ﺐﺒﺳ
ﯽﺒﺒﺳ-ﺩﺭﻮﻣ: 
ﺰﯿﭼ: ﻩﺩﺎﻣ, ﺮﻣﺍ, ﻩﺪﯾﺪﭘ, ﺰﯿﭼ, ﯽﭼ
ﻢﯿﻈﻨﺗ: ﻩﻭﺮﮔ, ﻥﺩﺍﺩ-ﺭﺍﺮﻗ, ﻦﺘﺷﺍﺩ-ﻩﺎﮕﻧ, ﯽﻧﺎﺣﻭﺭ-ﺮﯿﻏ, ﺮﯿﻤﺧ, ﻪﻋﻮﻤﺠﻣ, ﺐﯿﮐﺮﺗ, ﻪﯾﺍﺭﺁ, ﻪﻋﻮﻤﺠﻣ, ﻪﺘﺴﺑ, ﻡﺎﻘﻣ, ﺰﺘﻨﺳ, ﺮﮕﯾﺪﮑﯾ-ﺎﺑ, ﻪﻠﺴﻠﺳ, ﻥﺩﺯ-ﺭﻭﺩ, ﻩﺩﻭﺪﺤﻣ, ﻒﯾﺩﺭ, ﻪﺘﺷﺭ, ﺖﯿﮐ, ﻢﺴﺟ
ﻡﺎﻧ: ﯽﮔﺩﺍﻮﻧﺎﺧ-ﻡﺎﻧ, ﻢﺳﺍ
ﺐﺳﺎﻨﻣ-ﻢﺳﺍ: 
ﺰﯿﻣﺍ-ﺖﺤﯿﺼﻧ: ﯽﺒﯿﻏﺮﺗ
ﺭﻮﺸﮐ: ﺖﻠﻣ, ﻦﯿﻣﺯ, ﻦﯿﻣﺯ, ﻥﺩﺍﺩ-ﺡﺮﺷ-ءﺰﺟ ﻪﺑ ءﺰﺟ, ﻦﯿﻣﺯ, ﻥﺎﺘﺳﺮﻬﺷ, ﮎﺎﺧ, ﺏﺰﺣ
ﻪﺘﺳﺍﻮﺧ: 
ﺖﯾﻭﺭ-ﻞﺑﺎﻗ-ﯽﮐﺭﺪﻣ: 
ﺮﺘﻬﺑ: ﺮﺗﺮﺑ, ﻦﯾﺮﺘﻬﺑ, ﯽﻟﺎﻋ, ﻝﺁ-ﻩﺪﯾﺍ, ﻪﺘﺴﺟﺮﺑ
ﺖﻤﺳ: ﯽﺒﻧﺎﺟ, ﻒﻄﻟ, ﻒﻄﻟ, ﯽﮔﺪﻨﯾﺎﻤﻧ, ﻥﺩﺯ-ﺭﻭﺩ, ﻪﺤﻔﺻ, ﻪﺒﻨﺟ, ﻢﯿﻧ, ﻞﮑﺷ
ﻩﺭﻭﺩ: ﯽﻠﯿﺼﺤﺗ-ﻪﻣﺎﻧﺮﺑ, ﺱﺭﺩ, ﯽﻧﺍﺮﻨﺨﺳ, ﺎﻌﻄﻗ, ﺎﻤﻠﺴﻣ, ﺎﻌﻄﻗ, ﺥﺮﻧ
ﻥﺯ: ﻢﻧﺎﺧ, ﻪﻧﺎﻧﺯ, ﻪﻧﺎﻧﺯ, ﺎﻫ-ﻥﺯ, ﺮﺘﺧﺩ, ﻥﺯ
ﯽﻓﺎﮐ: ﯽﻓﺎﮐ, ﯽﻓﺎﮐ-ﻩﺯﺍﺪﻧﺍ-ﻪﺑ, ﯽﻓﺎﮐ, ﻥﺍﻭﺍﺮﻓ, ﻪﻧﺎﻔﺼﻨﻣ, ﻥﺍﻭﺍﺮﻓ, ﯽﻓﺎﮐ, ﻼ﻿ﻣﺎﮐ, ﺭﺎﯿﺴﺑ
ﯼﺩﻭﺯ-ﻪﺑ: ﯽﻫﺎﺗﻮﮐ-ﺕﺪﻣ, ﻊﯾﺮﺳ, ﮓﻧﺭﺩ-ﯽﺑ, ﺖﻋﺮﺳ-ﻪﺑ, ﻊﯾﺮﺳ, ﯼﺭﻮﻓ, ﻊﯾﺮﺳ, ﻪﻠﺠﻋ, ﯼﺭﻮﻓ, ﻦﯾﺍﺮﺑﺎﻨﺑ, ﻪﻠﺻﺎﻓﻼ﻿ﺑ, ﯽﻧﺎﺳﺁ-ﻪﺑ, ﮏﯾﺩﺰﻧ, ﻪﯿﻟﻭﺍ, ﯽﻧﺎﻬﮔﺎﻧ-ﻭ-ﻢﮑﺤﻣ ﻪﺑﺮﺿ
ﻩﺪﺷ-ﺮﭘ: ﻼ﻿ﻣﺎﮐ, ﯽﻓﺎﮐ-ﻩﺯﺍﺪﻧﺍ-ﻪﺑ, ﻖﻠﻄﻣ, ﻞﯿﻤﮑﺗ, ﺺﻗﺎﻧ, ﻡﺎﻤﺗ, ﻼ﻿ﻣﺎﮐ, ﻖﯿﻗﺩ, ﻖﻠﻄﻣ, ﺎﻘﯿﻗﺩ, ﻞﻣﺎﮐ, ﻡﺎﻤﺗ, ﻊﻣﺎﺟ, ﻩﺯﺍﺪﻧﺍ
ﻕﺎﺗﺍ: ﻕﺎﺗﺍ, ﻡﺭﺎﻬﭼ, ﺏﺍﻮﺧ-ﻕﺎﺗﺍ, ﺢﻠﺻ
ﺎﺒﯾﺮﻘﺗ: ﺎﺒﯾﺮﻘﺗ, ﻼ﻿ﻤﻋ, ﺎﺒﯾﺮﻘﺗ, ﺩﻭﺪﺣ-ﺭﺩ, ﮏﯾﺩﺰﻧ, ﻑﺍﺮﻃﺍ-ﺭﺩ, ﻦﺘﺴﺑ, ﺭﻭﺎﺠﻣ, ﺎﺒﯾﺮﻘﺗ, ﮏﯾﺩﺰﻧ, ﯽﻫﺎﺗﻮﮐ-ﺕﺪﻣ, ﻝﺎﻤﯾﺰﮔﻭﺮﭘ, ﺎﺒﯾﺮﻘﺗ, ﯽﺘﺨﺳ-ﻪﺑ
ﻥﺍﻮﺗ-ﯽﻤﻧ: ﻥﺍﻮﺗﺎﻧ
ﺏﺍ: ﻊﯾﺎﻣ, ﻊﯾﺎﻣ, ﻪﺿﻮﺣ
desiderative-ﺖﻟﺎﺣ: 
ﮏﺒﺳ: ﺶﺑﺎﺗ, ﻦﺷﻭﺭ, ﻊﻤﺷ, ﮎﺪﻧﺍ, ﮏﺒﺳ, ﮏﺒﺳ, ﻢﯾﻼ﻿ﻣ, ﺮﺗ-ﮏﺒﺳ, ﻩﺪﯾﺮﭘ-ﮓﻧﺭ, ﺢﺿﺍﻭ
ﻪﻧ-ﻭ: ﮏﯾ-ﭻﯿﻫ, ﺮﯿﻏ, ﻥﻮﻨﮐﺎﺗ, ﯽﭼ, ﻦﺘﺳﻮﯿﭘ-ﻉﻮﻗﻭ-ﻪﺑ, ﺎﯾ
ﻩﮊﺍﻭ: ﯼﻮﻐﻟ
ﺏﺭﺩ: ﯼﺩﻭﺭﻭ-ﺭﺩ, ﻩﺎﮔﺭﺩ, ﺩﻭﺭﻭ, ﻞﺼﻓ, ﺭﺪﻨﺑ
ﻥﺩﺮﮐ-ﻩﺩﺎﻔﺘﺳﺍ: ﻩﺩﺎﻔﺘﺳﺍ, ﻩﺩﺎﻔﺘﺳﺍ, ﻑﺮﺼﻣ, ﻪﻨﯾﺰﻫ, ﻩﺪﻨﻨﻛ-ﻑﺮﺼﻣ, ﻥﺩﺮﮐ-ﻝﻮﻐﺸﻣ, ﺭﺍﺰﻓﺍ-ﻡﺮﻧ, ﺭﺍﺰﺑﺍ, ﺖﺳﺍﻮﺧﺭﺩ, ﻡﺍﺪﺨﺘﺳﺍ
ﺢﺒﺻ: .ﺢﺒﺻ, ﻪﻧﺎﺤﺒﺻ
ﯽﻌﻄﻗ-ﺩﺭﻮﻣ: 
ﺕﺭﺪﻗ: ﻡﺎﮑﺤﺘﺳﺍ, ﯼﮊﺮﻧﺍ, ﻦﮑﻤﻣ, ﯼﻮﻗ, ﻥﺩﺮﻛ-ﺭﻮﺒﺠﻣ, ﺪﻨﻤﺗﺭﺪﻗ, ﺎﯾﻮﭘ, ﺩﻻ﻿ﺎﺳ, ﻂﻠﺴﺗ, ﻦﺘﺷﺍﺩ-ﺭﺎﯿﺘﺧﺍ
ﻥﺎﺷﺩﻮﺧ: ﻥﺎﻣﺩﻮﺧ, ﺕﺩﻮﺧ, ﺩﻮﺧ, ﻡﺩﻮﺧ, ﺵﺩﻮﺧ, ﺩﻮﺧ, ﺩﻮﺧ, ﺲﻔﻧ, ﻞﺼﻓ
ﺮﺿﺎﺣ: ﯼﺭﺎﺟ, ﺮﺿﺎﺣ, ﻥﻮﻨﮐﺍ, ﺮﺿﺎﺣ-ﻝﺎﺣ-ﺭﺩ, ﻪﯾﺪﻫ, ﺩﻮﺟﻭ, ﺱﺮﺘﺳﺩ-ﺭﺩ
ﺍﺪﺻ: ﺍﺪﺻ, ﺪﻨﻠﺑ-ﯼﺍﺪﺻ-ﺎﺑ, ﯼﺍﺭ-ﻪﻗﺭﻭ, ﯽﻌﻤﺳ, ﯼﺍﺭ, ﺩﺭﻮﻣ, ﻪﻌﯾﺎﺷ, ﻪﻌﯾﺎﺷ
ﺪﯿﻔﺳ: ﯽﻟﺎﺧ-ﯼﺎﺟ, ﺖﯾﺎﮑﺷ
ﻝﻮﭘ: ﺕﻭﺮﺛ, ﻩﺮﻘﻧ, ﯽﻟﺎﻣ, ﺪﻘﻧ, ﻝﻮﭘ-ﺪﺣﺍﻭ, ﯽﯾﺍﺭﺍﺩ, ﯽﻟﻮﭘ
ﺪﻌﺑ: ﺭﺎﻨﻛ-ﺭﺩ, ﺭﺎﻨﮐ-ﺭﺩ, ﺐﻨﺟ, ﻥﺩﺮﮐ-ﻝﺎﺒﻧﺩ, ﺪﻌﺑ, ﺪﻌﺑ, ﺪﻌﺑ, ﺐﻗﺎﻌﺘﻣ
ﺮﯿﻘﻓ: ﻭﺯﺎﺑ, ﯽﻟﻮﭘ-ﯽﺑ, ﺪﺑ, ﻦﯾﺮﺗﺪﺑ, ﺪﺳﺎﻓ, ﻒﯿﻌﺿ
ﮒﺮﻣ: ﺮﯿﻣﻭ-ﮒﺮﻣ, ﮒﺮﻣ-ﻝﺎﺣ-ﺭﺩ, ﻥﺎﺟ-ﯽﺑ
ﻥﺪﺷ-ﻞﻴﻜﺸﺗ: ﻞﮑﺷ, ﺐﻟﺎﻗ, ﺐﻟﺎﻗ, ﻞﺻﺎﻓ-ﺪﺣ, ﻮﮕﻟﺍ
inessive-ﺩﺭﻮﻣ: 
ﻉﻮﻧ: ﺱﻼ﻿ﮐ, ﯼﺯﺎﺳ-ﺐﺗﺮﻣ, ﺎﻫ-ﻪﻧﻮﮔ, ﻉﺍﻮﻧﺍ, ﻉﻮﻧ, ﻪﻧﺎﺘﺳﻭﺩ, ﺩﺭﻮﻣ, ﺏﻮﺧ, ﺮﯾﺬﭙﻟﺩ, ﺵﻮﺧ, ﺶﺨﺑ-ﺕﺬﻟ
ﻊﻗﺍﻮﻣ-ﺮﺘﺸﯿﺑ: ﺎﺒﻟﺎﻏ, ﻡﻭﺍﺪﻣ-ﺭﻮﻃ-ﻪﺑ, ﺐﺗﺮﻣ-ﺭﻮﻃ-ﻪﺑ, ﺭﺮﮑﻣ, ﺎﻣﻮﻤﻋ, ﻝﻮﻤﻌﻣ-ﺭﻮﻃ-ﻪﺑ, ﻻ﻿ﻮﻤﻌﻣ
ﻝﺎﺳ: ﻪﻧﺎﯿﻟﺎﺳ, ﻪﻧﻻ﻿ﺎﺳ, ﺞﻨﭘ
ﺖﺳﻭﺩ: ﺪﺤﺘﻣ, ﺮﺴﭘ-ﺖﺳﻭﺩ, ﺭﺎﮑﻤﻫ, ﺮﺴﻤﻫ
ﺐﯿﺗﺮﺗ: ﻢﺘﺴﯿﺳ, ﺐﯿﺗﺮﺗ, ﻥﺩﺍﺩ-ﺐﯿﺗﺮﺗ, ﯼﺭﺎﮐ-ﺩﺍﺩﺭﺍﺮﻗ, ﻪﯾﺍﺭﺁ, ﻥﺎﻣﺮﻓ, ﻥﺩﺯ-ﺭﻭﺩ, ﻒﯾﺩﺭ, ﻒﺻ
ﯼﺭﻭﺮﺿ-ﯼﺮﻣﺍ-ﺖﻟﺎﺣ: 
ﺩﺮﮔ: ﻩﺪﺷ-ﺩﺮﮔ, ﻩﺮﯾﺍﺩ, ﻥﺩﺮﮐ-ﭗﻠﺷ-ﭗﻠﺷ
ﻦﺘﺷﺍﺩ-ﺩﺎﻘﺘﻋﺍ: ﺩﺎﻤﺘﻋﺍ, ﻥﺩﺮﮐ-ﺏﺎﺴﺣ-ﯼﺰﯿﭼ ﯼﻭﺭ, ﺽﺮﻓ, ﻥﺎﻤﯾﺍ, ﺭﻭﺎﺑ, ﺲﻔﻧ-ﻪﺑ-ﺩﺎﻤﺘﻋﺍ, ﻦﺌﻤﻄﻣ, ﯽﻨﯿﺑ-ﺵﻮﺧ, ﻦﯿﺑ-ﺵﻮﺧ
ﻡﺩﺮﻣ-ﻡﻮﻤﻋ: ﯽﻣﻮﻤﻋ, ﯽﻣﻮﻤﻋ, ﺭﺎﻀﺣ
ﺖﻟﺎﺣ-ﻪﻨﯿﻣﺯ: 
ﺮﺴﭘ-ﺪﻧﺯﺮﻓ: ﻡﺎﺣﺩﺯﺍ, ﺮﺴﭘ
ﺪﺻ: ﻡﺪﺻ-ﮏﯾ, ﺕﺭﻮﺻ, ﺪﺻﺭﺩ
ﺎﻫ-ﻪﭽﺑ: ﻪﭽﺑ, ﺪﻧﺯﺮﻓ, ﻞﻔﻃ, ﮎﺩﻮﮐ
ﺐﯿﺗﺮﺗ-ﻦﯾﺪﺑ: ﻪﺠﯿﺘﻧ-ﺭﺩ, ﻦﯾﺍﺮﺑﺎﻨﺑ, ﻭﺭ-ﻦﯾﺍ-ﺯﺍ, ﻦﯿﻨﭼ, ﻪﻠﺑ
ﺪﯿﻣﺍ: ﻥﺩﺮﮐ-ﻭﺯﺭﺁ, ﺯﺍﺪﻧﺍ-ﻢﺸﭼ, ﯽﻨﯿﺑ-ﺶﯿﭘ, ﯽﻨﯿﺑ-ﺵﻮﺧ, ﻦﯿﺑ-ﺵﻮﺧ
ﻻ﻿ﺎﺑ-ﺭﺩ: ﻻ﻿ﺎﺑ, ﺮﺑ-ﻎﻟﺎﺑ, ﺎﻫ-ﻪﻠﭘ-ﺯﺍ, ﻻ﻿ﺎﺑ, ﻻ﻿ﺎﺑ, ﻪﺘﻓﺮﺸﯿﭘ, ﻻ﻿ﺎﺑ, ﻥﺎﯿﻣ-ﺭﺩ, ﻩﺭﺎﺑ-ﺭﺩ, ﻖﻳﺮﻃ-ﺯﺍ, ﺮﺑ, ﺮﺳ-ﯼﻻ﻿ﺎﺑ-ﺭﺩ, ﯼﻭﺭ-ﺮﺑ, ﺶﯿﭘ-ﺭﺩ, ﻻ﻿ﺎﺑ-ﻑﺮﻄﺑ
ﺰﯾﺰﻋ: ﻖﺷﺎﻋ, ﻥﺍﺮﮔ
ﻥﺪﻧﺍﻮﺧ: ﺖﺋﺍﺮﻗ, ﻥﺪﻧﺍﻮﺧ, ﻖﺒﻧﺯ
ﻥﺎﺘﺳﺮﻬﺷ: ﺮﻬﺷ, ﯼﺭﺍﺩﺮﻬﺷ, ﻥﺎﺘﺳﺮﻬﺷ
ﻼ﻿ﺒﻗ: ﻥﺩﻮﺑ-ﻩﺩﺎﻣﺁ, ﻩﺪﺷ-ﻩﺩﺎﻣﺁ, ﻞﯾﺎﻣ, ﻝﺎﺣ-ﺮﻫ-ﻪﺑ
ﺖﯿﻌﻗﺍﻭ: ﺖﻘﯿﻘﺣ, ﺖﯿﻌﻗﺍﻭ, ﯽﯾﻮﮕﻘﺣ, ﺖﺳﺭﺩ, ﯽﻌﻗﺍﻭ, ﯽﻌﻗﺍﻭ, ﻊﻗﺍﻭ-ﺭﺩ, ﺎﻌﻗﺍﻭ, ﻊﻗﺍﻭﺭﺩ, ﺩﺍﺩ-ﻡﺎﺠﻧﺍ
factive-ﯽﮐﺭﺪﻣ: 
ﻥﺪﯿﻨﺷ: ﻩﺪﺑ-ﺵﻮﮔ, ﯽﯾﺍﻮﻨﺷ, ﺱﺎﺴﺣﺍ
ﻦﯾﺮﺘﻤﮐ: ﻞﻗﺍﺪﺣ, ﻞﻗﺍﺪﺣ, ﻥﺪﻧﺎﺳﺭ-ﻞﻗﺍﺪﺣ-ﻪﺑ, ﯼﺎﻬﻨﻣ, ﺮﺘﻤﮐ
ﺪﯾﺎﺷ: ﺪﯾﺎﺷ, ﺪﯾﺎﺷ, ﻻ﻿ﺎﻤﺘﺣﺍ, ﻦﮑﻤﻣ, ﻻ﻿ﺎﻤﺘﺣﺍ, ﻦﮑﻤﻣ, ﺩﺭﺍﺩ-ﻝﺎﻤﺘﺣﺍ, ﯽﻟﺎﻤﺘﺣﺍ
ﻦﮐ-ﺯﺎﺑ: ﺢﺿﺍﻭ, ﻩﺩﺎﺳ, ﯽﻨﺷﻭﺭ-ﻪﺑ, ﺖﺨﻟ, ﺺﺨﺸﻣ-ﺭﻮﻃ-ﻪﺑ, ﯽﻟﺎﺧ, ﺢﯾﺮﺻ, ﺢﺿﺍﻭ, ﻝﺰﻨﻣ-ﺯﺍ-ﺝﺭﺎﺧ, ﺩﻮﺒﻤﮐ, ﻩﺪﯾﺮﭘ-ﮓﻧﺭ, ﻩﺩﺮﭘ-ﯽﺑ, ﻦﺘﺷﺍﺬﮔ-ﺽﺮﻌﻣ-ﺭﺩ
ﻥﺪﺑ: ﺖﺷﻮﮔ, ﯽﻧﺪﺑ, ﯽﮑﯾﺰﯿﻓ, ﯽﻤﺴﺟ-ﻅﺎﺤﻟ-ﺯﺍ, ﻢﺴﺟ, ﻮﻀﻋ, ﺪﺴﺟ
ﺍﻮﻫ: ﺩﺎﺑ, ﻢﯿﺴﻧ, ﯼﺩﺭﻮﻧﺍﻮﻫ, ﺍﻮﻫ, ﯽﯾﺎﻤﯿﭘﺍﻮﻫ
ﺖﻌﯿﺒﻃ: ﯽﻌﯿﺒﻃ, ﯽﻣﻮﺑ, ﯽﻌﯿﺒﻃ-ﺭﻮﻃ-ﻪﺑ, ﺐﺴﻧ-ﻭ-ﻞﺻﺍ, ﻝﻭﺰﻧ, ﯽﻣﻮﺑ, ﯽﺸﺣﻭ-ﺕﺎﻧﺍﻮﯿﺣ, ﺖﯿﺼﺨﺷ
ﮏﻤﮐ: ﯼﺭﺎﮑﻤﻫ, ﺪﯿﻔﻣ, ﮏﻤﮐ, ﺖﻧﻭﺎﻌﻣ, ﺭﺎﯿﺘﺳﺩ, ﯽﻧﺎﺣﻭﺭ-ﺮﯿﻏ
ﻪﻣﺎﻧ: ﻞﯿﻤﯾﺍ, ﻪﺘﺷﻮﻧ
ﺭﺎﻬﭼ: ﻡﺭﺎﻬﭼ
ﯽﯾﺎﻨﻤﺗ-ﺖﻟﺎﺣ: ﯽﻃﺮﺷ-ﻪﺟﻭ-ﺖﻟﺎﺣ
ﯼﺯﻮﺳ-ﺶﺗﺁ: ﻡﺮﮔ, ﻪﻠﻌﺷ, ﺐﺗ
ﻭﺭ-ﻦﯾﺍ-ﺯﺍ: ﻭﺭ-ﻦﯾﺍ-ﺯﺍ
ﺖﻋﺎﺳ: ﺖﻋﺎﺳ, ﺖﻋﺎﺳ, ﺱﻮﻗﺎﻧ
ﻥﺩﺮﮐ-ﺩﺍﺯﺁ: ﯼﺩﺍﺯﺁ, ﯼﺩﺍﺯﺍ, ﻑﺎﻌﻣ, ﻥﺎﮕﯾﺍﺭ, ﻩﺩﻮﻬﯿﺑ, ﻪﻧﺍﺩﺍﺯﺁ, ﯽﻟﺎﺧ, ﻪﻧﺍﺩﺍﺯﺁ, ﻥﺩﺮﮐ-ﺩﺍﺯﺁ
ﮓﻨﺟ: ﺩﺮﺒﻧ, ﻩﺯﺭﺎﺒﻣ
ﻪﭼ: ﺮﮔﺍ, ﺩﻮﺧ
ﻞﯿﻟﺩ: ﺩﻮﺷ-ﯽﻣ-ﺐﺒﺳ, ﺏﺎﺴﺣ, ﻞﻣﺎﻋ, ﯽﻘﻄﻨﻣ, ﻪﻧﺎﻬﺑ, ﻪﻨﯿﻣﺯ, ﻥﺩﺍﺩ-ﺭﺎﺸﺘﻧﺍ, ﯽﮐﺎﺷ
ﺪﺤﺘﻣ: ﺩﺮﻔﻣ, ﺕﺪﺣﻭ, ﻞﻣﺎﺷ, ﻪﯾﺩﺎﺤﺗﺍ, ﺪﺤﺘﻣ, ﺪﺤﺘﻣ, ﺩﺮﻔﺑ-ﺮﺼﺤﻨﻣ, ﻝﻮﻘﻟﺍ-ﻖﻔﺘﻣ
ﻥﺩﺯ-ﮓﻧﺯ: ﺶﻟﺎﭼ, ﻥﺩﺯ-ﮓﻧﺯ, ﺖﺳﺍﻮﺧﺭﺩ, ﺮﺑ, ﻝﺎﺼﺗﺍ, ﺐﯿﮐﺮﺗ, ﮎﺮﺘﺸﻣ, ﻡﺎﻏﺩﺍ, ﻪﻣﺎﻧ-ﺕﻮﻋﺩ
ﯽﭼ-ﻪﺳﺍﻭ: 
ﻩﺪﺷ-ﻢﮐ: ﻥﺎﯾﺯ, ﻢﮔ
ﺭﺍﺰﻫ: ﻡﺭﺍﺰﻫ
ﻩﺩﺍﻮﻧﺎﺧ: ﻝﺰﻨﻣ-ﻡﺯﺍﻮﻟ, ﻩﺪﻧﺎﻣﺯﺎﺑ
ﺡﻭﺭ: ﺡﻭﺭ, ﺡﻭﺭ, ﺮﮑﻔﺘﻣ-ﺰﻐﻣ
ﻝﺍﻮﺳ: ﻪﻟﺎﺴﻣ, ﺎﺿﺎﻘﺗ, ﺖﺋﺍﺮﻗ, ﻩﺩﺎﻣ
ﻥﺩﺍﺩ-ﺖﻴﻤﻫﺍ: ﻥﺍﺮﮕﻧ, ﻪﻗﻼ﻿ﻋ, ﻪﺟﻮﺗ, ﻪﺒﻗﺍﺮﻣ, ﯽﻧﺎﺳﺭ-ﺖﻣﺪﺧ, ﺖﯾﺎﻤﺣ, ﻥﺩﺮﮐ-ﺖﻈﻓﺎﺤﻣ, ﯽﻨﻤﯾﺍ, ﺖﻇﺎﻔﺣ, ﺖﯿﻨﻣﺍ, ﻆﻔﺣ, ﺖﻇﺎﻔﺣ, ﺶﺷﻮﭘ, ﻉﺎﻓﺩ, ﻁﺎﯿﺘﺣﺍ, ﻥﺎﻣﺭﺩ, ﻥﺎﻣﺭﺩ, ﻒﯿﻗﻮﺗ
REALIS-ﺖﻟﺎﺣ: 
ﻦﺘﺷﺍﺩ-ﺭﻮﻈﻨﻣ: ﺪﻨﻧﺎﺳﺮﯿﻣ-ﺍﺭ-ﻡﻮﻬﻔﻣ ﻦﯾﺍ, ﺲﺣ, ﯽﻨﻌﻣ, ﺭﺍﺩ-ﺎﻨﻌﻣ, ﻥﺩﺮﮐ-ﯽﻨﻌﻣ, ﻂﺳﻮﺘﻣ, ﻞﻣﺎﻋ, ﻂﺳﻮﺘﻣ, ﻂﺳﻮﺘﻣ, ﻂﺳﻮﺘﻣ-ﺪﺣ-ﺭﺩ
ﻩﻮﻘﻟﺎﺑ-ﺖﻟﺎﺣ: 
ﯼﻮﺳ-ﻪﺑ: ﻪﺑ-ﺖﺒﺴﻧ, ﺮﺑﺍﺮﺑ-ﺭﺩ, ﻒﻟﺎﺨﻣ, ﻒﻟﺎﺨﻣ, ﺮﻫ-ﺭﺩ, ﻡﺍﺮﺘﺣﺍ, ﯼﺍﺮﺑ
allative-ﺩﺭﻮﻣ: 
ﮏﯿﭘﻭﺮﺘﻧﺁ-ﺲﻨﺟ: 
ﻩﺎﺗﻮﮐ-ﺪﻗ: ﺮﺘﻤﮐ, ﻢﮐ, ﺮﺼﺘﺨﻣ, ﯽﻫﺎﺗﻮﮐ-ﺕﺪﻣ, ﻪﺻﻼ﻿ﺧ-ﺕﺭﻮﺻ-ﻪﺑ, ﺕﺭﺎﮐ, ﮏﯾﺭﺎﺑ, ﮎﺪﻧﺍ
ﺭﺩﺎﻗ: ﻥﺍﻮﺗ-ﯽﻣ, ﻂﯾﺍﺮﺷ-ﺪﺟﺍﻭ, ﻂﯾﺍﺮﺷ-ﺪﺟﺍﻭ, ﻪﺑ-ﺭﺩﺎﻗ, ﺖﯿﻓﺮﻇ, ﯽﯾﺎﻧﺍﻮﺗ, ﻥﺍﻮﺗﺎﻧ, ﻪﺘﺴﯾﺎﺷ, ﻩﻮﻘﻟﺎﺑ, ﯼﺮﯾﺬﭘ-ﻥﺎﮑﻣﺍ, ﻝﺎﻤﺘﺣﺍ, ﯼﻮﻗ, ﺪﻨﻤﺗﺭﺪﻗ, ﺮﻫﺎﻣ, ﺖﺳﺍ-ﻦﮑﻤﻣ
ﻩﺪﻧﺯ: ﯽﮔﺪﻧﺯ, ﻥﺪﻧﺎﻣ-ﻩﺪﻧﺯ, ﻥﺩﺮﻛ-ﺭﺎﺘﻓﺭ, ﻥﺩﺮﻛ-ﻲﮔﺪﻧﺯ, ﻪﻧﻻ﻿, ﻪﯿﺣﺎﻧ, ﯽﮕﯾﺎﺴﻤﻫ, ﯽﮕﯾﺎﺴﻤﻫ, ﻩﺪﻧﺯ, ﻩﺪﻧﺯ, ﻡﺎﺧ, ﻦﺘﺷﺍﺩ-ﺖﻣﺎﻗﺍ
ﻉﻮﺿﻮﻣ: ﻁﺎﺒﻀﻧﺍ, ﻉﻮﺿﻮﻣ, ﻉﻮﺿﻮﻣ, ﺱﺭﺩ, ﻩﺩﺎﻣ, ﻪﻟﺎﺴﻣ, ءﯽﺷ, ﯽﻨﻌﻣ, ﻩﺩﺎﻣ, ﯽﯾﺎﻨﻌﻣ, ﻩﺩﺎﻣ, ﺮﻣﺍ, ﻥﺍﻮﻨﻋ
ﻥﺎﺴﮑﯾ-ﻉﻮﺿﻮﻣ-ﺮﮕﻧﺎﺸﻧ: 
ﻒﻠﺘﺨﻣ-ﻉﻮﺿﻮﻣ: 
ﻩﺪﺑ-ﺏﺍﻮﺟ: ﻝﺎﻤﺷ, ﺦﺳﺎﭘ, ﺦﺳﺎﭘ, ﻞﺣ-ﻩﺍﺭ, ﻥﺩﻮﺑ-ﻖﺑﺎﻄﻣ, ﺦﺳﺎﭘ
ﺎﯾﺭﺩ: ﺱﻮﻧﺎﯿﻗﺍ, ﯽﯾﺎﯾﺭﺩ
ﺱﺮﺗ: ﺖﺸﺣﻭ, ﻩﺪﯿﺳﺮﺗ, ﺖﺸﺣﻭ, ﺖﺒﯿﻫ, ﻩﺪﯿﺳﺮﺗ, ﺖﺸﺣﻭ, ﺏﺍﺮﻄﺿﺍ, ﯽﻧﺍﺮﮕﻧ-ﻭ-ﺖﺸﺣﻭ ﺱﺎﺴﺣﺍ, ﺖﺸﺣﻭ, ﻥﺪﻧﺎﺳﺮﺗ
ﻦﮐ-ﮎﺭﺩ: ﻥﺩﺮﻛ-ﻙﺭﺩ, ﺐﻠﻄﻣ-ﮎﺭﺩ, ﮎﺭﺩ, ﻢﻬﻓ, ﺭﻮﺼﺗ, ﻡﻮﻬﻔﻣﺎﻧ, ﻞﻣﺎﺷ, ﻥﺪﯿﻤﻬﻓ
ﺖﺨﺳ: ﺭﺍﻮﺷﺩ, ﺖﻔﺳ, ﺞﻧﺮﻐﺑ, ﻦﺸﺧ, ﺪﻨﻠﺑ-ﯼﺍﺪﺻ-ﺎﺑ, ﺖﻧﻮﺸﺧ, ﻩﺪﻧﺭﺩ, ﺖﺨﺳ, ﺖﺨﺳ, ﺰﯿﮕﻧﺍﺮﺑ-ﺶﻟﺎﭼ, ﺮﯾﻭﺰﺗ-ﻭ-ﻪﻠﯿﺣ ﯼﻭﺭ, ﻦﯿﮕﻨﺳ, ﺮﺒﻗ, ﺪﯾﺪﺷ, ﺏﺮﻄﻀﻣ
ﺕﺎﺣﻼ﻿ﻄﺻﺍ: ﺕﺪﻣ, ﻥﺎﮔﮊﺍﻭ, ﻪﻟﺎﺴﻣ, ﺮﻘﺘﺴﻣ, ﻪﻨﯿﻣﺯ, ﺱﺎﺳﺍ, ﺎﺳﺎﺳﺍ, ﺎﺳﺎﺳﺍ, ﺎﺳﺎﺳﺍ
ﻥﺩﺮﻛ-ﻚﺷ: ﻦﻇ-ءﻮﺳ, ﯼﺩﺎﻤﺘﻋﺍ-ﯽﺑ, ﻥﻮﻨﻈﻣ
dubitative-ﺖﻟﺎﺣ: 
ﻥﺪﯿﺳﺮﭘ: ﻥﺩﺮﮐ-ﺎﻋﺩ, ﺯﺎﯿﻧ, ﻩﺪﺑ-ﺵﻮﮔ, ﻢﻨﻛ-ﻰﻣ-ﺶﻫﺍﻮﺧ
ﺡﻼ﻿ﺳ: ﺡﻼ﻿ﺳ, ﻥﺩﺮﮐ-ﺡﻼ﻿ﺳ-ﻊﻠﺧ, ﺢﻠﺴﻣ, ﻭﺯﺎﺑ
ﻩﺎﯿﺳ: 
ﺍﺭ: ﯽﺸﮐﺍﻭ, ﻞﻤﺣ, ﺍﺭ, ﯼﺮﺒﻫﺭ
ﻞﮕﺷﻮﺧ: ﺏﻮﺧ, ﺏﻮﺧ, ﻲﻨﺘﺷﺍﺩ-ﺖﺳﻭﺩ, ﯽﯾﺎﺒﯾﺯ, ﻪﻧﺎﻔﯾﺮﻇ, ﺭﺎﯿﺴﺑ, ﯽﻨﻨﻔﺗ, ﮏﻨﺧ, ﺏﺍﺬﺟ
ﮏﯾﺭﺎﺗ: ﯽﮕﻨﺗ-ﻝﺩ
ﻦﺘﺷﺍﺩ-ﻪﮕﻧ: ﻦﺘﺷﺍﺩ-ﻩﺎﮕﻧ, ﻦﺘﺷﺍﺩ-ﻪﮕﻧ, ﻦﺘﻓﺮﮔ, ﮓﻨﭼ, ﯼﺭﺎﮐ-ﺩﺍﺩﺭﺍﺮﻗ, ﻦﺘﻓﺮﮔ-ﻪﺠﯿﺘﻧ, ﻩﺮﮔ, ﻪﻫﺩ, ﻦﺘﺷﺍﺩ-ﻪﮕﻧ, ﻦﻛ-ﺮﺒﺻ, ﺪﻨﻧﺎﻣ, ﻆﻔﺣ
ﻩﺩ: ﻪﻫﺩ, ﻢﻫﺩ, ﻪﻧﻻ﻿ﺩﺎﻋ
ﺶﯾﺎﻤﻧ: ﻥﺩﺍﺩ-ﺶﯾﺎﻤﻧ, ﻥﺩﺍﺩ-ﻡﺎﺠﻧﺍ, ﺩﺮﮑﻠﻤﻋ, ﺕﺍﺮﻫﺎﻈﺗ, ﻪﺋﺍﺭﺍ, ﻥﺩﺍﺩ-ﻥﺎﺸﻧ, ﻥﺩﺮﮐ-ﯽﻨﻌﻣ, ﻪﻌﻗﺍﻭ, ﺡﺮﻃ
ﻥﺎﺘﺳﺍﺩ: ﻩﺭﻮﻄﺳﺍ, ﺦﯾﺭﺎﺗ, ﻥﺎﺘﺳﺍﺩ, ﺡﺮﻃ
ﺞﯾﺍﺭ: ﯽﻣﻮﻤﻋ, ﻝﻮﻤﻌﻣ, ﻝﺍﻭﺭ, ﻻ﻿ﻮﻤﻌﻣ, ﯽﻟﻮﻤﻌﻣ, ﻝﻮﻤﻌﻣ-ﺮﯿﻏ, ﺎﻣﻮﻤﻋ, ﻦﺗﻭﺮﻓ, ﯽﻌﯿﺒﻃ, ﻪﯾﻭﺭ-ﯽﺑ, ﯽﻟﻮﻤﻌﻣ, ﯽﻟﻮﻤﻌﻣ, ﻝﻮﻤﻌﻣ-ﺭﻮﻃ-ﻪﺑ, ﻻ﻿ﻮﻤﻌﻣ, ﮎﺮﺘﺸﻣ, ﮏﯾﺮﺷ, ﻪﺘﺴﺑﺍﻭ, ﻉﻮﻤﺠﻣ, ﯽﻠﮐ-ﺭﻮﻃ-ﻪﺑ, ﻞﺑﺎﻘﺘﻣ, ﮒﺭﺰﺑ-ﯼﺎﻫ-ﺖﮐﺮﺷ
ﺏﺎﺘﮐ: ﺭﺎﻣﻮﻃ, ﻩﺮﯿﺧﺫ, ﺪﻧﻮﭘ, ﯽﺳﺭﺩ-ﺏﺎﺘﮐ
ﮏﯿﻧﻭﺮﺘﮑﻟﺍ: ﮏﯿﻧﻭﺮﺘﮑﻟﺍ, ﻥﻭﺮﺘﮑﻟﺍ, ﻕﺮﺑ, ﯽﻗﺮﺑ, ﻕﺮﺑ, ﯽﮑﯾﺮﺘﮑﻟﺍ
ﺪﯿﻨﮐ-ﺖﺒﺤﺻ: ﻮﮕﺘﻔﮔ, ﻥﺩﺯ-ﭗﮔ, ﻩﺮﮐﺍﺬﻣ, ﻞﺑﺎﻘﺘﻣ-ﺮﺛﺍ, ﻞﻣﺎﻌﺗ, ﻩﺮﮐﺍﺬﻣ, ﻦﺘﻔﮔ-ﻦﺨﺳ, ﯽﻧﺍﺮﻨﺨﺳ, ﯼﺭﺎﺘﻔﮔ, ﻦﺨﺳ
ﺖﻣﻼ﻿ﻋ: ﺮﮕﻧﺎﺸﻧ, ﺩﺭ, ﻪﻟﺎﺒﻧﺩ, ﻩﺮﻤﻧ, ﻪﺘﺴﺟﺮﺑ, ﮏﯿﺗ, ﻥﺩﺮﮐ-ﺎﻀﻣﺍ, ﻝﺎﻨﮕﯿﺳ, ﻪﻧﺎﺸﻧ, ﻒﺻ, ﮎﺭﺎﻣ, ﺖﯿﺼﺨﺷ, ﺐﺴﭼﺮﺑ
ﻪﻗﻼ﻿ﻋ: ﻞﮔ, ﺪﻨﻣ-ﻪﻗﻼ﻿ﻋ, ﻪﻗﻼ﻿ﻋ
ﻦﺘﺷﻮﻧ: ﻥﺩﻭﺮﺳ, ﻪﺘﺷﻮﻧ, ﻉﻮﻧ, ﺖﺳﺍ-ﻩﺪﺷ-ﻪﺘﺷﻮﻧ
ﺮﺘﺴﺑ: 
ﻡﺯﻻ﻿: ﯼﺭﻭﺮﺿ, ﺖﯿﻤﻫﺍ-ﺎﺑ, ﺪﯿﻔﻣ, ﯽﻧﺍﺮﺤﺑ, ﯽﺗﺎﯿﺣ, ﻪﺟﻮﺗ-ﻞﺑﺎﻗ, ﺖﯿﻤﻫﺍ-ﯽﺑ, ﻝﺍﺮﮕﺘﻧﺍ, ﯽﺗﺎﯿﺣ, ﺮﺘﻤﻬﻣ, ﻦﺘﺷﺍﺩ-ﻡﺯﻻ﻿, ﺎﻣﻭﺰﻟ, ﻡﺯﻻ﻿, ﻡﺯﻻ﻿, ﻡﺯﻻ﻿
ﻪﺸﯾﺪﻧﺍ: ﺮﮑﻓ, ﻪﺟﻮﺗ, ﻝﻻ﻿ﺪﺘﺳﺍ, ﺮﻈﻧ, ﻡﻮﻬﻔﻣ, ﯽﻧﺎﻬﮔﺎﻧﻭ-ﺮﮑﺑ-ﺮﮑﻓ
ﺮﻨﻫ: ﺕﺭﺎﻬﻣ, ﻪﻧﺍﺪﻨﻣﺮﻨﻫ
Vialis-ﺎﻫ-ﺩﺭﻮﻣ: 
ﺭﺩﺍﺮﺑ: ﺭﺩﺍﺮﺑ-ﻭ-ﺮﻫﺍﻮﺧ, ﺮﻫﺍﻮﺧ
ﺎﻬﺘﻗﻭ-ﯽﻀﻌﺑ: ﺕﺭﺪﻨﺑ, ﻩﺎﮕﯿﺑ-ﻭ-ﻩﺎﮔ, ﺖﻗﻭ-ﺪﻨﭼ
ﻂﺧ: ﻢﯿﺳ, ﺦﻧ, ﻒﯾﺩﺭ, ﻪﭼﻮﮐ, ﻝﺎﻘﺘﻧﺍ, ﻩﺮﯿﺗ-ﻂﺧ, ﻩﺍﺭ-ﻩﺍﺭ-ﻪﭼﺭﺎﭘ, ﺕﺎﯿﻟﺎﻣ, ﻂﺧ
ﺰﯿﻣ: ﻪﻌﻟﺎﻄﻣ-ﺰﯿﻣ, ﻪﻣﺎﻧﺮﺑ, ﺖﺳﺮﻬﻓ
ﻪﻧﺎﺧﺩﻭﺭ: ﺶﻟﺎﺑ, ﻦﺳﻮﮐ, ﺭﺎﺷ
ﻢﺸﭼ: ﻦﯿﯿﻌﺗ, ﻑﺍﺮﻃﺍ-ﺭﺩ
ﺕﺎﻋﻼ﻿ﻃﺍ: ﻡﺎﯿﭘ, ﺢﯿﺿﻮﺗ, ﺕﺎﺤﯿﺿﻮﺗ, ﻪﻣﺎﻨﺸﻫﻭﮋﭘ, ﺶﻧﺍﺩ, ﺎﻫ-ﻩﺩﺍﺩ
ﻩﺭﺎﺒﮑﯾ-ﻪﺑ: ﻩﺮﻈﺘﻨﻣ-ﺮﻴﻏ
ﺐﻳﺮﻏ-ﻭ-ﺐﻴﺠﻋ: ﺐﯿﺠﻋ, ﻩﺪﻨﻨﮐ-ﺮﯿﮕﻠﻓﺎﻏ, ﺐﯿﺠﻋ, ﺩﺮﻓ, ﺐﺠﻌﺗ, ﺰﯿﮕﻧﺍ-ﺖﻔﮕﺷ, ﻪﺟﻮﺗ-ﺐﻟﺎﺟ, ﻩﺩﺎﻌﻟﺍ-ﻕﺭﺎﺧ, ﯽﻧﺩﺮﮑﻧ-ﺭﻭﺎﺑ, ﺭﻭﺁ-ﺖﻔﮕﺷ, ﺐﯿﺠﻋ-ﻭ-ﺐﯾﺮﻏ, ﺭﺍﺩ-ﻩﺪﻨﺧ, ﻪﻧﺎﮕﯿﺑ, ﺐﯾﺮﻏ-ﻭ-ﺐﯿﺠﻋ, ﺎﭘ-ﻭ-ﺖﺳﺩ ﯽﺑ
ﻖﯿﻤﻋ: ﺎﻘﯿﻤﻋ, ﻖﻤﻋ, ﻊﯿﺳﻭ, ﻖﻤﻋ-ﻢﮐ, ﻞﻣﺎﮐ, ﻖﯿﻗﺩ, ﻊﻣﺎﺟ, ﻪﻧﺍﺪﻘﺘﻨﻣ, ﻖﯿﻤﻋ, ﺩﻭﺪﺣ-ﺭﺩ-،ﻞﺧﺍﺩ ﺭﺩ, ﻞﺧﺍﺩ, ﯽﻠﺧﺍﺩ, ﻡﺮﮐ
ﻥﺩﺍﺩ-ﺮﯿﯿﻐﺗ: ﺡﻼ﻿ﺻﺍ, ﺮﯿﯿﻐﺗ, ﯽﻧﻮﮔﺮﮔﺩ, ﻞﯾﺪﺒﺗ, ﺶﻬﺟ, ﺮﯿﯿﻐﺗ, ﻥﺩﺍﺩ-ﺮﯿﯿﻐﺗ, ﺡﻼ﻿ﺻﺍ, ﻝﺎﻘﺘﻧﺍ, ﺡﻼ﻿ﺻﺍ, ﯽﻨﯾﺰﮕﯾﺎﺟ
ﺱﺎﺴﺣﺍ: ﺱﺎﺴﺣﺍ, ﺱﺎﺴﺣﺍ, ﮎﺍﺭﺩﺍ, ﺱﺎﺴﺣﺍ, ﯽﻧﺎﺠﯿﻫ, ﺖﻟﺎﺣ, ﺭﺍﺮﻗ-ﺮﯿﺛﺎﺗ-ﺖﺤﺗ, ﯽﻔﻃﺎﻋ, ﯽﺴﺣ, ﺱﺎﺴﺣﺍ, ﺲﺣ, ﺭﻮﺷ, ﻪﻧﺎﻫﺎﮔﺁ, ﯼﺭﺎﯿﺷﻮﻫ
ﺕﺎﻗﻼ﻿ﻣ: ﻦﺘﻓﺮﮔ, ﺍﺮﮕﻤﻫ, ﺩﺭﻮﺧﺮﺑ, ﻖﺑﺎﻄﻣ, ﻥﺩﺮﮐ-ﻊﻧﺎﻗ, ﯼﺭﺎﮐ-ﻪﺴﻠﺟ
ﻑﺪﻫ: ءﯽﺷ, ﻦﺘﻓﺮﮔ-ﻪﻧﺎﺸﻧ, ﻑﺪﻫ, ﻑﺪﻫ, ﺪﺼﻘﻣ, ﺪﺼﻗ, ﻩﺪﺷ-ﻪﺘﻓﺮﮔ-ﺮﻈﻧ ﺭﺩ, ﻩﺰﯿﮕﻧﺍ, ﻑﺪﻫ
ﻝﺎﺤﺷﻮﺧ: ﺵﻮﺧ, ﻝﺎﺤﺷﻮﺧ, ﺕﺬﻟ, ﻝﺎﺤﺷﻮﺧ, ﺕﺬﻟ, ﯼﺩﺎﺷ, ﺕﺬﻟ, ﻝﺎﺤﺷﻮﺧ, ﯽﻣﺮﮔﺮﺳ, ﯽﻟﺎﺤﺷﻮﺧ-ﺎﺑ, ﺲﻧﺎﺷ-ﺵﻮﺧ, ﻝﺎﺤﺷﻮﺧ
ﺪﺳﺭ-ﯽﻣ-ﺮﻈﻧ ﻪﺑ: ﯼﺮﻫﺎﻇ-ﻞﮑﺷ, ﺪﺳﺭ-ﯽﻣ-ﺮﻈﻧ ﻪﺑ, ﺍﺮﻫﺎﻇ
ﻥﻮﺧ: ﻦﺘﻓﺮﮔ-ﻥﻮﺧ, ﯽﯾﺎﻨﺟ
ﺥﺮﺳ-ﻞﮔ: ﯽﺗﺭﻮﺻ-ﮓﻧﺭ
ﺏﻮﻨﺟ: ﯽﺑﻮﻨﺟ, ﺮﻬﻇ, ﺮﻬﻇ
ﺩﺮﺳ: ﻥﺎﺘﺴﻣﺯ, ﮏﻨﺧ, ﺩﺮﺳ-ﺭﻮﻄﺑ
ﻮﻠﺟ-ﻪﺑ: ﺮﺘﺸﯿﺑ, ﺮﺗﺭﻭﺩ, ﺶﯿﭘ-ﺭﺩ, ﻩﺮﻈﻨﻣ, ﻮﻠﺟ, ﻪﺘﻓﺮﺸﯿﭘ, ﺶﯿﭘ, ﺵﺎﻔﺧ, ﯼﻭﺭ-ﺮﺑ, ﺪﻌﺑ
ﺖﯿﻌﻗﻮﻣ: ﻞﺤﻣ, ﺖﯿﻌﺿﻭ, ﺖﯿﻌﺿﻭ, ﺲﻧﺎﺷ, ﺖﺻﺮﻓ, ﺎﻀﻓ, ﺖﻟﺎﺣ, ﺖﻟﺎﺣ, ﻥﺩﺍﺩ-ﯼﺎﺟ, ﺖﺴﭘ, ﺩﺭﻮﻣ
ﺮﯾﺩ: ﯽﻣﺍﺭﺁ-ﻪﺑ, ﻥﺎﯾﺎﭘ
ﻥﺩﺎﺘﺴﯾﺍ: ﻩﺎﮕﺘﺴﯾﺍ, ﯼﺩﻮﻤﻋ, ﺵﺮﮕﻧ, ﺖﻟﺎﺣ, ﻥﺩﺮﮐ-ﻒﻗﻮﺘﻣ, ﺖﻟﺎﺣ, ﺖﻟﺎﺣ, ﻪﻓﺮﻏ
ﺪﯿﻨﮐ-ﺽﺮﻓ: ﺽﺮﻓ, ﻪﯿﺿﺮﻓ, ﻢﯿﻨﮐ-ﺽﺮﻓ, ﺫﺎﺨﺗﺍ, ﺽﺮﻓ, ﻥﺩﺮﮐ-ﺽﺮﻓ, ﺪﻫﺩ-ﯽﻣ-ﺩﺎﻬﻨﺸﯿﭘ
ﺮﺘﺧﺩ-ﺪﻧﺯﺮﻓ: ﺮﺘﺧﺩ, ﻩﺮﮐﺎﺑ
ﻡﺩﻮﺧ-ﻝﺎﻣ: ﻦﻣ
ﺵﺮﺑ: ﻡﺪﻋ, ﺪﻗﺎﻓ, ﺶﻫﺎﮐ, ﺩﻮﺒﻤﮐ, ﻥﺩﺮﮐ-ﻝﻭﺰﻧ, ﺩﻮﺒﻤﮐ, ﻥﺩﺍﺩ-ﺖﺳﺩ-ﺯﺍ, ﻥﺩﺍﺩ-ﺵﺮﺑ, ﻥﺩﺮﮐ-ﻊﻄﻗ, ﻥﺩﺮﮐ-ﻪﮑﺗ, ﻥﺩﺮﮐ-ﻩﺪﯾﺮﺑ-ﻩﺪﯾﺮﺑ, ﻝﻮﺼﺤﻣ, ﺰﯿﻤﺗ-ﻭ-ﺮﺗ, ﻪﺘﺴﮑﺷ, ﺾﻘﻧ
ﻪﺨﺴﻧ: ﺮﯿﺜﮑﺗ, ﯼﺯﺎﺳ-ﺪﻨﻧﺎﻤﻫ, ﺭﺍﺮﮑﺗ, ﯽﺴﯾﻮﻧﻭﺭ, ﯽﭙﮐﻮﺘﻓ, ﻥﻮﻠﮐ, ﻪﺨﺴﻧ, ﻪﺨﺴﻧ
ﺮﻫﻮﺷ: ﻥﺎﺴﻧﺍ, ﺮﺴﻤﻫ
ﺶﺷ: ﯽﺴﻨﺟ-ﻁﺎﺒﺗﺭﺍ
ﻥﺩﺭﻭﺁ-ﺩﺎﻳ-ﻪﺑ: ﺪﯿﺷﺎﺑ-ﻪﺘﺷﺍﺩ-ﻪﺟﻮﺗ, ﻥﺍﻮﺧﺍﺮﻓ, ﯼﺭﻭﺁﺩﺎﯾ, ﻥﺩﺮﮐ-ﻆﻔﺣ
ﺮﺛﺍ: ﺮﯿﺛﺎﺗ, ﺩﺭﺍﺬﮔ-ﯽﻣ-ﺮﯿﺛﺎﺗ, ﺱﺎﺴﺣﺍ, ﺮﯿﺛﺄﺗ, ﻂﻠﺴﺗ, ﺪﻣﺁﺭﺎﮐ, ﺮﺛﻮﻣ-ﺭﻮﻃ-ﻪﺑ, ﯽﺸﺨﺑﺮﺛﺍ, ﻪﺠﯿﺘﻧ, ﻪﺠﯿﺘﻧ, ﻪﺋﺍﺭﺍ
ﻁﻮﻘﺳ: ﺰﻴﻳﺎﭘ-ﻞﺼﻓ, ﺩﺭﻮﻣ, ﻊﻗﺍﻭ, ﻁﻮﻘﺳ, ﻥﺩﺮﮐ-ﺰﯿﺧ-ﻭ ﺖﺴﺟ, ﻦﺘﺴﮑﺷ-ﻢﻫﺭﺩ, ﻁﻮﻘﺳ, ﻥﺩﺮﮐ-ﺎﻫﺭ, ﺶﻫﺎﮐ, ﻥﺩﺮﮐ-ﻝﻭﺰﻧ
ﺰﺠﺑ: ﻪﮑﻨﯾﺍ-ﺮﮕﻣ, ﺯﺍ-ﺝﺭﺎﺧ, ﺯﺍ-ﺝﺭﺎﺧ, ﺯﺍ-،-ﺍﺪﺟ ﻢﻫ ﺯﺍ, ﺍﺪﺟ, ﯼﺎﻨﺜﺘﺳﺍ-ﻪﺑ, ﺭﺎﻨﻛ-ﺭﺩ, ﺯﺍ-ﻪﺘﺷﺬﮔ, ﺯﺍ-ﯼﺍﺪﺟ
ﻮﻣ: 
ﻥﺩﺮﮐ-ﯽﻃ: ﻂﺳﻮﺗ, ﻖﯾﺮﻃ-ﺯﺍ, ﺭﻮﺒﻋ, ﻖﻳﺮﻃ-ﺯﺍ, ﮏﯾﺩﺰﻧ, ﺭﺎﻨﻛ-ﺭﺩ, ﻞﻣﺎﺷ, ﻞﯿﺼﺤﺘﻟﺍ-ﻍﺭﺎﻓ, ﮓﻧﺯ, ﺐﯿﻠﺻ, ﺭﻮﺒﻋ, ﻪﻣﺍﺩﺍ
ﺖﯾﺍﺭ-ﯽﭙﮐ: 
ﺶﺗﺭﺍ: ﯼﺎﻫﻭﺮﯿﻧ, ﯽﻣﺎﻈﻧ-ﯼﺎﻫﻭﺮﯿﻧ, ﻥﺎﺑﺰﯿﻣ, ﺯﺎﺑﺮﺳ
ﻥﺪﯾﻭﺩ: ﻦﺘﺨﯾﺮﮔ, ﯽﺸﮐ-ﻩﺯ, ﺍﺮﺟﺍ-ﻝﺎﺣ-ﺭﺩ, ﻥﺩﺮﮐ-ﺍﺮﺟﺍ, ﻞﻤﻋ, ﻮﯾﺍﺭﺩ, ﻩﺪﻧﻭﺩ, ﻩﺪﻧﺩ
ﺐﺳﺍ: ﺐﺳﺍ-ﻞﻌﻧ, ﺭﺩ
ﻩﺪﻨﯾﺁ: ﻩﺪﻨﯾﺁ, ﺪﻌﺑ, ﻥﺁ-ﺯﺍ-ﺪﻌﺑ, ﻥﺁ-ﺯﺍ-ﺪﻌﺑ
ﺏﺮﻏ: ﯽﺑﺮﻏ
ﺖﺧﺍﺩﺮﭘ: ﺩﺰﻣ, ﻪﻤﺣﺰﻟﺍ-ﻖﺣ, ﻕﻮﻘﺣ, ﺭﺎﺸﻓ, ﺖﺧﺍﺩﺮﭘ, ﻥﺩﺍﺩ-ﻥﺍﻭﺎﺗ, ﺖﺧﺍﺩﺮﭘ, ﻪﻨﯾﺰﻫ
ﺰﻣﺮﻗ: 
ﻼ﻿ﻃ: 
ﻦﺘﺷﺍﺩ-ﻞﻳﺎﻤﺗ: ﻩﺩﺍﺭﺍ, ﻕﺎﯿﺘﺷﺍ-ﺎﺑ, ﺎﻬﺘﺷﺍ, ﻥﺩﺮﮐ-ﻭﺯﺭﺁ, ﻦﺘﺷﺍﺩ-ﻕﺎﯿﺘﺷﺍ, ﻢﯿﻫﺍﻮﺧ-ﯽﻣ
ﯼﺯﺎﺑ: ﺺﻗﺭ, ﺭﺎﻤﻗ, ﯼﺯﺎﺑ, ﻪﻧﻮﮔ, ﯼﺯﺎﺑ-ﺏﺎﺒﺳﺍ
ﺩﺎﺘﺳﺍ: ﺪﻧﻭﺍﺪﺧ, ﯽﻠﺻﺍ, ﯽﻠﺻﺍ, ﺩﺎﺘﺳﺍ, ﻦﺘﺷﺍﺩ-ﻂﻠﺴﺗ, ﻥﺩﺮﮐ-ﺖﻣﻮﮑﺣ, ﯼﺎﻗﺁ, ﺎﻗﺁ, ﻥﺪﺷ-ﯽﻬﺘﻨﻣ, ﺎﻗﺁ
ﯼﺭﺍﺩﺍ-ﺮﺘﻓﺩ: ﯽﮔﺪﻨﯾﺎﻤﻧ, ﻪﻌﻟﺎﻄﻣ-ﺰﯿﻣ
ﺖﻟﻭﺩ: ﻥﺩﺍﺩ-ﺡﺮﺷ-ءﺰﺟ ﻪﺑ ءﺰﺟ, ﻒﯾﺩﺭ
ﺎﺴﯿﻠﮐ: 
ﻝﻮﻃ: ﻉﺎﻔﺗﺭﺍ, ﻉﺎﻔﺗﺭﺍ, ﻝﻮﻃ, ﻩﺍﺮﻤﻫ, ﻥﺎﻣﺯ-ﺕﺪﻣ
ﺖﮐﺮﺷ: ﺖﮐﺮﺷ, ﺖﮐﺮﺷ, ﻪﻌﻣﺎﺟ, ﺕﺭﺎﺠﺗ, ﮒﺭﺰﺑ-ﯼﺎﻫ-ﺖﮐﺮﺷ, ﺩﻮﺟﻭ, ﻪﺴﺳﻮﻣ, ﯽﮔﺪﻨﯾﺎﻤﻧ, ﻪﺴﺳﻮﻣ, ﯼﺭﺍﺬﮔ-ﻪﯾﺎﻣﺮﺳ
ﺬﻏﺎﮐ: ﻕﺭﻭ, ﺕﺭﺎﮐ, ﺭﻮﺸﻨﻣ
ﻝﺎﻤﺘﺣﺍ: ﯼﺮﯾﺬﭘ-ﻥﺎﮑﻣﺍ, ﻝﺎﻤﺘﺣﺍ, ﺩﺭﺍﺩ-ﻝﺎﻤﺘﺣﺍ, ﻻ﻿ﺎﻤﺘﺣﺍ, ﺪﯿﻌﺑ, ﺯﺍﺪﻧﺍ-ﻢﺸﭼ, ﺲﻧﺎﺷ
ﺹﻮﺼﺨﺑ: ﻩﮋﯾﻭ, ﻩﮋﻳﻭ-ﻪﺑ, ﺹﺎﺧ-ﺭﻮﻃ-ﻪﺑ, ﺹﻮﺼﺧ-ﻪﺑ, ﺹﺎﺧ, ﻼ﻿ﻣﺎﮐ, ﻩﺪﻤﻋ-ﺭﻮﻃ-ﻪﺑ, ﺐﻠﻏﺍ, ﻝﻭﺍ-ﻪﺟﺭﺩ-ﺭﺩ, ﺹﺎﺧ
ﻞﻤﺤﺗ: ﻞﻤﺣ, ﻞﻤﺤﺗ, ﺮﺑﺍﺮﺑ-ﺭﺩ-ﺖﻣﻭﺎﻘﻣ, ﻞﻤﺤﺗ, ﻞﻤﺤﺗ, ﺪﻧﺭﺍﺩ, ﯼﺍﺭﺍﺩ, ﻦﺘﺷﺍﺩ-ﺖﻋﺎﻄﺘﺳﺍ
ﻩﺮﺠﻨﭘ: 
ﯼﺭﺎﮑﻤﻫ-ﺩﺍﺩﺭﺍﺮﻗ: ﻞﮑﺗﻭﺮﭘ, ﻥﺎﮑﺳﺍ, ﺵﺯﺎﺳ, ﻉﺎﻤﺟﺍ, ﻩﺪﻫﺎﻌﻣ, ﻥﺩﺮﮐ-ﻝﻮﺒﻗ, ﻪﻣﺎﻧ-ﻢﻫﺎﻔﺗ, ﻖﻓﺍﻮﺗ, ﻪﺼﻗﺎﻨﻣ, ﺮﺗﻭ, ﯼﺭﺎﮐ-ﺩﺍﺩﺭﺍﺮﻗ, ﺩﺍﺩﺭﺍﺮﻗ, ﺐﯿﺗﺮﺗ
ﯽﯾﺎﺒﯾﺯ: ﯽﯾﺎﺒﯾﺯ, ﯽﮔﺪﻨﺸﺧﺭﺩ, ﯽﯾﺎﺒﯾﺯ
ﻪﻔﯿﻇﻭ: ﯽﻫﺪﺑ, ﺖﯿﻟﻮﺌﺴﻣ-ﺱﺎﺴﺣﺍ, ﺪﻬﻌﺗ, ﻝﻮﺌﺴﻣ, ﮎﺮﻤﮔ, ﻪﻔﯿﻇﻭ, ﯼﺭﺍﺬﮔﺍﻭ, ﯽﻫﺪﺑ, ﻥﺩﻮﺑ-ﺭﺎﮑﻫﺪﺑ, ﺪﯾﺎﺑ
ﻝﺎﺳﺭﺍ: ﻝﺎﻘﺘﻧﺍ, ﻝﺎﺳﺭﺍ, ﺖﺴﭘ, ﺶﺨﭘ, ﮏﯿﻧﻭﺮﺘﮑﻟﺍ-ﺖﺴﭘ
ﻪﻠﺻﺎﻓ: ﺖﺷﺍﺩﺮﺑ, ﻩﺩﻭﺪﺤﻣ, ﯽﯾﺍﺪﺟ
ﺕﻮﮑﺳ: ﻥﻮﮑﺳ
ﺎﭘ: ﺎﭘ, ﻒﻗﻮﺗ, ﻥﺍﺭ, ﻪﺠﻨﭘ, ﻊﺑﺭ, ﻦﺘﻓﺭ-ﻩﺍﺭ, ﯼﻭﺭ-ﻩﺩﺎﯿﭘ
ﯽﺸﺣﻭ: ﺪﯾﺪﺷ, ﯽﻧﻮﻧﺎﻗ-ﺮﯿﻏ, ﻩﺪﻧﺭﺩ, ﯽﺸﺣﻭ-ﺕﺎﻧﺍﻮﯿﺣ
ﻥﺩﺮﻣ: ﻥﺎﺟ-ﯽﺑ, ﮒﺮﻣ-ﻝﺎﺣ-ﺭﺩ
ﯽﯾﻮﺟ-ﻪﻓﺮﺻ: ﻥﺩﺮﮐ-ﯽﯾﻮﺟ-ﻪﻓﺮﺻ, ﻆﻔﺣ, ﻦﺘﻓﺎﯾ-ﺩﻮﺒﻬﺑ, ﻭﺮﺴﻨﮐ, ﺖﻇﺎﻔﺣ, ﻥﺩﺮﮐ-ﻆﻔﺣ, ﻩﺎﮕﺷﻭﺮﻓ, ﻥﺩﺭﻭﺍ-ﺭﺩ-ﻭﺮﮔ ﺯﺍ, ﺕﺎﺠﻧ-ﻭ-ﺩﺍﺪﻣﺍ, ﺩﺭﻮﮐﺭ
ﺰﺒﺳ: ﻡﺎﺧ, ﻡﺎﺧ
ﻞﮑﺸﻣ: ﺖﻤﺣﺯ, ﻪﻟﺎﺴﻣ, ﻪﻠﺌﺴﻣ, ﯽﺘﺨﺳ, ﻞﮑﺸﻣ, ﻥﺩﺮﮐ-ﻁﻮﻠﺨﻣ, ﻥﺪﯿﺸﮐ-ﺞﻧﺭ
ﺪﻨﺨﺒﻟ: ﺪﻨﺧﺯﻮﭘ
ﻩﺎﺒﺘﺷﺍ: ﻩﺎﺒﺘﺷﺍ, ﺎﻄﺧ, ﻩﺎﺒﺘﺷﺍ, ﺪﺑ, ﻥﺩﺍﺩ-ﻡﺎﻨﺷﺩ, ﻂﻠﻏ, ﺎﻄﺧ, ﺖﺴﮑﺷ, ﺐﯿﻋ, ﻩﺎﺒﺘﺷﺍ, ﻩﺎﺒﺘﺷﺍ
ﻒﻠﺘﺨﻣ: ﻒﻠﺘﺨﻣ, ﻉﻮﻨﺘﻣ, ﻦﯾﺪﻨﭼ, ﻩﺩﻭﺪﺤﻣ, ﻉﻮﻨﺘﻣ, ﺪﻨﭼ, ﻑﻼ﻿ﺧﺮﺑ, ﺮﮕﯾﺩ-ﻉﻮﻧ, ﻦﺘﺷﺍﺩ-ﺕﻭﺎﻔﺗ, ﺕﻭﺎﻔﺘﻣ, ﻉﺍﻮﻧﺍ
ﺏﺍﻮﺧ: ﻩﺪﯿﺑﺍﻮﺧ, ﺏﺍﻮﺧ
quotative-ﺩﺭﻮﻣ: 
ﻉﻭﺮﺷ: ﺯﺎﻏﺁ, ﻉﻭﺮﺷ, ﻦﺘﻓﺮﮔ-ﻩﺪﻬﻌﺑ, ﺵﺍﺮﺧ, ﻉﻭﺮﺷ, ﻪﯿﻟﻭﺍ, ﻪﯿﻟﻭﺍ, ﻉﻭﺮﺷ, ﺭﺎﮐ-ﺯﺎﻏﺍ, ﻞﺻﺍ
ﻞﻤﻋ: ﻪﻔﯿﻇﻭ, ﻥﺩﺮﻛ-ﻩﺭﺎﺷﺍ, ﻡﺎﮔ, ﻪﻨﺤﺻ, ﻞﻤﻋ, ﺵﻭﺭ, ﻝﺎﻌﻓ, ﺩﺮﮑﻠﻤﻋ, ﯽﺗﺎﯿﻠﻤﻋ, ﻥﺩﺮﮐ-ﻝﺎﻌﻓ, ﻝﺎﻌﻓ, ﺖﮐﺮﺣ, ﻞﻤﻋ, ﻞﻤﻋ, ﻞﻤﻋ, ﺱﺭﻮﺑ-ﻥﺎﻣﺯﺎﺳ, ﻊﻤﺠﺗ, ﺍﺮﺟﺍ, ﻥﺩﺮﮐ-ﺍﺮﺟﺍ
ﺪﯾﺩﺯﺎﺑ: ﯽﺳﺮﺘﺳﺩ, ﻪﺒﺣﺎﺼﻣ, ﺱﺮﺘﺳﺩ-ﺭﺩ, ﻦﺘﻓﺭ-ﺮﻔﺳ, ﺮﻔﺳ, ﺮﻔﺳ, ﺮﻔﺳ
ﻥﺩﺮﮐ-ﻝﺎﺒﻧﺩ: ﻕﺎﺒﻄﻧﺍ, ﻥﺪﯿﺒﺴﭼ, ﻥﺩﺮﮐ-ﻝﺎﺒﻧﺩ, ﻥﺩﺮﮐ-ﻝﺎﺒﻧﺩ, ﺮﯿﺴﻣ, ﻥﺩﺮﮐ-ﯽﻫﺍﺮﻤﻫ
ﻥﺩﺮﻛ-ﺵﻼ﻿ﺗ: ﺶﺷﻮﮐ, ﺵﻼ﻿ﺗ, ﺵﻼ﻿ﺗ, ﻞﻤﻋ-ﺭﺎﮑﺘﺑﺍ, ﻪﺑﺮﺠﺗ, ﺖﺴﺗ, ﻪﻧﻮﻤﻧ
ﺭﻮﻀﺣ: ﺩﻮﺟﻭ, ﺩﻮﺟﻭ, ﺩﻮﺟﻭ, ﯽﯾﺍﺭﺍﺩ
ﻦﯾﺮﯿﺷ: ﺕﺎﺒﻧ, ﻢﯾﻼ﻿ﻣ, ﺏﻮﻠﻄﻣ-ﻭ-ﻦﯾﺮﯿﺷ, ﺏﺍﺬﺟ
ﺪﻨﻤﺗﻭﺮﺛ: ﻥﺍﻭﺍﺮﻓ, ﻥﺍﻭﺍﺮﻓ, ﺪﻨﻤﺗﻭﺮﺛ
ﻦﻤﺷﺩ: 
ﯽﺘﺸﮐ: ﻖﯾﺎﻗ, ﻥﺎﺑﺩﺎﺑ, ﻥﺎﮔﻭﺎﻧ, ﯽﻧﺍﺮﯿﺘﺸﮐ, ﯽﺘﺸﮐ, ﯽﯾﺎﯾﺭﺩ-ﺮﻔﺳ, ﯽﺘﺸﮐ
ﺖﯿﻌﺿﻭ: ﻁﺮﺷ, ﯼﺪﻨﺑ-ﻁﺮﺷ, ﻥﺩﺍﺩ-ﺡﺮﺷ-ءﺰﺟ ﻪﺑ ءﺰﺟ, ﺖﯿﻌﺿﻭ, ﯽﮕﻧﻮﮕﭼ, ﺖﯿﻌﺿﻭ, ﺕﻭﺮﺛ, ﻪﻨﺤﺻ, ﺢﻄﺳ, ﻡﺍﺪﻧﺍ-ﺐﺳﺎﻨﺗ, ﺯﺎﯿﻧ
ﻪﻠﻤﺟ-ﺯﺍ: ﯼﻭﺎﺣ, ﻞﻣﺎﺷ, ﻞﻣﺎﺷ, ﻖﻠﻌﺗ
ﻞﻣﺎﺷ-ﺺﺨﺷ: 
ﺯﺍﺭ: ﺰﯿﻣﺁ-ﺭﺍﺮﺳﺍ, ﺯﺍﺭ, ﻕﺎﺠﻨﺳ, ﻦﯿﻣﺯ-ﺮﯾﺯ, ﻥﺩﺮﮐ-ﻥﺎﻬﻨﭘ
precative-ﺖﻟﺎﺣ: 
ﺏﺩﺍ-ﺎﺑ-ﻡﺎﻧ ﺖﺒﺛ: 
ﺪﺑ: ﻪﻣﺪﺻ, ﻩﺪﻨﻧﺯ-ﻭ-ﺪﻨﺗ, ﺮﯾﺮﺷ, ﺪﺑ, ﺪﺑ
ﺱﺭﺎﻣ: ﻩﮊﺭ, ﺽﺍﺮﺘﻋﺍ, ﺕﺍﺮﻫﺎﻈﺗ, ﻡﺍﺮﻬﺑ
ﻪﭼ-ﺮﻫ: ﻱﺰﻴﭼ-ﺮﻫ, ﻪﮐ-ﻡﺍﺪﮐ-ﺮﻫ
ﻥﺩﺮﮐ-ﺖﻣﺎﻗﺍ: ﻥﺪﻧﺎﻣ, ﻦﺘﺴﺸﻧ, ﻞﺼﻓ-ﻭ-ﻞﺣ, ﻥﺪﻧﺎﻣ-ﻩﺪﻧﺯ, ﻦﺘﺷﺍﺩ-ﺖﻣﺎﻗﺍ, ﻦﻛ-ﺮﺒﺻ
ﯼﺎﺠﺑ: ﯼﺎﺠﺑ, ﺎﺘﺒﺴﻧ, ﯽﻨﯾﺰﮕﯾﺎﺟ, ﯽﻨﯾﺰﮕﯾﺎﺟ
ﯽﺑﺁ: ﯼﺮﭘ-ﻭ-ﻦﺟ
ﻦﮑﻤﻣ-ﺮﯿﻏ: 
ﻪﺳﺭﺪﻣ: ﺲﯾﺩﺮﭘ, ﻥﺎﺑﺩﺮﻧ
ﺖﺒﺳﺎﻨﻣ: ﺖﺻﺮﻓ, ﻪﻌﻗﺍﻭ, ﻉﻮﻗﻭ, ﺲﻧﺎﺷ, ﻥﺎﺑﺎﯿﺧ, ﻪﻠﻣﺎﻌﻣ
ﻩﺩﺮﮐ-ﺝﺍﻭﺩﺯﺍ: ﺝﺍﻭﺩﺯﺍ, ﻥﺩﺮﮐ-ﺝﺍﻭﺩﺯﺍ, ﺝﺍﻭﺩﺯﺍ-ﻦﺸﺟ
ﺍﺬﻏ: ﯽﯾﺍﺬﻏ-ﻩﺪﻋﻭ, ﯽﯾﺍﺬﻏ-ﻢﯾﮊﺭ, ﺏﺎﻘﺸﺑ, ﻥﺩﺮﮐ-ﻪﯾﺬﻐﺗ, ﯼﺬﻐﻣ-ﻩﺩﺎﻣ
ﺖﺴﯿﺑ: 
ﻡﺍﺭﺁ: ﻡﺍﺭﺁ, ﻡﺍﺭﺁ, ﻥﺩﺮﮐ-ﺖﯿﺒﺜﺗ, ﺍﺪﺻ-ﯽﺑ, ﺰﯿﻣﺁ-ﺢﻠﺻ, ﻡﺍﺭﺁ, ﻡﺍﺭﺁ, ﻢﯾﻼ﻿ﻣ
ﯽﻧﺎﺳﺁ-ﻪﺑ: ﺩﺭﺍﺩ-ﻝﺎﻤﺘﺣﺍ, ﯽﻧﺎﺳﺁ-ﻪﺑ, ﻝﻮﺌﺴﻣ, ﻥﺎﺳﺁ, ﯽﺘﺣﺍﺭ, ﮎﺪﻧﺍ, ﯽﻤﮐ, ﮏﺒﺳ, ﺖﺣﺍﺭ, ﺖﺳﺍﺭ-ﺮﺳ
ﺮﮕﻧ-ﻩﺪﻨﯾﺁ-ﻪﺒﻨﺟ: 
ﻥﺎﺑﺯ: ﯽﻧﺎﺑﺯ, ﻥﺎﺑﺯ
ﻥﺎﯿﺑ: ﻥﺎﯿﺑ, ﻪﯿﻧﺎﯿﺑ, ﺕﺭﺎﺒﻋ, ﻥﺎﯿﺑ, ﯽﺣﻭ, ﻪﺋﺍﺭﺍ, ﻦﺨﺳ
ﻪﺘﻔﻫ: ﻪﺒﻨﺸﮑﯾ
ﻦﻟﺎﺳ: ﻥﺍﻮﯾﺍ, ﺮﺗﺎﺌﺗ, ﺭﻭﺪﯾﺮﮐ, ﺎﻀﻓ, ﻕﺎﺗﺍ, ﻦﻟﺎﺳ, ﻦﻟﺎﺳ, ﻭﺮﻫﺍﺭ, ﻩﺪﻧﻭﺩ, ﻭﺮﻫﺍﺭ
ﺮﻄﺧ: ﮎﺎﻧﺮﻄﺧ, ﺮﻄﺧ, ﻡﺍﺮﺘﺣﺍ, ﺪﯾﺪﻬﺗ
ﯽﮔﮋﯾﻭ: ﯽﯾﺍﺭﺍﺩ, ﻖﻠﻌﺗ, ﺖﯿﮑﻟﺎﻣ, ﺖﻨﻄﻠﺳ, ﻦﺘﺷﺍﺩ-ﺭﺎﯿﺘﺧﺍ-ﺭﺩ, ﺕﺎﯿﺻﻮﺼﺧ, ﯽﮔﮋﯾﻭ, ﮎﻼ﻿ﻣﺍ, ﺕﻭﺮﺛ, ﺕﻭﺮﺛ
ﻥﺪﻣﺁ-ﺎﯿﻧﺪﺑ: ﺪﻟﻮﺗ
ﻩﺎﮔﺩﺍﺩ: ﯽﯾﺎﻀﻗ, ﺏﺎﻘﺸﺑ, ﻦﻤﺠﻧﺍ, ﺶﯾﺎﻣﺯﺁ
ﯽﻠﮐ-ﺭﻮﻄﺑ: ﻝﻮﻤﻌﻣ, ﻻ﻿ﻮﻤﻌﻣ, ﯽﻣﻮﻤﻋ, ﯽﻠﮐ-ﺭﻮﻃ-ﻪﺑ, ﻩﺩﺮﺘﺴﮔ-ﺭﻮﻃ-ﻪﺑ, ﻻ﻿ﻮﻤﻌﻣ, ﺎﻣﻮﻤﻋ, ﻝﻮﻤﻌﻣ-ﺭﻮﻃ-ﻪﺑ, ﻩﺩﺮﺘﺴﮔ-ﺭﻮﻃ-ﻪﺑ
ﯽﻠﺜﻤﻟﺍ-ﺏﺮﺿ-ﻪﺒﻨﺟ: 
ﺵﺯﺭﺍ: ﻦﺘﺷﺍﺩ-ﻕﺎﻘﺤﺘﺳﺍ, ﺵﺯﺭﺍ, ﺪﻨﻤﺷﺯﺭﺍ, ﺭﺎﺒﺘﻋﺍ, ﯽﮕﺘﺴﯾﺎﺷ
ﻩﺩﺎﺳ: ﯽﮔﺩﺎﺳ, ﺖﺳﺍﺭ-ﺮﺳ, ﺖﺣﺍﺭ, ﺮﯾﺬﭘ-ﻑﺎﻄﻌﻧﺍ, ﻥﺎﺳﺁ, ﻂﻘﻓ, ﻩﺩﺎﺳ-ﻥﺎﺑﺯ-ﻪﺑ, ﻩﺩﺎﺳ, ﻦﺗﻭﺮﻓ, ﺎﻬﻨﺗ, ﺾﺤﻣ, ﺖﺳﺍﺭ-ﺮﺳ, ﯽﻟﻮﻤﻌﻣ
ﺖﺧﺭﺩ: ﻩﺎﯿﮔ, ﺏﻮﭼ, ﺭﻮﺤﻣ, ﺏﻮﭼ
ﻥﺩﺮﮐ-ﻩﺯﺭﺎﺒﻣ: ﻩﺯﺭﺎﺒﻣ, ﺩﺮﺒﻧ, ﻪﻬﺟﺍﻮﻣ, ﻉﺍﺰﻧ, ﺵﻼ﻿ﺗ
ﺭﺍﻮﯾﺩ: 
ﻥﺎﻤﺳﺁ: ﻥﺎﻤﺳﺁ
inchoative-ﻪﺒﻨﺟ: 
ﯼﺮﻣﺍ-ءﻪﻤﻠﮐ-ﺖﻟﺎﺣ: 
ﻦﺤﻟ: ﺮﯿﻗ, ﯼﺩﻮﻠﻣ, ﻦﺗ, ﻦﺗ, ﻪﯾﺎﺳ
ﻪﺟﻮﺗ: ﻡﺍﺮﺘﺣﺍ, ﻢﯿﻨﮐ-ﺽﺮﻓ, ﺽﺮﻓ, ﻪﺟﻮﺗ, ﻪﺟﻮﺗ, ﻦﺘﻓﺮﮔ-ﺮﻈﻧ-ﺭﺩ, ﻁﺎﺒﺗﺭﺍ, ﻦﻤﺠﻧﺍ, ﻁﺎﺒﺗﺭﺍ, ﻩﺭﺎﺑ-ﺭﺩ, ﺖﺑﺎﺑ-ﺯﺍ, ﺭﺎﻬﻇﺍ, ﺶﺷﻮﭘ
ﺩﻭﺭ-ﯽﻣ-ﺭﺎﻈﺘﻧﺍ: ﯽﻨﯿﺑ-ﺶﯿﭘ
ﻩﺎﻣ: ﻩﺎﻣ
ﻪﺑﺮﺠﺗ: ﯽﺑﺮﺠﺗ, ﯽﺑﺮﺠﺗ, ﻪﺑﺮﺠﺗ-ﺎﺑ, ﺺﺼﺨﺗ, ﻩﺰﻣ, ﻪﺑﺮﺠﺗ
ﻼ﻿ﻣﺎﮐ: ﻼ﻿ﻣﺎﮐ, ﻼ﻿ﻣﺎﮐ, ﻼ﻿ﻣﺎﮐ, ﻞﻣﺎﮐ-ﺕﺭﻮﺻ-ﻪﺑ, ﻼ﻿ﻣﺎﮐ, ﻉﻮﻤﺠﻣ, ﻼ﻿ﻣﺎﮐ, ﻖﻠﻄﻣ, ﻡﺎﻤﺗ, ﻞﻣﺎﮐ-ﺭﻮﻄﺑ, ﻪﻧﺎﻔﺼﻨﻣ, ﺎﻓﺮﺻ, ﻼ﻿ﻣﺎﮐ
ﺕﻭﺍﺮﻃ-ﺎﺑ: ﻩﺯﺎﺗ, ﺺﻟﺎﺧ, ﺰﯿﻤﺗ, ﺪﯾﺪﺠﺗ, ﺪﯾﺪﺟ, ﺭﺎﮐ-ﻩﺯﺎﺗ
ﮎﻭﺩ: ﺶﻛ-ﻂﺧ, ﻩﺩﺍﺰﻫﺎﺷ
ﻩﺪﺷ-ﻩﺩﺍﺩ-ﺶﺷﻮﭘ: ﺶﺷﻮﭘ, ﺶﺷﻮﭘ, ﺵﻮﻣﺎﺧ, ﻪﺘﺴﺑ, ﯽﻠﺧﺍﺩ
ﻥﺍﺮﮐ: ﺪﺣ, ﺖﯾﺩﻭﺪﺤﻣ, ﺪﺣ, ﺯﺮﻣ, ﺖﯾﺩﻭﺪﺤﻣ, ﺮﺼﺤﻨﻣ, ﻞﺼﺘﻣ, ﺩﺭﺍﺩ-ﯽﮕﺘﺴﺑ, ﻥﺩﺮﮐ-ﺮﯿﺳﺍ-ﻭ ﺭﺎﺘﻓﺮﮔ
ﻕﺮﺷ: ﯽﻗﺮﺷ, ﺶﯿﭘ, ﯽﻠﺒﻗ, ﯽﻠﺒﻗ, ﺶﯿﭘ, ﻕﺮﺷ
ﮓﻨﺳ: ﺮﻣﺮﻣ-ﮓﻨﺳ, ﮓﻨﺳ, ﺮﻫﻮﮔ
ﯼﺪﺣﺎﺗ: ﯼﺰﯿﭼ-ﻪﯾ, ﻱﺰﻴﭼ-ﺮﻫ, ﺯﺍ-ﯽﺧﺮﺑ, ﻼ﻿ﻣﺎﮐ, ﺎﺘﺒﺴﻧ, ﯽﻤﮐ, ﯼﺪﺣﺎﺗ, ﯼﻮﺤﻧ-ﻪﺑ
ﺖﻬﺟ: ﺖﻬﺟ, ﺪﻌﺑ, ﺪﻧﻭﺭ, ﻞﮑﺷ, ﻞﻤﻌﻟﺍ-ﺭﻮﺘﺳﺩ
ﯽﻟﺪﻨﺻ: ﯽﻟﺪﻨﺻ, ﯽﺘﺣﺍﺭ-ﯽﻟﺪﻨﺻ, ﻉﻮﻓﺪﻣ
ﻥﺩﺮﮐ-ﺖﯾﺎﻤﺣ: ﻆﻔﺣ, ﺪﯿﯾﺎﺗ, ﺖﻧﻭﺎﻌﻣ, ﯼﺭﺎﮑﻤﻫ, ﺏﻼ﻿ﻗ, ﮏﻤﮐ
ﺦﯾﺭﺎﺗ: ﺦﯾﺭﺎﺗ, ﺩﺭﻮﺧﺮﺑ
ﻩﺪﮑﻫﺩ: ﻩﺪﮑﻫﺩ, ﺮﻬﺷ-ﻪﻣﻮﺣ
ﻩﺯﻮﺣ: ﻩﺮﮐ, ﻩﺯﻮﺣ, ﻪﻘﻄﻨﻣ, ﻭﺮﻤﻠﻗ, ﻪﻘﻄﻨﻣ, ﻪﻘﻄﻨﻣ, ﺶﺨﺑ, ﻪﻨﻣﺍﺩ, ﻪﺻﺮﻋ, ﻩﺎﮕﺷﺯﺭﻭ, ﺎﻀﻓ, ﻪﯿﺷﺎﺣ, ﺮﻬﺷ-ﻪﻣﻮﺣ, ﻩﺎﮔﻭﺩﺭﺍ
ﻩﺯﺎﺟﺍ: ﻥﺩﺍﺩ-ﻩﺯﺎﺟﺍ, ﺵﻮﮔ, ﻩﺯﺎﺟﺍ, ﮎﺮﻤﮔ-ﺯﺍ-ﻻ﻿ﺎﮐ ﺺﯿﺧﺮﺗ, ﻥﺩﺮﮐ-ﮎﺮﺗ, ﺯﻮﺠﻣ, ﺯﻮﺠﻣ, ﺖﯾﺎﺿﺭ, ﭖﺎﭼ
ﺯﺎﺠﻣ-ﺖﻟﺎﺣ: 
ﺖﯿﻘﻓﻮﻣ: ﻥﺪﺷ-ﻖﻓﻮﻣ, ﻥﺪﺷ-ﻖﻓﻮﻣ, ﯽﺑﺎﯿﻣﺎﮐ, ﺖﯿﻘﻓﻮﻣ, ﯼﺯﻭﺮﯿﭘ, ﯼﺯﻭﺮﯿﭘ, ﺖﺑﺎﺻﺍ, ﻩﺪﻧﺮﺑ, ﻩﺪﻧﺮﺑ
ﺐﺳﺎﻨﻣ: ﯽﺘﺳﺭﺩ-ﻪﺑ, ﺖﺳﺭﺩ, ﻝﻮﻘﻌﻣ, ﺐﺳﺎﻨﻣ, ﻖﯿﻗﺩ, ﻖﯿﻗﺩ, ﻖﺣ, ﻖﯿﻗﺩ, ﺎﻘﯿﻗﺩ, ﮓﻧﺭﺩ-ﯽﺑ, ﻪﻧﺎﻗﺩﺎﺻ, ﯽﺘﺳﺭﺩ, ﺖﺳﺭﺩ, ﺲﻧﺎﯾﺭﺍﻭ, ﻥﺪﺷ-ﺎﺟ, ﺐﺳﺎﻨﻣ, ﺖﺣﺍﺭ, ﺐﺳﺎﻨﻣ, ﻥﺩﻮﺑ-ﻖﺑﺎﻄﻣ, ﻂﯾﺍﺮﺷ-ﺪﺟﺍﻭ, ﻁﻮﺑﺮﻣ, ﻞﻣﺎﮐ, ﯽﻓﺎﮐ, ﺐﺗﺮﻣ-ﺭﻮﻃ-ﻪﺑ
ﻪﭙﺗ: ﻩﻮﮐ, ﻩﻮﮐ
ﯽﻘﯿﺳﻮﻣ: ﯽﻘﯿﺳﻮﻣ
ﻝﺎﺘﺴﯾﺩ-ﯽﺸﯾﺎﻤﻧ: 
ﺮﻬﻇ-ﺯﺍ-ﺪﻌﺑ: ﺮﻬﻇ-ﺯﺍ-ﺪﻌﺑ, ﺮﻬﻇ, ﺮﻬﻇ, ﺐﺷ
ﻥﺩﺮﮐ-ﻪﯾﺮﮔ: ﻥﺩﺮﮐ-ﻪﯾﺮﮔ, ﺩﺎﯾﺮﻓ, ﺩﺎﯾﺮﻓ
ﺭﺎﺨﺘﻓﺍ: ﺭﺎﺨﺘﻓﺍ, ﻡﺍﺮﺘﺣﺍ, ﺭﺎﻗﻭ, ﻡﺍﺮﺘﺣﺍ-ﻞﺑﺎﻗ, ﺰﯿﻣﺁ-ﺭﺎﺨﺘﻓﺍ, ﯽﻠﯿﻠﺠﺗ, ﻊﺿﺍﻮﺗ, ﻩﻮﮑﺷ, ﺥﺮﻧ, ﺖﻤﯿﻗ
ﺖﻔﻫ: 
ﯽﺻﻮﺼﺧ: ﯽﺼﺨﺷ, ﺩﻮﺧ, ﺎﺼﺨﺷ, -ﺩﻮﺧ, ﻩﮋﯾﻭ, ﯽﺻﻮﺼﺧ-ﻢﯾﺮﺣ, ﺹﺎﺧ, ﯼﺭﺎﺼﺤﻧﺍ
ﺭﺎﺒﺧﺍ: ﻡﺎﯿﭘ
ﻪﻨﺤﺻ: ﻞﺤﻣ, ﻩﺮﻈﻨﻣ, ﻪﻨﯿﻣﺯ, ﻥﺩﺍﺩ-ﺶﯾﺎﻤﻧ, ﯼﺮﺼﺑ, ﻪﻨﺤﺻ, ﺯﺍﺪﻧﺍ-ﻢﺸﭼ, ﺯﺍﺪﻧﺍ-ﻢﺸﭼ, ﺭﺩﺎﭼ
ﻍﺎﺑ: ﮎﺭﺎﭘ
ﻪﻘﺑﺎﺴﻣ: ﯼﺩﺍﮋﻧ, ﻪﻘﺑﺎﺴﻣ, ﺍﺮﺟﺍ-ﻝﺎﺣ-ﺭﺩ, ﻪﻘﺑﺎﺴﻣ, ﻪﻘﺑﺎﺴﻣ, ﻪﺼﻗﺎﻨﻣ, ﺩﺍﮋﻧ-ﺡﻼ﻿ﺻﺍ-ﻭ ﺵﺭﻭﺮﭘ, ﻦﺘﺷﺍﺩ-ﯽﻧﺍﻮﺨﻤﻫ
ﯽﻌﯾﺯﻮﺗ-ﺩﺭﻮﻣ: 
ﺮﯿﮕﺑ-ﺩﺎﯾ: ﻥﺩﺮﮐ-ﻞﯿﺼﺤﺗ, ﺵﺯﻮﻣﺁ
ﯽﺳﺎﯿﺳ: ﺖﺳﺎﯿﺳ, ﯽﺳﺎﯿﺳ, ﺭﺍﺪﻤﺘﺳﺎﯿﺳ, ﺖﺳﺎﯿﺳ
ﻍﻭﺭﺩ: ﻂﻠﻏ
ﺐﻟﺎﻗ: ﺏﺎﺗﺮﭘ, ﻥﺩﺮﻛ-ﺕﺮﭘ, ﻥﺩﺮﮐ-ﺕﺮﭘ, ﺏﺎﺗﺮﭘ, ﺐﻟﺎﻗ, ﺐﻟﺎﻗ, ﯼﺯﺍﺪﻧﺍ-ﻩﺍﺭ, ﻦﺘﺨﯾﺭ, ﮎﺮﺗ
ﻥﺩﺭﻮﺧ: ﯽﯾﺍﺬﻏ-ﻩﺪﻋﻭ, ﻥﺩﺮﮐ-ﻪﯾﺬﻐﺗ, ﺏﺎﻘﺸﺑ, ﻥﺩﺭﻮﺧ-ﺭﺎﻫﺎﻧ, ﻑﺮﺼﻣ
ﻪﻘﺒﻃ: ﻪﭽﯿﻟﺎﻗ, ﻦﯿﻣﺯ, ﻦﯿﯾﺎﭘ, ﮎﺎﺧ, ﻦﺘﻓﺭ-ﻩﺍﺭ, ﻻ﻿ﺎﺑ, ﺪﻨﻠﺑ
ﺭﺎﻤﯿﺑ: ﺭﺎﻤﯿﺑ, ﺭﺎﻤﯿﺑ, ﻢﺧﺯ, ﯼﺭﺎﻤﯿﺑ, ﻂﻠﻏ, ﺪﺑ
ﯽﻠﺻﺍ: ﺐﺴﻧ-ﻭ-ﻞﺻﺍ, ﻞﺻﺍ-ﺭﺩ, ﯽﺗﺎﻣﺪﻘﻣ, ﻪﯿﻟﻭﺍ, ﺰﺘﻨﺳ, ﺍﺪﺘﺑﺍ-ﺭﺩ, ﯽﻣﻮﺑ, ﯽﻌﻗﺍﻭ, ﯽﺗﺍﺫ, ﯽﻣﻮﺑ, ﯽﻠﺻﺍ, ﯽﻠﺻﺍ, ﻪﯿﻟﻭﺍ-ﻪﻧﻮﻤﻧ
ﻥﺎﺘﺴﺑﺎﺗ: ﺕﺭﺍﺮﺣ
ﻦﯾﺩ: ﯽﻨﯾﺩ, ﯽﻫﺪﺑ
ﺮﯾﻮﺼﺗ: ﺮﯾﻮﺼﺗ, ﯼﺰﯿﻣﺁ-ﮓﻧﺭ, ﺮﯾﻮﺼﺗ, ﺲﮑﻋ, ﯽﺴﮑﻋ, ﯽﺳﺎﮑﻋ, ﺲﮑﻋ, ﯽﭙﮐﻮﺘﻓ, ﻢﺳﺭ, ﯽﻧﺎﻬﮔﺎﻧ-ﻭ-ﻢﮑﺤﻣ ﻪﺑﺮﺿ, ﻢﻠﯿﻓ, ﺮﯾﻮﺼﺗ, ﺮﯾﻮﺼﺗ, ﻞﮑﺷ, ﻞﮑﺷ
ﻦﺘﻓﺭ-ﺭﺩ: ﻦﺘﺨﯾﺮﮔ
ﻩﺪﻨﺴﯾﻮﻧ: ﻩﺪﻨﺴﯾﻮﻧ, ﻢﻠﻌﻣ, ﺮﮕﺸﯾﺍﺮﯾﻭ
ﻱﺍ-ﻩﻮﻬﻗ: ﯼﺮﺘﺴﮐﺎﺧ, ﯼﺮﺘﺴﮐﺎﺧ, ﺥﺮﺴﺑ-ﻞﯾﺎﻣ-ﻩﻮﻬﻗ, ﯼﺰﻧﺮﺑ
ﺺﺨﺸﻣ: ﻦﯿﯿﻌﺗ, ﻦﺘﻓﺮﮔ-ﻢﻴﻤﺼﺗ, ﻥﺪﺷ-ﻦﯿﯿﻌﺗ, ﯽﻌﻄﻗ, ﻩﺪﻨﻨﮐ-ﺭﺎﻬﻇﺍ, ﺡﺍﺮﻃ, ﻩﺪﺷ-ﻦﯿﯿﻌﺗ, ﻡﻮﻠﻌﻣ, ﺕﺎﺒﺛ-ﺎﺑ, ﯽﻀﻌﺑ
ﺩﺭﺩ: ﻪﻣﺪﺻ, ﻩﻭﺪﻧﺍ-ﻭ-ﻢﻏ, ﮎﺎﻧﺩﺭﺩ, ﻢﻏ, ﻢﺧﺯ
ﺭﺎﻬﺑ: ﺮﭘ, ﺎﻣ, ﺎﻣ-ﻝﺎﻣ
ﻥﺮﻗ: ﻦﺳ
ﻡﺮﻧ: ﯽﻘﯾﺪﺼﺗ, ﻑﺎﺻ, ﺰﯾﺭ, ﻪﺼﻗﺎﻨﻣ, ﯽﻣﺍﺭﺁ-ﻪﺑ, ﻢﯾﻼ﻿ﻣ, ﻢﯾﻼ﻿ﻣ, ﺏﻮﻠﻄﻣ-ﻭ-ﻦﯾﺮﯿﺷ, ﻢﯾﻼ﻿ﻣ
ﻪﺷﻮﮔ: ﻪﯾﻭﺍﺯ, ﻩﻮﮔ, ﻥﺪﺷ-ﻕﺮﻏ
ﻥﺩﺮﮐ-ﺪﯿﻟﻮﺗ: ﺪﯿﻟﻮﺗ, ﺪﯿﻟﻮﺗ, ﻩﺪﻨﻨﮐ-ﺪﯿﻟﻮﺗ, ﻦﺘﺧﺎﺳ, ﺪﯿﻟﻮﺗ, ﺪﯿﻟﻮﺗ
ﻩﺪﻨﺧ: ﯽﺧﻮﺷ
ﻥﺩﺮﮐ-ﺵﻮﻣﺍﺮﻓ: ﻥﺩﺮﮐ-ﯽﺷﻮﭘ-ﻢﺸﭼ
ﺎﭘﻭﺭﺍ: 
ﺖﺸﻫ: ﻢﺘﺸﻫ
ﺱﺎﺒﻟ: ﺱﺎﺒﻟ, ﺵﻮﭘ-ﻦﺗ, ﺐﺷ-ﺱﺎﺒﻟ, ﺩﺎﺸﮔ-ﻭ-ﺪﻨﻠﺑ ﺱﺎﺒﻟ, ﻩﺪﯿﺷﻮﭘ-ﺱﺎﺒﻟ, ﻡﺮﻓ-ﺱﺎﺒﻟ, ﮒﺮﺑ-ﻭ-ﺯﺎﺳ
ﮎﺎﻨﺘﺸﺣﻭ: ﺡﺎﻀﺘﻓﺍ, ﺭﺎﺑ-ﺖﺒﯿﺼﻣ, ﯽﮐﺎﻨﺘﺸﺣﻭ, ﮎﺎﻨﺳﺮﺗ, ﻢﯿﻈﻋ, ﺰﯿﮕﻧﺍ-ﻢﻏ, ﻩﺪﻨﻫﺩ-ﺭﺍﺪﺸﻫ, ﻥﺪﻧﺎﺳﺮﺗ, ﻻ﻿ﻮﯿﻫ, ﺭﻮﺟﺪﺑ
ﺲﻔﻧ: ﯽﺴﻔﻨﺗ, ﻥﺪﯿﺸﮐ-ﺲﻔﻧ, ﺲﻔﻨﺗ, ﻥﺩﺍﺩ-ﻥﻭﺮﯿﺑ, ﺲﻔﻧ, ﻥﺩﺯ-ﺲﻔﻧ-ﺲﻔﻧ
ﺎﻧﺍﺩ: ﻝﻮﻘﻌﻣ, ﻝﻮﻘﻌﻣ, ﻁﺎﯿﺘﺣﺍ-ﺎﺑ, ﺮﮑﻔﺘﻣ, ﺵﻮﻫﺎﺑ, ﺪﻨﻤﺷﻮﻫ, ﺪﻨﻤﺷﻮﻫ---ﺵﻮﻫﺎﺑ
ﻪﯿﻟﺎﻓﺎﻀﻣ-ﺮﮕﻧﺎﺸﻧ: 
ﻪﻈﻓﺎﺣ: ﻥﺩﺮﮐ-ﻆﻔﺣ, ﻊﺟﺮﻣ, ﺩﻮﺑﺩﺎﯾ
ﻥﺭﺪﻣ: ﺮﺻﺎﻌﻣ, ﻪﺘﻓﺮﺸﯿﭘ, ﻥﺩﺮﮐ-ﻦﯾﻮﻧ, ﺯﻭﺭ-ﺪﻣ, ﺮﯿﺧﺍ, ﻦﺨﺳ
ﻪﻄﻘﻧ: ﻥﺩﺮﻛ-ﻩﺭﺎﺷﺍ, ﻪﻄﻘﻧ, ﺖﻋﺎﺳ, ﻞﺤﻣ, ﻪﮑﻟ, ﻥﺩﺮﮐ-ﺭﺍﺩ-ﻪﮑﻟ, ﻪﻠﺻﻭ, ﻥﺩﺍﺩ-ﯼﺎﺟ, ﯽﯾﺎﺟ-ﭻﯿﻫ, ﻞﺤﻣ, ﻥﺎﮑﻣ, ﻞﺤﻣ, ﯽﻠﺤﻣ, ﻥﺩﺍﺩ-ﺭﺍﺮﻗ, ﻥﺩﺮﮐ-ﺎﻀﻣﺍ, ﻦﯿﻣﺯ
ﻥﺪﻣﺁ-ﻻ﻿ﺎﺑ: ﻩﺎﯿﮔ, ﯼﺩﺭﻮﻧ-ﮓﻨﺳ, ﻕﺎﭼ-ﻭ-ﻪﺘﺨﻠﺷ, ﻦﺘﻓﺭ-ﻻ﻿ﺎﺑ, ﻻ﻿ﺎﺑ, ﻪﺘﺨﺗ, ﻥﺪﺷ-ﺭﺍﻮﺳ, ﻥﺩﺮﺑ-ﻻ﻿ﺎﺑ, ﺪﻨﯾﺁ-ﯽﻣ-ﺩﻮﺟﻮﺑ, ﻥﺩﺮﺑ-ﻻ﻿ﺎﺑ, ﺝﻭﺮﺧ, ﻥﺩﺮﮐ-ﺪﺷﺭ
ﺢﻳﺮﻔﺗ-ﮓﻧﺯ: ﺭﺩ-ﻦﺘﺴﮑﺷ, ﺰﻣﺮﺗ, ﺭﺮﮑﻣ-ﺪﻣﺁ-ﻭ ﺖﻓﺭ, ﻦﻟﺎﺳ, ﻪﻔﻗﻭ, ﻩﺯﺎﺑ, ﻑﺎﮑﺷ, ﻥﺪﯿﺑﻮﮐ-ﻢﻫﺭﺩ, ﻦﺘﺴﮑﺷ, ﻥﺩﺮﮐ-ﻒﻗﻮﺘﻣ, ﻒﻗﻮﺗ, ﻥﺩﺮﮐ-ﻊﻄﻗ
ﻩﺎﺠﻨﭘ: 
ﻩﺮﯾﺰﺟ: 
ﻪﺑ-ﻥﺩﺯ-ﺖﺳﺩ: ﺱﺎﻤﺗ
ﻩﺪﻋﻭ: ﺐﮑﺗﺮﻣ, ﺪﻬﻌﺗ, ﻭﺮﮔ, ﺏﺎﺼﺘﻧﺍ
commissive-ﺖﻟﺎﺣ: 
ﻪﺟﺭﺩ: ﺮﺑﺍﺮﺑ, ﺪﺣ, ﻪﺟﺭﺩ, ﺖﯿﻔﯿﮐ
ﺡﺮﻃ: ﺡﺮﻃ, ﻪﻣﺎﻧ-ﻢﻫﺎﻔﺗ, ﻪﻣﺎﻧﺮﺑ, ﻪﻣﺎﻧﺮﺑ, ﻞﻤﻋ-ﺭﺎﮑﺘﺑﺍ, ﺶﮐ-ﻪﺸﻘﻧ, ﯼﺩﺎﻬﻨﺸﯿﭘ-ﺡﺮﻃ, ﻩﮊﻭﺮﭘ, ﺡﺮﻃ, ﺡﺮﻃ, ﺡﺮﻃ, ﺡﺮﻃ, ﺖﺨﺗ, ﻢﺳﺭ, ﻥﺩﺮﮐ-ﯽﺣﺍﺮﻃ
ﺭﺎﺘﻓﺭ: ﺪﻧﻭﺭ, ﺭﺎﺘﻓﺭ, ﺭﺎﺘﻓﺭ, ﯼﺭﺎﺘﻓﺭ
ﻥﺩﺮﮐ-ﺮﯿﮕﻠﻓﺎﻏ: ﺐﯿﺠﻋ, ﻪﺒﻗﺮﺘﻣ-ﺮﯿﻏ, ﯽﻓﺩﺎﺼﺗ, ﻩﺪﻨﻨﮐ-ﺮﯿﮕﻠﻓﺎﻏ
ﻪﻘﯿﻗﺩ: 
ﺲﮑﻋ: ﻦﺘﺨﯾﺭ-ﻥﻭﺮﯿﺑ, ﯼﺯﺍﺪﻧﺍﺮﯿﺗ, ﻪﻟﻮﻠﮔ, ﺕﺎﻤﻬﻣ, ﺲﮑﻋ, ﺲﮑﻋ, ﻪﺑﺮﺿ, ﺭﺎﺠﻔﻧﺍ, ﺎﺗﺩﻮﮐ, ﻥﺩﺮﻛ-ﺕﺮﭘ, ﺏﺎﻗ
ﺮﺗﺪﺑ: ﺪﺑ, ﻦﯾﺮﺗﺪﺑ, ﻦﺸﺧ, ﺮﻀﻣ, ﺪﺑ, ﯽﮐﺎﻨﺘﺸﺣﻭ, ﺖﺴﭘ, ﻻ﻿ﺎﺑ, ﺎﻫ-ﻪﻠﭘ-ﺯﺍ
ﻪﺸﯿﺷ: ﻪﻨﯿﯾﺁ, ﻝﺎﺘﺴﯾﺮﮐ, ﻪﺸﯿﺷ, ﮏﻨﯿﻋ, ﮏﻨﯿﻋ
ﻝﺎﺜﻣ: ﻝﺎﺜﻣ, ﺮﯾﻮﺼﺗ, ﻝﺪﻣ, ﻮﮕﻟﺍ, ﻩﺭﺎﻌﺘﺳﺍ, ﻪﯿﻟﻭﺍ-ﻪﻧﻮﻤﻧ, ﻪﻟﺰﻨﻣ-ﻪﺑ, ﯽﮔﺪﻨﯾﺎﻤﻧ, ﻪﻧﻮﻤﻧ, ﺩﺭﻮﻣ, ﻪﻘﺑﺎﺳ, ﻪﻧﻮﻤﻧ, ﻮﮕﻟﺍ, ﻝﺎﺜﻣ-ﯼﺍﺮﺑ
ﺮﻄﺧ-ﯽﺑ: ﻦﻣﺍ, ﯽﻨﻤﯾﺍ, ﺖﯿﻨﻣﺍ, ﺮﻄﺧ-ﻥﻭﺪﺑ, ﻦﺌﻤﻄﻣ, ﻪﻤﯿﺑ
ﺮﺘﮐﺩ: ﮏﺷﺰﭘ, ﺱﺎﻨﺸﻧﺎﻣﺭﺩ, ﺺﺼﺨﺘﻣ, ﯽﮑﺷﺰﭘ
completive-ﻪﺒﻨﺟ: 
ﺭﺮﮑﻣ: ﺎﺒﻟﺎﻏ, ﻢﻈﻨﻣ, ﺖﺑﺎﺛ, ﻡﻭﺍﺪﻣ-ﺭﻮﻃ-ﻪﺑ, ﻩﺎﮕﯿﺑ-ﻭ-ﻩﺎﮔ, ﺭﺮﮑﻣ, ﺐﺗﺮﻣ-ﺭﻮﻃ-ﻪﺑ, ﻥﺩﺮﮐ-ﺭﺍﺮﮑﺗ
ﯽﻣﺎﻈﻧ: ﯽﻣﺎﻈﻧ-ﯼﺎﻫﻭﺮﯿﻧ, ﺐﻠﻃ-ﮓﻨﺟ
ﻡﺮﮔ: ﻡﺮﮔ, ﻡﺮﻧ-ﻭ-ﻡﺮﮔ, ﺕﺭﺍﺮﺣ, ﯽﻣﺮﮔ, ﺕﺭﺍﺮﺣ-ﻪﺟﺭﺩ, ﺶﯾﺎﻣﺮﮔ, ﻡﺮﮔ, ﻡﺮﮔ
ﻥﺪﯿﺷﻮﻧ: ﻪﺑﺎﺷﻮﻧ
ﺶﺳﺮﭘ: 
ﻢﺸﺧ: ﻦﯿﮕﻤﺸﺧ, ﻢﺸﺧ, ﺖﻣﺮﺣ-ﮏﺘﻫ, ﮏﯾﺮﺤﺗ, ﻪﻨﯿﮐ
ﻢﯿﻘﺘﺴﻣ-ﺭﻮﻃ-ﻪﺑ: ﺖﺳﺍﺭ-ﺮﺳ, ﻢﯿﻘﺘﺴﻣ, ﻢﯿﻘﺘﺴﻣ-ﺮﯿﻏ, ﮏﯿﺗﺎﻣﻮﺗﺍ, ﺖﺳﺍﺭ-ﺮﺳ, ﯼﺭﻮﻓ
ﻩﻼ﻿ﮐ: ﺭﺍﺩ-ﻪﺒﻟ-ﻩﻼ﻿ﮐ, ﯽﻨﻤﯾﺍ-ﻩﻼ﻿ﮐ
ﮓﺳ: 
ﺭﺍﺰﮕﺘﻣﺪﺧ: ﺮﺷﺎﺒﻣ, ﺖﻣﺪﺨﺸﯿﭘ, ﻥﺯ-ﺖﻣﺪﺨﺸﯿﭘ
ﺭﻭﺮﻏ: ﺮﺒﮑﺘﻣ, ﺭﻭﺮﻐﻣ, ﺭﺎﺨﺘﻓﺍ-ﺎﺑ
ﺖﯿﻌﻤﺟ: ﻥﺩﺮﺑ-ﻡﻮﺠﻫ, ﻍﻮﻠﺷ, ﺖﯿﻌﻤﺟ, ﻥﺍﺰﯿﻣ, ﺭﺍﺪﻘﻣ, ﺖﯿﻌﻤﺟ, ﻥﺎﺑﺰﯿﻣ, ﻩﺩﻮﺗ
ﺭﺎﻄﻗ: ﻪﮑﺴﻟﺎﮐ, ﻭﺭﺩﻮﺧ, ﻦﮔﺍﻭ, ﯼﺭﺎﮔ, ﻦﻫﺁ-ﻩﺍﺭ, ﻞﯾﺭ, ﺵﺯﻮﻣﺁ
ﯽﻗﻼ﻿ﺧﺍ: ﻕﻼ﻿ﺧﺍ, ﯽﻗﻼ﻿ﺧﺍ-ﺮﻈﻧ-ﺯﺍ, ﯽﻗﻼ﻿ﺧﺍ, ﻕﻼ﻿ﺧﺍ-ﻝﻮﺻﺍ, ﻪﯿﺣﻭﺭ, ﯽﻧﺎﺣﻭﺭ
ﻩﺍﺮﻤﻫ: ﻪﺘﺴﺑﺍﻭ, ﻁﺎﺒﺗﺭﺍ, ﻥﺩﺮﮐ-ﻂﺒﺗﺮﻣ, ﻁﻮﺑﺮﻣ, ﻥﺍﺮﮕﻧ, ﻪﻗﻼ﻿ﻋ, ﻁﻮﺑﺮﻣ, ﻩﺍﺮﻤﻫ, ﻞﺼﺘﻣ, ﻁﺎﺒﺗﺭﺍ, ﺪﺤﺘﻣ
ﻥﺪﺷ-ﻞﺧﺍﺩ: ﻢﺘﺴﯿﺳ-ﻪﺑ-ﺩﻭﺭﻭ, ﺩﻭﺭﻭ, ﻥﺩﺍﺩ-ﺡﺮﺷ-ءﺰﺟ ﻪﺑ ءﺰﺟ, ﻥﺩﺍﺩ-ﻥﺎﺸﻧ, ﻥﺩﺍﺩ-ﺭﺍﺮﻗ, ﻞﻣﺎﺷ
ﻥﻮﻧﺎﻗ: ﺖﻣﻮﮑﺣ, ﻪﻄﻠﺳ, ﻢﯾﮊﺭ, ﯼﺭﻭﺍﺩ, ﻢﮑﺣ, ﯼﺭﻭﺍﺩ, ﯼﺭﻭﺍﺩ, ﺭﻭﺍﺩ, ﻥﺩﺮﮐ-ﺖﻣﻮﮑﺣ, ﻥﻮﻧﺎﻗ, ﻥﻮﻧﺎﻗ, ﺭﺎﺠﻨﻫ
ﺮﯿﺸﻤﺷ: ﻪﻐﯿﺗ
ﻪﻠﻤﺣ: ﻢﺟﺎﻬﺗ, ﻪﻠﻤﺣ, ﺯﻭﺎﺠﺗ, ﻡﺮﺟ, ﻪﻠﻤﺣ, ﻦﯿﻫﻮﺗ, ﺏﺎﺼﺘﻋﺍ, ﻉﻭﺮﺷ, ﻪﻠﻤﺣ
ﺖﻣﻼ﻿ﺳ: ﻢﻟﺎﺳ, ﻦﺘﻔﮔ-ﮏﯾﺮﺒﺗ
ﺪﻨﺑ: ﺮﻌﺷ, ﺪﻨﺑ, ﻪﮑﺗ, ﻥﺩﺮﻛ-ﻩﺭﺎﺷﺍ, ﺵﺮﮕﻧ, ﺖﻟﺎﺣ
ﯽﻋﺎﻤﺘﺟﺍ: ﻪﻌﻣﺎﺟ, ﯽﻋﺎﻤﺘﺟﺍ
ﺩﺍﺩﺮﺘﺳﺍ: ﺦﺳﺎﭘ, ﺦﺳﺎﭘ, ﺖﺸﮔﺮﺑ
ﻒﺳﺎﺘﻣ: ﻥﺪﺷ-ﻥﺎﻤﻴﺸﭘ, ﺐﻄﻗ, ﺶﺸﺨﺑ, ﻪﻧﺎﻬﺑ, ﯽﻫﺍﻮﺧﺭﺬﻋ
ﺖﻋﺎﺠﺷ: ﺕﺍﺮﺟ-ﻭ-ﻝﺩ, ﺭﻮﺴﺟ, ﻦﺌﻤﻄﻣ, ﺐﺼﻋ, ﯽﯾﺎﺒﯿﮑﺷ, ﺖﻣﺎﻬﺷ
ﺖﻓﺍﺮﻇ: ﻒﻄﻟ, ﻒﻄﻟ, ﺖﻤﺣﺭ, ﯽﻧﺎﺑﺮﻬﻣ, ﯽﻫﺍﻮﺧ-ﺮﯿﺧ, ﯽﮔﺪﻨﯾﺎﻤﻧ, ﺶﺸﺨﺑ
ﯽﻤﺳﺭ: ﯽﻤﺳﺭ, ﯽﻤﺳﺭ-ﺭﻮﻃ-ﻪﺑ, ﺎﻤﺳﺭ, ﺮﺴﻓﺍ, ﯽﺸﻨﻣ
ﻩﺪﺷ-ﻪﺋﺍﺭﺍ: ﺪﻨﮐ-ﯽﻣ-ﻢﻫﺍﺮﻓ, ﺩﺎﻬﻨﺸﯿﭘ, ﻥﺩﺭﻭﺁ-ﻢﻫﺍﺮﻓ, ﯽﻓﺮﻌﻣ, ﺱﺮﺘﺳﺩ-ﺭﺩ, ﻦﯿﻣﺎﺗ, ﮎﺭﺍﺪﺗ, ﻥﺩﺮﮐ-ﻪﯿﻬﺗ, ﺮﮔﺍ
ﻥﺩﺮﮐ-ﺎﺿﺎﻘﺗ: ﺯﺎﻤﻧ, ﺎﺿﺎﻘﺗ, ﺎﻋﺩﺍ, ﺯﺎﯿﻧ, ﺯﺎﯿﻧ, ﻮﺟ-ﻭ-ﺱﺮﭘ, ﻮﺟ-ﻭ-ﺱﺮﭘ, ﮓﻧﺭﺩ-ﯽﺑ, ﺩﺎﻬﻨﺸﯿﭘ, ﺭﺍﺰﻓﺍ-ﻡﺮﻧ
ﻩﺎﮕﻧ: ﯽﻟﺎﻤﺟﺍ-ﺮﻈﻧ, ﺯﺍﺪﻧﺍ-ﻢﺸﭼ, ﺵﺮﮕﻧ, ﮎﺍﺭﺩﺍ, ﺯﺍﺪﻧﺍ-ﻢﺸﭼ, ﻩﺮﻈﻨﻣ, ﻦﮐ-ﻩﺎﮕﻧ
ﯽﯾﺎﺠﺑﺎﺟ: ﺖﮐﺮﺣ, ﯽﺗﺎﺑﺎﺨﺘﻧﺍ-ﺕﺍﺯﺭﺎﺒﻣ, ﺵﺯﺭﻭ, ﯽﺒﯿﻠﺻ-ﮓﻨﺟ, ﻞﻤﻋ, ﺖﮐﺮﺣ, ﮎﺮﺤﺗ, ﺕﺭﺎﺠﺗ, ﯽﺸﮐ-ﺙﺎﺛﺍ
ﺭﺎﻈﺘﻧﺍ: ﺭﺎﻈﺘﻧﺍ, ﯽﻨﯿﺑ-ﺶﯿﭘ, ﯽﻨﯿﺑ-ﺶﯿﭘ, ﻦﻛ-ﺮﺒﺻ
ﻞﺑﺎﻘﻣ: ﻮﻠﺟ, ﻒﻟﺎﺨﻣ, ﻒﻟﺎﺨﻣ, ﻒﻟﺎﺨﻣ, ﻥﺎﯿﻣ-ﺭﺩ, ﻩﺪﻧﺭﺎﻤﺷ
ﻩﺩﺯﺍﻭﺩ: 
ﻝﻮﻐﺸﻣ: ﯼﺩﺰﻣﺎﻧ, ﻝﻮﻐﺸﻣ, ﺭﺎﮐﺭﺪﻧﺍ-ﺖﺳﺩ, ﻥﺩﺮﮐ-ﺖﮐﺮﺷ, ﻩﺪﺷ-ﻝﺎﻐﺷﺍ
ﺏﺍﺮﺷ: ﺭﻮﮕﻧﺍ, ﻞﮑﻟﺍ, ﯽﻠﮑﻟﺍ
ﻢﻌﻃ: ﻢﻌﻃ, ﻢﻌﻃ, ﺬﯾﺬﻟ---ﻩﺰﻤﺷﻮﺧ, ﻪﻤﻌﻃ, ﻩﺰﻣ
ﻥﺪﯿﺸﮐ-ﻮﺗﺍ: ﺩﻻ﻿ﻮﻓ, ﺰﻠﻓ
ﻊﯾﺯﻮﺗ: ﻝﺎﻘﺘﻧﺍ, ﺵﺮﺘﺴﮔ, ﺭﺎﺸﺘﻧﺍ, ﺮﺸﻧ-ﻭ-ﭖﺎﭼ, ﺭﺎﺸﺘﻧﺍ, ﻥﺩﺭﻭﺍ-ﺭﺩ-ﺵﺩﺮﮔ ﻪﺑ, ﻊﯾﺯﻮﺗ, ﻥﺩﺍﺩ-ﺹﺎﺼﺘﺧﺍ, ﻢﻬﺳ, ﻥﺩﺮﮐ-ﻢﯿﺴﻘﺗ, ﻑﺎﮑﺷ, ﯼﺯﺎﺳﺍﺪﺟ, ﻥﺩﺮﮐ-ﯼﺪﻨﺑ-ﻪﺘﺳﺩ
ﺕﺭﺎﺠﺗ: ﺕﺭﺎﺠﺗ, ﺕﺭﺎﺠﺗ, ﺕﺭﺎﺠﺗ, ﻻ﻿ﺎﮐ, ﺖﻧﺮﺘﻨﯾﺍ, ﻪﻠﻣﺎﻌﻣ, ﺶﻨﮐﺍﺮﺗ, ﺮﺟﺎﺗ, ﻥﺩﺮﻛ-ﺪﻳﺮﺧ, ﯽﺑﺎﯾ-ﺭﺍﺯﺎﺑ
ﺖﯾﺰﻣ: ﻥﺩﺮﮐ-ﺐﺴﮐ, ﺩﻮﺳ, ﻥﺩﺮﺑ-ﻩﺮﻬﺑ, ﻡﺍﻭﺩ-ﻞﺑﺎﻗ, ﯽﺑﻮﺧ, ﯽﯾﺍﺭﺍﺩ, ﺢﯿﺟﺮﺗ, ﻂﻠﺴﺗ
ﺎﻫ-ﺱﺎﺒﻟ: ﯽﺘﺧﺭ-ﺎﺟ, ﻪﭼﺭﺎﭘ, ﺵﻮﭘ-ﻦﺗ, ﮒﺮﺑ-ﻭ-ﺯﺎﺳ, ﮎﺎﺷﻮﭘ, ﻥﺩﺮﮐ-ﺰﯿﺧ-ﻭ ﺖﺴﺟ
ﯽﺿﺎﻗ: ﯼﺭﻭﺍﺩ, ﯼﺭﻭﺍﺩ, ﯼﺭﻭﺍﺩ, ﺭﻭﺍﺩ
ﺕﻭﺎﻔﺗ: ﻞﯿﺴﻧﺍﺮﻔﯾﺩ, ﻕﺍﺮﺘﻓﺍ, ﻒﻠﺘﺨﻣ, ﻪﻧﺎﮔﺍﺪﺟ, ﺰﯾﺎﻤﺘﻣ, ﻦﺘﺷﺍﺩ-ﺕﻭﺎﻔﺗ, ﺮﯿﯿﻐﺗ, ﻪﻧﺎﮔﺍﺪﺟ-ﺕﺭﻮﺼﺑ, ﯼﺮﯾﺬﭘ-ﺮﯿﯿﻐﺗ, ﺲﻧﺎﯾﺭﺍﻭ, ﻥﺩﺮﮐ-ﻢﯿﺴﻘﺗ
ﺲﭘﺍﻮﻟﺩ: ﯼﺭﺍﺮﻄﺿﺍ, ﺕﺭﻭﺮﺿ, ﻥﺍﺮﮕﻧ, ﺏﺮﻄﻀﻣ, ﻥﺍﺮﮕﻧ, ﺏﺍﺮﻄﺿﺍ, ﻪﻗﻼ﻿ﻋ, ﻥﺩﻮﺑ-ﻥﺍﺮﮕﻧ, ﺮﮑﻔﺘﻣ, ﺖﺣﺍﺭﺎﻧ, ﻩﺪﻨﻨﮐ-ﻥﺍﺮﮕﻧ, ﻩﺪﯿﺳﺮﺗ, ﻕﺎﺘﺸﻣ, ﻥﺍﺮﮕﻧ, ﻩﺪﻨﻫﺩ-ﺭﺍﺪﺸﻫ, ﻕﺎﺘﺸﻣ, ﻕﺎﯿﺘﺷﺍ-ﺎﺑ, ﺭﺍﺮﻗ-ﻲﺑ, ﺏﺮﻄﻀﻣ
ﻥﺍﻭﺮﺳ: 
ﺪﯿﺳﺭ-ﻥﺎﯾﺎﭘ-ﻪﺑ: ﻥﺎﯾﺎﭘ, ﻥﺎﯾﺎﭘ, ﺩﻭﺪﺤﻣ, ﻥﺩﻮﺑ-ﻩﺩﺎﻣﺁ
ﻒﻗﻮﺗ-ﻪﺒﻨﺟ: 
ﻭﺎﮑﺠﻨﮐ: ﻕﺎﯿﺘﺷﺍ-ﺎﺑ, ﺖﺴﻫ-ﺐﻟﺎﺟ, ﺞﯿﻬﻣ
ﯽﺟﺭﺎﺧ: ﺭﻮﺸﮐ-ﺯﺍ-ﺝﺭﺎﺧ, ﻪﻧﺎﮕﯿﺑ, ﯽﺟﺭﺎﺧ, ﺐﯾﺮﻏ-ﻭ-ﺐﯿﺠﻋ, ﻪﻧﺎﮕﯿﺑ, ﯽﺟﺭﺎﺧ
ﻩﺪﻨﻨﮐﺪﯾﺪﺸﺗ: ﺪﯾﺪﺸﺗ
ﺖﯿﻤﻫﺍ: ﺕﺭﻭﺮﺿ, ﻁﺎﺒﺗﺭﺍ, ﯽﻨﻌﻣ, ﺵﺯﺭﺍ
ﺖﯾﺎﻬﻧ-ﺭﺩ: ﺖﯾﺎﻬﻧ-ﺭﺩ, ﺖﯾﺎﻬﻧ-ﺭﺩ, ﺩﻭﺪﺤﻣ, ﯽﯾﺎﻬﻧ, ﯽﯾﺎﻬﻧ, ﻪﻧﺎﯾﺎﭘ, ﺰﯾﺭ
ﻪﺤﯾﻻ﻿: ﻞﻤﻋ, ﯽﻄﺧ-ﻪﺨﺴﻧ, ﺏﺎﺴﺣ, ﻪﻠﺿﺎﻓ-ﻭ-ﻪﻌﻣﺎﺟ ﺏﺎﺴﺣ
ﻥﺩﺮﻛ-ﺖﺑﺎﺛ: ﺕﺎﺒﺛﺍ, ﻥﺩﺮﻛ-ﺪﻴﻳﺎﺗ, ﺪﯿﯾﺄﺗ, ﻥﺩﺍﺩ-ﻥﺎﺸﻧ, ﻥﺩﺍﺩ-ﺕﺩﺎﻬﺷ
ﻥﺩﺮﮐ-ﯼﺮﯿﮔﻮﻠﺟ: ﻒﻗﻮﺗ, ﻉﻮﻨﻤﻣ, ﺖﺷﺍﺩﺯﺎﺑ, ﻥﺩﺮﮐ-ﺏﻮﮐﺮﺳ, ﻥﺩﺮﮐ-ﺩﻭﺪﺤﻣ, ﺭﺎﻬﻣ, ﻥﺩﺮﮐ-ﺩﻭﺪﺴﻣ, ﻥﺩﺮﮐ-ﺭﺎﻬﻣ, ﻥﺪﻧﺎﺳﺮﺗ, ﺖﺳﺍ-ﻩﺩﺮﮐ-ﻉﻮﻨﻤﻣ, ﻥﺩﺮﮐ-ﺏﺎﻨﺘﺟﺍ, ﻥﺪﻧﺎﺸﻧ-ﺐﻘﻋ, ﻥﺩﺮﮐ-ﺏﻮﮐﺮﺳ, ﻥﺩﺮﮐ-ﻖﻠﻌﻣ
ﻥﺩﺮﮔ: ﻮﻠﮔ
ﯽﻧﻮﻧﺎﻗ: ﯽﯾﺎﻀﻗ, ﻥﻮﻧﺎﻗ, ﻉﻭﺮﺸﻣ, ﺏﺎﻗ
ﮏﺸﺧ: ﻪﻗﺎﺳ
ﺖﻣﺪﺧ: ﯽﻧﺎﺳﺭ-ﺖﻣﺪﺧ, ﻥﺩﺭﻭﺁ-ﺖﺳﺪﺑ, ﻥﺩﺮﮐ-ﻪﯿﻬﺗ, ﺩﺎﻬﻨﺸﯿﭘ
ﻥﺩﺍﺩ-ﺖﺳﺩ-ﺯﺍ: ﻥﺩﺍﺩ-ﺖﺳﺩ-ﺯﺍ, ﻦﺘﺷﺍﺬﮔ-ﺎﺟ
ﮎﺭﺪﻣ: ﯽﮐﺭﺪﻣ, ﺕﺎﺒﺛﺍ, ﺎﻤﻨﻫﺍﺭ, ﺪﯿﻠﮐ, ﺎﻤﻨﻫﺍﺭ-ﺖﺳﺮﻬﻓ, ﻥﺩﺍﺩ-ﺶﯾﺎﻤﻧ, ﺪﻫﺎﺷ
ﯽﮐﺭﺪﻣ-ﺩﺭﻮﻣ: 
ﻦﺘﻓﺭ-ﺶﯿﭘ: ﻦﺘﺷﺍﺩﺮﺑ-ﺪﻨﻠﺑ-ﯼﺎﻫ ﻡﺎﮔ, ﺖﻓﺮﺸﯿﭘ, ﻪﻌﺳﻮﺗ, ﯽﻗﺮﺘﻣ, ﻪﻌﺳﻮﺗ, ﻥﺩﺮﺑ-ﺶﯿﭘ, ﻪﻣﺍﺩﺍ, ﺩﻮﺒﻬﺑ, ﻥﺩﺮﺑ-ﻻ﻿ﺎﺑ
ﺎﻨﺑ: ﻦﺘﺧﺎﺳ, ﺭﺎﺘﺧﺎﺳ, ﺭﺎﺘﺧﺎﺳ, ﺖﺧﺎﺳ, ﻞﺤﻣ
ﻥﺩﺮﮐ-ﻮﺠﺘﺴﺟ: ﻥﺩﺮﮐ-ﺍﺪﯿﭘ, ﻥﺩﺮﻛ-ﻒﺸﻛ, ﻒﺸﮐ, ﻮﺠﺘﺴﺟ, ﻒﺸﮐ, ﻝﺎﺒﻧﺩ-ﻪﺑ, ﻝﺎﺒﻧﺩ-ﻪﺑ, ﻥﺩﺮﻛ-ﻖﻴﻘﺤﺗ, ﯽﺳﺭﺮﺑ, ﺐﯿﻘﻌﺗ, ﻮﺟ-ﻭ-ﺱﺮﭘ, ﯽﺳﺭﺮﺑ-ﻭ-ﻖﯿﻘﺤﺗ, ﻮﺟ-ﻭ-ﺱﺮﭘ
ﻦﯿﮕﻤﻏ: ﻩﺩﺮﺴﻓﺍ, ﯽﺘﺣﺍﺭﺎﻧ-ﺎﺑ, ﯽﺘﺨﺑﺪﺑ, ﻩﺪﻨﻨﻛ-ﺖﺣﺍﺭﺎﻧ, ﻦﯿﮕﻤﻏ, ﺖﻣﺍﺪﻧ, ﻩﺩﺮﺴﻓﺍ
ﻩﺎﻨﮔ: ﻩﺎﻨﮔ
ﯽﺳ: 
ﻕﺩﺎﺻ: ﻕﺩﺎﺻ, ﺭﺍﺩﺎﻓﻭ, ﻪﻧﺎﻗﺩﺎﺻ, ﺢﯾﺮﺻ
ﻪﺘﺴﺑ: ﻦﺘﺴﺑ, ﻪﺘﺴﺑ, ﻥﺪﺷ-ﻪﺘﺴﺑ, ﺵﻮﻣﺎﺧ, ﺐﺼﻧ, ﻦﺘﺴﺑ, ﻪﺘﺴﺑ, ﻪﺘﺴﺑ, ﻪﺘﺴﺑ, ﻪﺘﺴﺑ, ﻪﺘﺴﺑ, ﻦﺘﺷﺍﺩ-ﻪﮕﻧ
ﮏﻧﺎﺑ: ﺖﮑﻤﯿﻧ, ﻊﻠﻗ
ﺖﺷﻮﻧﺮﺳ: ﺕﻭﺮﺛ, ﺲﻧﺎﺷ, ﯼﻮﺤﻧ, ﺪﺼﻘﻣ, ﺭﺎﯿﺴﺑ
ﻞﮕﻨﺟ: ﻞﮕﻨﺟ
ﻦﺘﻓﺮﮔ-ﻩﺯﺍﺪﻧﺍ: ﻩﺯﺍﺪﻧﺍ, ﯼﺮﯿﮔ-ﻩﺯﺍﺪﻧﺍ, ﻥﺯﻭ, ﺮﺘﻣ, ﺮﺘﻣ
ﺕﺭﻮﺻ-ﻦﯾﺍ-ﺮﯿﻏ ﺭﺩ: ﺎﺑﻭﺎﻨﺘﻣ
ﻥﺎﯾﺮﺟ: ﻥﺎﯾﺮﺟ, ﺪﻨﺑ, ﯼﺭﺎﺟ, ﻕﺮﺑ, ﺭﺎﺷ, ﺖﺟ
ﻥﺎﻧ: ﻦﺘﺨﭘ, ﻕﺎﭼ-ﻭ-ﻪﺘﺨﻠﺷ, ﭻﯾﻭﺪﻧﺎﺳ
ﯽﻓﺎﺿﺍ: ﯽﻓﺎﺿﺍ, ﯽﮐﺪﯾ, ﻦﯾﺍ-ﺮﺑ-ﻩﻭﻼ﻿ﻋ, ﺩﺍﺯﺎﻣ, ﺩﺍﺯﺎﻣ, ﺮﺘﺸﯿﺑ, ﻪﻓﺎﺿﺍ, ﻞﻤﮑﻣ, ﻥﺩﺮﮐ-ﻪﻓﺎﺿﺍ, ﻪﻤﯿﻤﺿ
ﻥﺩﺮﻛ-ﺏﺎﺨﺘﻧﺍ: ﺏﺎﺨﺘﻧﺍ, ﺏﺎﺨﺘﻧﺍ, ﺪﯿﻨﮐ-ﺏﺎﺨﺘﻧﺍ, ﯽﺑﺎﺨﺘﻧﺍ, ﺪﯿﻨﮐ-ﺏﺎﺨﺘﻧﺍ, ﺐﺨﺘﻨﻣ, ﯼﺮﯿﮔ-ﻩﺭﺎﻤﺷ, ﯼﺍﺭ, ﻪﻨﯾﺎﻌﻣ, ﺢﯿﺟﺮﺗ
ﻥﺍﻮﯿﺣ: 
zoic-ﺲﻨﺟ: 
eventive-ﺖﻟﺎﺣ: 
ﻥﺎﺴﮑﯾ-ﻪﻌﻗﺍﻭ-ﺮﮕﻧﺎﺸﻧ: 
ﯽﺑﺮﺿ-ﺩﺭﻮﻣ: 
ﻢﯿﺨﺿ: ﻕﺎﭼ, ﻢﯿﺨﺿ-ﺎﺘﺒﺴﻧ, ﻢﮐﺍﺮﺘﻣ, ﯽﺑﺮﭼ
ﺩﻮﺟﻮﻣ: ﻢﺴﯿﻧﺎﮔﺭﺍ, ﺖﯿﻫﺎﻣ
ﻥﺍﺭﺎﺑ: ﺏﻮﻃﺮﻣ, ﻥﺍﺭﺎﺑ-ﺵﺭﺎﺑ, ﺵﻭﺩ
ﺢﻄﺳ: ﺕﺭﻮﺻ, ﺢﻄﺳ, ﺢﻄﺳ, ﻪﻘﻄﻨﻣ
ﺱﺪﻘﻣ: ﺱﺪﻘﻣ, ﺺﻟﺎﺧ, ﺎﻓﺮﺻ
ﯼﻻ﻿ﻮﺟ: 
ﺵﺭﺍﺰﮔ: ﻦﯿﯿﻌﺗ, ﻪﯿﻧﺎﯿﺑ, ﺖﺒﺴﻧ, ﻁﺎﺒﺗﺭﺍ, ﻁﺎﺒﺗﺭﺍ, ﻪﻧﻻ﻿ﺩﺎﻋ, ﻩﺎﮕﺸﯾﺎﻤﻧ, ﻪﻟﺎﻘﻣ, ﻪﺋﺍﺭﺍ, ﻩﺮﻤﻧ
ﻞﺣﺎﺳ: ﻪﺘﺷﺭ, ﺎﯾﺭﺩ-ﻞﺣﺎﺳ
ﻞﯾﺎﻓ: ﺪﻨﺳ, ﭻﯿﭘ-ﻢﯿﺳ, ﻝﺰﻨﻣ, ﻞﯾﺎﻓﻭﺮﭘ, ﯽﻧﺎﮕﯾﺎﺑ
ﻪﻧﺎﺷ: ﺭﻮﺤﻣ, ﺭﻮﺤﻣ, ﺮﯾﻮﺼﺗ, ﻪﻧﺎﺷ, ﻭﺯﺎﺑ
ﻥﺪﺷ-ﺮﯿﮕﻠﻓﺎﻏ: ﺐﺠﻌﺘﻣ, ﺐﺠﻌﺗ
ﯽﺘﻨﻄﻠﺳ: ﯼﺭﻮﺗﺍﺮﭙﻣﺍ, ﺖﻨﻄﻠﺳ, ﯽﻫﺎﺷﺩﺎﭘ, ﯽﯾﺍﻭﺮﻧﺎﻣﺮﻓ, ﯽﻌﻗﺍﻭ, ﯽﻌﻗﺍﻭ
ﻪﻧﺍﺮﺗ: ﮓﻨﻫﺍ, ﺮﯿﺴﻣ, ﯽﮔﺪﻨﻧﺍﻮﺧ, ﺮﻌﺷ
ﯽﺘﺣﺍﺭ: ﺖﻟﻮﻬﺳ, ﻡﺍﺭﺁ, ﺶﺨﺑ-ﺶﻣﺍﺭﺁ, ﻖﯾﻮﺸﺗ, ﯽﺘﺣﺍﺭ, ﯽﻗﺎﺑ, ﻦﯿﮑﺴﺗ
ﯽﺴﮐ-ﺮﻫ: ﯽﺼﺨﺷ-ﺮﻫ, ﯽﺴﮐ, ﯽﺴﮐ, ﺲﻛ-ﭻﻴﻫ, ﯽﺴﮐ-ﺮﻫ
ﻦﻤﭼ: ﮏﺸﺧ-ﻒﻠﻋ, ﺯﺮﻫ-ﻒﻠﻋ, ﻥﺎﻫﺎﯿﮔ-ﮒﺮﺑ-ﻭ ﺥﺎﺷ, ﻦﻤﭼ, ﻡﺮﮔ
ﻢﺳﺭ: ﻥﺪﯿﺸﮐ, ﻥﺪﯿﺸﮐ, ﻞﻘﻧ-ﻭ-ﻞﻤﺣ, ﺖﺴﻫ-ﺐﻟﺎﺟ, ﺖﺳﺍﻮﺧﺭﺩ, ﺏﺍﺬﺟ, ﻥﺪﯿﺸﮐ-ﺭﺎﻨﮐ, ﺞﯿﻬﻣ, ﻥﺩﺮﻛ-ﺏﺬﺟ, ﺐﻟﺎﺟ, ﻢﺳﺭ, ﻦﺘﺷﺍﺩﺮﺑ, ﻥﺩﺮﮐ-ﻖﯾﺮﻔﺗ
ﺡﺎﺘﺘﻓﺍ: ﯽﺗﺎﻣﺪﻘﻣ, ﻪﯿﻟﻭﺍ, ﻒﺸﮐ, ﻑﺎﮑﺷ, ﻑﺎﮑﺷ, ﻩﺩﺮﭘ-ﯽﺑ
ﻦﺋﻭﮊ: 
ﯽﻫﺎﻣ: ﻡﻮﯾﺭﺍﻮﮐﺁ
ﺖﺨﺘﯾﺎﭘ-،ﻪﯾﺎﻣﺮﺳ: ﻞﺼﻓ, ﻕﻭﺪﻨﺻ, ﯽﯾﺍﺭﺍﺩ
ﻥﺎﺘﺴﭘ: ﻪﻨﯿﺳ-ﻪﺴﻔﻗ
ﻑﺮﺑ: ﺦﯾ
ﺕﻼ﻿ﯿﺼﺤﺗ: ﺵﺯﻮﻣﺁ, ﺱﺭﺩ, ﯽﺷﺯﻮﻣﺁ, ﺩﺍﻮﺳ, ﻞﯿﮑﺸﺗ, ﺵﺯﻮﻣﺁ, ﻩﺩﺮﮐ-ﻞﯿﺼﺤﺗ, ﯽﻫﺎﮕﺸﻧﺍﺩ
ﺰﯿﺗ: ﻦﺷﻭﺭ, ﻩﺪﻧﺭﺩ, ﺖﺨﺳ, ﺕﺪﺷ-ﻪﺑ, ﺪﻨﺗ, ﻥﺎﺸﻧ-ﺮﻃﺎﺧ, ﺩﺎﺣ, ﻕﺎﺘﺸﻣ, ﺩﺮﺗ
ﻢﺣﺮﺗ: ﺖﻤﺣﺭ, ﺖﻘﻔﺷ, ﯼﺩﺭﺪﻤﻫ-ﺯﺍﺮﺑﺍ, ﺯﻮﺴﻟﺩ, ﻥﺎﺑﺮﻬﻣ, ﺡﺎﻀﺘﻓﺍ, ﺕﺍﺯﺎﺠﻣ, ﺮﭘ, ﻒﺳﺎﺗ-ﻪﯾﺎﻣ, ﺮﺑ-ﻥﺩﺮﮐ-ﯼﺯﻮﺴﻟﺩ, ﻪﻣﺪﺻ, ﻥﺪﻧﺎﺳﺭ-ﺐﯿﺳﺁ, ﺖﻣﺍﺪﻧ
ﻪﻨﯾﺰﻫ: ﺖﺧﺍﺩﺮﭘ, ﻪﻨﯾﺰﻫ, ﻪﻨﯾﺰﻫ, ﭖﺎﭼ, ﺪﯿﻟﻮﺗ, ﮊﺭﺎﺷ
ﺎﻤﺷ-ﻝﺎﻣ: ﺍﺭ-ﺩﻮﺧ
ﻥﻮﯿﻠﯿﻣ: ﻥﻮﯿﻠﯿﻣ
ﻪﺘﺴﺧ: ﯽﮕﺘﺴﺧ, ﻩﺪﻨﻨﮐ-ﻪﺘﺴﺧ
ﻦﺘﺸﮐ: ﯽﺸﮐ-ﻡﺩﺁ, ﻞﺘﻗ
ﻪﯾﺎﺳ: ﻪﯾﺎﺳ
ﻥﺯﻭ: ﺭﺎﺑ, ﻦﯿﮕﻨﺳ, ﺕﺪﺷ-ﻪﺑ, ﻥﺯﻭ, ﺭﺎﺸﻓ
ﻡﺮﺟ: ﺖﯿﻔﯿﮐ, ﯽﻌﻤﺟ, ﺭﺍﺪﻘﻣ, ﻢﺠﺣ, ﻊﻤﺟ, ﺭﺎﯿﺴﺑ, ﻩﺩﻮﺗ, ﻪﺷﻮﺧ, ﺖﯿﻌﻤﺟ, ﻡﺮﺟ, ﺮﯿﻤﺧ, ﺎﺘﺳﺎﭘ
ﺩﺎﺠﯾﺍ: ﺐﺼﻧ, ﺪﻣﺎﺟ, ﻢﮑﺤﻣ, ﺕﺎﺒﺛ-ﺎﺑ, ﺩﺎﺠﯾﺍ, ﺩﺎﺠﯾﺍ, ﺖﻗﻭ
ﻉﺎﺠﺷ: ﺭﻮﺴﺟ
ﺮﻏﻻ﻿: ﺮﻏﻻ﻿, ﻥﺩﺮﮐ-ﻖﯿﻗﺭ, ﯽﻃﻭﺮﺨﻣ, ﮏﯾﺭﺎﺑ, ﺮﻏﻻ﻿, ﺏﻮﺧ, ﻒﯿﻄﻟ, ﺰﯾﺭ, ﮎﺪﻧﺍ, ﯽﺘﻨﻌﻟ, ﻖﯿﻗﺭ, ﻒﯾﺮﻇ, ﻩﺯﺍﺪﻧﺍ
ﯽﺿﺍﺭ: ﻝﺎﺤﺷﻮﺧ, ﺖﯾﺎﺿﺭ, ﺖﻋﺎﻨﻗ, ﻝﺎﺤﺷﻮﺧ, ﻥﺩﺮﮐ-ﻊﻧﺎﻗ, ﺶﺨﺑ-ﺖﯾﺎﺿﺭ
ﯽﺳﺭﺮﺑ: ﯽﺳﺭﺮﺑ, ﻦﮐ-ﻩﺎﮕﻧ, ﻥﺩﺮﮐ-ﺎﺷﺎﻤﺗ, ﺏﺎﺨﺘﻧﺍ, ﯽﺳﺭﺮﺑ, ﯽﺳﺭﺯﺎﺑ, ﻪﻨﯾﺎﻌﻣ, ﺖﺴﺗ, ﯽﺳﺮﺑﺎﺴﺣ, ﻂﺳﺍﻭ-ﺪﺣ, ﯽﺳﺭﺮﺑ, ﯽﺳﺭﺮﺑ, ﻡﻮﻠﻌﻣ, ﻥﺩﺮﮐ-ﺮﻈﻧ-ﺪﯾﺪﺠﺗ, ﻝﺮﺘﻨﮐ
ﺍﻮﻘﺗ: ﯽﻧﺎﺑﺮﻬﻣ, ﺖﻠﯿﻀﻓ-ﺎﺑ, ﯽﺑﻮﺧ, ﯽﻫﺍﻮﺧ-ﺮﯿﺧ
ﯽﻠﻣ: ﺖﻠﻣ, ﺖﯿﻠﻣ, ﯽﻣﻮﻗ, ﯽﮕﻧﺎﺧ
ﯽﻬﻟﺍ: ﺱﺪﻘﻣ
ﻩﺭﺩ: ﻪﻧﺎﺧﺩﻭﺭ-ﻩﺯﻮﺣ
ﻥﺰﺑ-ﺱﺪﺣ: ﺝﺎﺘﻨﺘﺳﺍ, ﻥﻮﻨﻈﻣ, ﺽﺮﻓ, ﻥﺩﺯ-ﻦﯿﻤﺨﺗ, ﻥﺩﺮﮐ-ﺩﺭﻭﺁﺮﺑ, ﯽﻨﯿﺑ-ﺶﯿﭘ, ﯽﻨﯿﺑ-ﺶﯿﭘ, ﯽﻨﯿﺑ-ﺶﯿﭘ, ﻥﺪﯿﺸﯾﺪﻧﺍ
ﯼﺮﮑﻔﺗ-ﺖﻟﺎﺣ: ﯽﺿﺮﻓ-ﺖﻟﺎﺣ
ﺩﺭﺯ-ﮓﻧﺭ: ﻩﺪﯾﺮﭘ-ﮓﻧﺭ, ﺎﺑﺮﻬﮐ, ﺎﻫ-ﺵﺯﺭﻭ
ﯽﻗﺎﺑ: ﻩﺪﻧﺎﻣ-ﯽﻗﺎﺑ, ﻩﺪﻧﺎﻣ-ﯽﻗﺎﺑ, ﻩﺪﻧﺎﻣ-ﯽﻗﺎﺑ, ﯽﻗﺎﺑ, ﯽﻗﺎﺑ
ﻩﺪﺷ-ﻢﺧ: ﯽﻨﺤﻨﻣ, ﻢﺧ, ﻢﺧ-ﻭ-ﭻﯿﭘ ﺮﭘ, ﺪﻧﻭﺭ, ﻩﺩﺭﻮﺧ-ﭻﯿﭘ, ﺐﯿﺷ, ﺐﯿﺷ, ﺞﮐ, ﻮﺷﺎﺗ
ﻪﺒﻌﺟ: ﻥﺍﺪﻤﭼ, ﻮﺸﮐ, ﻕﻭﺪﻨﺻ, ﺖﯿﮐ, ﻥﺍﻮﺗ-ﯽﻣ, ﻦﺑ
ﻞﺼﻓ: ﯽﻠﺼﻓ, ﻞﺼﻓ, ﻩﺎﮕﺘﺴﯾﺍ, ﺮﺼﻋ
ﯽﺑﺮﺠﺗ-ﻡﻮﻠﻋ: ﯽﻤﻠﻋ
ﻥﺩﺮﮐ-ﺥﺍﺭﻮﺳ-ﻪﺘﻣ ﺎﺑ: ﺥﺍﺭﻮﺳ, ﻪﺘﻣ, ﺪﻨﮐ, ﺮﺑ-ﺮﺳ-ﻪﻠﺻﻮﺣ, ﻥﺩﺮﮐ-ﺥﺍﺭﻮﺳ, ﻥﺩﺮﮐ-ﮏﯾﺮﺤﺗ, ﻦﻤﺠﻧﺍ
ﯽﯾﺍﺩ: 
ﺖﺳﺮﻬﻓ: ﺺﺧﺎﺷ, ﺖﺳﺮﻬﻓ, ﻮﻨﻣ, ﻡﺎﻧ-ﺖﺒﺛ
ﺕﻭﺍ: 
ﺪﻨﺴﭘ-ﻪﻣﺎﻋ: ﻉﻮﯿﺷ, ﻑﻭﺮﻌﻣ, ﻪﺘﺴﺟﺮﺑ, ﻡﺩﺮﻣ
ﻪﺘﺧﺎﻨﺷﺎﻧ: ﻪﻧﺎﮕﯿﺑ
ﺎﻨﺷﺁ: ﯽﯾﺎﻨﺷﺁ, ﺐﺴﻧ-ﻭ-ﻞﺻﺍ, ﻞﺴﻧ
ﺎﻨﺷﺁ-ﻡﺎﻧ-ﺖﺒﺛ: 
ﻩﺪﻨﻧﺍﻮﺧ: ﻩﺪﻨﻧﺍﻮﺧ
ﺵﻭﺭ: ﻪﺑ-ﻥﺪﯿﺳﺭ, ﯽﺳﺮﺘﺳﺩ, ﮏﯿﻨﮑﺗ, ﮏﯿﺘﮐﺎﺗ, ﯽﺳﺎﻨﺷ-ﺵﻭﺭ, ﺵﺮﮕﻧ, ﺵﻭﺭ, ﺵﻭﺭ, ﺵﻭﺭ, ﺵﻭﺭ, ﺐﯾﺮﻘﺗ, ﻂﺑﺍﺭ
ﺮﺑﺍﺮﺑ-ﻭﺩ: ﺮﺑﺍﺮﺑ-ﻭﺩ
ﯼﺮﮑﻓ: ﻦﻫﺫ, ﺵﻮﻫ, ﯽﻧﺍﻭﺭ, ﺪﻨﻤﺷﻮﻫ---ﺵﻮﻫﺎﺑ, ﯽﻧﺍﻭﺭ, ﺯﺍﺩﺮﭘ-ﻩﺪﯾﺍ, ﺩﺮﺧ, ﯽﻧﺎﺣﻭﺭ
ﯽﺘﺳﺍﺮﺑ: ﺎﻌﻗﺍﻭ, ﻊﻗﺍﻭ-ﺭﺩ, ﻼ﻿ﻣﺎﮐ, ﻊﻗﺍﻭﺭﺩ, ﻼ﻿ﻤﻋ, ﺎﺒﯾﺮﻘﺗ, ﺖﺳﺭﺩ, ﻕﺩﺎﺻ, ﻦﯿﺑ-ﻊﻗﺍﻭ, ﻼ﻿ﻣﺎﮐ, ﺎﻌﻄﻗ, ﻢﺸﭼ-ﯼﻭﺭ-ﻪﺑ, ﺎﻌﻄﻗ, ﺎﻤﻠﺴﻣ
ﺶﯿﺸﮐ: ﻥﻮﯿﻧﺎﺣﻭﺭ
ﺡﻭﺮﺠﻣ: ﺡﻭﺮﺠﻣ, ﻢﺧﺯ, ﻪﻣﺪﺻ
ﻩﻭﺪﻧﺍ-ﻭ-ﻢﻏ: ﻢﻏ, ﻪﺼﻏ-ﻭ-ﻢﻏ, ﯽﮔﺩﺮﺴﻓﺍ, ﻩﺩﺮﺴﻓﺍ, ﯼﺭﺍﺩﺍﺰﻋ, ﻩﻭﺪﻧﺍ-ﻭ-ﻢﻏ
ﺥﺎﮐ: 
ﻢﺘﺷ-ﻭ-ﺏﺮﺿ: ﺖﺴﮑﺷ, ﺖﺸﻣ, ﻥﺩﺯ-ﯽﻠﯿﺳ, ﻥﺩﺯ-ﺭﺩ, ﻥﺩﺯ-ﻢﻬﺑ-ﺕﺪﺷ ﺎﺑ, ﻢﺘﯾﺭ, ﺮﺑ-ﻪﺒﻠﻏ
؟ﯽﻤﯾﻼ﻿ﻣ-ﺪﻨﮔﻮﺳ: 
ﻖﻤﺣﺍ: ﻪﻧﺎﻘﻤﺣﺍ, ﻦﻓ-ﻭ-ﺕﻮﻓ, ﻥﺩﺍﺩ-ﺐﯾﺮﻓ, ﻥﺩﺍﺩ-ﺐﯾﺮﻓ, ﻖﻤﺣﺍ, ﻖﻤﺣﺍ, ﻪﻧﺍﻮﯾﺩ, ﻪﻧﺍﻮﯾﺩ, ﻪﻧﺍﻮﯾﺩ, ﻥﺩﺮﮐ-ﻩﺍﺮﻤﮔ
ﻪﺒﻟ: ﺯﺮﻣ, ﻪﯿﺷﺎﺣ, ﯼﺍ-ﻪﯿﺷﺎﺣ, ﺪﯾﺪﺷ, ﺯﺮﻣ, ﻪﯿﺷﺎﺣ, ﻪﺘﺨﺗ
ﺮﻔﻧ-ﻪﻧ: ﻦﯿﻤﻬﻧ, ﺪﯾﺪﺟ
ﺭﺎﺠﻔﻧﺍ: ﺭﺎﺠﻔﻧﺍ, ﺭﺎﺠﻔﻧﺍ, ﻥﺪﺷ-ﺮﺠﻔﻨﻣ, ﻩﺩﺭﻮﺧ-ﮎﺮﺗ, ﺵﺮﻏ, ﺞﻨﺸﺗ, ﺭﺎﺠﻔﻧﺍ
ﻥﺩﺮﺑ-ﺞﻧﺭ: ﻞﻤﺤﺗ, ﻆﻔﺣ
ﺍﺪﺻ-ﻭ-ﺮﺳ: ﺍﺪﺻ-ﻭ-ﺮﺳ ﺮﭘ, ﺩﺎﯾﺮﻓ, ﻦﺘﻓﺮﮔ-ﺩﺍﺮﯾﺍ, ﺍﺪﺻ-ﻭ-ﺮﺳ
ﺕﺎﯿﺑﺩﺍ: ﯽﺑﺩﺍ
ﺖﺤﯿﺼﻧ: ﺍﺭﻮﺷ, ﻪﯿﺻﻮﺗ, ﻪﯿﺻﻮﺗ, ﻪﯿﺻﻮﺗ, ﻩﺭﻭﺎﺸﻣ, ﻪﺘﺨﺗ, ﻡﺎﻌﻧﺍ
ﯽﻟﺎﺧ: ﯽﻟﺎﺧ-ﯼﺎﺟ, ﯽﻟﺎﺧ, ﻞﺒﻃ, ﺖﻏﺍﺮﻓ, null-ﺭﺍﺪﻘﻣ, ﯽﭼﻮﭘ, ءﻼ﻿ﺧ, ﻩﺩﻮﻬﯿﺑ
ﻪﺒﺗﺭ: ﺖﺴﭘ, ﻪﺟﺭﺩ, ﺖﯿﻘﻓﻮﻣ, ﯼﺪﻨﺑ-ﻪﺘﺳﺩ, ﺵﺯﺭﺍ, ﺱﻼ﻿ﮐ
ﻥﺎﻓﻮﻃ: 
ﺐﯿﺟ: ﻪﺴﯿﮐ, ﻪﺘﺴﺑ
ﻞﯿﺨﺗ: ﯽﻨﻨﻔﺗ, ﻦﮐ-ﺭﻮﺼﺗ, ﺽﺮﻓ, ﯼﺰﺘﻧﺎﻓ, ﻥﺎﺘﺳﺍﺩ, ﯽﻟﺎﯿﺧ
ﻪﻠﻤﺟ: ﯼﺭﻭﺍﺩ, ﯼﺭﻭﺍﺩ, ﻩﺭﺍﺰﮔ, ﻪﯿﻀﻗ, ﺩﺎﻬﻨﺸﯿﭘ, ﯼﺩﺎﻬﻨﺸﯿﭘ-ﺡﺮﻃ, ﺕﺍﺯﺎﺠﻣ, ﻩﺪﯿﻘﻋ, ﺕﺭﺎﺒﻋ, ﻥﺩﺮﮐ-ﻡﻮﮑﺤﻣ, ﻡﻮﮑﺤﻣ, ﺕﺍﺯﺎﺠﻣ
ﺮﺒﻣﺍﻮﻧ: 
ﺮﺒﻣﺎﺳﺩ: 
ﻡﺪﻋ: ﺐﯾﺎﻏ, ﻡﺪﻋ, ﺩﻮﺒﻤﮐ
ﺮﮑﺸﺗ: ﯽﺳﺎﻨﺷ-ﻖﺣ, ﺭﺍﺰﮕﺳﺎﭙﺳ, ﺮﮑﺸﺗ-ﺎﺑ, ﻡﺮﮑﺸﺘﻣ
ﯽﻧﺎﺸﻧ: 
ﻩﺪﻧﺮﭘ: ﺯﺍﻭﺮﭘ, ﺢﻄﺳ, ﺖﺟ, ﺎﻤﯿﭘﺍﻮﻫ, ﺎﻤﯿﭘﺍﻮﻫ, ﯽﯾﺎﻤﯿﭘﺍﻮﻫ
ﮏﻟﺎﻣ: ﺲﻴﺋﺭ, ﻪﻧﺎﺧ-ﺐﺣﺎﺻ
ﺖﮐ: ﺐﺷ-ﺱﺎﺒﻟ, ﻑﻼ﻿ﻏ, ﺶﺷﻮﭘ, ﺖﮐﺍﮊ, ﺰﺧ
ﻥﺩﺮﮐ-ﻩﺩﺎﻣﺁ: ﻥﺩﻮﺑ-ﻩﺩﺎﻣﺁ, ﻩﺪﺷ-ﻩﺩﺎﻣﺁ, ﻥﺩﺍﺩ-ﻥﺎﻣﺯﺎﺳ, ﯼﺯﺎﺳ-ﻩﺩﺎﻣﺁ, ﻪﻟﻮﻣﺮﻓ-ﻭ-ﻦﯾﻭﺪﺗ
ﻂﺑﺍﻭﺭ: ﻁﺎﺒﺗﺭﺍ, ﻁﺎﺒﺗﺭﺍ, ﺖﺒﺴﻧ, ﻁﺎﺒﺗﺭﺍ, ﻁﺎﺒﺗﺭﺍ, ﺮﻣﺍ, ﻁﺎﺒﺗﺭﺍ, ﻥﺩﺮﻛ-ﺭﺍﺮﻗﺮﺑ-ﻁﺎﺒﺗﺭﺍ
ﺩﻭﺩ: ﻥﺪﯿﺸﮐ-ﺭﺎﮕﯿﺳ, ﺕﺎﯿﻧﺎﺧﺩ, ﯽﮕﺘﺧﻮﺳ
ﻪﯾﻮﻧﺍﮊ: 
ﻦﯿﺷﺎﻣ: ﻩﺎﮕﺘﺳﺩ, ﺭﻮﺗﻮﻣ, ﺢﻄﺳ, ﻪﯿﻠﻘﻧ-ﻪﻠﯿﺳﻭ
ﺍﻮﺘﺤﻣ: ﻩﺩﺎﻣ, ﺰﯿﭼ, ﻖﺑﺎﻄﻣ, ﻥﺩﺮﮐ-ﻊﻧﺎﻗ, ﯼﻭﺎﺣ, ﻞﻣﺎﺷ, ﻞﻣﺎﺷ, ﻞﻣﺎﺷ
ﺎﻬﻧﺍﺪﻧﺩ: ﻥﺍﺪﻧﺩ, ﻩﺪﻧﺩ
ﻡﺮﺷ: ﯽﯾﺍﻮﺳﺭ, ﻩﺩﺯ-ﺖﻟﺎﺠﺧ, ﯽﺘﻟﺎﺠﺧ, ﻞﺠﺧ, ﺭﻭﺁ-ﻡﺮﺷ, ﺖﻟﺎﺠﺧ, ﺖﺨﻟ, ﻪﻨﻫﺮﺑ, ﻥﺩﺮﻛ-ﻦﻴﻫﻮﺗ, ﺖﻣﺮﺣ-ﮏﺘﻫ
ﺰﻣﺮﻗ-ﻪﺑ-ﻞﯾﺎﻣ ﺥﺮﺳ: ﺕﻮﺗ, ﻞﺒﻬﻣ
ﺰﻐﻣ: ﺮﮑﻔﺘﻣ-ﺰﻐﻣ, ﺰﻐﻣ
ﻪﻘﻠﺣ: ﺩﺮﺧ, ﯼﺮﯿﮔ-ﻩﺭﺎﻤﺷ, ﻪﻘﻠﺣ, ﻪﻘﻠﺣ, ﮏﯿﺘﺳﻻ﻿, ﮏﯿﺘﺳﻻ﻿, ﯽﺑﺍ-ﮎﻮﺧ, ﺮﻬﻣ
ﺕﺭﺎﺒﻋ-ﺮﮕﻧﺎﺸﻧ: 
ﻊﺑﺮﻣ: 
ﻩﻮﯿﻣ: 
ﯼﺎﭼ: 
ﺢﯿﺿﻮﺗ: ﺢﯿﺿﻮﺗ, ﻥﺩﺍﺩ-ﻥﺎﺸﻧ, ﻥﺎﯿﺑ, ﻥﺎﯿﺑ, ﻦﺘﺷﺍﺩ-ﺭﺎﻬﻇﺍ, ﻥﺩﺮﮐ-ﺢﯾﺮﺼﺗ, ﺮﯿﺴﻔﺗ, ﺢﯿﺿﻮﺗ
ﯼﺪﻣﺁ-ﺵﻮﺧ: ﯽﺳﺮﭘ-ﻝﺍﻮﺣﺍ-ﻭ ﻡﻼ﻿ﺳ, ﺵﺮﯾﺬﭘ, ﻥﺩﺮﮐ-ﻡﺮﮔﺮﺳ, ﯽﻫ, ﻡﻼ﻿ﺳ, ﻦﺘﻔﮔ-ﮏﯾﺮﺒﺗ
ﺮﻌﺷ: ﺮﻌﺷ, ﺮﻌﺷ
ﺪﯾﺮﺧ: ﺪﯾﺮﺧ, ﻥﺩﺭﻭﺁ-ﺖﺳﺩ, ﻦﺘﺷﺍﺩ-ﺖﻋﺎﻄﺘﺳﺍ, ﺭﺍﺯﺎﺑ
ﻥﺎﻤﯾﺍ-ﺎﺑ: ﺐﻠﻘﺘﻣ, ﺭﺍﺩﺎﻓﻭ, ﻪﻧﺎﻗﺩﺎﺻ, ﺭﺎﮐﺍﺪﻓ, ﺖﺳﺭﺩ, ﺩﺎﻤﺘﻋﺍ-ﻞﺑﺎﻗ
ﻥﺎﺠﯿﻫ: ﮏﯾﺮﺤﺗ, ﻪﺘﺨﯿﮕﻧﺍﺮﺑ, ﻦﺘﻓﺮﮔ-ﺩﺍﺮﯾﺍ, ﺶﻨﺗ, ﮏﯾﺮﺤﺗ, ﺕﺬﻟ, ﯽﮕﺘﺨﯿﮕﻧﺍ, ﻥﺩﺮﮐ-ﺖﯿﭘ-ﻭ ﻂﯿﺧ, ﺏﺍﺮﻄﺿﺍ
ﻞﻬﭼ: 
ﻞﯾﺭﻭﺁ: 
ﺰﯿﻣﺁ-ﺖﺒﺤﻣ: ﻢﻨﻛ-ﻰﻣ-ﺶﻫﺍﻮﺧ, ﻪﻧﺎﺘﺳﻭﺩ, ﯽﻣﺍﺭﺁ-ﻪﺑ
ﺮﺒﺘﮐﺍ: 
ﺦﻠﺗ: ﯽﺘﺨﺳ, ﺞﻧﺭ, ﻩﻭﺪﻧﺍ-ﻭ-ﻢﻏ, ﯽﺨﻠﺗ-ﻪﺑ, ﻥﺪﯿﺸﮐ-ﺞﻧﺭ, ﮎﺎﻧﺩﺭﺩ, ﺶﯿﻧ
ﻩﺩﺮﺑ: ﯽﮔﺩﺮﺑ
ﻞﺷ: ﻞﻘﺘﺴﻣ, ﻪﻧﺍﺩﺍﺯﺁ, ﻥﺩﺮﮐ-ﻑﺮﻃﺮﺑ, ﻥﺩﺮﻛ-ﻞﺣ, ﻞﺷ, ﯽﻟﺎﺧ, ﻪﻧﺍﺩﺍﺯﺁ
ﻦﺘﻣ: ﯼﺪﻨﺑ-ﻪﻠﻤﺟ
ﺭﺎﺒﺘﻋﺍ: ﻦﻫﺭ, ﯼﺭﺎﺒﺘﻋﺍ-ﺕﺭﺎﮐ, ﯽﻫﺪﺑ, ﻥﺩﺍﺩ-ﺽﺮﻗ, ﻦﺘﻓﺮﮔ-ﺖﻧﺎﻣﺍ, ﻡﺍﻭ, ﺭﺎﺒﺘﻋﺍ, ﺭﺎﺒﺘﻋﺍ, ﺭﺎﺒﺘﻋﺍ
ﻩﺩﺰﻧﺎﭘ: 
ﻪﻧﺎﻤﻟﺎﻇ: ﻩﺪﻧﺭﺩ, ﺖﺨﺳ
ﻥﺩﺮﮐ-ﻞﺻﻭ: ﻥﺩﺮﮐ-ﺖﮐﺮﺷ, ﻥﺩﺮﻛ-ﻪﻌﺟﺍﺮﻣ, ﺭﺎﮐﺭﺪﻧﺍ-ﺖﺳﺩ, ﻮﺷ-ﺭﺍﻮﺳ, ﻥﺪﯿﺒﺴﭼ, ﻩﺪﻨﻨﮐ-ﺖﮐﺮﺷ, ﯼﺮﯿﮔﺭﺩ, ﻥﺩﺮﮐ-ﺪﺤﺘﻣ, ﻝﺎﺼﺗﺍ
ﺪﻨﯾﺁﺮﻓ: ﯽﮔﺪﯿﺳﺭ, ﺵﻭﺭ, ﻥﺎﻣﺭﺩ, ﺩﺮﮑﻠﻤﻋ, ﺶﯾﺎﻣﺯﺁ
ﻩﺰﺑ-؛ﺖﯾﺎﻨﺟ-؛ﻡﺮﺟ: ﻩﺎﻨﮔ, ﻡﺮﺟ, ﻦﯿﻫﻮﺗ
ﮎﺎﺧ-ﻭ-ﺩﺮﮔ: ﺪﺳ, ﺭﺩﻮﭘ
ﯽﻠﻤﻋ: ﯽﻌﺑﺎﺗ, ﯽﻠﻤﻋ, ﻼ﻿ﻤﻋ, ﺖﺣﺍﺭ, ﺎﺒﯾﺮﻘﺗ, ﯽﺘﺳﺩ, ﯽﻠﻤﻋ
ﮓﻧﺭ: ﮓﻧﺭ, ﮓﻧﺭ, ﺱﻮﻫ-ﻭ-ﯼﻮﻫ, ﮓﻧﺭ, ﻩﺪﯾﺮﭘ-ﮓﻧﺭ, ﯽﮕﻧﺭ, ﮓﻧﺭﺎﮕﻧﺭ, ﻥﺩﺮﮐ-ﺖﯿﭘ-ﻭ ﻂﯿﺧ, ﻥﺎﯾﺎﭘ
ﻦﺘﻓﺭ-ﻦﯿﺑ-ﺯﺍ: ﻥﺩﺮﮐ-ﺏﺍﺮﺧ, ﻥﺩﺮﺑ-ﻞﯿﻠﺤﺗ, ﯼﺭﺎﮑﺑﺍﺮﺧ, ﺶﻫﺎﮐ, ﻥﺩﺮﮐ-ﺏﺍﺮﺧ, ﻥﺪﺷ-ﻪﻟ, ﻥﺪﯿﺑﻮﮐ-ﻢﻫﺭﺩ, ﺏﺍﺮﺧ, ﻥﺩﺮﮐ-ﺕﺎﻣ, ﻥﺩﺮﮐ-ﮎﺎﭘ, ﻥﺩﺮﮐ-ﯽﺜﻨﺧ, ﺐﯾﺮﺨﺗ
ﻥﺩﺍﺩ-ﺶﯾﺍﺰﻓﺍ: ﻪﻣﺍﺩﺍ, ﻥﺩﺮﺑ-ﻻ﻿ﺎﺑ, ﻩﻮﮐ, ﻥﺩﺮﺑ-ﻻ﻿ﺎﺑ, ﻥﺩﺮﮐ-ﻪﻓﺎﺿﺍ, ﻥﺩﺍﺩ-ﺭﺍﺮﻗ, ﺪﺷﺭ, ﻥﺩﺮﮐ-ﮒﺭﺰﺑ
ﯽﻨﯿﺑ: 
ﻥﺩﺮﮐ-ﺭﺍﺮﻗﺍ: ﻦﺘﺧﺎﻨﺷ-ﺖﯿﻤﺳﺭ-ﻪﺑ, ﻥﺩﺮﮐ-ﺭﺍﺬﮔﺍﻭ, ﺪﯿﻨﮐ-ﺪﯿﯾﺎﺗ, ﺺﯿﺨﺸﺗ, ﻥﺎﻋﺫﺍ, ﺐﯾﻮﺼﺗ, ﺪﯿﯾﺎﺗ, ﻥﺩﺮﮐ-ﺎﻄﻋﺍ, ﻩﺰﯾﺎﺟ
ﺯﻭﺮﯾﺩ: ﺍﺩﺮﻓ
hesternal-ﺖﻔﺳ: 
ﺖﺴﮑﺷ: ﺖﺴﮑﺷ, ﻖﻓﻮﻣﺎﻧ, ﺖﺴﮑﺷ, ﺖﺴﮑﺷ, ﻥﺍﻮﺗﺎﻧ, ﻥﺩﺮﮐ-ﺕﺎﻣ, ﺪﯿﻣﺍ-ﺎﻧ
ﻪﻣﺍﺩﺍ: ﻪﻣﺍﺩﺍ, ﻡﻭﺍﺪﻣ, ﻡﻭﺍﺪﻣ, ﻪﻣﺍﺩﺍ, ﻡﻭﺍﺪﻣ-ﺭﻮﻃ-ﻪﺑ, ﻪﻣﺍﺩﺍ
ﻥﺪﯿﺷﻮﭘ: ﻞﻤﺣ, ﺮﺑﺭﺎﺑ
ﺎﻨﯿﺑﺎﻧ: 
ﻦﯿﺟﻭﺩ: ﺪﻨﭼ
ﺯﺍﻭﺮﭘ: ﺯﺍﻭﺮﭘ, ﺵﺮﭘ, ﺯﺍﻭﺮﭘ, ﯼﺩﺭﻮﻧﺍﻮﻫ
ﺶﯾﺎﺘﺳ: ﻦﯿﺴﺤﺗ, ﻥﺩﺮﮐ-ﻦﯿﺴﺤﺗ, ﺕﺮﻬﺷ, ﯽﮕﺘﺴﯾﺎﺷ, ﻦﺘﻔﮔ-ﮏﯾﺮﺒﺗ, ﻢﻳﻮﮔ-ﻲﻣ-ﻚﻳﺮﺒﺗ, ﻩﻮﮑﺷ, ﺕﺮﻬﺷ
ﻥﺎﻄﯿﺷ: 
ﻪﺘﻓﺭ-ﻪﺘﻓﺭ: ﯽﻣﺍﺭﺁ-ﻪﺑ, ﯽﺠﯾﺭﺪﺗ
ﯽﻧﺎﺑﺮﻗ: ﯽﻧﺎﺑﺮﻗ, ﺭﺎﮑﺷ, ﻪﺤﻧﺎﺳ
ﻦﯾﺮﻤﺗ: ﯽﻧﺍﻮﻠﻬﭘ, ﻥﺩﺮﮐ-ﺭﺎﮐ, ﯼﺭﺍﺬﮔﺍﻭ, ﻞﻤﻋ, ﻞﻤﻋ, ﺵﺯﺭﻭ, ﻡﺍﺪﻧﺍ-ﺐﺳﺎﻨﺗ, ﻦﯾﺮﻤﺗ
ﻥﺍﺪﺟﻭ: ﺮﯿﻤﺿ, ﯼﺭﺎﯿﺷﻮﻫ
ﻪﯾﺮﻈﻧ: ﻞﺻﺍ, ﺯﺍﺩﺮﭘ-ﻪﯾﺮﻈﻧ, ﻪﯿﻀﻗ
ﺮﯾﺯﻭ: 
ﺕﺮﻔﻧ: ﻩﺪﻨﻧﺯ-ﻭ-ﺪﻨﺗ, ﺭﻭﺁ-ﺵﺪﻨﭼ, ﺕﺮﻔﻧ, ﻦﺘﺷﺍﺪﻧ-ﺖﺳﻭﺩ, ﺐﺼﻌﺗ, ﻪﻨﯿﮐ, ﺯﺍ-ﻥﺪﺷ-ﻦﯿﮕﻤﺸﺧ, ﺮﺟﺰﻨﻣ, ﺕﺮﻔﻧ, ﺭﺎﺟﺰﻧﺍ
ﻪﭼﺎﯾﺭﺩ: 
ﺰﮐﺮﻣ: ﯼﺰﮐﺮﻣ, ﺰﮐﺮﻣ, ﻩﺎﮕﺘﺴﯾﺍ, ﯽﻫﺪﻧﺎﻣﺮﻓ-ﺰﮐﺮﻣ
ﻦﺘﻓﺭ-ﻝﺎﺣ-ﺯﺍ: ﻩﺎﮔﺁﺩﻮﺧﺎﻧ, ﺱﺎﯾ, ﻪﺘﺷﺬﮔ-ﻥﺎﺟ-ﺯﺍ, ﻒﯿﻌﺿ, ﻩﺪﯾﺮﭘ-ﮓﻧﺭ
ﯽﻘﻄﻨﻣ-ﺲﻨﺟ: 
ﻖﯿﻗﺩ: ﺮﮑﻔﺘﻣ, ﻪﺟﻮﺘﻣ, ﻦﺘﺷﺍﺩ-ﺰﮐﺮﻤﺗ, ﻁﺎﺘﺤﻣ, ﻖﯿﻗﺩ, ﻖﯿﻗﺩ, ﻖﯿﻗﺩ, ﻖﯿﻗﺩ
ﺪﯾﺮﺒﺑ-ﺕﺬﻟ: ﺕﺬﻟ, ﯽﻧﺍﺩﺭﺪﻗ
ﺕﺩﺎﺒﻋ: ﺕﺎﻔﯾﺮﺸﺗ
ﺕﻻ﻿ﻮﺼﺤﻣ: ﻝﻮﺼﺤﻣ, ﺩﺭﻮﻣ, ﻻ﻿ﺎﮐ, ﻻ﻿ﺎﮐ, ﺰﯿﭼ
ﺖﺳﻮﭘ: ﻡﺮﭼ, ﺏﺬﺟ, ﮓﺳ-ﺱﺭﺎﭘ, ﻪﺘﺳﻮﭘ, ﻥﺪﻨﮐ-ﺖﺳﻮﭘ, ﺰﺧ, ﻩﺰﻣ
ﻒﻘﺳ: ﺱﺍﺮﺗ, ﻒﻘﺳ, ﺶﺷﻮﭘ, ﺶﺷﻮﭘ, ﮏﻫﻼ﻿ﮐ
ﯽﻫﺎﺷﺩﺎﭘ-ﺝﺎﺗ: 
ﻪﻌﻠﻗ: ﺲﻔﻗ, ﺥﺭ, ﻞﻔﻗ
ﯽﻫﺎﺷﺩﺎﭘ-ﺖﺨﺗ: 
ﻪﺘﺴﺑﺍﻭ: ﻥﺩﺮﮐ-ﻝﻮﻐﺸﻣ, ﻁﻭﺮﺸﻣ, ﻪﻤﯿﻤﺿ, ﻞﺼﺘﻣ, ﻪﺘﺴﺑﺍﻭ, ﻪﺘﺴﺑﺍﻭ
ﻞﯾﺎﻣ: ﺶﯾﺍﺮﮔ, ﺐﯿﺷ, ﺮﻏﻻ﻿, ﺐﯿﺷ, ﻞﯾﺎﻣ
ﻁﺮﻔﻣ: ﻦﯾﺮﺘﺸﯿﺑ, ﯽﯾﺎﻬﻧ, ﺐﻄﻗ, ﯽﺒﻄﻗ, ﯽﻃﺍﺮﻓﺍ, ﯼﺪﺟ, ﺪﯾﺪﺷ, ﺪﯾﺪﺷ, ﻡﺍﺪﻧﺍ, ﻡﺎﻌﻧﺍ
ﻥﺍﺪﻧﺯ: ﻥﺍﺪﻧﺯ
ﻥﺎﺠﻨﻓ: ﻥﺍﻮﯿﻟ, ﻪﺳﺎﮐ
ﻮﻀﻋ: ﻮﻀﻋ, ﺖﯾﻮﻀﻋ, ﻡﺍﺪﻧﺍ, ﯼﺩﻮﺧ
ﯽﻧﺪﻣ: ﯽﮕﻧﺎﺧ, ﺪﻧﻭﺮﻬﺷ, ﯽﻧﺪﻣ, ﯽﻣﺎﻈﻧ-ﺮﯿﻏ
ﺎﺟ-ﻪﻤﻫ-ﺭﺩ: ﺮﺳﺍﺮﺳ, ﺎﺟ-ﺮﻫ
ﺩﻮﻬﺸﻣ: ﺢﺿﺍﻭ, ﺺﺨﺸﻣ-ﺭﻮﻃ-ﻪﺑ, ﯽﮐﺭﺪﻣ, ﻢﯿﻘﺘﺴﻣ, ﺮﻫﺎﻇ, ﺎﻌﻄﻗ, ﯽﻌﻄﻗ, ﺢﺿﺍﻭ, ﯽﻨﺷﻭﺭ-ﻪﺑ, ﻑﺎﻔﺷ, ﺢﺿﺍﻭ-ﺮﯿﻏ, ﻪﺟﻮﺗ-ﻞﺑﺎﻗ
ﺮﻫﻮﺷ-ﻭ-ﻥﺯ: ﺖﻔﺟ, ﻝﺩﺎﻌﺗ, ﺮﺑﺍﺮﺑ-ﻭﺩ, ﻭﺩ, ﺭﺎﻤﺷ-ﺖﺸﮕﻧﺍ, ﺪﻨﭼ, ﺭﺎﺨﺑ
ﻢﺠﺣ: ﻩﺮﻗﺮﻗ, ﺭﺎﯿﺴﺑ, ﺪﺣ, ﻥﺍﺰﯿﻣ, ﯽﺒﺴﻧ-ﺭﻮﻃ-ﻪﺑ, ﯽﻤﮐ, ﻥﺩﺮﮐ-ﺩﻭﺪﺴﻣ, ﻪﺘﺳﺩ, ﺪﺣﺍﻭ, ﻢﺠﺣ, ﺖﯿﻓﺮﻇ, ﺶﺷﻮﭘ
ﯽﺷﺭﺎﻔﺳ: ﻩﺪﻨﻫﺩ-ﺵﺭﺎﻔﺳ, ﯼﺭﺎﯿﺘﺧﺍ, ﺱﺎﺒﻟ, ﮎﺮﻤﮔ, ﻞﻤﻋ, ﺕﺩﺎﻋ, ﻦﺘﺷﺍﺩ-ﺕﺩﺎﻋ
ﻢﯿﻈﻌﺗ: ﺱﻮﻗ, ﺯﺎﯿﭘ, ﯽﻨﺤﻨﻣ
ﺖﺳﺍﻮﺧﺩﺍﺩ: ﻥﺪﺷ-ﺎﺟ, ﺱﺎﺒﻟ, ﺐﺳﺎﻨﻣ, ﻖﻓﺍﻮﺗ, ﻥﺩﻮﺑ-ﻖﺑﺎﻄﻣ, ﻖﺑﺎﻄﺗ, ﺩﺭﻮﻣ, ﯽﻧﻮﻧﺎﻗ-ﺩﺮﮕﯿﭘ, ﯽﯾﺎﻀﻗ-ﯼﻮﻋﺩ, ﺐﺷ-ﺱﺎﺒﻟ, ﺎﻋﺩﺍ
ﺖﺷﻮﮔ: ﺖﺷﻮﮔ, ﻭﺎﮔ-ﺖﺷﻮﮔ
ﺮﯿﺷ: ﺕﺎﯿﻨﺒﻟ, ﺮﯿﺷ, ﻪﻟﮊ
ﯽﻫﺎﯿﮔ-ﺲﻨﺟ: 
ﺯﺍﺪﻧﺍ-ﻢﺸﭼ: ﻩﺮﻈﻨﻣ, ﯽﺷﻮﻬﯿﺑ, ﺶﻨﯿﺑ, ﻮﻠﺟ, ﺯﺍﺪﻧﺍ-ﻢﺸﭼ, ﯽﻟﺎﻤﺟﺍ-ﺮﻈﻧ, ﺯﺍﺪﻧﺍ-ﻢﺸﭼ, ﺯﺍﺪﻧﺍ-ﻢﺸﭼ, ﺯﺍﺪﻧﺍ-ﻢﺸﭼ
ﺭﺩﺎﻧ: ﺕﺭﺪﻧ-ﻪﺑ, ﯽﺘﺨﺳ-ﻪﺑ
ﻩﺩﺍﺯ-ﻪﻟﺎﺧ: ﯽﻠﯿﻣﺎﻓ-ﺖﺒﺴﻧ
ﻞﭘ: ﻪﺟﺭﺩ, ﻪﺷﺮﻋ
ﺖﻈﻓﺎﺤﻣ: ﺖﻇﺎﻔﺣ, ﺖﻇﺎﻔﺣ, ﻥﺩﺮﮐ-ﺖﻈﻓﺎﺤﻣ, ﺮﭙﺳ, ﻉﺎﻓﺩ, ﻆﻔﺣ, ﻦﺘﺷﺍﺩ-ﻪﮕﻧ, ﻭﺮﺴﻨﮐ, ﻦﻣﺍ
ﮏﻤﻧ: ﺰﯿﻣﺁ-ﻕﺍﺮﻏﺍ, ﻪﻐﻟﺎﺒﻣ, ﻩﺰﻣ-ﺭﻮﺷ
ﻩﺎﻨﮔ-ﯽﺑ: 
ﻪﮑﻠﻣ: 
ﻥﺩﺮﻤﺷ: ﻢﯿﺴﻘﺗ, ﻥﺩﺮﮐ-ﺏﺎﺴﺣ-ﯼﺰﯿﭼ ﯼﻭﺭ, ﻥﺩﺮﻛ-ﺏﺎﺴﺣ, ﻪﯿﮑﺗ, ﯼﺪﯿﻣﺍ-ﺎﻧ, ﺏﺎﺴﺣ
ﯼﻭﺎﮑﺠﻨﮐ-ﺲﺣ: ﯼﻭﺎﮑﺠﻨﮐ
ﺺﻗﺭ: ﻞﺒﻃ, ﺺﻗﺭ, ﺵﺮﭘ, ﺰﯿﺧ-ﻭ-ﺖﺴﺟ
ﻞﺘﻫ: ﺖﻣﺎﻗﺍ-ﻞﺤﻣ, ﻪﻧﺎﺧﺮﻓﺎﺴﻣ
ﻥﺩﺮﮐ-ﺮﭘ: 
ﯽﻧﺍﺪﻧﺯ: 
ﻩﺎﮕﺷﻭﺮﻓ: ﻩﺎﮕﺷﻭﺮﻓ, ﻪﻓﺮﻏ, ﺕﺭﺎﺠﺗ, ﻪﻣﺎﻧ-ﻢﻫﺎﻔﺗ, ﻥﺩﺮﻛ-ﺪﻳﺮﺧ
ﺎﻫ-ﻪﻠﭘ: ﻪﻠﭘ-ﻩﺍﺭ, ﻪﻠﭘ, ﻥﺎﺑﺩﺮﻧ, ﻮﺸﮐ
ﻥﺩﺮﻛ-ﺶﻫﺍﻮﺧ: ﻝﺎﺒﻧﺩ-ﻪﺑ, ﻢﯿﻨﮐ-ﺽﺮﻓ, ﻥﺩﺮﮐ-ﻪﺑﻻ﻿
ﻦﺷ: 
ﺪﯾﺪﺷ: ﺖﻧﻮﺸﺧ, ﻩﺪﻧﺭﺩ, ﺶﮐﺮﺳ, ﺰﯿﮕﻧﺍ-ﺖﻔﮕﺷ, ﺪﯾﺪﺷ, ﯼﻮﻗ, ﺪﯾﺪﺷ, ﺪﯾﺪﺷ, ﺪﯾﺪﺷ, ﺪﯾﺪﺷ
ﺮﺒﻣﺎﺘﭙﺳ: 
ﺖﻤﯾﺰﻋ: ﻥﺩﺮﮐ-ﮎﺮﺗ, ﮎﺮﺗ, ﺰﯾﺮﭘ, ﺪﯿﻟﻮﺗ
ﯽﻫﺎﺒﺗ: ﺐﯾﺮﺨﺗ, ﯼﺭﺎﮑﺑﺍﺮﺧ, ﻥﺪﻧﺎﺳﺭ-ﺐﯿﺳﺁ, ﻥﺩﺮﺑ-ﻦﯿﺑ-ﺯﺍ, ﻪﻌﺟﺎﻓ, ﻪﺑﺍﺮﺧ
ﺕﺭﺎﻬﻣ: ﯽﯾﺎﻧﺍﻮﺗ, ﻪﺑ-ﺭﺩﺎﻗ, ﺖﯿﻓﺮﻇ, ﯽﺸﺨﺑﺮﺛﺍ, ﺖﯿﺣﻼ﻿ﺻ, ﺕﺭﺎﻬﻣ, ﺺﺼﺨﺗ
ﻭﺎﮔ: ﻭﺎﮔ
ﺕﺍﺰﯿﻬﺠﺗ: ﻩﺎﮕﺘﺳﺩ, ﻩﺎﮕﺘﺳﺩ, ﺖﯿﮐ, ﻩﺪﻧﺩ, ﮒﺮﺑ-ﻭ-ﺯﺎﺳ, ﺎﺑ-ﺩﺭﻮﺧﺮﺑ, ﺭﺍﺰﻓﺍ-ﺖﺨﺳ, ﮏﯿﻨﮑﺗ, ﯼﮊﻮﻟﻮﻨﮑﺗ, ﻥﺎﮑﻣﺍ, ﯽﻧﺩﺮﮐ-ﺐﺼﻧ-ﻡﺯﺍﻮﻟ
ﻪﻧﺎﺧﺰﭙﺷﺁ: ﺰﭘ-ﻭ-ﺖﺨﭘ, ﺯﺎﮔ-ﻕﺎﺟﺍ
ﺵﻭﺮﻓ: ﺵﻭﺮﻓ, ﻪﻤﯿﻧ
ﺖﻋﺮﺳ: ﺖﻋﺮﺳ, ﺖﻋﺮﺳ, ﺖﮐﺮﺣ, ﺕﺪﺷ-ﻪﺑ
ﻪﺠﯿﺘﻧ: ﺝﺎﺘﻨﺘﺳﺍ, ﺏﺎﺴﺣ-ﺯﺍ-ﺖﺷﺍﺩﺮﺑ, ﺪﯿﻟﻮﺗ, ﻡﻮﻬﻔﻣ, ﺡﻮﺿﻭ, ﻪﺠﯿﺘﻧ, ﻪﺠﯿﺘﻧ, ﻪﻋﻮﻤﺠﻣ, ﻦﺘﻓﺮﮔ-ﻪﺠﯿﺘﻧ, ﯼﺩﺎﻬﻨﺸﯿﭘ-ﺡﺮﻃ
ﺮﺗﻮﯿﭙﻣﺎﮐ: ﻪﺒﺳﺎﺤﻣ
ﯼﺪﺑﺍ: ﻪﺸﯿﻤﻫ, ﻪﺸﯿﻤﻫ-ﯼﺍﺮﺑ, ﺖﻳﺎﻬﻧ-ﻲﺑ
ﺩﻭﺪﺤﻣ: ﺩﻭﺪﺤﻣ, ﺩﻭﺪﺤﻣ, ﻥﺩﺮﮐ-ﺩﻭﺪﺤﻣ, ﯽﺼﺨﺸﻣ-ﺯﺮﻣ-ﻭ ﺪﺣ, ﺮﺼﺤﻨﻣ, ﺩﻭﺪﺤﻣ
ﻪﻧﺎﺨﺑﺎﺘﮐ: ﺏﺎﺘﮐ-ﻪﺴﻔﻗ
ﯼﺎﻨﺑ-ﺮﯾﺯ: ﻪﯾﺎﭘ, ﺱﺎﺳﺍ, ﺮﻘﺘﺴﻣ, ﯽﺳﺎﺳﺍ, ﯽﻠﺻﺍ, ﯽﯾﺍﺪﺘﺑﺍ, ﻪﺘﺴﻫ, ﯽﺳﺎﺳﺍ, ﻦﯿﯾﺎﭘ
ﯽﺠﯿﮔ: ﯽﮕﺘﺨﯾﺭ-ﻢﻬﺑ, ﺝﺮﻣ-ﻭ-ﺝﺮﻫ, ﻦﺘﻓﺮﮔ-ﺩﺍﺮﯾﺍ, ﻩﺪﻨﻨﮐ-ﺞﯿﮔ
ﻩﻮﮑﺷ-ﺎﺑ: ﻥﺎﺸﺧﺭﺩ, ﻲﻨﺘﺷﺍﺩ-ﺖﺳﻭﺩ, ﺐﯿﺠﻧ
ﺐﯿﺗﺮﺗ-ﻦﯿﻤﻫ-ﻪﺑ: ﻪﺑﺎﺸﻣ-ﺭﻮﻃ-ﻪﺑ, ﻦﯿﻨﭽﻤﻫ, ﻥﺎﺴﮑﯾ-ﺭﻮﻃ-ﻪﺑ
ﻩﺩﺯ-ﺖﺸﺣﻭ: ﻩﺪﯿﺳﺮﺗ, ﻩﺪﯿﺳﺮﺗ, ﺖﺸﺣﻭ, ﻥﺪﻧﺎﺳﺮﺗ
ﻡﺎﮐﺎﻧ: ﻒﺳﺎﺗ-ﻪﯾﺎﻣ, ﺲﻧﺎﺷ-ﺪﺑ, ﯽﺘﺨﺑﺪﺑ
ﻪﻟﺎﻘﻣ: ﻪﻟﺎﻘﻣ, ﺩﺭﻮﻣ
ﻦﺘﺨﭘ: ﺰﭘ-ﻭ-ﺖﺨﭘ, ﻦﺘﺨﭘ, ﺵﻮﺟ
ﺪﻧﺎﺑ: ﺪﻨﺑﺮﻤﮐ, ﻥﺎﺑﻭﺭ, ﺭﺍﻮﻧ, ﻪﺧﻮﺟ, ﻩﻭﺮﮔ, ﺭﺍﻮﻧ, ﻩﺍﺭ-ﻩﺍﺭ-ﻪﭼﺭﺎﭘ, ﻪﻘﻄﻨﻣ, ﻪﺘﺷﺭ, ﻪﺘﺳﺩ, ﻪﺷﻮﺧ, ﻪﭼﻮﮐ
ﺮﯾﻮﮐ: ﻥﺎﺑﺎﯿﺑ, ﻪﻨﮑﺳ-ﺯﺍ-ﯽﻟﺎﺧ
ﻪﺳﻮﺑ: 
ﭖﻮﺗ: ﮏﯿﺘﺳﻻ﻿, ﻩﺮﮐ, ﭖﻮﺗ, ﻪﻟﻮﻠﮔ
ﺏﻮﭼ: ﺱﺭﻮﺑ-ﻥﺎﻣﺯﺎﺳ, ﺮﮑﺸﯿﻧ, ﻥﺪﯿﺒﺴﭼ, ﺏﻮﭼ, ﺏﻮﭼ, ﺵﺎﻔﺧ, ﻒﺻ
ﻝﺪﺟ-ﻭ-ﺚﺤﺑ: ﻖﻄﻨﻣ, ﺖﮐﺮﺣ, ﻝﻻ﻿ﺪﺘﺳﺍ, ﻝﺍﺪﺟ, ﻪﺜﺣﺎﺒﻣ, ﻩﺮﻇﺎﻨﻣ, ﻉﺍﺰﻧ, ﻪﻟﺎﺳﺭ
ﻥﺩﺮﮐ-ﻩﺪﻫﺎﺸﻣ: ﯽﺳﺭﺯﺎﺑ, ﯽﺳﺭﺮﺑ, ﻒﺸﮐ, ﯽﺳﺭﺮﺑ, ﻩﺪﻫﺎﺸﻣ
ﺶﯾﺎﯿﻧ-ﺖﻟﺎﺣ: 
ﻪﺟﻮﺗ-ﻞﺑﺎﻗ: ﻪﺘﺴﺟﺮﺑ, ﻩﺪﻨﻨﮐ-ﻩﺮﯿﺧ, ﺏﺎﺼﺘﻋﺍ, ﻪﺟﻮﺗ-ﻞﺑﺎﻗ, ﻪﺟﻮﺗ-ﻞﺑﺎﻗ, ﻪﺟﻮﺗ-ﻞﺑﺎﻗ, ﻪﺟﻮﺗ-ﻞﺑﺎﻗ, ﺮﯿﮕﻤﺸﭼ, ﻩﺪﻨﻨﮐ-ﺮﯿﮕﻠﻓﺎﻏ, ﺐﯿﺠﻋ, ﺢﺿﺍﻭ, ﻦﺷﻭﺭ
ﺭﺎﮑﻫﺎﻨﮔ: ﻩﺎﻨﮔ, ﻥﺩﻮﺑ-ﺭﺎﮑﻫﺪﺑ, ﻥﺩﺮﮐ-ﺖﯾﺫﺍ, ﻒﻠﺨﺘﻣ, ﻡﻮﮑﺤﻣ
ﮓﻨﻔﺗ: ﮓﻨﻔﺗ, ﺡﻼ﻿ﺳ, ﭖﻮﺗ, ﺥﺭ
ﺲﯿﻠﭘ: ﯼﺍﺮﺟﺍ, ﻥﺩﺮﮐ-ﺕﺭﺎﻈﻧ
ﻥﺩﺮﮐ-ﯽﻔﺨﻣ: ﻥﺩﺮﮐ-ﻥﺎﻬﻨﭘ, ﻥﺩﺮﮐ-ﻥﺎﻬﻨﭘ, ﻥﺩﺮﮐ-ﻥﺎﻬﻨﭘ
ﺮﻔﺳ: ﯽﺗﺎﺑﺎﺨﺘﻧﺍ-ﺕﺍﺯﺭﺎﺒﻣ, ﻮﯾﺍﺭﺩ, ﺮﻔﺳ, ﺮﻔﺳ, ﺮﻔﺳ, ﺮﻔﺳ
ﻥﺍﺩﺎﻧ: ﻞﻬﺟ, ﺮﺒﺧ-ﯽﺑ, ﻥﺍﺩﺎﻧ, ﻖﻤﺣﺍ, ﻪﻧﺎﻘﻤﺣﺍ, ﻖﻤﺣﺍ, ﮏﺤﻀﻣ
ﻩﺪﻨﺸﺨﺑ: ﻝﺍﺮﺒﯿﻟ, ﻱﺯﺍﻮﻧ-ﻥﺎﻤﻬﻣ, ﯽﻫﺍﻮﺧ-ﺮﯿﺧ
ﺮﺑﺍ: 
ﯽﻨﺘﺨﯾﺭ-ﺭﻭﺩ: ﺭﻮﺨﻧ-ﺩﺭﺪﺑ, ﯼﺭﻭﺮﺿ-ﺮﯿﻏ, ﺩﺭ, ﻉﺎﻨﺘﻣﺍ, ﻥﺪﺷ-ﺩﺮﻃ, ﻩﺪﻧﺎﻣ-ﯽﻗﺎﺑ, ﯽﻗﺎﺑ, ﻪﻟﺎﺑﺯ
ﻪﯾﺭﻮﻓ: 
ﯼﺭﺎﻤﯿﺑ: ﯼﺭﺎﻤﯿﺑ, ﯼﺭﺎﻤﯿﺑ, ﺮﻧﻭﺮﮐ-ﻕﻭﺮﻋ, ﺶﺨﺒﺘﯾﺎﺿﺭ, ﺶﺨﺑ-ﺖﯾﺎﺿﺭ, ﻡﺭﺪﻨﺳ
ﻥﺩﺮﮐ-ﺝﺮﺧ: ﻞﮔ, ﻩﺩﺎﻔﺘﺳﺍ, ﻪﻨﯾﺰﻫ, ﻥﺩﺮﮐ-ﻝﺎﺒﻧﺩ, ﺰﯿﺧ-ﻭ-ﺖﺴﺟ, ﻥﺩﺍﺩ-ﺖﺳﺩ-ﺯﺍ
ﻊﺒﻨﻣ: ﻊﺑﺎﻨﻣ, ﻡﺎﺧ, ﺎﻤﻨﺑﺁ
ﺭﺎﮑﺘﺑﺍ-ﺩﺭﻮﻣ: 
ﻪﻤﻋ: 
ﻦﺘﺧﺍﺪﻧﺍ-ﺮﯿﺧﺎﺗ: ﻥﺩﺎﺘﻓﺍ-ﻖﯾﻮﻌﺗ-ﻪﺑ
ﺮﯿﺧﺎﺗ-ﺎﺑ-ﯼﺭﻭﺮﺿ ﯼﺮﻣﺍ: 
ﺵﺭﺍﺰﮔ-ﯽﮐﺭﺪﻣ: 
ﺐﺷ-ﻪﻤﯿﻧ: ﻝﺎﻤﺷ
ﻥﺎﻣﺮﻬﻗ: ﻮﺠﮕﻨﺟ, ﻥﺎﻣﺮﻬﻗ
ﻪﻔﺴﻠﻓ: ﯽﻔﺴﻠﻓ
ﺖﺸﮕﻧﺍ: ﻪﺠﻨﭘ
ﺖﺣﺍﺭ: ﻲﺑﻮﺧ-ﻪﺑ, ﻞﻣﺎﮐ-ﺭﻮﻄﺑ, ﯽﺘﺳﺭﺩ-ﻪﺑ, ﺭﺍﻮﻤﻫ, ﯽﺘﺣﺍﺭ-ﻪﺑ, ﺖﺣﺍﺭ, ﺶﺨﺑ-ﺶﻣﺍﺭﺁ, ﺮﯾﺬﭙﻟﺩ, ﻡﺮﻧ-ﻭ-ﻡﺮﮔ, ﯽﺘﺳﺩ
ﯽﯾﺎﺟ-ﮏﯾ: ﺎﺟ-ﺮﻫ
ﺕﺎﻋﻮﺒﻄﻣ: ﺎﻫ-ﻪﻧﺎﺳﺭ, ﻪﻠﺠﻣ, ﻪﻠﺠﻣ, ﭖﺎﭼ, ﻉﻮﻧ, ﻝﻮﻣﺮﻓ
ﻥﺎﻨﮐﺭﺎﮐ: ﻪﻣﺪﺧ, ﯽﺼﺨﺷ
ﻩﺰﯾﺎﺟ: ﻩﺰﯾﺎﺟ, ﻪﯾﺪﻫ, ﻩﺰﯾﺎﺟ, ﻩﺰﯾﺎﺟ
ﺶﻧﺯﺮﺳ: ﺎﻄﺧ, ﺺﻘﻧ, ﺐﯿﻋ, ﯽﻫﺪﺑ, ﻩﺎﻨﮔ, ﺶﻧﺯﺮﺳ, ﺭﺍﺮﻗ-ﯽﻧﻮﻧﺎﻗ-ﺩﺮﮕﯿﭘ ﺖﺤﺗ, ﯽﻫﺪﺑ, ﺖﯿﻟﻮﺌﺴﻣ-ﺱﺎﺴﺣﺍ
ﯽﺘﺨﺑﺪﺑ: ﯽﺘﺨﺳ, ﻥﺪﯿﺸﮐ-ﺞﻧﺭ, ﻩﻭﺪﻧﺍ-ﻭ-ﻢﻏ, ﯽﺘﺨﺑﺪﺑ, ﯽﮕﺘﺴﺧ
ﯽﻧﺎﺸﯿﭘ: 
ﺩﻼ﻿ﯿﻣ-ﺯﺍ-ﺪﻌﺑ: ﺕﺎﻐﯿﻠﺒﺗ, ﺕﺎﻐﯿﻠﺒﺗ, ﺕﺎﻐﯿﻠﺒﺗ, ﯽﻬﮔﺁ, ﻥﻼ﻿ﻋﺍ, ﺕﺎﻐﯿﻠﺒﺗ, ﻉﻼ﻿ﻃﺍ, ﻡﻼ﻿ﻋﺍ
ﻪﺘﺷﺮﻓ: ﮏﻠﻣ-ﺐﺣﺎﺻ, ﯼﺮﭘ-ﻭ-ﻦﺟ
ﺩﺮﻔﻣ-ﺩﺪﻋ: 
ﻡﺩ-ﻩﺪﯿﭙﺳ: ﺶﯿﻣ-ﻭ-ﮒﺮﮔ
ﯼﺭﺎﺠﺗ: ﯼﺍ-ﻪﻓﺮﺣ, ﺕﺎﻐﯿﻠﺒﺗ, ﺕﺭﺎﺠﺗ, ﺕﺭﺎﺠﺗ
ﺶﺨﺒﺑ: ﻪﻧﺎﻬﺑ, ﺶﺸﺨﺑ, ﻥﺩﺮﻛ-ﻞﻤﺤﺗ, ﻑﺎﻌﻣ, ﻥﺩﺮﺑ-ﻦﯿﺑ-ﺯﺍ, ﺩﺭ
ﺪﻨﻔﺳﻮﮔ: ﻩﺮﺑ
ﺮﺒﺻ: ﯽﯾﺎﺒﯿﮑﺷ, ﻞﻤﺤﺗ
ﻪﻋﺭﺰﻣ: ﻪﻋﺭﺰﻣ, ﺖﺸﮐ, ﻉﺭﺯ-ﻭ-ﺖﺸﮐ, ﯼﺯﺭﻭﺎﺸﮐ
ﯽﻋﺎﺟﺭﺍ: ﻊﺟﺮﻣ, ﺪﯿﻨﮐ-ﻪﻌﺟﺍﺮﻣ
ﺕﺭﺫ: ﻡﺪﻨﮔ-ﻪﺷﻮﺧ, ﺥﺎﺷ
ﺪﯿﻠﮐ: ﻪﺿﺮﻗ-ﻕﺍﺭﻭﺍ, ﻪﻤﮐﺩ, ﺭﺎﭼﺍ, ﭻﯿﺋﻮﺳ, ﯽﻠﺻﺍ, ﯽﺗﺎﯿﺣ, ﻪﺘﺴﺟﺮﺑ, ﺱﺎﺴﺣ, ﮒﺭﺰﺑ, ﺭﺍﻮﯾﺩ-ﺭﺩ-ﯽﮕﺘﻓﺭ ﻮﺗ, ﯽﻠﺻﺍ-ﺮﯿﺴﻣ, ﺪﯿﻠﮐ
ﺖﯾﺮﺜﮐﺍ: ﯼﺭﺎﯿﺴﺑ, ﻦﯾﺮﺘﺸﯿﺑ
ﻒﻌﺿ: ﺰﺠﻋ
ﻮﺟ: ﻂﯿﺤﻣ, ﻥﺎﻤﺳﺁ, ﯼﺩﺭﻮﻧﺍﻮﻫ, ﯽﯾﺎﻀﻓ
ﻩﺁ: ﻥﺩﺯ-ﺲﻔﻧ-ﺲﻔﻧ
ﺖﯾﺮﺸﺑ: ﻥﺎﺴﻧﺍ
ﺖﻔﻟﺎﺨﻣ: ﻒﻟﺎﺨﻣ, ﺖﻔﻟﺎﺨﻣ, ﻒﻟﺎﺨﻣ, ﺩﺎﻀﺗ, ﻥﺩﺮﮐ-ﺖﻣﻭﺎﻘﻣ, ﺽﺍﺮﺘﻋﺍ, ﻒﻟﺎﺨﻣ, ﺖﻣﻭﺎﻘﻣ, ﻩﺪﻧﺭﺎﻤﺷ, ﻒﯾﺮﺣ, ﺩﺭ, ﺪﺿ, ﻡﻭﺎﻘﻣ, ﻒﻟﺎﺨﻣ, ﺽﺍﺮﺘﻋﺍ
ﮏﺴﯾﺩ: ﮏﺴﯾﺩ, ﻪﮑﺗ, ﻩﺪﻧﺭﺎﻤﺷ, ﺭﺪﻨﻠﯿﺳ, ﻪﺤﻔﺻ, ﺩﺭﻮﮐﺭ, ﯽﻨﯿﺳ, ﻮﯾﺍﺭﺩ
ﺎﻬﻨﺗ: ﺲﮐ-ﯽﺑ, ﯽﯾﺎﻬﻨﺗ, ﻪﻧﺎﮔﺍﺪﺟ-ﺕﺭﻮﺼﺑ, ﺎﻬﻨﺗ, ﺎﻬﻨﺗ
ﺪﻨﻣﺮﻨﻫ: ﺮﮕﯾﺯﺎﺑ, ﺵﺎﻘﻧ, ﻩﺪﻨﻨﮐ-ﻡﺮﮔﺮﺳ
ﻪﯿﻟﺍﻮﺷ: ﺭﺍﻮﺳ
ﻥﻮﺴﻓﺍ: ﮏﯿﺗﺎﻣﺰﯾﺭﺎﮐ, ﻪﺑﺫﺎﺟ, ﻭﺩﺎﺟ, ﻥﺩﺮﮐ-ﯽﺠﻫ
ﻢﯿﻤﺼﺗ: ﻦﺘﻓﺮﮔ-ﻢﻴﻤﺼﺗ, ﯼﺭﻭﺍﺩ, ﻢﮑﺣ, ﯼﺭﻭﺍﺩ, ﻦﯿﯿﻌﺗ, ﺡﻮﺿﻭ, ﻞﺣ-ﻩﺍﺭ
ﺭﺍﺪﻧﺎﻣﺮﻓ: ﺭﺎﮐ-ﻪﻈﻓﺎﺤﻣ, ﺶﻛ-ﻂﺧ
ﻪﺧﺎﺷ: 
ﻊﺿﻭ: ﺐﯿﺗﺮﺗ, ﯼﺪﻨﺑ-ﺮﮑﯿﭘ, ﺶﯾﺍﺮﮔ, ﺪﻧﻭﺭ, ﮎﺭﺍﺪﺗ, ﺡﺮﻃ, ﺖﻟﺎﺣ, ﻪﻣﺎﻧﺮﺑ, ﯽﻧﺎﻣﺯ-ﻝﻭﺪﺟ
ﻕﺎﯿﺘﺷﺍ: ﺐﺼﻌﺗ, ﯽﻣﺮﮔ, ﻕﺎﺘﺸﻣ, ﻩﺰﻣ, ﺖﯾﺎﺿﺭ, ﺭﻮﺷ, ﺪﺟﻭ, ﻥﺩﺮﮐ-ﻖﯾﻮﺸﺗ
ﯽﺋﺎﻘﻟﺍ-ﺖﻟﺎﺣ: ﯽﻃﺎﺒﻨﺘﺳﺍ-ﺖﻟﺎﺣ, ﯽﺳﺎﯿﻗ-ﺎﯾ-ﯽﯾﺍﺮﻘﺘﺳﺍ ﺖﻟﺎﺣ
ﻉﺎﻤﺘﺟﺍ: ﻪﻌﻣﺎﺟ, ﯼﺪﻨﺑ-ﻪﺘﺳﺩ, ﺎﻫ-ﻥﺎﺴﻧﺍ
ﺖﻔﻧ: ﯽﺑﺮﭼ, ﺖﺧﻮﺳ, ﻞﯿﺴﻓ, ﺰﻐﻣ, ﯽﺗﺭﺍﺮﺣ, ﻩﺮﮐ
ﻪﻟﻮﻟ: ﻪﻟﻮﻟ, ﺮﯿﺷ, ﺏﺁ-ﺮﻴﺷ, ﻥﺩﺍﺩ-ﺕﺭﻮﻗ, ﺰﯾﺭﺎﮐ
ﭖﺎﭼ: ﭖﺎﭼ, ﺭﺎﺸﻓ, ﭖﺎﭼ, ﺭﻮﺤﻣ, ﺐﻟﺎﻗ, ﺱﺎﺴﺣﺍ
ﻩﻭﺍ: ﻪﻠﺑ
ﻦﺨﺳ-ﻪﻨﯿﻣﺯ: 
ﯽﯾﺍﺪﻧ-ﺩﺭﻮﻣ: 
ﻦﯿﺑﺎﮐ: ﻪﺒﻠﮐ, ﺭﺩﺎﭼ, ﻝﺰﻨﻣ
ﺮﻄﺧ-ﮓﻧﺯ: ﺱﻮﻗﺎﻧ, ﺭﺎﯿﺷﻮﻫ, ﻥﺪﻧﺎﺳﺮﺗ, ﻥﺩﺮﮐ-ﻩﺩﺯ-ﺖﺸﺣﻭ
ﯽﺒﺼﻋ: ﻥﺎﻣﺯ, ﻢﮔﺭﺩﺮﺳ, ﻥﺪﺷ-ﻢﺣﺍﺰﻣ, ﻦﯿﮕﻤﻏ, ﻞﺠﺧ, ﻥﺍﺮﮕﻧ, ﻥﺩﺮﮐ-ﺖﯾﺫﺍ, ﻩﺪﻨﻨﻛ-ﺖﺣﺍﺭﺎﻧ, ﯽﺒﺼﻋ, ﻥﺍﺮﮕﻧ, ﺐﺼﻋ
ﻲﻤﺋﺍﺩ: ﻥﺎﻣﺯ-ﺕﺪﻣ, ﺎﺒﻟﺎﻏ, ﺐﺗﺮﻣ-ﺭﻮﻃ-ﻪﺑ, ﻡﻭﺍﺪﻣ, ﺖﺑﺎﺛ, ﺪﺷ-ﺖﺳﺭﺩ, ﺖﺑﺎﺛ
ﻮﻗﺎﭼ: ﺩﺎﯾﺮﻓ, ﻪﻐﯿﺗ
ﻢﺸﯾﺮﺑﺍ: 
ﺮﯿﻘﺤﺗ: ﻥﺩﺮﻤﺷ-ﺭﺍﻮﺧ, ﺕﺮﻔﻧ, ﻦﺘﺷﺍﺪﻧ-ﺖﺳﻭﺩ, ﺭﺎﺟﺰﻧﺍ, ﺕﺮﻔﻧ, ﺶﻧﺯﺮﺳ, ﻥﺩﺮﻛ-ﻦﻴﻫﻮﺗ, ﺖﻣﺮﺣ-ﮏﺘﻫ, ﯼﺭﺎﮕﻧﺍ-ﻞﻬﺳ
ﻢﻨﻬﺟ: 
ﻢﻫ-ﺯﺍ-ﺍﺪﺟ: ﻪﻧﺎﮔﺍﺪﺟ, ﺯﺍ-ﻪﺘﺷﺬﮔ, ﺍﺪﺟ, ﺰﯾﺎﻤﺘﻣ, ﻦﺘﺷﺍﺩ-ﺕﻭﺎﻔﺗ, ﻪﻧﺎﮔﺍﺪﺟ-ﺕﺭﻮﺼﺑ, ﺭﻭﺩ, ﻪﺘﺴﺴﮔ, ﺍﻭﺰﻧﺍ, ﺩﺮﻃ, ﯽﺼﺨﺸﻣ-ﺯﺮﻣ-ﻭ ﺪﺣ, ﯽﯾﺍﺪﺟ
ﯼﺪﺟ-ﺭﻮﻃ-ﻪﺑ: ﯼﺪﺟ, ﻪﻧﺎﺼﻟﺎﺧ, ﻦﯿﮕﻨﺳ, ﺕﺪﺷ-ﻪﺑ, ﺕﺪﺷ-ﻪﺑ, ﻪﻧﻻ﻿ﺎﻌﻓ
ﻁﻮﻠﺨﻣ: ﻁﻮﻠﺨﻣ, ﺐﯿﮐﺮﺗ, ﺐﮐﺮﻣ, ﻁﻮﻠﺨﻣ, ﮎﺮﺘﺸﻣ
ﯽﺑﻮﭼ: ﺏﻮﭼ, ﺏﻮﭼ
ﻢﻫﺩ-ﯽﻣ-ﺢﯿﺟﺮﺗ: ﺢﯿﺟﺮﺗ
ﺭﺍﺪﺸﻫ: ﻁﺎﯿﺘﺣﺍ, ﻥﺩﺍﺩ-ﺭﺍﺪﺸﻫ, ﺭﺎﯿﺷﻮﻫ, ﺩﻮﺑﺩﺎﯾ, ﻉﻼ﻿ﻃﺍ
ﺮﮐﺬﺗ-ﺖﻟﺎﺣ: 
ﻪﺑ-ﻥﺩﺍﺩ-ﻩﺰﯿﮕﻧﺍ: ﻡﺎﻬﻟﺍ, ﺾﺒﻧ, ﻪﺘﺳﺩ, ﻢﯿﻫﺍﻮﺧ-ﯽﻣ, ﺖﮐﺮﺣ, ﺭﺎﺸﻓ
ﯽﺒﻠﻃ-ﻩﺎﺟ: ﺪﯿﻣﺍﺎﻧ, ﯼﺪﯿﻣﺍ-ﺎﻧ, ﺕﻮﻬﺷ, ﺺﯾﺮﺣ, ﻥﺩﺮﮐ-ﺩﺮﺴﻟﺩ, ﺐﻠﻃ-ﻩﺎﺟ
ﺭﺎﮑﻧﺍ: ﻉﺎﻨﺘﻣﺍ, ﺩﺭ, ﺭﺎﮑﻧﺍ, ﻥﺪﺷ-ﺩﺮﻃ, ﯽﻔﻧ, ﺩﺭ, ﻥﺩﺮﮐ-ﯽﺜﻨﺧ, ﺶﻫﺎﮐ, ﻥﺩﺮﮐ-ﺩﺭ, ﺩﺭ, ﻉﻮﻨﻤﻣ, ﻥﺩﺮﮐ-ﻊﻨﻣ, ﺖﺳﺍ-ﻩﺩﺮﮐ-ﻉﻮﻨﻤﻣ, ﺾﻗﺎﻨﺗ
ﻲﺳﺎﺳﺍ-ﻥﻮﻧﺎﻗ: ﺭﻮﺸﻨﻣ, ﻪﻃﻭﺮﺸﻣ
ﺭﺍﺰﺑﺍ: ﺭﺍﺰﺑﺍ, ﯽﺘﺸﮐ, ﺩﻮﺟﻭ, ﻮﻀﻋ, ﻑﺮﻇ, ﺭﺍﺰﺑﺍ
ﻡﻭﺍﺪﻣ-ﻪﺒﻨﺟ: 
ﺪﻣ-ﻭ-ﺭﺰﺟ: ﻥﺩﺍﺩ-ﻥﺎﮑﺗ-ﺖﺳﺩ, ﯽﻧﺎﻬﮔﺎﻧ-ﻭ-ﻢﮑﺤﻣ ﻪﺑﺮﺿ
ﺞﻟﺎﮐ: ﻩﺪﮑﺸﻧﺍﺩ, ﻩﺎﮕﺸﻧﺍﺩ, ﺲﯾﺩﺮﭘ, ﻩﺎﮕﺸﻧﺍﺩ
ﻡﺩ: ﻒﺻ
ﻞﺴﻧ: ﻞﺴﻧ
ﻪﺑﺮﮔ: 
ﻢﯿﻘﺘﺴﻣ-ﯽﮐﺭﺪﻣ: 
ﻪﮐﻭﺮﺘﻣ: ﯽﻬﺟﻮﺗ-ﯽﺑ, ﻥﺩﺮﮐ-ﮎﺮﺗ, ﻪﻨﮑﺳ-ﺯﺍ-ﯽﻟﺎﺧ, ﮎﺮﺗ, ﻥﺩﺮﮐ-ﮎﺮﺗ
ﻩﺩﺯﺎﯾ: 
ﻩﺰﯾﺮﻏ: ﺩﻮﺨﺑ-ﺩﻮﺧ
ﻪﺼﺨﺸﻣ: ﯽﮔﮋﯾﻭ, ﺺﺼﺨﺗ, ﺖﯿﺼﺨﺷ, ﺕﺩﺎﻋ, ﺶﯾﺍﺮﮔ, ﺭﺎﺘﻓﺭ, ﺭﺎﺘﻓﺭ, ﺕﺎﯿﺻﻮﺼﺧ, ﺕﺎﯿﺻﻮﺼﺧ, ﯽﻔﯿﮐ, ﯽﻟﻮﻤﻌﻣ
ﻪﻠﯿﺒﻗ: ﻪﻨﺗ, ﻪﻗﺎﺳ, ﺭﺎﺑ
ﻥﺍﺮﮕﻧ-ﺖﻟﺎﺣ: 
ﻩﺎﻨﭘ-ﻥﺎﺟ: ﺭﺮﮑﻣ-ﺪﻣﺁ-ﻭ ﺖﻓﺭ, ﺖﻣﺎﻗﺍ-ﻞﺤﻣ, ﻥﺎﮑﺳﺍ, ﺖﻧﻮﮑﺳ-ﻞﺤﻣ, ﯽﻧﻮﮑﺴﻣ, ﺖﻇﺎﻔﺣ, ﻩﺎﮕﺑﺍﻮﺧ, ﻩﺎﻨﭘ
ﺏﺩﺍ-ﯽﺑ: ﻪﻧﺎﺧﺎﺘﺴﮔ, ﻦﺸﺧ, ﻥﺎﺑﺮﻬﻣﺎﻧ
ﯼﺭﺍﻮﺳ: ﻥﺪﺷ-ﺭﺍﻮﺳ, ﺭﺍﻮﺳ
ﺵﺯﺮﻟ: ﯽﻧﺎﻬﮔﺎﻧﻭ-ﺮﮑﺑ-ﺮﮑﻓ
ﺖﻌﻨﺻ: ﺶﺨﺑ, ﺪﯿﻟﻮﺗ, ﯽﺘﻌﻨﺻ, ﻥﺩﺮﮐ-ﯽﺘﻌﻨﺻ
ﻪﻓﺮﺣ: ﯼﺍ-ﻪﻓﺮﺣ, ﯼﺍ-ﻪﻓﺮﺣ, ﻝﺎﻐﺘﺷﺍ, ﯽﺼﺼﺨﺗ
ﭗﻣﻻ﻿: ﺯﺎﯿﭘ
ﻩﻮﻬﻗ: ﻪﻓﺎﮐ
ﻥﺩﺮﮐ-ﺖﻋﺎﻃﺍ: ﻝﺎﺳﺭﺍ, ﻖﺑﺎﻄﻣ, ﻩﺪﺑ-ﺵﻮﮔ
ﯽﻟﺎﻤﺷ: ﻝﺎﻤﺷ
ﺭﺎﺘﺳﺮﭘ: 
ﻥﺩﺍﺩ-ﻥﺎﻨﯿﻤﻃﺍ: ﻦﯿﻤﻀﺗ, ﻢﮑﺣ, ﻭﺮﮔ, ﺖﻧﺎﻤﺿ, ﻥﺩﺮﮐ-ﻪﻤﯿﺑ, ﻥﺎﻨﯿﻤﻃﺍ, ﻡﻮﻠﻌﻣ, ﻥﺩﺮﻛ-ﺪﻴﻳﺎﺗ, ﺪﻨﮐ-ﯽﻣ-ﻢﻫﺍﺮﻓ, ﻥﺩﺮﮐ-ﻪﯿﻬﺗ, ﻢﺸﭼ-ﯼﻭﺭ-ﻪﺑ, ﻥﺩﺮﻛ-ﻊﻧﺎﻗ, ﺪﯿﯾﺄﺗ, ﻦﻣﺍ
ﺮﯿﺠﻧﺯ: ﻪﻟﺎﺒﻧﺩ, ﻪﻠﺴﻠﺳ, ﻪﺘﺷﺭ, ﻥﺍﺪﻧﺯ
ﻢﯿﻠﻌﺗ: ﻞﻤﻌﻟﺍ-ﺭﻮﺘﺳﺩ, ﺵﺯﻮﻣﺁ, ﺵﺯﻮﻣﺁ
ﺶﻔﮐ: ﺶﻔﮐ, ﻝﺪﻨﺻ
ﻁﺎﯿﺣ: ﺪﮐ, ﻪﺤﻔﺻ, ﻪﻘﺷﺎﻌﻣ
ﻢﻬﺒﻣ: ﻡﺎﻬﺑﺍ, ﻢﻬﺒﻣ, ﻢﻬﺒﻣ, ﺢﺿﺍﻭ-ﺮﯿﻏ, ﺰﯿﻣﺁ-ﺭﺍﺮﺳﺍ, ﯽﻌﻄﻗ-ﺮﯿﻏ, ﻦﯿﻌﻣ-ﺎﻧ, ﻥﺩﺍﺩ-ﻥﺎﮑﺗ-ﺖﺳﺩ, ﯽﻟﺎﺧ
ﺮﮕﯾﺩ-ﯼﺎﺟ-ﺭﺩ: ﯼﺮﮕﯾﺩ
ﯽﻧﻮﮑﺴﻣ-ﻥﺎﻤﺗﺭﺎﭘﺁ: ﺖﺨﺗ, ﻩﺮﯾﺍﺩ, ﻪﭘﻮﮐ, ﻪﻋﻮﻤﺠﻣ
ﺖﯿﻟﺎﻌﻓ: ﺶﻨﮐﺍﺮﺗ, ﺩﺮﮑﻠﻤﻋ
ﻪﺒﻨﺷ-ﺯﻭﺭ: ﻪﺒﻨﺷ
ﺏﺎﺘﻓﺍ-ﺭﻮﻧ: ﯼﺪﯿﺷﺭﻮﺧ
ﻩﻮﯿﺑ: 
ﺮﺼﻨﻋ: ﻪﺒﻨﺟ, ﺕﺎﯿﺻﻮﺼﺧ, ﺩﺭﻮﻣ, ءﺰﺟ, ﻮﻀﻋ
ﺱﺎﮑﻌﻧﺍ: ﺮﮑﻔﺗ
ﻥﺎﻣﺯﺎﺳ: ﺖﻓﺎﺑ, ﻥﺎﻣﺯﺎﺳ, ﻥﺩﺍﺩ-ﻥﺎﻣﺯﺎﺳ, ﮒﺮﺑ-ﻭ-ﺯﺎﺳ, ﺖﮐﺮﺷ, ﺭﺍﺰﺑﺍ, ﯽﮔﺪﻨﯾﺎﻤﻧ, ﺩﻮﺟﻭ, ﻢﺘﺴﯿﺳ, ﺭﺎﺘﺧﺎﺳ, ﺖﻓﺎﺑ, ﺡﺮﻃ, ﻪﺴﺳﻮﻣ, ﻪﺴﺳﻮﻣ
ﻩﺭﺎﺘﺳ: 
ﻪﺛﺩﺎﺣ: ﻪﻌﻗﺍﻭ, ﻉﻮﻗﻭ, ﻩﺪﯾﺪﭘ, ﻉﻮﻗﻭ, ﻑﺩﺎﺼﺗ, ﺩﺭﻮﻣ
ﻥﺎﻤﻬﻣ: ﻪﻧﺎﮕﯿﺑ, ﻥﺎﻤﻬﻣ, ﻪﻧﺎﮕﯿﺑ, ﯽﺟﺭﺎﺧ, ﺩﺭﺍﻭ-ﻩﺯﺎﺗ, ﻩﺪﻨﻫﺩ-ﺵﺭﺎﻔﺳ, ﯼﺮﺘﺸﻣ, ﻥﺎﺑﺰﯿﻣ
ﺭﺎﺑ: ﺖﺨﻟ, ﻪﻧﺎﺨﯿﻣ, ﺭﺎﺑ, ﺭﺎﺑ, ﻪﻓﺎﮐ, ﻢﯾﺭﺎﺑ
ﯼﺮﻄﺑ: ﻪﺸﯿﺷ
ﺖﮐﺮﺑ: ﺖﮐﺮﺑ
ﻥﺩﺯ-ﻢﻬﺑ: ﻥﺩﺮﮐ-ﯼﺭﺎﮑﺘﺳﺩ, ﻁﻮﻠﺨﻣ, ﻥﺪﯿﺸﮐ-ﻥﻭﺮﯿﺑ, ﺵﺭﻮﺷ
ﯽﻠﺧﺍﺩ: ﺩﻭﺪﺣ-ﺭﺩ-،ﻞﺧﺍﺩ ﺭﺩ, ﻞﺧﺍﺩ, ﯽﻠﺧﺍﺩ, ﯽﻠﺧﺍﺩ, ﯽﻠﺤﻣ, ﯽﮕﻧﺎﺧ, ﯽﻠﺧﺍﺩ, ﯽﻧﺍﻭﺭ, ﯼﺩﻮﺧ
ﺖﺑﺎﺛ: ﺪﺷ-ﺖﺳﺭﺩ, ﻥﺩﺮﮐ-ﻢﯿﻈﻨﺗ, ﻥﺩﺮﮐ-ﺮﻈﻧ-ﺪﯾﺪﺠﺗ, ﻞﺣ-ﻩﺍﺭ, ﻥﺩﺮﮐ-ﻑﺮﻃﺮﺑ, ﻥﺩﺮﻛ-ﻞﺣ, ﻥﺎﻣﺭﺩ, ﻥﺩﺮﮐ-ﺮﺘﻬﺑ, ﺖﺳﺍﺭ, ﻪﺷﺎﺑ, ﻪﺷﺎﺑ, ﺖﺑﺎﺛ, ﺖﺑﺎﺛ, ﻩﺮﯿﺧ, ﺖﺳﺭﺩ, ﻥﺪﺷ-ﻦﯿﯿﻌﺗ, ﺩﺎﺠﯾﺍ, ﯽﯾﺎﺳﺎﻨﺷ, ﻡﻮﻠﻌﻣ
ﻖﺘﺸﻣ: ﻥﺩﺭﻭﺁ-ﺖﺳﺩ-ﻪﺑ, ﻥﺩﺭﻭﺁ-ﺖﺳﺩ, ﻖﺘﺸﻣ, ﻦﺘﻓﺮﮔ, ﻥﺩﺮﻛ-ﺖﻓﺎﻳﺭﺩ
ﯽﻟﺎﺧﻮﺗ: ﻩﺩﺎﺳ, ﺖﺨﻟ, ﯽﻟﺎﺧ-ﯼﺎﺟ, ﻞﺑﺎﮐ
ﻥﺎﺘﺳﺍ: ﯽﻧﺎﺘﺳﺍ
ﻥﺪﻤﺗ: 
ﻥﺪﺷ-ﻥﺍﺰﯾﻭﺁ: 
ﻥﺪﺷ-ﻪﮐﻮﺷ: ﻪﺑﺮﺿ, ﺖﺴﮑﺷ, ﻢﺧﺯ, ﻩﺪﻨﻫﺩ-ﻥﺎﮑﺗ, ﺩﺭﻮﺧﺮﺑ
ﺎﻨﺜﺘﺳﺍ: ﻲﺋﺰﺟ, ﺾﯿﻌﺒﺗ, ﻪﺸﯿﻠﮐ, ﺖﯿﻓﺎﻌﻣ
ﺩﺍﮋﻧ: ﺱﺮﺘﺳﺍ, ﺶﻨﺗ, ﺭﺎﺑ, ﯽﮕﺘﺴﺧ, ﺵﻼ﻿ﺗ, ﺕﺪﺷ
ﺩﺭﺍﺪﻧﺎﺘﺳﺍ: ﺭﺎﯿﻌﻣ, ﺺﺧﺎﺷ, ﺥﺮﻧ, ﺢﻄﺳ, ﺽﺮﻓ-ﺶﯿﭘ-ﺭﻮﻃ ﻪﺑ, ﺭﺎﺠﻨﻫ, ﺪﺷ-ﺖﺳﺭﺩ, ﺖﺑﺎﺛ, ﺖﺑﺎﺛ, ﺕﺎﺒﺛ-ﺎﺑ, ﺎﺘﺴﯾﺍ, ﺭﺍﺪﯾﺎﭘ, ﺩﺭﺍﺪﻧﺎﺘﺳﺍ, ﻮﮕﻟﺍ
ﯽﮔﺪﻨﻧﺍﺭ: ﻮﯾﺍﺭﺩ, ﻩﺪﻨﻧﺍﺭ, ﺎﻤﻨﻫﺍﺭ, ﺖﯾﺮﯾﺪﻣ, ﻥﺪﺷ-ﺭﺍﻮﺳ
ﺮﺷ-ﺯﺍ-ﻥﺪﺷ ﺹﻼ﻿ﺧ: ﻦﺘﺷﺍﺩﺮﺑ, ﻥﺪﯿﺸﮐ-ﺭﺎﻨﮐ, ﻥﺩﺮﺑ-ﻦﯿﺑ-ﺯﺍ, ﻑﺬﺣ, ﻑﺎﻌﻣ, ﻥﺩﺮﺑ-ﻦﯿﺑ-ﺯﺍ, ﻥﺩﺮﮐ-ﻪﺋﺮﺒﺗ
ﺪﻨﮔﻮﺳ: ﻥﺩﺭﻮﺧ-ﻢﺴﻗ
ﺞﻨﮔ: ﺮﻫﺍﻮﺟ
ﻪﻧﺍﺩ: ﻪﻔﻄﻧ, ﻩﺮﻬﻣ, ﻩﺭﺫ
ﺝﺮﺑ: ﺥﺭ
ﺏﻮﺒﺤﻣ: ﺏﻮﺒﺤﻣ
ﯽﮔﺯﺎﺗ-ﻪﺑ: ﺮﯿﺧﺍ, ﻩﺯﺎﺗ, ﺍﺮﯿﺧﺍ
ﺮﯿﺧﺍ-ﻪﺘﺷﺬﮔ-ﺖﻔﺳ: 
ﺭﺍﺪﯿﺑ: ﻪﻧﺎﻫﺎﮔﺁ, ﻪﯿﺣﻭﺭ, ﯼﺭﺍﺪﯿﺑ, ﺭﺎﯿﺷﻮﻫ
ﻪﻧﺎﺧ-ﺏﺎﺒﺳﺍ: 
ﺏﺎﻨﻃ: ﺏﺎﻨﻃ, ﻪﺘﺷﺭ, ﻪﻤﺴﺗ
ﺍﺮﺟﺎﻣ: ﯼﺭﺍﺬﮔ-ﻪﯾﺎﻣﺮﺳ, ﺭﺎﻤﻗ
ﯽﺘﻨﻄﻠﺳ-ﻩﺩﺍﻮﻧﺎﺧ-ﯼﺎﻀﻋﺍ: ﺖﻨﻄﻠﺳ
ﻦﺸﺟ: ﺏﺰﺣ, ﻦﺸﺟ, ﺖﻓﺎﯿﺿ, ﻞﯿﻄﻌﺗ-ﺯﻭﺭ
ﻥﺩﺮﮐ-ﻒﯿﺻﻮﺗ: ﺕﺎﺤﯿﺿﻮﺗ, ﺕﺎﯿﺻﻮﺼﺧ, ﺪﺸﮐ-ﯽﻣ-ﺮﯾﻮﺼﺗ ﻪﺑ, ﻥﺪﯿﺸﮐ-ﺮﯾﻮﺼﺗ, ﻥﺩﺮﻛ-ﻒﻳﺮﻌﺗ
ﺖﺼﺷ: 
ﺱﺎﯿﻘﻣ: ﺏﺎﻗ, ﻩﺯﺍﺪﻧﺍ, ﺖﺒﺴﻧ, ﻥﺎﺑﺩﺮﻧ, ﻪﻠﭘ-ﻩﺍﺭ, ﻪﻠﭘ
ﻢﺳﺍﺮﻣ: ﺕﺎﻔﯾﺮﺸﺗ, ﺩﺮﮑﻠﻤﻋ
ﺪﯿﺻ: ﺭﺎﮑﺷ, ﯽﻧﺎﺑﺮﻗ, ﺭﺎﮑﺷ, ﺐﯿﻘﻌﺗ, ﯼﺯﺍﺪﻧﺍﺮﯿﺗ
ﻥﺩﺮﮐ-ﻪﻣﺰﻣﺯ: ﺮﻏﺮﻏ
ﯼﺩﺎﯾﺯ-ﺪﺣ-ﺎﺗ: ﯼﺍ-ﻪﻈﺣﻼ﻿ﻣ-ﻞﺑﺎﻗ, ﻪﻈﺣﻼ﻿ﻣ-ﻞﺑﺎﻗ-ﺭﻮﻃ ﻪﺑ, ﻦﯾﺮﺘﺸﯿﺑ, ﻩﺪﻤﻋ-ﺭﻮﻃ-ﻪﺑ, ﺐﻠﻏﺍ, ﯼﺩﺎﯾﺯ-ﺪﺣ-ﺎﺗ, ﻩﺩﺮﺘﺴﮔ-ﺭﻮﻃ-ﻪﺑ, ﺎﺗﺪﻤﻋ
ﺖﯿﺤﯿﺴﻣ: 
ﻞﯿﮐﻭ: ﻞﯿﮐﻭ, ﻊﻓﺍﺪﻣ
ﺕﺎﯿﺋﺰﺟ: ﻥﺩﺍﺩ-ﺭﺎﺸﺘﻧﺍ, ﻥﺩﺮﻛ-ﺪﻳﺪﻤﺗ, ﺵﺮﺘﺴﮔ, ﻪﻌﺳﻮﺗ, ﻥﺩﺍﺩ-ﻪﻌﺳﻮﺗ, ﺎﻘﯿﻤﻋ, ﻖﯿﻗﺩ
ﻢﻧﺎﺧ-ﻩﺩﺍﺰﻫﺎﺷ: 
ﺏﺍﺮﺤﻣ: ﺏﺍﺮﺤﻣ
ﺏﻭ: ﻪﮑﺒﺷ, ﺺﻟﺎﺧ, ﯼﺭﻮﺗ, ﺖﻓﺎﺑ, ﯽﺷﺎﻘﻧ-ﻡﻮﺑ, ﺮﺘﺳﻮﭘ
ﺶﻔﻨﺑ-ﮓﻧﺭ: ﯽﻧﺍﻮﻏﺭﺍ
ﻥﺩﺮﮐ-ﻊﻤﺟ: ﯼﺭﻭﺁ-ﻊﻤﺟ, ﻦﺘﺷﺎﺒﻧﺍ, ﻥﺪﺷ-ﮏﭼﻮﮐ, ﯼﺮﯿﮔ-ﻩﺭﺎﻤﺷ
ﺏﺎﺨﺘﻧﺍ: ﺏﺎﺨﺘﻧﺍ, ﺐﺨﺘﻨﻣ, ﻪﻟﺎﺒﻧﺩ, ﯼﺍﺭ, ﮓﻨﻬﻧ, ﺏﺎﺨﺘﻧﺍ, ﯼﺍﺭ-ﻪﻗﺭﻭ
ﺭﻮﺼﺗ: ﻡﻮﻬﻔﻣ, ﻡﻮﻬﻔﻣ, ﺭﻮﺼﺗ, ﮎﺍﺭﺩﺍ, ﮎﺭﺩ, ﯽﮐﺍﺭﺩﺍ, ﻥﺩﺮﮐ-ﯽﺣﺍﺮﻃ, ﻦﺘﻓﺮﮔ, ﺖﺷﺍﺩﺯﺎﺑ, ﻦﺘﻓﺮﮔ
ﺖﺴﻣ: ﯽﻠﮑﻟﺍ
ﻦﺘﺨﯾﺭ: ﯽﻧﻮﮕﻧﺮﺳ, ﻦﺘﺨﯾﺭ, ﺖﺸﻧ, ﯽﻧﻮﮕﻧﺮﺳ
ﻥﺩﺮﮐ-ﺪﻨﻠﺑ: ﺭﻮﺴﻧﺎﺳﺁ, ﻥﺩﺮﺑ-ﻻ﻿ﺎﺑ, ﻥﺩﺮﺑ-ﻻ﻿ﺎﺑ, ﻥﺩﺮﺑ-ﻻ﻿ﺎﺑ, ﯼﻭﺭ-ﻩﺩﺎﯿﭘ
ﺖﺳﮊ: ﻥﺩﺮﮐ-ﺎﻀﻣﺍ, ﻝﺎﻨﮕﯿﺳ, ﻞﺒﻤﺳ, ﻦﯾﺩﺎﻤﻧ, ﺵﺮﮕﻧ, ﺖﻟﺎﺣ
ﺖﯾﺮﯾﺪﻣ: ﺖﯾﺮﯾﺪﻣ, ﻥﺩﺮﮐ-ﺕﺭﺎﻈﻧ, ﯽﮔﺪﯿﺳﺭ, ﺖﻣﻮﮑﺣ, ﻥﺩﺮﮐ-ﺖﻣﻮﮑﺣ, ﻥﺩﺮﮐ-ﺖﯾﺍﺪﻫ, ﻝﺮﺘﻨﮐ
ﻝﺩﺎﺒﺗ: ﻪﻟﺩﺎﺒﻣ, ﻞﺑﺎﻘﺘﻣ, SWOP, ﯽﻨﯾﺰﮕﯾﺎﺟ
ﯽﻌﻄﻗ-ﻪﻟﺎﻘﻣ: 
ﺭﻮﺗﺍﺮﭙﻣﺍ: ﻩﺎﺷﺩﺎﭘ
ﺭﻭﺩ-ﻩﺍﺭ-ﺯﺍ: ﺭﻭﺩ, ﺭﺎﯿﺴﺑ, ﺭﻭﺩ
ﺖﺷﺯ: ﻩﺪﻨﻧﺯ-ﻭ-ﺪﻨﺗ, ﺭﻭﺁ-ﺵﺪﻨﭼ
ﺭﺍﺯﺁ-ﯽﺑ: 
ﻝﻭﺭ: ﺭﺎﻣﻮﻃ, ﭻﯿﭘ-ﻢﯿﺳ
ﭻﻨﯾﺍ: ﮎﺮﻤﮔ, ﺖﺴﺷ
ﻪﻣﺎﻧﺯﻭﺭ: ﻪﻠﺠﻣ, ﻥﺩﺮﮐ-ﻩﺎﮔﺁ, ﺕﺍﺮﻃﺎﺧ-ﺮﺘﻓﺩ
ﺶﯾﺭ: ﻡﺎﻌﻧﺍ, ﻪﻧﺎﭼ
ﻥﺩﺍﺩ-ﺮﺟ: ﻥﺩﻮﺑﺭ
ﻥﻮﯿﺴﯿﻤﮐ: ﻥﻮﯿﺴﯿﻤﮐ, ﻪﺘﺨﺗ
ﻪﮑﯿﻟﺎﺣ-ﺭﺩ: ﻦﯿﺣ-ﺭﺩ, ﻥﺎﯾﺮﺟ-ﺭﺩ
ﺭﻮﺒﻋ: ﺐﯿﻠﺻ, ﻝﺎﺼﺗﺍ, ﺭﻮﺒﻋ, ﺭﻮﺒﻋ, ﻝﺎﻘﺘﻧﺍ, ﻭﺮﻫﺍﺭ
ﻝﻼ﻿ﻘﺘﺳﺍ: ﻞﻘﺘﺴﻣ, ﯼﺩﺍﺯﺁ, ﻪﻧﺍﺩﺍﺯﺁ, ﯼﺩﺍﺯﺍ, ﯼﺭﺎﺘﺨﻣﺩﻮﺧ
ﻮﺑ: ﻦﻔﻌﺗ, ﺮﻄﻋ
ﻩﺪﺠﻫ: 
ﯽﺨﯾﺭﺎﺗ: ﯽﺨﯾﺭﺎﺗ, ﺦﯾﺭﺎﺗ, ﺱﺎﻨﺷ-ﺦﯾﺭﺎﺗ
ﺖﺷﺭﺩ: ﻊﻤﺟ, ﻉﻮﻤﺠﻣ, ﻒﯿﺜﮐ, ﻡﺎﺧ, ﻡﺎﺧ
ﻪﺸﯾﺭ: ﻪﻗﺎﺳ, ﻩﺯﺎﺗ
ﻞﮔ: ﮎﺎﺧ, ﻞﮔ-ﻭ-ﻦﺠﻟ, ﺱﺭ-ﮎﺎﺧ, ﮎﺎﺧ, ﻞﮔ
ﺱﻭﺮﻋ-ﻩﺯﺎﺗ: ﮒﺭﺰﺑ-ﺭﺩﺎﻣ
ﻪﻧﺎﻧﺯ-ﺭﺩﺎﭼ: ﻩﺩﺮﭘ, ﻥﺎﺑﺩﺎﺑ, ﯽﻧﺍﺮﯿﺘﺸﮐ
ﺮﺗﺎﺌﺗ: ﺮﺗﺎﺌﺗ
ﻪﺴﯾﺎﻘﻣ: ﻥﺩﺮﻛ-ﻪﺴﻳﺎﻘﻣ, ﯼﺍ-ﻪﺴﯾﺎﻘﻣ, ﻁﺎﺒﺗﺭﺍ, ﺖﺒﺴﻧ, ﻪﻬﺟﺍﻮﻣ
ﺐﯿﻗﺭ: ﻒﯾﺮﺣ, ﻒﻟﺎﺨﻣ, ﺖﺑﺎﻗﺭ, ﯽﺘﺑﺎﻗﺭ, ﺖﺑﺎﻗﺭ
ﻝﺩﺎﻌﺗ: ﻝﺩﺎﻌﺗ, ﻥﺎﺴﮑﯾ-ﺭﻮﻃ-ﻪﺑ, ﯼﺮﺑﺍﺮﺑ, ﯽﻘﻓﺍ, ﺖﺒﺴﻧ-ﻪﺑ, ﻝﺩﺎﻌﺗ, ﻪﺟﺩﻮﺑ
ﯽﺑﺮﻣ: ﯽﺑﺮﻣ, ﺺﺼﺨﺘﻣ, ﯽﺑﺮﻣ, ﯽﺑﺮﻣ
ﯽﻌﺒﻃ-ﺥﻮﺷ: ﯽﻌﺒﻃ-ﺥﻮﺷ, ﯽﻫﺎﮑﻓ, ﺖﻟﺎﺣ, ﯼﺪﻤﮐ
ﻥﺎﻣﺭ: ﻥﺎﺘﺳﺍﺩ, ﺪﯾﺪﺟ, ﺍﺮﯿﺧﺍ
ﻡﺎﻘﺘﻧﺍ: ﻪﻨﯿﮐ
ﺩﻮﺴﺣ: ﺕﺩﺎﺴﺣ, ﺕﺩﺎﺴﺣ
ﺥﺮﭼ: ﻪﺧﺮﭼﻭﺩ, ﻩﺮﯾﺍﺩ
ﻪﺘﺧﻮﺳ: ﯽﮕﺘﺧﻮﺳ, ﺩﺎﺸﮔ
ﻥﺩﺯ-ﻕﺮﺑ: ﻕﺮﺑ, ﺶﺑﺎﺗ, ﺶﺸﺧﺭﺩ
ﻥﺩﺭﻭﺁ-ﺩﻮﺟﻭ-ﻪﺑ: ﺩﺎﺠﯾﺍ, ﻦﺘﺧﺎﺳ, ﺭﺎﺘﺧﺎﺳ, ﻩﺪﻧﺯﺎﺳ, ﻦﺘﺧﺎﺳ, ﻦﺘﺧﺎﺳ, ﻥﺩﻭﺮﺳ, ﻞﻌﺟ, ﺪﯿﻟﻮﺗ
ﺩﺎﻀﺗ: ﺩﺭﻮﺧﺮﺑ, ﻩﺯﺭﺎﺒﻣ, ﻪﻬﺟﺍﻮﻣ, ﺩﺎﻀﺗ, ﻁﻮﻘﺳ, ﺮﯿﺛﺄﺗ
ﺖﻨﻌﻟ: 
ﺰﯿﻣﺍ-ﺖﻨﻌﻟ-ﺖﻟﺎﺣ: 
ﻩﺪﻧﺎﻣﺭﺩ: ﯽﺘﺨﺑﺪﺑ
ﺖﺒﺜﻣ: ﺖﺒﺜﻣ
ﻩﺎﮕﺷﺎﺑ: ﺵﺎﻔﺧ, ﻢﺘﺴﯿﺳ-ﻪﺑ-ﺩﻭﺭﻭ
ﻞﯿﺳ: 
ﺕﻼ﻿ﻏ: ﺕﺎﺑﻮﺒﺣ, ﻡﺪﻨﮔ-ﻪﺷﻮﺧ
ﯽﮕﻗﻼ﻿ﻋ-ﯽﺑ: ﯽﮕﻗﻼ﻿ﻋ-ﯽﺑ, ﻁﺎﯿﺘﺣﺍ-ﯽﺑ, ﯼﺭﺎﮕﻧﺍ-ﻞﻬﺳ
ﻖﻓﺍ: 
ﯽﺿﺮﻓ-ﺖﻟﺎﺣ: ﯽﺿﺮﻓ-ﺖﻟﺎﺣ
ﺪﻨﺗ-ﺐﯿﺷ: ﯼﺪﻨﻠﺑ, ﺐﯿﺷ
ﯽﻧﻮﻣﺭﺎﻫ: ﺵﺯﺎﺳ, ﮓﻨﻫﺍ
ﺪﻋﺭ: 
ﯽﮐﺩﻮﮐ-ﻥﺍﺭﻭﺩ: 
ﻮﻧﺍﺯ: ﻥﺩﺮﮐ-ﭗﻠﺷ-ﭗﻠﺷ
ﺭﺍﺰﻓﺍ-ﻡﺮﻧ: ﺭﺍﺰﻓﺍ-ﻡﺮﻧ, ﻪﻋﻮﻤﺠﻣ
ﯽﮔﺪﯾﺩ-ﺐﯿﺳﺁ: ﻪﻣﺪﺻ, ﻪﻣﺪﺻ, ﻥﺪﻧﺎﺳﺭ-ﺐﯿﺳﺁ, ﻥﺩﺯ-ﺐﯿﺳﺍ, ﻢﺧﺯ, ﻢﺧﺯ, ﺡﻭﺮﺠﻣ, ﺾﻘﻧ
ﻝﻮﺻﻭ-ﻡﻼ﻿ﻋﺍ: ﻥﺩﺮﻛ-ﺖﻓﺎﻳﺭﺩ, ﺩﻭﺭﻭ, ﺵﺮﯾﺬﭘ, ﺵﺮﯾﺬﭘ, ﺵﺮﯾﺬﭘ, ﺪﻨﺳ, ﺫﺎﺨﺗﺍ
ﻦﺘﺧﺎﺳ-ﺭﺩﺎﻗ: ﻪﺑ-ﺭﺩﺎﻗ, ﻪﺘﺴﯾﺎﺷ, ﻥﺩﺮﮐ-ﻝﺎﻌﻓ, ﻥﺩﺍﺩ-ﻩﺯﺎﺟﺍ, ﻥﺩﺎﻬﻧ-ﻡﺎﻧ, ﻞﻤﺣ, ﯼﺍﺮﺟﺍ, ﺪﯿﻫﺩ-ﻩﺯﺎﺟﺍ, ﻥﺩﺍﺩ-ﻩﺯﺎﺟﺍ
ﯽﻣﻭﺭ-ﻢﯾﺪﻗ-ﻡﺍﺭﺩ ﺖﻤﺴﻗ ﻦﯿﺘﺴﺨﻧ: 
ﺵﺰﻐﻟ: ﻩﺪﻧﺰﻐﻟ, ﺵﺰﻐﻟ, ﻥﺩﺭﻮﺧ-ﺮﺳ
ﺏﻼ﻿ﻘﻧﺍ: ﯽﺑﻼ﻿ﻘﻧﺍ, ﺎﺗﺩﻮﮐ, ﺶﺧﺮﭼ, ﺵﺭﻮﺷ, ﺵﺭﻮﺷ
ﺭﺍﺩ-ﻪﻋﺭﺰﻣ: ﯽﻧﺎﻘﻫﺩ
ﻪﺑﺮﺿ: ﻪﺑﺮﺿ, ﺎﺗﺩﻮﮐ, ﻥﺩﺮﺑ-ﻡﻮﺠﻫ, ﺵﻼ﻿ﺗ
ﻮﮑﺳ: ﻪﻨﺤﺻ, ﻦﻤﺠﻧﺍ, ﻪﯾﺎﭘ
ﻝﻮﺳﺭ: ﻩﺪﻨﯾﺎﻤﻧ, ﺮﯿﻔﺳ, ﺕﺎﻤﻠﭙﯾﺩ
ﺯﺎﯿﺘﻣﺍ: ﺯﺎﺘﻤﻣ, ﺢﯿﺟﺮﺗ, ﻪﯿﻤﻬﺳ, ﻥﺩﺍﺩ-ﯼﺍﺭ-ﻖﺣ, ﺩﺎﻬﻨﺸﯿﭘ, ﺯﺎﯿﺘﻣﺍ
ﻪﺘﻓﺎﯾ-ﻥﺎﻣﺯﺎﺳ: ﻪﺴﺳﻮﻣ, ﻥﺩﺍﺩ-ﻥﺎﻣﺯﺎﺳ, ﻪﺴﺳﻮﻣ, ﺐﯿﺗﺮﺗ, ﻥﺩﺍﺩ-ﺐﯿﺗﺮﺗ
ﻮﺠﺸﻧﺍﺩ: ﺩﺮﮔﺎﺷ, ﻩﻭﮋﭘ-ﺶﻧﺍﺩ, ﯽﺳﺎﻨﺷﺭﺎﮐ
ﺭﺎﻏ: 
ﺖﻨﺳ: ﯽﺘﻨﺳ, ﯽﺘﻨﺳ-ﺭﻮﻃ-ﻪﺑ, ﮎﺮﻤﮔ, ﻢﯿﻠﺴﺗ
ﯼﺩﮊﺍﺮﺗ: ﻥﺪﺷ-ﺮﯿﮔﺍﺮﻓ, ﻪﺼﻏ-ﻭ-ﻢﻏ
ﯽﻈﻓﺎﺣﺍﺪﺧ: ﯽﻈﻓﺎﺣﺍﺪﺧ, ﻆﻓﺎﺣ-ﺍﺪﺧ
ﺩﺎﻘﺘﻧﺍ: ﻥﺩﺮﮐ-ﺩﺎﻘﺘﻧﺍ, ﺩﺎﻘﺘﻧﺍ, ﯽﻨﯿﺑﺯﺎﺑ
ﻪﺒﻨﭘ: ﻢﺸﭘ
ﻥﺎﺘﺳﺭﺎﻤﯿﺑ: ﻩﺎﻨﭘ
ﻥﺩﺮﮐ-ﻩﺭﺎﺟﺍ: ﻪﯾﺍﺮﮐ, ﻡﺍﺪﺨﺘﺳﺍ, ﺕﺎﯿﻟﺎﻣ, ﻡﺍﺮﺘﺣﺍ, ﻩﺭﺎﺟﺍ, ﻡﺍﺪﺨﺘﺳﺍ, ﻥﺩﺮﮐ-ﻝﻮﻐﺸﻣ, ﻩﺭﺎﺟﺍ, ﺭﻮﺸﻨﻣ
ﺭﺎﺨﺑ-،ﺯﺎﮔ-،ﺩﻭﺩ: 
ﺮﯾﺬﭘﺎﻧ-ﺏﺎﻨﺘﺟﺍ: ﺭﺎﭼﺎﻧ-ﻪﺑ
ﺭﺎﺒﮔﺮﻣ: 
ﮒﺮﺑ: ﻕﺭﻭ, ﻪﻐﯿﺗ
ﺭﺎﺸﺘﻧﺍ: ﺭﺎﺸﺘﻧﺍ, ﺮﺸﻧ-ﻭ-ﭖﺎﭼ, ﭖﺎﭼ, ﻡﻼ﻿ﻋﺍ, ﺶﺨﭘ, ﻥﺩﺮﮐ-ﺩﺍﺯﺁ, ﺪﯿﻟﻮﺗ, ﺭﺎﺸﺘﻧﺍ, ﭖﺎﭼ, ﻡﻼ﻿ﻋﺍ
ﻢﺻﺎﺨﺘﻣ: ﻪﻧﺎﺘﺳﻭﺩ-ﺮﯿﻏ, ﺖﻣﻮﺼﺧ
ﻪﻤﺟﺮﺗ: ﻥﺩﺮﮐ-ﻪﻤﺟﺮﺗ, ﻥﺩﺮﮐ-ﻪﻤﺟﺮﺗ, ﺮﯿﺴﻔﺗ, ﻥﺪﺷ-ﺮﯿﮔﺍﺮﻓ, ﻝﺎﻘﺘﻧﺍ
ﯼﺭﺎﭙﺴﮐﺎﺧ: ﯼﺭﺎﭙﺴﮐﺎﺧ, ﻥﺎﺘﺳﺮﺒﻗ
ﺭﺩﻮﭘ: ﺭﺩﻮﭘ, ﺮﯿﻤﺧ, ﻖﯿﻗﺩ, ﻖﯿﻗﺩ, ﻖﯿﻗﺩ, ﯽﯾﺍﺬﻏ-ﻩﺪﻋﻭ
ﺕﺎﺒﺗﺎﮑﻣ: ﻥﺩﻮﺑ-ﻖﺑﺎﻄﻣ, ﺱﺎﻤﺗ, ﻁﺎﺒﺗﺭﺍ, ﯽﻃﺎﺒﺗﺭﺍ
ﮏﯿﺘﻧﺎﻣﻭﺭ: 
ﻪﺒﻠﮐ: ﻪﺒﻠﮐ, ﻝﺰﻨﻣ
ﺩﺎﻬﻨﺸﯿﭘ: ﺖﻟﺎﺣ, ﺩﺎﻬﻨﺸﯿﭘ, ﺖﮐﺮﺣ, ﻩﺭﺍﺰﮔ, ﯼﺩﺎﻬﻨﺸﯿﭘ-ﺡﺮﻃ, ﺪﻫﺩ-ﯽﻣ-ﺩﺎﻬﻨﺸﯿﭘ, ﻪﯿﺻﻮﺗ, ﺩﺎﻬﻨﺸﯿﭘ, ﺩﺎﻬﻨﺸﯿﭘ, ﻥﺩﺮﮐ-ﺩﺰﻣﺎﻧ
ﺪﯿﻠﻘﺗ-ﻪﺑ-ﻪﺘﺴﺑﺍﻭ: 
ﺭﻻ﻿ﺩ: 
ﻦﺷﻭﺭ-ﺯﻭﺭ: 
ﻩﺩﺰﻧﺎﺷ: 
ﮊﺎﺘﻧﻮﻣ: ﯼﺭﺎﮐ-ﻪﺴﻠﺟ, ﺲﻧﺍﺮﻔﻨﮐ, ﻩﺮﮕﻨﮐ, ﯼﺪﻨﺑ-ﺮﮑﯿﭘ
ﻩﺮﻤﻌﺘﺴﻣ: 
ﻝﺎﺑ: ﺶﺨﺑ, ﻪﻋﻮﻤﺠﻣ
ﺮﯿﺷ-ﻥﺍﻮﯿﺣ: 
ﮓﻨﻫﺮﻓ: ﯽﮕﻨﻫﺮﻓ
ﻥﻮﺘﺳ: ﻪﯾﺍﺭﺁ, ﻪﯾﻻ﻿, ﺐﻄﻗ, ﺭﻮﺒﻋ
ﯼﺮﮔ-ﻪﻠﯿﺣ: ﺮﯾﻭﺰﺗ-ﻭ-ﻪﻠﯿﺣ ﯼﻭﺭ, ﻦﻓ-ﻭ-ﺕﻮﻓ, ﺮﻫﺎﻣ
ﻡﺍﺭﺩ: ﺮﻫﺎﻈﺗ, ﯽﺸﯾﺎﻤﻧ
ﯽﺧﻮﺷ: ﯽﺧﻮﺷ, ﺰﻐﻟ
ﺭﺎﺒﻏ: ﻪﻣ
ﻭﺭﺍﺩ: ﻭﺭﺍﺩ, ﻥﺎﻣﺭﺩ, ﻥﺪﯿﺷﺎﭘ, ﻪﺨﺴﻧ
ﻩﺩﺭﺎﻬﭼ: 
ﺪﯿﺳﺍ: ﺵﺮﺗ, ﯼﺪﯿﺳﺍ
ﯽﻨﻌﯾ: ﺮﻫ, ﻝﺎﺜﻣ-ﻥﺍﻮﻨﻋ-ﻪﺑ, ﺹﺎﺧ
ﺪﻣﺁﺭﺩ: ﯼﺭﻮﺗ
ﻒﻘﺳﺍ: 
ﯽﺠﻧﺭﺎﻧ: 
ﻥﺍﻭ: ﻡﺎﻤﺣ, ﺵﻭﺩ, ﻡﺎﻤﺣ-ﻥﺍﻭ
ﻪﯿﻟﻭﺍ: ﻪﯿﻟﻭﺍ, ﻪﯿﻟﻭﺍ
ﺪﺒﺳ: ﻦﺑ, ﻪﺴﯿﮐ
ﺮﯿﺑﺩ: 
ﯽﻧ: ﮏﺸﺧ-ﻒﻠﻋ
ﺮﺒﺻ-ﯽﺑ: ﻕﺎﯿﺘﺷﺍ-ﺎﺑ
ﺕﺎﺠﻧ: ﯽﻨﻤﯾﺍ, ﯽﯾﺎﻫﺭ, ﻡﻼ﻿ﺳ
hodiernal-ﺖﻔﺳ: 
ﺪﺼﻗ: ﻩﺪﺷ-ﻪﺘﻓﺮﮔ-ﺮﻈﻧ ﺭﺩ, ﺪﺼﻗ, ﺪﻨﻣ-ﻪﻗﻼ﻿ﻋ, ﻕﺎﺘﺸﻣ, ﻩﺰﯿﮕﻧﺍ, ﻞﯿﻣ-ﯽﺑ, ﻥﺩﺍﺩ-ﺹﺎﺼﺘﺧﺍ, ﻥﺩﺍﺩ-ﺹﺎﺼﺘﺧﺍ
ﺭﺎﺨﺑ: ﺭﺎﺨﺑ
ﻢﺳ: ﯽﻤﺳ, ﯽﻤﺳ, ﺶﮐ-ﻒﻠﻋ
ﺩﺍﺪﻌﺘﺳﺍ: ﯽﮔﺪﻨﺸﺧﺭﺩ, ﺪﻌﺘﺴﻣ, ﺖﯿﺣﻼ﻿ﺻ, ﯽﯾﺎﻧﺍﻮﺗ, ﻪﻋﻮﻤﺠﻣ
ﻢﯿﻠﻗﺍ: ﺍﻮﻫ
ﺭﺍﺬﮔ-ﺮﻴﺛﺎﺗ: ﺮﺒﺘﻌﻣ, ﺮﺛﻮﻣ-ﺭﻮﻃ-ﻪﺑ, ﺪﻣﺁﺭﺎﮐ, ﯽﺸﺨﺑﺮﺛﺍ, ﺫﻮﻔﻧ, ﺪﯿﻔﻣ, ﻡﺍﻭﺩ-ﻞﺑﺎﻗ
ﻥﺩﺍﺩ-ﺰﯿﻤﺗ: ﻕﺍﺮﺘﻓﺍ, ﻥﺪﺷ-ﻞﺋﺎﻗ-ﺾﯿﻌﺒﺗ, ﺾﯿﻌﺒﺗ, ﮏﯿﮑﻔﺗ, ﻥﺩﺍﺩ-ﺹﺎﺼﺘﺧﺍ, ﯼﺯﺎﺳﺍﺪﺟ, ﺩﺭ, ﻥﺩﺮﮐ-ﻡﻭﺮﺤﻣ, ﻥﺩﺮﮐ-ﻥﺎﻬﻨﭘ
ﻮﺸﺘﺴﺷ: ﯽﯾﻮﺸﺳﺎﺒﻟ
ﺭﺍﺮﻗﺍ: ﻥﺎﻋﺫﺍ, ﻩﺪﯿﻘﻋ, ﻦﺘﺧﺎﻨﺷ-ﺖﯿﻤﺳﺭ-ﻪﺑ
ﻑﺮﺧﺰﻣ: ﻪﻟﺎﺑﺯ, ﻞﯿﻟﺩ-ﯽﺑ, ﺲﻧﺎﺠﺘﻣﺎﻧ
ﮓﻨﺳ-ﻝﺎﻏﺯ: ﻦﺑﺮﮐ
ﯽﻧﺍﺭ-ﻖﯾﺎﻗ: 
ﺖﻗﻮﻣ: ﻩﺯﺎﺑ, ﻥﺎﻣﺯ-ﺕﺪﻣ, ﯽﻧﺎﻣﺯ, ﯽﻓﺩﺎﺼﺗ, ﻦﯿﺣ-ﺭﺩ
delimitative-ﻪﺒﻨﺟ: 
ﻥﺍﻮﺨﺘﺳﺍ: ﺎﭘ
ﻪﺒﻨﺷﻭﺩ: 
ﻪﺒﻨﺸﻬﺳ: ﻡﻮﺳ
ﻪﺒﻨﺷ-ﺭﺎﻬﭼ: ﻡﺭﺎﻬﭼ
ﻝﺍﺭﺪﻓ: ﻥﻮﯿﺳﺍﺭﺪﻓ, ﯼﺰﮐﺮﻣ
ﺏﻮﻠﻄﻣ: ﺏﺍﺬﺟ, ﺏﻮﻠﻄﻣ
ﻩﺪﻨﯾﺎﻤﻧ: ﯽﮔﺪﻨﯾﺎﻤﻧ, ﯽﮔﺪﻨﯾﺎﻤﻧ, ﻩﺪﻨﯾﺎﻤﻧ, ﻞﯿﮐﻭ, ﻡﺎﻘﻣ-ﻢﺋﺎﻗ, ﯼﻮﮕﻨﺨﺳ
ﯽﻧﺎﺘﮐ-ﻪﭼﺭﺎﭘ: ﮎﺭﺬﺑ, ﯼﺭﺍﻮﻠﺷ-ﺮﯾﺯ
ﯽﯾﻮﺸﻓﺮﻇ-ﮏﻨﯿﺳ: ﻥﺪﺷ-ﻕﺮﻏ, ﻪﻧﺎﺧﺩﻭﺭ-ﻩﺯﻮﺣ, ﯼﻭﺭ-ﺰﻠﻓ
ﺭﺩﺍﺮﺑ-ﺎﯾ-ﺮﻫﺍﻮﺧ ﺮﺴﭘ: ﻩﺩﺍﺯ-ﺮﻫﺍﻮﺧ, ﻩﻮﻧ, ﻩﻮﻧ
ﻦﯿﻧﻮﺧ: ﯼﺰﯾﺭ-ﻥﻮﺧ, ﻦﺘﻓﺮﮔ-ﻥﻮﺧ
ﻩﺮﺻﺎﺤﻣ: ﻪﻃﺎﺣﺍ, ﯽﻟﺪﻨﺻ
ﻩﺪﻌﻣ: ﻢﮑﺷ, ﻢﮑﺷ, ﯽﻤﮑﺷ, ﺲﯾﺮﺗﺎﻣ
ﺞﻧﺮﺑ-ﺰﻠﻓ: ﯼﺰﻧﺮﺑ, ﺲﻣ-ﺰﻠﻓ, ﺞﻧﺮﺑ
ﻪﻠﻗ: ﺝﻭﺍ, ﻻ﻿ﺎﺑ, ﻡﺎﻌﻧﺍ
ﻢﺠﻨﭘ: ﺞﻨﭘ
ﻥﺍﺯﺭﺍ: ﻥﺍﺯﺭﺍ, ﻢﮐ
ﯼﺭﺎﺼﺤﻧﺍ-ﺺﺨﺷ: 
ﻥﺩﺮﮐ-ﺐﺣﺎﺼﺗ: ﺎﺑ-ﺩﺭﻮﺧﺮﺑ, ﻥﺩﺮﮐ-ﺩﻭﺪﺤﻣ, ﺖﺷﺍﺩﺯﺎﺑ, ﻭﺭﺯﺭ, ﻥﺩﻮﺑﺭ, ﻩﺪﺷ-ﻝﺎﻐﺷﺍ, ﻝﺎﻐﺷﺍ, ﻦﺘﺷﺍﺩ-ﻪﮕﻧ, ﻦﺘﻓﺮﮔ, ﻢﻬﻓ
ﺭﺎﺼﺣ: ﻦﯿﭼﺮﭘ
ﻪﻤﺴﺠﻣ: ﯼﺯﺎﺳ-ﻪﻤﺴﺠﻣ
ﻪﻧﺎﺨﭘﻮﺗ: ﭖﻮﺗ
ﻦﺘﻓﺮﯾﺬﭘ: ﻥﺪﺷ-ﺏﺬﺟ, ﻥﺪﺷ-ﻊﻤﺟ
ﻑﺍﺮﻃﺍ: ﻑﺍﺮﻃﺍ-ﺭﺩ, ﯽﮕﯾﺎﺴﻤﻫ, ﻪﯾﺎﺴﻤﻫ, ﻪﯾﺎﺴﻤﻫ, ﯽﮕﯾﺎﺴﻤﻫ, ﯽﻧﻮﻣﺍﺮﯿﭘ, ﻑﺍﺮﻃﺍ-ﻂﯿﺤﻣ, ﺭﻭﺎﺠﻣ, ﮏﯾﺩﺰﻧ
ﺍﺪﮐﻮﻣ: ﺖﺨﺳ, ﻢﺠﺴﻨﻣ, ﺖﻗﺩ, ﮓﻨﺗ, ﺪﯾﺪﺷ, ﺎﻌﻄﻗ, ﻼ﻿ﻣﺎﮐ, ﺎﻌﻄﻗ, ﻢﮑﺤﻣ, ﻦﺸﺧ
ﻥﺯﻮﮔ: 
ﻪﺗﻮﺑ: 
ﻦﻫﺁ-ﻩﺍﺭ: ﻦﻫﺁ-ﻩﺍﺭ, ﻞﯾﺭ
ﻪﯿﻠﺨﺗ: ﯽﯾﺎﻫﺭ, ﻥﺩﺮﮐ-ﯽﻟﺎﺧ, ﻥﺩﺮﮐ-ﺩﺍﺯﺁ, ﻥﺩﺮﮐ-ﮎﺮﺗ, ﻦﺘﺧﺍﺪﻧﺍ-ﻥﻭﺮﯿﺑ
ﺙﺭﺍﻭ: ﻥﺩﺮﺑ-ﺙﺭﺍ
ﻁﻮﻠﺑ: 
ﺪﻨﯾﺎﺷﻮﺧﺎﻧ: ﺕﺬﻟ, ﺵﻮﺧ, ﺏﺮﻄﻀﻣ, ﺖﯾﺫﺍ, ﻩﺪﻨﻨﻛ-ﺖﺣﺍﺭﺎﻧ, ﻩﺪﻨﻧﺯ-ﻭ-ﺪﻨﺗ, ﺖﺣﺍﺭﺎﻧ
ﻉﺍﺮﺘﺧﺍ: ﻥﺩﺮﮐ-ﻉﺍﺮﺘﺧﺍ, ﻒﺸﮐ, ﯼﺭﻭﺁﻮﻧ
ﻮﻧﺎﯿﭘ: 
ﻥﺩﺮﮐ-ﺪﻋﺎﻘﺘﻣ: ﻥﺩﺮﻛ-ﻊﻧﺎﻗ, ﻦﺘﻓﺮﮔ-ﻦﺸﺟ, ﺖﺷﺍﺪﮔﺭﺰﺑ
ﯽﻔﺨﻣ: ﺰﯿﻣﺁ-ﺭﺍﺮﺳﺍ
ﻡﺎﻨﮑﯿﻧ: ﻑﻭﺮﻌﻣ, ﻡﺎﻧﺪﺑ, ﻪﺘﺴﺟﺮﺑ
ﻢﻠﻇ: 
ﻪﺳﻮﺳﻭ: 
ﯽﯾﺎﻬﻧ-ﻑﺪﻫ-ﯼﺍﺭﺍﺩ ﻪﺒﻨﺟ: 
ﯼﺩﺎﺼﺘﻗﺍ: ﺩﺎﺼﺘﻗﺍ, ﯼﺩﺎﺼﺘﻗﺍ-ﺮﻈﻧ-ﺯﺍ, ﻥﺍﺩﺩﺎﺼﺘﻗﺍ, ﯽﻟﺎﻣ
ﻲﻠﻠﻤﻟﺍ-ﻦﻴﺑ: ﯽﻧﺎﻬﺟ, ﯽﺘﯿﻠﻣ-ﺪﻨﭼ
ﻥﺩﺮﮐ-ﻪﻠﺧﺍﺪﻣ: ﻞﺧﺍﺪﺗ, ﻪﻠﺧﺍﺪﻣ, ﻪﻠﺧﺍﺪﻣ, ﻥﺪﺷ-ﻢﺣﺍﺰﻣ, ﺖﻤﺣﺯ, ﻥﺍﺮﮕﻧ, ﻥﺩﺮﮐ-ﻊﻄﻗ, ﻥﺩﺮﮐ-ﮏﯾﺮﺤﺗ, ﮏﯾﺮﺤﺗ, ﻥﺩﺮﮐ-ﺖﯾﺫﺍ, ﺩﺭﻮﺧﺮﺑ
ﻑﻮﺴﻠﯿﻓ: ﯽﻔﺴﻠﻓ
ﺎﺒﯾﺯ: ﺯﻭﺭ-ﺪﻣ, ﻒﯾﺮﻇ
ﻩﺎﻓﺭ: ﯽﻫﺍﻮﺧ-ﺮﯿﺧ, ﯽﺑﺎﯿﻣﺎﮐ, ﮎﺭﺍﺪﺗ
ﯽﻫﺎﻣ-ﺪﯿﺻ: 
ﺖﻗﺮﺳ: ﯼﺩﺯﺩ, ﺕﺭﺎﻏ, ﺖﻗﺮﺳ, ﻥﺩﺯ-ﺪﯾﺪﺷﻭ-ﺪﻨﺗ ﻪﺑﺮﺿ
ﺐﻟ: ﺭﺎﻘﻨﻣ, ﯽﻫﺎﻔﺷ, ﺯﺮﻣ
ﻪﺘﺴﺸﻧﺯﺎﺑ: ﯽﮕﺘﺴﺸﻧﺯﺎﺑ, ﻪﺘﺴﺸﻧﺯﺎﺑ, ﻪﺘﺴﺸﻧﺯﺎﺑ, ﯽﻨﯿﺸﻧ-ﺐﻘﻋ, ﯽﻗﺎﺑ, ﺖﻏﺍﺮﻓ, ﻥﺪﯿﺸﮐ-ﺭﺎﻨﮐ, ﺎﻔﻌﺘﺳﺍ
ﻂﺴﺑ: ﺖﺳﺍﺭ, ﻥﺩﺮﻛ-ﺪﻳﺪﻤﺗ, ﻪﻟﺎﺳﺭ, ﯽﮔﮋﯾﻭ, ﻪﻌﻄﻗ, ﺭﻮﺒﻋ, ﻪﻌﻄﻗ, ﻪﮑﺗ
ﺲﮑﻋ-ﻡﻮﺒﻟﺁ: ﻪﻋﻮﻤﺠﻣ
ﺕﺍﺯﺍﻮﻣ-ﻪﺑ: ﺭﺎﻨﮐ-ﺭﺩ, ﺭﺎﮔﺯﺎﺳ, ﻪﺘﺴﺑﺍﻭ, ﻥﺩﻮﻤﻧ-ﻪﻓﺎﺿﺍ
atelic-ﻪﺒﻨﺟ: 
ﻩﺭﺎﻗ: ﯼﺎﻫﺭﺎﻗ
ﻥﺍﺮﮔ-ﺖﻟﺎﺣ: ﻥﺍﺮﮔ-ﺖﻟﺎﺣ
ﺕﺍﻭﺍﺮﮐ: ﺕﺍﻭﺍﺮﮐ, ﺏﺎﻘﻋ
ﻝﻮﻠﺳ: ﺖﯿﻫﺎﻣ, ﻪﺘﺴﻫ, ﺲﻔﻗ, ﻪﺨﺴﻧ, ﺭﺎﯿﺳ, ﻩﺍﺮﻤﻫ-ﻦﻔﻠﺗ, ﻩﺍﺮﻤﻫ-ﻦﻔﻠﺗ
ﻍﺮﻣ-ﻢﺨﺗ: ﻪﻀﯿﺑ
ﯽﻋﻮﻨﺼﻣ: ﯽﺒﯿﮐﺮﺗ
ﻦﻤﺿ-ﺭﺩ: ﻥﺎﻣﺰﻤﻫ-ﺭﻮﻄﺑ
ﻥﺍﺮﺤﺑ: ﺩﻮﮐﺭ, ﯼﺭﻭﺍﺩ, ﯼﺭﻭﺍﺩ, ﯼﺭﺍﺮﻄﺿﺍ
ﺏﺩﺍ-ﺎﺑ: ﻊﺿﺍﻮﺗ, ﻩﺩﺮﮐ-ﻞﯿﺼﺤﺗ
ﺭﺎﻫﺎﻧ: ﻪﻧﺎﺤﺒﺻ, ﻡﺎﺷ
ﺝﺎﮐ: ﮏﻓ
ﺭﺎﺸﻓ: ﺭﺎﺸﻓ, ﻮﯾﺍﺭﺩ, ﻥﺩﺮﻛ-ﻖﻳﻮﺸﺗ, ﺞﯾﻭﺮﺗ, ﺭﺎﺸﻓ, ﺭﺎﺸﻓ
ﺩﺎﺤﺗﺍ: ﻪﯾﺩﺎﺤﺗﺍ, ﻪﯾﺩﺎﺤﺗﺍ, ﻑﻼ﻿ﺘﺋﺍ, ﻦﺘﺨﯿﻣﺁ, ﺖﮐﺭﺎﺸﻣ
ﺮﻤﮐ-ﺭﻭﺩ: ﻥﺍﺭ-ﻞﺼﻔﻣ, ﯽﮔﺪﻧﺯ, ﻥﺩﺮﻛ-ﻲﮔﺪﻧﺯ, ﻂﺳﻮﺘﻣ, ﻪﻤﯿﻧ, ﻂﺳﺍﻭﺍ
ﻩﺰﺠﻌﻣ: ﺐﺠﻌﺗ
ﻥﺍﻮﻠﻣ: 
ﺹﻮﻠﺧ: ﺖﻔﻋ
ﯼﺭﻮﻬﻤﺟ: ﯽﺳﺍﺮﮐﻮﻣﺩ
ﻦﻔﻠﺗ: ﻦﻔﻠﺗ, ﺭﺎﯿﺳ
ﻕﻼ﻿ﺷ: 
ﻦﻫﺍﺮﯿﭘ: ﺕﺮﺷ-ﯽﺗ
ﻥﺩﺮﮐ-ﯽﻓﺮﻌﻣ: ﯽﻓﺮﻌﻣ, ﻪﺋﺍﺭﺍ, ﺩﺎﺠﯾﺍ, ﺯﺎﻏﺁ, ﻪﺋﺍﺭﺍ, ﮎﺭﺍﺪﺗ, ﻪﯿﺻﻮﺗ, ﻪﻌﺟﺍﺮﻣ, ﻖﯾﺭﺰﺗ, ﻪﺋﺍﺭﺍ, ﻞﯾﻮﺤﺗ, ﺪﺸﮐ-ﯽﻣ-ﺮﯾﻮﺼﺗ ﻪﺑ, ﻥﺪﯿﺸﮐ-ﺮﯾﻮﺼﺗ
ﻪﭘﺎﻧﺎﮐ: ﯽﺘﺣﺍﺭ-ﯽﻟﺪﻨﺻ
ﺖﺸﮔﺮﺑ-ﻭ-ﺖﻓﺭ: ﻥﺩﺮﮐ-ﮎﺎﭘ, ﺶﮐ-ﻦﺷ, ﻦﮑﺳﺍ
ﺩﺯﺩ: ﺲﻴﺋﺭ
ﻆﻔﺣ: ﻆﻔﺣ, ﻩﺮﯿﺧﺫ, ﻭﺭﺯﺭ, ﻥﺪﻧﺍﺩﺮﮔﺯﺎﺑ, ﻦﺘﺷﺍﺩ-ﻩﺎﮕﻧ, ﻥﺩﺮﮐ-ﺭﺎﻬﻣ, ﺖﺷﺍﺩﺯﺎﺑ, ﺮﺑﺍﺮﺑ-ﺭﺩ-ﺖﻣﻭﺎﻘﻣ, ﻥﺩﺮﮐ-ﻝﻮﻐﺸﻣ, ﻆﻔﺣ, ﻆﻔﺣ, ﻭﺮﺴﻨﮐ, ﻦﺘﺷﺍﺩ-ﻪﮕﻧ, ﻥﺪﯿﺒﺴﭼ
ﻝﺎﻧﺎﮐ: ﺰﯾﺭﺎﮐ
ﺖﯿﺼﺨﺷ: ﺖﯿﺼﺨﺷ
ﺕﺎﺣﻼ﻿ﺻﺍ: ﺩﻮﺒﻬﺑ, ﺡﻼ﻿ﺻﺍ, ﯽﻠﻣﺎﮑﺗ-ﺮﯿﺳ, ﺡﻼ﻿ﺻﺍ
ﺰﯿﻣﺁ-ﺪﯾﺪﻬﺗ: ﺪﯾﺪﻬﺗ, ﻥﺩﺮﮐ-ﺪﯾﺪﻬﺗ, ﮎﺎﻧﺮﻄﺧ, ﮎﺎﻨﺳﺮﺗ
ﺖﺳﺩ-ﻒﻛ: ﺍﺮﻓﺍ
ﻮﮔﺪﻨﻠﺑ: ﯼﻮﮕﻨﺨﺳ
ﻪﻧﺎﺘﺳﺁ: ﻊﻧﺎﻣ
ﻥﺩﺮﮐ-ﺭﺍﺩﺍﻭ: ﻭﺮﻫﺍﺭ, ﻢﯿﻫﺍﻮﺧ-ﯽﻣ, ﺩﻮﺷ-ﯽﻣ-ﺐﺒﺳ, ﻥﺩﺍﺩ-ﺭﺍﺪﺸﻫ, ﻥﺩﺮﮐ-ﮏﯾﺮﺤﺗ, ﺖﻟﺎﺣ, ﯼﺮﺒﻫﺭ, ﻥﺩﺮﮐ-ﺍﻮﻏﺍ, ﻥﺪﯿﺸﮐ-ﻥﻭﺮﯿﺑ
ﻩﺰﯿﻧ: ﯽﮐﺪﯾ
ﻪﺘﻓﺭ-ﻭ-ﻪﺘﺴﺷ: ﺐﺗﺮﻣ, ﺰﯿﻤﺗ, ﻩﺪﺷ-ﻪﺘﺴﺑ-ﻢﮑﺤﻣ
ﻪﺴﻠﺟ: ﯼﺭﺎﮐ-ﻪﺴﻠﺟ, ﺲﻧﺍﺮﻔﻨﮐ
ﻪﺠﻨﮑﺷ: ﻥﺪﯿﺸﮐ-ﺞﻧﺭ
ﺖﺑﻮﻃﺭ: ﮎﺎﺧ, ﺏﻮﻃﺮﻣ, ﻩﺪﻧﻭﺩ, ﻡﺮﮔ
ﺱﺍﺮﻟﺍ-ﻂﺧ: ﻻ﻿ﺎﺑ, ﻦﺘﻓﺎﺑ-ﻭ-ﻥﺪﯿﺑﺎﺗ ﻢﻬﺑ, ﻪﺘﺸﭘ, ﻪﻧﺎﺷ
ﺮﻓﺎﺴﻣ: ﻥﺎﻤﻬﻣ, ﺮﻓﺎﺴﻣ, ﺖﺴﯾﺭﻮﺗ, ﺮﻓﺎﺴﻣ
ﻪﻧﺎﺧﺭﺎﮐ: ﻪﻧﺎﺧﺭﺎﮐ, ﺪﯿﻟﻮﺗ, ﻩﺎﯿﮔ
ﻪﺸﻘﻧ: ﺕﺭﺎﮐ, ﺭﺍﺩﻮﻤﻧ, ﻑﺍﺮﮔ, ﻪﯾﺍﺮﮐ, ﻂﯿﻠﺑ
ﻪﻘﯾ: ﻪﻃﺎﺣﺍ
ﻥﺩﺮﮐ-ﻦﯾﺰﮕﯾﺎﺟ: ﯽﻨﯾﺰﮕﯾﺎﺟ, ﻥﺩﺮﮐ-ﺎﺠﺑﺎﺟ, ﯽﮐﺪﯾ, ﻦﯾﺰﮕﯾﺎﺟ, ﻦﯿﺸﻧﺎﺟ, ﯽﻨﯾﺰﮕﯾﺎﺟ, ﯽﯾﺎﺟ-ﻪﺑﺎﺟ, ﻥﺩﺍﺩ-ﺮﯿﯿﻐﺗ, ﺕﻭﺎﻔﺘﻣ, ﺡﻼ﻿ﺻﺍ, ﺮﯾﺯ
ﺍﺪﻤﻋ: ﯼﺪﻤﻋ, ﻪﻧﺎﻫﺎﮔﺁ, ﻊﻠﻄﻣ, ﻪﻧﺎﻫﺎﮔﺁ, ﺪﻨﻣﺩﻮﺳ
ﻮﺠﺑﺁ: ﺖﻨﯾﺎﭘ
ﯽﻠﻤﺨﻣ: 
ﻦﯿﻣﺯ-ﻪﺑﺫﺎﺟ: ﻪﺑﺫﺎﺟ, ﻥﺪﺷ-ﻪﻟ
ﻪﺒﻄﺧ: ﻥﺩﺮﮐ-ﺖﺤﯿﺼﻧ
ﻩﺩﺎﻔﺘﺳﺍ-ﻮﺳ: ﻩﺎﺒﺘﺷﺍ, ﻩﺎﺒﺘﺷﺍ
ﻪﻠﮔ: ﻩﻭﺮﮔ, ﻪﻠﮔ, ﻪﺘﺳﺩ, ﻡﺎﺣﺩﺯﺍ
ﻩﺩﺰﯿﺳ: 
ﻪﯿﺟﻮﺗ: ﻢﮑﺣ, ﻥﺩﺮﮐ-ﻪﺑﻻ﻿, ﻊﻓﺍﺪﻣ, ﻪﯿﺟﻮﺗ, ﻩﺪﺷ-ﻞﯾﺪﻌﺗ
ﻪﻌﻤﺟ: ﻩﺮﻘﻧ, ﻩﺮﻫﺯ-ﻩﺭﺎﯿﺳ
ﻮﻣ-ﻢﻠﻗ: ﻪﻧﺎﺷ
ﺩﻮﻠﻧﺍﺩ: 
ﻡﺮﮐ-ﮓﻧﺭ: ﯽﻨﺘﺴﺑ
ﻩﺮﺨﺻ: ﮓﻨﺳ, ﺯﺮﻣ
ﻥﺍﺭﻭﺍﺩ-ﺖﺌﯿﻫ: 
ﻻ﻿ﻮﯿﻫ: ﻝﻮﻏ, ﻻ﻿ﻮﯿﻫ
ﻩﺩﺯ-ﺦﯾ: ﯽﮔﺩﺯ-ﺦﯾ
ﻥﺍﺪﻠﮔ: ﻪﺑﺎﺗ-ﯽﻫﺎﻣ, ﻪﺸﯿﺷ, ﻑﺮﻇ
ﯽﻨﭘ: ﺪﺻﺭﺩ
ﻥﺩﺮﮐ-ﺭﺍﺮﺻﺍ: ﺪﻨﻠﺑ-ﯼﺍﺪﺻ-ﺎﺑ, ﺭﺎﺸﻓ, ﺎﻋﺩﺍ, ﻂﺧ-ﺭﺍﺩ-ﻂﺧ ﺮﯾﺯ, ﺪﯿﮐﺎﺗ, ﻪﻣﺍﺩﺍ, ﺭﺍﺮﺻﺍ, ﺯﺎﯿﻧ, ﺚﺤﺑ-ﻭ-ﺮﺟ
ﺐﯿﺳ: 
ﻮﮕﺘﻔﮔ-ﻭ-ﺚﺤﺑ: ﻪﺜﺣﺎﺒﻣ, ﻩﺮﮐﺍﺬﻣ, ﺚﺤﺑ-ﻭ-ﺮﺟ
ﻪﻨﯿﻣﺯ-ﺲﭘ: 
ﻥﺩﺮﮐ-ﯽﺴﯾﻮﻧﻭﺭ: ﻕﺎﺒﻄﻧﺍ, ﯽﺴﯾﻮﻧ-ﺯﺎﺑ
ﯼﺎﻫﺭﻭﺩ: ﻢﻈﻨﻣ, ﯼﺎﻬﺧﺮﭼ
ﯽﻣﺮﮔﺮﺳ-ﻭ​​-ﺢﯾﺮﻔﺗ: ﺢﯾﺮﻔﺗ, ﻩﺪﻨﻨﮐ-ﻡﺮﮔﺮﺳ, ﺖﻏﺍﺮﻓ, ﻩﺪﻨﻨﮐ-ﻡﺮﮔﺮﺳ, ﻥﺩﺮﮐ-ﻡﺮﮔﺮﺳ, ﯽﻣﺮﮔﺮﺳ, ﯽﻣﺮﮔﺮﺳ
ﺱﻭﺮﯾﻭ: 
ﻪﻧﺎﮔ-ﻪﭽﺑ: ﮓﻧﺍﺪﺸﺷ
ﻥﺩﺮﮐ-ﺲﮑﻌﻨﻣ: ﺮﮑﻔﺗ, ﻪﺒﻗﺍﺮﻣ, ﻥﺩﺮﮐ-ﺮﮑﻔﺗ, ﻥﺩﺍﺩ-ﻥﺎﺸﻧ, ﺪﺸﮐ-ﯽﻣ-ﺮﯾﻮﺼﺗ ﻪﺑ
ﻞﯾﺪﺒﺗ: ﻥﺩﺍﺩ-ﺮﯿﯿﻐﺗ, ﻞﯾﺪﺒﺗ, ﭻﯿﺋﻮﺳ, ﺶﻬﺟ
ﯽﻠﮐ-ﺡﺮﻃ: ﻞﯾﺎﻓﻭﺮﭘ, ﻞﺻﺎﻓ-ﺪﺣ, ﻪﺻﻼ﻿ﺧ, ﺡﺮﻃ, ﻦﺘﺷﺍﺬﮔ-ﺽﺮﻌﻣ-ﺭﺩ, ﯽﻠﮐ-ﺪﯾﺩ, ﺲﯾﻮﻧ-ﺶﯿﭘ
ﺍﺮﭘﺍ: 
ﺐﯾﻮﺼﺗ: ﺐﯾﻮﺼﺗ, ﻥﺎﺷﺩﻮﻨﺸﺧﺎﻧ, ﺖﯾﺎﺿﺭ, ﺵﺮﯾﺬﭘ, ﺎﻋﺩﺍ, ﺪﯿﯾﺎﺗ, ﺪﯿﯾﺎﺗ, ﺫﺎﺨﺗﺍ, ﺪﯿﺠﻤﺗ-ﻭ-ﻖﯾﻮﺸﺗ
ﻥﺩﺮﮐ-ﺖﻧﺎﯿﺧ: ﻦﺘﺧﺎﺳ-ﺭﺎﮑﺷﺁ, ﻥﺩﺍﺩ-ﺐﯾﺮﻓ, ﺪﯿﻣﺍ-ﺎﻧ
ﻥﺩﺮﮐ-ﻪﯿﺒﻨﺗ: ﻡﻮﮑﺤﻣ
ﺞﻧﺭﺁ: ﺏﻼ﻿ﻗ
ﯽﮕﺘﺴﺒﻟﺩ: ﻪﻤﯿﻤﺿ, ﻝﺎﺼﺗﺍ, ﻪﻠﺻﻭ, ﻥﺩﺍﺩ-ﻁﺎﺒﺗﺭﺍ, ﻝﺎﺼﺗﺍ
ﯼﺯﺎﺳﺯﺎﺑ: ﻢﯿﻣﺮﺗ, ﺩﻮﺒﻬﺑ, ﯼﺯﺎﺳﺯﺎﺑ, ﺡﻼ﻿ﺻﺍ
ﮎﻮﮑﺸﻣ: ﻦﻇ-ءﻮﺳ, ﻥﻮﻨﻈﻣ
ﺩﺎﺘﻔﻫ: 
ﺱﺪﻘﻣ-ﺏﺎﺘﮐ: ﺱﺪﻘﻣ-ﺏﺎﺘﮐ, ﻂﺧ
ﻝﺍﺩﻮﮔ: ﺥﺍﺭﻮﺳ, ﯼﺭﺎﻔﺣ, ﺮﺨﺘﺳﺍ
ﻝﻼ﻿ﺘﺧﺍ: ﺝﺮﻣ-ﻭ-ﺝﺮﻫ, ﺝﺮﻣ-ﻭ-ﺝﺮﻫ, ﻡﺍﺭﺁ-ﺎﻧ, ﻝﻼ﻿ﺘﺧﺍ, ﯽﮕﺘﺨﯾﺭ-ﻢﻬﺑ, ﻩﺪﻨﻨﻛ-ﺖﺣﺍﺭﺎﻧ, ﻞﺧﺍﺪﺗ, ﺖﻟﺎﺠﺧ
ﯽﯾﺎﺗﻭﺩ: ﯽﯾﺎﺗﻭﺩ
ﻪﻌﻣﻮﺻ: ﻪﻌﻣﻮﺻ
ﻥﺎﮑﯿﭘ: 
ﻞﯾﺎﻤﺗ: ﻝﻮﺌﺴﻣ, ﻻ﻿ﻮﻤﻌﻣ, ﻝﻮﻤﻌﻣ-ﺭﻮﻃ-ﻪﺑ, ﻻ﻿ﻮﻤﻌﻣ
ﻩﺪﺷ-ﺖﺳﺭﺩ-ﻪﻧﺍﺩﺎﺘﺳﺍ: ﻖﯿﻗﺩ, ﻥﺩﺮﻛ-ﻒﻳﺮﻌﺗ, ﻥﺩﺮﮐ-ﺢﯾﺮﺼﺗ, ﻪﻌﺳﻮﺗ, ﺞﻧﺮﻐﺑ, ﺮﯾﻭﺰﺗ-ﻭ-ﻪﻠﯿﺣ ﯼﻭﺭ, ﻥﺩﺮﮐ-ﺭﺎﮐ
ﯼﺭﺍﺩﺎﻓﻭ: ﺭﺎﮐﺍﺪﻓ, ﺭﺍﺩﺎﻓﻭ, ﺩﺎﻤﺘﻋﺍ, ﻪﻧﺎﻗﺩﺎﺻ, ﻪﻧﺎﻗﺩﺎﺻ, ﯼﺩﺎﻤﺘﻋﺍ-ﯽﺑ, ﺭﺎﺒﺘﻋﺍ, ﻥﺎﻤﯾﺍ, ﺭﻭﺎﺑ
ﻪﮑﺳ: ﻝﻮﭘ-ﺪﺣﺍﻭ
ﻩﺯﺮﻟ: ﺯﺮﻟ
ﺪﯿﻌﺒﺗ: ﻦﺘﺨﯾﺭ-ﻥﻭﺮﯿﺑ, ﺭﻮﺸﮐ-ﺯﺍ-ﺝﺭﺎﺧ
ﯽﮑﯿﻧﺎﮑﻣ: ﻩﺎﮕﺘﺳﺩ, ﮏﯿﻧﺎﮑﻣ, ﺱﺪﻨﻬﻣ
ﻡﺍﺩ: ﮓﻨﭼ, ﻡﻮﮑﺤﻣ
ﮏﯿﮐ: ﯼﺎﭘ, ﯽﻨﯾﺮﯿﺷ, ﺮﯿﻤﺧ
ﺎﻗﺁ: ﯼﺎﻗﺁ, ﺎﻗﺁ, ﺪﻧﻭﺍﺪﺧ, ﺎﻗﺁ
ﻎﯾﺭﺩ: ﻥﺩﺯ-ﺭﺩ, ﺩﺎﯾﺯ-ﺪﺷ-ﻭ ﺪﻣﺍ, ﺲﻧﺎﮐﺮﻓ, ﺭﻭﺎﻨﺷ
ﻩﺪﻔﻫ: 
ﻞﺴﻋ: 
ﻁﺮﺷ: ﻁﺮﺷ, ﺖﺒﺴﻧ, ﻩﻮﮔ, ﻩﺩﻮﺗ, ﻢﻬﺳ, ﺮﺴﮐ, ﻢﻬﺳ
ﺝﺁ: ﺖﮐﺮﺣ, ﻦﻓ-ﻭ-ﺕﻮﻓ, ﻦﺘﻓﺭ-ﻩﺍﺭ, ﯼﻭﺭ-ﻩﺩﺎﯿﭘ, ﻝﺍﺪﭘ, ﻡﺎﮔ, ﻦﺘﺷﺍﺩﺮﺑ-ﺪﻨﻠﺑ-ﯼﺎﻫ ﻡﺎﮔ, ﻪﻠﭘ
ﺮﺟﺁ: ﯽﺷﺎﮐ
ﺩﺎﺘﺸﻫ: 
ﻪﻧﺎﻔﺳﺎﺘﻣ: ﻒﺳﺎﺗ-ﻪﯾﺎﻣ, ﺲﻧﺎﺷ-ﺪﺑ, ﯽﺘﺣﺍﺭﺎﻧ-ﺎﺑ
ﺕﺭﻮﺸﻣ: ﻩﺭﻭﺎﺸﻣ, ﺪﯿﻨﮐ-ﻪﻌﺟﺍﺮﻣ
ﻪﻧﺎﺴﻓﺍ: ﻩﺭﻮﻄﺳﺍ
ﻥﺩﺮﮐ-ﻭﺭﺩ: ﻝﻮﺼﺤﻣ
ﻊﯿﻓﺮﺗ: ﻥﺩﺮﺑ-ﻻ﻿ﺎﺑ, ﺞﯾﻭﺮﺗ, ﯽﻓﺮﻌﻣ, ﻪﺋﺍﺭﺍ, ﺕﺎﻐﯿﻠﺒﺗ
ﻕﺎﺟﺍ: ﺯﺎﮔ-ﻕﺎﺟﺍ, ﮓﻨﺳ-ﻪﺘﺨﺗ, ﺮﻓ
ﯽﺷﺭﻮﺷ: ﺵﺭﻮﺷ, ﺵﺭﻮﺷ
ﻩﺩﺎﺘﻓﺍ-ﺪﻣ-ﺯﺍ: ﯽﻧﺎﺘﺳﺎﺑ
ﻡﺭﻮﺗ: ﻥﺩﺮﮐ-ﺩﺎﺑ, ﻡﺭﻮﺘﻣ, ﻡﺭﻮﺗ, ﻡﺭﻭ, ﻥﺩﺮﮐ-ﮒﺭﺰﺑ
ﻕﻼ﻿ﺗﺎﺑ: ﺏﺍﺩﺮﻣ
ﺲﺳ: ﺏﺭ, ﯼﺪﻨﺑ-ﻢﺧﺯ-ﺭﺍﻮﻧ
ﻪﻧﺍﺪﻫﺍﺯ: ﻦﯿﺸﻧ-ﻪﺷﻮﮔ
ﺮﯾﺪﻣ: ﺮﺷﺎﺒﻣ, ﺲﯿﺋﺭ, ﺲﻴﺋﺭ, ﺮﯾﺪﻣ, ﺮﯾﺪﻣ, ﺮﯾﺪﻣ, ﺮﺒﻫﺭ, ﯽﯾﺍﺮﺟﺍ
ﺮﮐ-ﻩﻭﺮﮔ: ﻮﯾﺍﺭﺩ, ﻢﯿﺗ
ﯽﻘﻄﻨﻣ: ﻩﺪﺷ-ﻞﯾﺪﻌﺗ, ﻖﻄﻨﻣ, ﯽﻘﻄﻨﻣ, ﻞﯿﻟﺩ-ﯽﺑ, ﻝﻮﻘﻌﻣ, ﯽﻘﻄﻨﻣ, ﻝﻮﻘﻌﻣ
ﺵﺯﺍﺩﺮﭘ-ﻝﺎﺣ-ﺭﺩ: 
ﮒﺮﮔ: 
ﺵﺮﻓ: ﻪﭽﯿﻟﺎﻗ
ﺖﻣﺪﻗ: 
ﺭﻭﺭﺎﺑ: 
ﺕﻮﺳ: ﺕﻮﻠﻓ
ﺮﯿﻨﭘ: 
ﺶﯿﻧ: ﻥﺩﺮﮐ-ﻪﮑﺗ, ﻥﺩﺮﻛ-ﻚﺣ, ﺶﯿﻧ
ﻥﺩﺮﻛ-ﺕﻮﻋﺩ: ﻪﻣﺎﻧ-ﺕﻮﻋﺩ
ﻊﻣﺎﺟ-ﯼﺎﺴﯿﻠﮐ: ﺪﺒﻌﻣ
ﻩﺎﮔﺭﺪﻨﺑ: ﺭﺪﻨﺑ
ﻥﺩﻮﺑ-ﻥﺍﺩﺮﮔﺮﺳ: ﻥﺩﺯ-ﻡﺪﻗ, ﺕﺮﺟﺎﻬﻣ, ﯼﻭﺭ-ﻩﺩﺎﯿﭘ
ﯽﻋﺍﺭﺯ-ﺕﻻ﻿ﻮﺼﺤﻣ: ﻝﻮﺼﺤﻣ
ﯽﯾﺎﯾﺭﺩ-ﯼﻭﺮﯿﻧ: ﯽﯾﺎﯾﺭﺩ, ﻥﺎﮔﻭﺎﻧ
ﮏﺳﺎﻣ: ﻮﻠﺟ, ﻡﺮﮐ
ﺩﺍﺪﻣ: ﻢﻠﻗ
ﯼﺰﺒﺳ: ﺭﺍﻮﺧ-ﻩﺎﯿﮔ
ﻩﺎﮕﺸﯾﺎﻤﻧ: ﻩﺎﮕﺸﯾﺎﻤﻧ, ﺩﺎﻬﻨﺸﯿﭘ, ﻥﺩﺍﺩ-ﺶﯾﺎﻤﻧ, ﻪﺋﺍﺭﺍ, ﻪﻧﺎﺸﻧ, ﻪﺋﺍﺭﺍ
ﺭﺍﻮﻠﺷ: ﺭﺍﻮﻠﺷ, ﺭﺍﻮﻠﺷ
ﺩﺎﺴﻓ: ﯽﯾﺍﻮﺳﺭ, ﯽﮔﺩﻮﻟﺍ
ﻪﻨﯿﺑﺎﮐ: ﻪﺠﻨﮔ, ﺱﺎﺒﻟ-ﺪﻤﮐ, ﯽﺘﺧﺭ-ﺎﺟ, ﺖﻟﺍﻮﺗ
ﭖﻮﺳ: 
ﺡﺍﺮﺟ: ﻲﺣﺍﺮﺟ-ﻞﻤﻋ, ﯽﺣﺍﺮﺟ, ﺩﺮﮑﻠﻤﻋ
ﯼﺮﻤﺘﺴﻣ: ﯽﻨﯾﺰﮕﯾﺎﺟ, ﻦﯿﺸﻧﺎﺟ, ﻥﺍﺮﺒﺟ, ﻝﺪﺑ, ﺺﯿﺼﺨﺗ, ﻪﻤﯿﻤﺿ
ﺱﻮﺳﺎﺟ: 
ﺍﻭﺮﭘ-ﯽﺑ: ﻁﺎﯿﺘﺣﺍ-ﯽﺑ, ﻢﻫﺮﺑ-ﻭ-ﻢﻫﺭﺩ
ﺱﺎﺳﺍ-ﯽﺑ-ﺕﺎﻌﯾﺎﺷ: ﻪﻌﯾﺎﺷ, ﻪﻌﯾﺎﺷ
ﺰﻣﺭ: 
ﻩﺪﯿﮑﭼ: ﻪﺻﻼ﻿ﺧ, ﺱﻭﺭﺩ-ﻞﺼﻓﺮﺳ
ﻪﺒﻨﺷ-ﺞﻨﭘ: 
ﮏﯿﻓﺍﺮﺗ: ﺵﺩﺮﮔ, ﻞﻘﻧ-ﻭ-ﻞﻤﺣ, ﻞﻘﻧ-ﻭ-ﻞﻤﺣ
ﯼﺭﺎﻤﻌﻣ: 
ﮎﺮﺗ: ﻑﺎﮑﺷ, ﻩﺩﺭﻮﺧ-ﮎﺮﺗ, ﮎﺮﺗ, ﮎﺮﺗ, ﯽﮕﺘﺴﮑﺷ
ﺖﻨﯾﺯ: ﻦﯿﯾﺰﺗ, ﯽﺘﻨﯾﺯ, ﻥﺩﺮﮐ-ﻦﯿﺋﺰﺗ, ﺕﺍﺮﻫﺍﻮﺟ, ﺰﯿﻤﺗ-ﻭ-ﺮﺗ
ﺱﻮﮑﻌﻣ: ﻒﻟﺎﺨﻣ, ﺱﻮﮑﻌﻣ, ﭻﯿﺋﻮﺳ, ﻥﺩﺮﮐ-ﺱﻮﮑﻌﻣ, ﺮﻀﻣ, ﺲﮑﻋﺮﺑ, ﺐﻘﻋ
ﻥﺩﺮﮐ-ﺮﯿﺤﺘﻣ-ﻭ ﺕﺎﻣ: ﻥﺩﺮﮐ-ﻡﺮﮔﺮﺳ, ﻩﺪﻨﻨﮐ-ﻡﺮﮔﺮﺳ, ﻝﺎﺤﺷﻮﺧ
ﺩﻮﺒﻬﺑ: ﻢﯿﻣﺮﺗ, ﺕﺎﺠﻧ-ﻭ-ﺩﺍﺪﻣﺍ, ﺩﻮﺒﻬﺑ, ﺎﯿﺣﺍ, ﻦﺘﻓﺎﯾ-ﺩﻮﺒﻬﺑ, ﻥﺪﻧﺍﺩﺮﮔﺯﺎﺑ, ﯼﺯﺎﺳﺯﺎﺑ
ﻭﺭ-ﻩﺩﺎﻴﭘ: ﻥﺩﺮﮐ-ﺩﻭﺪﺤﻣ, ﺮﯿﻗ, ﺮﯿﻗ, ﻞﮔ-ﻭ-ﻦﺠﻟ, ﺶﺷﻮﭘ
ﻊﻃﺎﻗ: ﯽﺗﺎﯿﺣ, ﯽﺗﺎﯿﺣ, ﻥﺪﺷ-ﻦﯿﯿﻌﺗ, ﻦﺘﻓﺮﮔ-ﻢﻴﻤﺼﺗ, ﻩﺪﻨﻨﮐ-ﺭﺎﻬﻇﺍ
ﯽﻔﻨﻣ: ﺮﻀﻣ
ﻩﺭﺍﻮﻨﺸﺟ: ﺕﺮﺴﻨﮐ
ﻥﺩﺍﺩ-ﺶﻫﺎﻛ: ﺶﻫﺎﮐ, ﻥﺩﺮﮐ-ﻝﻭﺰﻧ, ﺖﻟﻮﻬﺳ, ﻥﺩﺮﺑ-ﻦﯿﺑ-ﺯﺍ, ﻥﺪﻧﺎﺳﺭ-ﻞﻗﺍﺪﺣ-ﻪﺑ, ﺶﻫﺎﮐ, ﻥﺩﺮﮐ-ﻩﺪﯾﺮﺑ-ﻩﺪﯾﺮﺑ, ﺰﯿﻤﺗ-ﻭ-ﺮﺗ, ﻥﺩﺮﮐ-ﻖﯾﺮﻔﺗ, ﻥﺩﺮﮐ-ﺩﻭﺪﺤﻣ, ﻥﺩﺮﮐ-ﺩﻭﺪﺤﻣ
ﺖﻧﺎﯿﺧ: 
ﯽﭼﺭﺎﮑﺷ: 
ﺭﺎﻣ: ﻩﺪﻧﺰﺧ
ﯼﺮﺗﺎﺑ: 
ﻡﻮﻣ: ﻊﻤﺷ
ﻩﺎﮔﺍﺭﺎﮐ: ﻖﻘﺤﻣ
ﻞﯿﻠﺤﺗ: ﻞﯿﻠﺤﺗ-ﻭ-ﻪﯾﺰﺠﺗ, ﻥﺩﺮﻛ-ﻖﻴﻘﺤﺗ, ﻥﺩﺮﮐ-ﻞﯿﺼﺤﺗ, ﯽﺳﺭﺮﺑ, ﯽﺳﺭﺯﺎﺑ, ﻑﺎﺸﺘﮐﺍ, ﺡﻮﺿﻭ, ﻦﺘﺴﮑﺷ-ﻢﻫﺭﺩ, ﮏﯿﮑﻔﺗ
ﺪﯿﮐﺎﺗ: ﺪﮐﻮﻣ, ﺭﺎﺸﻓ, ﻂﺧ-ﺭﺍﺩ-ﻂﺧ ﺮﯾﺯ, ﺪﯿﮐﺎﺗ, ﺪﯿﮐﺎﺗ, ﻪﺠﻬﻟ, ﺎﻋﺩﺍ, ﻪﺟﻮﺗ
ﺎﻨﺷ: ﺎﻨﺷ
ﻪﻣﺎﻧ-ﺖﻛﺎﭘ: ﯽﮕﻧﻮﮕﭼ, ﺪﯿﻗ, ﻑﻼ﻿ﻏ
ﻪﮐ-ﯽﺴﮐ-ﺮﻫ: ﯽﺴﮐ-ﻪﭼ, ﯽﺴﮐ, ﻪﮐ, ﯽﺼﺨﺷ-ﺮﻫ
ﺭﺎﮕﯿﺳ: ﻥﺪﯿﺸﮐ-ﺭﺎﮕﯿﺳ, ﺕﺎﯿﻧﺎﺧﺩ
ﺭﻮﺗﻮﻣ: ﻞﯿﺒﻣﻮﺗﺍ, ﺭﻮﺗﻮﻣ, ﻩﺰﯿﮕﻧﺍ, ﺭﻮﺗﻮﻣ
ﺐﻠﻃﻭﺍﺩ: ﻥﺩﺍﺩ-ﺹﺎﺼﺘﺧﺍ, ﻪﻧﺎﺒﻠﻃﻭﺍﺩ
ﻞﻤﻌﻟﺍ-ﺲﻜﻋ: ﯽﺸﻨﮐﺍﻭ, ﺦﺳﺎﭘ, ﺦﺳﺎﭘ, ﻥﺩﺍﺩ-ﻥﺎﺸﻧ-ﺶﻨﮐﺍﻭ, ﺩﺭﻮﺧﺯﺎﺑ
ﻥﺍﺪﻤﭼ: ﻪﺷﻮﺗ, ﺭﺎﺑ, ﻪﻨﺗ, ﻥﺍﺪﻤﭼ
ﺍﻮﻨﺷﺎﻧ: 
ﻩﻮﯿﻤﺑﺁ: ﻥﺩﺮﮐ-ﺝﺍﺮﺨﺘﺳﺍ
ﯽﻨﺗﻭﺮﻓ: ﯽﮔﺩﺎﺳ, ﻦﺗﻭﺮﻓ
ﺕﺭﺍﺯﻭ: 
ﯽﺴﻨﺟ: ﯽﺴﻨﺟ-ﻁﺎﺒﺗﺭﺍ, ﯽﺴﻨﺟ-ﺕﻼ﻿ﯾﺎﻤﺗ
ﺮﻄﻗ: 
ﺮﺒﺗ: 
ﺱﺎﻤﻟﺍ: 
ﺏﻭﺎﻨﺘﻣ: ﯽﮐﺪﯾ, ﻦﯾﺰﮕﯾﺎﺟ, ﻦﯿﺸﻧﺎﺟ, ﻪﻨﯾﺰﮔ, ﻡﺎﻘﻣ-ﻢﺋﺎﻗ, ﯽﻨﯾﺰﮕﯾﺎﺟ, ﺪﻧﻮﯿﭘ
ﮎﺍﻭﮋﭘ: 
ﯼﺭﺍﺩ-ﻦﺘﺸﯾﻮﺧ: ﻥﺩﺮﮐ-ﺭﺎﻬﻣ, ﻥﺩﺮﮐ-ﺩﻭﺪﺤﻣ, ﺖﯾﺩﻭﺪﺤﻣ, ﺖﯾﺩﻭﺪﺤﻣ, ﺖﯾﺩﻭﺪﺤﻣ
ﺖﯾﻮﻫ: ﯽﯾﺎﺳﺎﻨﺷ, ﺖﯾﻮﻫ-ﺺﯿﺨﺸﺗ, ﻦﯾﺩﺎﻤﻧ
ﺶﯾﺎﻤﻧ-ﻪﺤﻔﺻ: ﻥﺩﺍﺩ-ﺶﯾﺎﻤﻧ, ﻩﺩﺮﭘ
ﻞﺒﻨﺗ: ﺪﺳﺎﻓ
momentane-ﻪﺒﻨﺟ: 
ﺭﻮﺟ-ﻭ-ﻊﻤﺟ: ﻖﻓﺍﻮﺗ, ﺪﻣﺎﺟ, ﻢﮐﺍﺮﺘﻣ
ﯽﮔﺪﻧﺍﺭ: ﺩﺮﮑﻠﻤﻋ, ﻑﺍﺮﺤﻧﺍ, ﺶﯾﺍﺮﮔ, ﺪﻧﻭﺭ
ﻥﺪﺷ-ﺪﯾﺪﭘﺎﻧ: ﻩﺪﺷ-ﺽﺮﻘﻨﻣ
ﻪﻌﺷﺍ: ﻮﺗﺮﭘ, ﻭﺮﻫﺍﺭ, ﻉﺎﻌﺷ
ﺮﻫﻮﺟ: 
ﻢﯿﻈﻋ: ﮒﺭﺰﺑ, ﮒﺭﺰﺑ, ﮒﺭﺰﺑ, ﻢﯿﻈﻋ, ﻢﯿﻈﻋ, ﮒﺭﺰﺑ, ﻩﺩﺎﻌﻟﺍ-ﻕﻮﻓ
ﺭﺎﺒﻧﺍ: 
ﻲﻧﺪﻧﺎﻣ-ﺩﺎﻳ-ﻪﺑ: ﻪﺘﺴﺟﺮﺑ
ﻩﺪﻨﻨﮐ-ﻩﺮﯿﺧ-ﺶﺑﺎﺗ: ﺶﺑﺎﺗ, ﺶﺸﺧﺭﺩ, ﯽﮔﺪﻨﺸﺧﺭﺩ
ﺎﻨﺳ-ﺲﻠﺠﻣ: ﺲﻠﺠﻣ
ﺕﻮﺑﺎﺗ: 
ﺶﺸﺨﺑ: 
ﻊﻠﺑ: ﻪﻋﺮﺟ
ﻦﺘﺧﺎﺳ-ﺎﻫﺭ: ﻥﺩﺮﮐ-ﻝﺎﺒﻧﺩ, ﻥﺩﺮﮐ-ﻊﻧﺎﻗ
ﻥﺩﺭﻮﺧ-ﺏﺎﺗ: 
ﺭﺍﺰﻔﻠﻋ: ﻥﺪﯾﺮﭼ, ﺶﯿﭘ, ﻦﻤﭼ
ﻩﺪﯿﭽﯿﭘ: ﺞﻧﺮﻐﺑ, ﻥﺩﺮﮐ-ﻩﺪﯿﭽﯿﭘ, ﻪﺘﻓﺮﺸﯿﭘ, ﺐﯿﮐﺮﺗ, ﺮﯾﻭﺰﺗ-ﻭ-ﻪﻠﯿﺣ ﯼﻭﺭ
ﺎﻔﻌﺘﺳﺍ: ﺎﻔﻌﺘﺳﺍ, ﯽﮕﺘﺴﺸﻧﺯﺎﺑ
ﻦﺗﻭﺮﻓ-ﻡﺎﻧ-ﺖﺒﺛ: 
ﻪﺌﻃﻮﺗ: ﺡﺮﻃ
ﻞﻔﻠﻓ: 
ﻮﺗﺎﺗ: 
ﺩﺰﻣﺎﻧ: ﻩﺪﻨﻨﮐ-ﺖﺳﺍﻮﺧﺭﺩ
ﻩﺎﺑﻭﺭ: 
ﺶﮐﺩﻭﺩ: ﯼﺭﺎﺨﺑ, ﻪﺘﺸﭘ
ﻩﺎﮔﺩﺍﺩ-ﻦﯾﺍ-ﺖﯿﺣﻼ﻿ﺻ: ﻦﺘﺷﺍﺩ-ﺭﺎﯿﺘﺧﺍ, ﯼﺭﻭﺍﺩ, ﯼﺭﻭﺍﺩ, ﺖﯿﺣﻼ﻿ﺻ
ﯼﺯﺭﻭﺎﺸﮐ: ﯼﺯﺭﻭﺎﺸﮐ, ﯼﺯﺭﻭﺎﺸﮐ
ﺖﻗﺩ: ﺖﻗﺩ, ﺖﻔﻋ, ﺖﻗﺩ, ﺖﺳﺭﺩ, ﯽﯾﻮﮕﻘﺣ
ﻖﺑﺎﺳ-ﻩﺪﺷ-ﺕﻮﻓ: 
ﮏﯿﺗﺍﺮﮐﻮﻣﺩ: 
ﻪﻧﺍﻮﺟ: ﻩﺮﯿﮕﺘﺳﺩ, ﻪﻧﺍﻮﺟ
ﻮﺘﭘ: ﻒﻘﺳ, ﺶﺷﻮﭘ, ﻪﭽﯿﻟﺎﻗ, ﺶﺷﻮﭘ
ﮒﺮﮕﺗ: ﻩﺪﺷ-ﻝﺎﻐﺷﺍ, ﻦﺘﻔﮔ-ﮏﯾﺮﺒﺗ
ﮎﻮﺧ: ﻕﺎﭼ-ﻭ-ﻪﺘﺨﻠﺷ
ﻞﮑﺷ: ﻞﮑﺷ, ﻞﮑﺷ, ﻞﮑﺷ, ﻞﮑﺷ
ﺝﺎﻋ: 
ﮏﯿﺳﻼ﻿ﮐ: ﮏﯿﺳﻼ﻿ﮐ, ﯽﺘﻨﺳ
ﻩﺪﻨﻨﮐ-ﻩﺪﻫﺎﺸﻣ: ﺖﺳﺮﭘﺮﺳ, ﻥﺎﻤﻬﻣ
ﻞﯿﻓ: 
ﻦﺧﺎﻧ: ﻦﺧﺎﻧ
ﺭﻮﺒﻧﺯ: 
ﻦﻓﺩ: ﯼﺭﺎﭙﺴﮐﺎﺧ, ﻥﺩﺍﺩﺭﺍﺮﻗ
ﺮﮕﯾﺯﺎﺑ: ﺮﮕﯾﺯﺎﺑ, ﺮﮕﯾﺯﺎﺑ, ﯽﮐﺎﺷ
ﻕﺮﻋ: 
ﯽﻧﺎﺘﺴﻬﻟ: ﺶﯾﻮﮔ
ﻝﺎﯿﺧ: ﺐﻠﻘﺗ
ﺪﯾﺩﺮﺗ: ﯽﻌﻄﻗ-ﺮﯿﻏ, ﻡﺎﻬﺑﺍ
ﻡﻭﺩ: ﯽﺋﺰﺟ, ﻂﺳﻮﺘﻣ, ﻂﺳﻮﺘﻣ, ﻂﺳﻮﺘﻣ-ﺪﺣ-ﺭﺩ, ﯽﻠﺻﺍ-ﺮﯿﺴﻣ, ﻂﺳﺍﻭﺍ
ﻥﺩﺮﮐ-ﺎﺗ: ﻮﺷﺎﺗ
ﯽﯾﺎﺘﺳﻭﺭ: ﯽﻧﺎﺘﺳﺍ, ﺮﻬﺷ-ﻪﻣﻮﺣ, ﯽﯾﺎﺘﺳﻭﺭ
ﻪﻟﺎﻧ: 
ﻪﯿﺒﺷ: ﻢﻫ-ﻪﯿﺒﺷ, ﻪﺑﺎﺸﺗ, ﯼﺭﻭﺁﺩﺎﯾ
ﻝﻮﻗ-ﻞﻘﻧ: ﻥﺩﺮﮐ-ﺝﺍﺮﺨﺘﺳﺍ, ﻝﻮﻗ-ﻞﻘﻧ, ﻥﺩﺮﮐ-ﻡﺎﻤﺗ-ﺍﺭ ﻝﻮﻗ ﻞﻘﻧ, ﻥﺩﺍﺩ-ﺽﺮﻗ, ﻦﺘﻓﺮﮔ-ﺖﻧﺎﻣﺍ, ﻡﺍﻭ
ﻪﺴﯿﮐ: ﺩﺭ, ﺝﺍﺮﺧﺍ, ﻪﺴﯿﮐ
ﯼﺭﻮﺨﻟﺩ: ﻝﻼ﻿ﺘﺧﺍ, ﻞﺧﺍﺪﺗ, ﻪﻔﻗﻭ, ﯽﺘﺨﺳ, ﯽﮕﺘﺴﺧ, ﺖﻤﺣﺯ
ﻥﺯﻮﺳ: ﻖﯾﺭﺰﺗ, ﮓﻧﺮﺳ, ﻢﻠﻗ, ﻕﺎﺠﻨﺳ
ﻝﺮﺘﻨﮐ: ﻝﺮﺘﻨﮐ
ﻪﺟﻮﺟ: ﻍﺮﻣ
ﺭﺍﻮﺘﺳﺍ: ﻡﻭﺍﺪﻣ, ﺭﺎﮔﺯﺎﺳ, ﻦﺘﺑ, ﯽﻨﻤﺿ, ﺐﺳﺎﻨﻣ, ﺭﺍﻮﯾﺩ-ﺭﺩ-ﯽﮕﺘﻓﺭ ﻮﺗ, ﻁﻮﺑﺮﻣ, ﻢﺠﺴﻨﻣ, ﯽﭘ-ﺭﺩ-ﯽﭘ, ﻝﺩﺎﻌﺘﻣ, ﺖﺑﺎﺛ
ﻪﮑﺸﺑ: ﻞﻄﺳ
ﯽﮕﺸﯿﻤﻫ-ﻪﺒﻨﺟ: 
ﺱﺎﻨﺷﺭﺎﮐ: ﺺﺼﺨﺘﻣ, ﻪﺑﺮﺠﺗ-ﺎﺑ, ﻩﮋﯾﻭ, ﺹﺎﺧ
ﻦﺘﺷﺍﺬﮔ-ﺮﯿﺛﺎﺗ: ﺩﺭﺍﺬﮔ-ﯽﻣ-ﺮﯿﺛﺎﺗ, ﺱﺎﺴﺣﺍ, ﻥﺩﺮﻛ-ﺏﺬﺟ
ﻥﻮﺘﯾﺯ: 
ﻥﻭ: ﻪﮑﻠﻓ-ﺮﯿﺷ
ﻊﻧﺎﻣ: ﻥﺩﺮﮐ-ﻊﻄﻗ, ﺖﯾﺩﻭﺪﺤﻣ, ﺺﻘﻧ, ﻊﻧﺎﻣ, ﺖﺴﮑﺷ
ﻥﺩﺮﮐ-ﻩﺭﺎﺷﺍ-ﺮﺳ ﺎﺑ: 
ﺮﺘﺳﺎﻓ: ﺖﺸﮐ, ﺝﺎﻨﻔﺳﺍ, ﺞﯾﻭﺮﺗ, ﻥﺩﺮﮐ-ﻞﯿﻬﺴﺗ, ﻥﺩﺮﮐ-ﻪﯾﺬﻐﺗ, ﻒﻄﻟ, ﻒﻄﻟ
ﻒﯾﺮﻌﺗ: ﺮﯿﺴﻔﺗ, ﺖﯾﻮﻫ-ﺺﯿﺨﺸﺗ, ﺕﺎﺤﯿﺿﻮﺗ, ﻦﯿﯿﻌﺗ
ﺪﻟﻮﺗ-ﺯﻭﺭ: ﺩﺮﮕﻟﺎﺳ
ﺶﮑﭼ: 
ﺮﻄﻌﻣ: 
ﺭﺍﺮﮑﺗ: ﻦﯿﮕﻨﺳ, ﺪﺼﻘﻣ, ﻥﺩﺮﮐ-ﺭﺍﺮﮑﺗ, ﺭﺍﺮﮑﺗ, ﻦﯾﺮﻤﺗ
ﯽﻬﯾﺪﺑ: ﺩﺮﺧ, ﺖﯿﻤﻫﺍ-ﯽﺑ
ﻥﺩﺯ-ﺪﮕﻟ: ﺖﺑﺎﺻﺍ, ﻩﺩﺎﺟ-ﺯﺍﺪﻧﺍ-ﺖﺳﺩ, ﻝﺎﺒﺗﻮﻓ, ﻢﯿﺴﻠﮐ, ﻝﺎﺒﺗﻮﻓ, ﻪﺑﺮﺿ
ﯼﺭﺎﻔﺣ: ﻥﺪﯾﻭﺎﮐ, ﻪﺘﻣ, ﯼﺭﺎﻔﺣ
ﯽﮕﻧﺎﺧ-ﻥﺍﻮﯿﺣ: 
ﻪﻤﺠﻤﺟ: 
ﻪﻨﻨﻘﻣ-ﻩﻮﻗ: ﺲﻠﺠﻣ, ﻪﻨﻨﻘﻣ, ﻥﻮﻧﺎﻗ
ﻪﻨﺷﺎﭘ: ﺵﺮﭘ
ﻢﺧﺍ: 
ﻉﺍﺮﺘﺧﺍ-ﺖﺒﺛ: 
ﻥﻮﯿﻠﯿﺑ: 
ﯽﯾﺎﯿﻤﯿﺷ: ﯽﻤﯿﺷ-ﻢﻠﻋ, ﯽﯾﺎﯿﻤﯿﺷ-ﺩﺍﻮﻣ, ﻥﺍﺩ-ﯽﻤﯿﺷ
ﻥﺎﺒﻠﺧ: ﻪﺑﺮﺠﺗ, ﯽﺑﺮﺠﺗ
ﻥﺩﺮﮐ-ﺪﯿﻠﻘﺗ: ﯼﺯﺎﺳ-ﻪﯿﺒﺷ, ﯼﺯﺎﺳ-ﻪﯿﺒﺷ, ﺭﺍﺮﮑﺗ, ﺮﯿﺜﮑﺗ
ﻦﻣﺍﺩ: ﮓﻨﺳ
ﻩﺮﻈﺘﻨﻣ-ﺮﯿﻏ: ﻝﻮﻤﻌﻣ-ﺮﯿﻏ, ﯽﻌﯿﺒﻃ-ﺮﯿﻏ, ﺩﺮﻓ, ﻪﺟﻮﺗ-ﺐﻟﺎﺟ, ﻩﺩﺎﻌﻟﺍ-ﻕﺭﺎﺧ, ﯽﻧﺩﺮﮑﻧ-ﺭﻭﺎﺑ, ﻪﯾﻭﺭ-ﯽﺑ, ﻩﺩﺎﻌﻟﺍ-ﻕﻮﻓ, ﻩﺩﺎﻌﻟﺍ-ﻕﻮﻓ, ﯽﻠﯿﺧ, ﺐﯿﺠﻋ
ﯽﮕﺘﻔﻫ: 
ﯽﻨﻓ: ﮏﯿﻨﮑﺗ, ﯼﮊﻮﻟﻮﻨﮑﺗ, ﯽﻨﻓ-ﻅﺎﺤﻟ-ﺯﺍ, ﯼﮊﻮﻟﻮﻨﮑﺗ
ﯽﻫﺎﯿﮔ-ﯽﮔﺪﻧﺯ: 
ﻍﻼ﻿ﮐ: ﺥﺭ
ﺏﺎﺘﻓﺁ-ﻉﻮﻠﻃ: 
ﺮﻤﻋ-ﻝﻮﻃ: ﯽﮔﺪﻧﺯ, ءﺎﻘﺑ, ﯽﮔﺪﻧﺯ-ﮏﺒﺳ, ﻥﺩﺮﻛ-ﻲﮔﺪﻧﺯ
ﺖﮐﺭﺎﺸﻣ: ﻢﻬﺳ, ﻥﺩﺮﮐ-ﺍﺪﻫﺍ, ﺖﮐﺭﺎﺸﻣ, ﺞﯾﻭﺮﺗ, ﻥﺩﺮﮐ-ﻞﯿﻬﺴﺗ
ﺏﻼ﻿ﻗ: ﻁﺎﺒﺗﺭﺍ, ﻝﺎﺼﺗﺍ, ﻥﺩﺮﮐ-ﻂﺒﺗﺮﻣ, ﺏﻼ﻿ﻗ
ﺮﺒﺑ: 
ﺫﻮﻔﻧ: ﻥﺩﺮﮐ-ﺥﺍﺭﻮﺳ, ﻖﯾﺮﻃ-ﺯﺍ, ﺫﻮﻔﻧ
ﻦﯿﺘﺳﺍ: ﻭﺯﺎﺑ
ﻩﺍﺮﮔﺭﺰﺑ: ﻩﺩﺎﺟ
ﯽﻣﺎﻈﻧ-ﻪﺒﺷ: 
ﻕﺪﻨﺧ: ﺮﮕﻨﺳ, ﺭﻮﺤﻣ
ﺖﯿﻣﺎﻤﺗ: 
ﻩﺩﺯﻮﻧ: 
ﯽﻟﺍ: 
ﺕﺎﯿﻬﻟﺍ: 
ﺭﻭﺎﻨﺷ: ﻖﯾﺎﻗ, ﺭﻭﺎﻨﺷ, ﻥﺎﮔﻭﺎﻧ
ﻩﺮﺣﺎﺳ: 
ﻪﻠﺻﻮﺣ-ﯽﺑ: ﺮﺑ-ﺮﺳ-ﻪﻠﺻﻮﺣ, ﯽﮕﺘﺴﺧ
ﮏﯿﺗﺎﻤﻠﭙﯾﺩ: ﺕﺎﻤﻠﭙﯾﺩ
ﻩﺎﮔﺭﺎﮐ: ﺐﺴﭼﺮﺑ, ﻩﺎﮔﺭﺎﮐ, ﻥﺩﺮﮐ-ﻞﯿﺼﺤﺗ
ﺯﻭﺎﺠﺗ: ﺯﻭﺎﺠﺗ, ﺯﻭﺎﺠﺗ, ﺮﺑ-ﻪﺒﻠﻏ, ﺐﯿﻠﺻ
ﻦﯾﺎﭙﻣﺎﺷ: 
ﻥﺪﯿﺸﺨﺑ-ﻡﺎﻬﻟﺍ: ﻥﺩﺮﻛ-ﻖﻳﻮﺸﺗ, ﻡﺎﻬﻟﺍ, ﻩﺪﻨﻨﮐ-ﻡﺮﮕﻟﺩ, ﻕﺎﺸﻨﺘﺳﺍ
ﻢﭼﺮﭘ: ﻢﭼﺮﭘ, ﺮﺘﺳﻮﭘ, ﻂﯿﻠﺑ
ﻕﻼ﻿ﻃ: ﻩﺪﺷ-ﺍﺪﺟ
ﭻﯿﭘ: ﻕﺮﺑ, ﻦﺧﺎﻧ, ﭻﯿﭘ, ﭻﯿﭘ
ﺪﯾﺭﻭ: ﺐﺼﻋ
ﻝﺎﻌﻓ-ﺮﯿﻏ: ﺭﺎﻀﺣ, ﻝﺎﻌﻓ-ﺮﯿﻏ
ﻒﮐ: ﺏﺎﺒﺣ
ﻩﺰﯾﺭ-ﮓﻨﺳ: 
ﺪﻨﺒﺸﯿﭘ: ﻥﺩﺮﮐ-ﭗﻠﺷ-ﭗﻠﺷ
ﻩﺭﺎﯿﺳ: 
ﻪﭽﻗﺎﺗ: ﻥﺩﺮﮐ-ﺭﺍﺩ-ﻪﻧﺍﺪﻧﺩ, ﻪﺠﻨﮔ
ﻪﮑﻨﭘ: 
ﯼﺮﯿﺴﻣﺮﮔ: 
ﺯﺎﻓ: ﯽﺴﮑﻋ, ﻪﻨﺤﺻ, ﯽﻧﺎﻣﺯ-ﻩﺭﻭﺩ, ﺭﺎﺘﺧﺎﺳ, ﻡﺎﮔ
ﻩﺍﻮﺨﻟﺩ: ﺩﻮﺨﺑ-ﺩﻮﺧ
ﻆﻔﻠﺗ: ﻆﻔﻠﺗ, ﻪﺠﻬﻟ, ﻦﺨﺳ, ﻖﻠﻄﻣ
ﻩﻮﯿﺟ: 
ﻥﺪﯾﺰﺧ: ﻥﺪﯾﺰﺧ, ﯼﺩﺭﻮﻧ-ﮓﻨﺳ, ﻩﺮﺑ
ﺭﺎﺤﺘﻧﺍ: 
ﺭﺎﮕﻧﺮﺒﺧ: ﺭﺎﮕﻧ-ﻪﻣﺎﻧﺯﻭﺭ
ﻥﺩﺮﮐ-ﻡﻭﺮﺤﻣ: ﺖﯿﻣﻭﺮﺤﻣ, ﻝﺎﻄﺑﺍ, ﻥﺩﺮﮐ-ﻡﻭﺮﺤﻣ, ﻥﺩﺮﮐ-ﻖﯾﺮﻔﺗ
ﺮﻫﺎﻣ: ﺮﻫﺎﻣ, ﺪﻣﺁﺭﺎﮐ, ﻪﺑ-ﺭﺩﺎﻗ, ﺪﻌﺘﺴﻣ, ﻪﺑﺮﺠﺗ-ﺎﺑ, ﻂﯾﺍﺮﺷ-ﺪﺟﺍﻭ, ﺵﻮﻫﺎﺑ
ﻦﮑﻟﺎﺑ: ﺱﺍﺮﺗ, ﻥﺍﻮﯾﺍ
ﻝﺎﮕﻨﭼ: 
ﺪﻨﻣﺭﺎﮐ: ﺮﮔﺭﺎﮐ, ﺮﮔﺭﺎﮐ, ﻥﺩﺮﮐ-ﺭﺎﮐ, ﻞﻣﺎﻋ, ﻪﺘﺴﺑﺍﻭ, ﯽﺸﻨﻣ
ﺎﻣﺮﻓﺭﺎﮐ: ﺲﻴﺋﺭ
ﺽﺮﻋ: ﻩﺩﺮﺘﺴﮔ-ﺭﻮﻃ-ﻪﺑ, ﻦﯿﻣﺎﺗ, ﻊﯿﺳﻭ, ﻪﻤﯿﻧ
ﮏﯾﺮﺤﺗ: ﺖﯾﺫﺍ, ﻪﺘﺨﯿﮕﻧﺍﺮﺑ, ﮏﯾﺮﺤﺗ, ﮏﯾﺮﺤﺗ, ﮏﯾﺮﺤﺗ
ﻥﺩﺮﮐ-ﻢﻬﺘﻣ: ﻡﻮﮑﺤﻣ
ﯽﮕﺘﺴﺸﻧﺯﺎﺑ-ﻕﻮﻘﺣ: ﯽﮕﺘﺴﺸﻧﺯﺎﺑ, ﻮﺤﻧ
ﻞﻌﻓ: ﻞﻤﻋ, ﻥﺩﺍﺩ-ﻥﺎﺸﻧ-ﺶﻨﮐﺍﻭ
ﻥﻮﻤﯿﻣ: 
ﻝﻮﺒﻗ-ﻞﺑﺎﻗ: ﺪﯿﻨﮐ-ﺪﯿﯾﺎﺗ, ﺵﺮﯾﺬﭘ, ﻞﻤﺘﺤﻣ
ﺎﻀﻣﺍ: 
ﺲﮐﻭﺪﺗﺭﺍ: ﺭﺎﮐ-ﻪﻈﻓﺎﺤﻣ
ﺰﻨﻃ: ﯽﺧﻮﺷ, ﭻﯿﭘ
ﻪﻧﺎﺨﻠﮔ: ﻉﺭﺯ-ﻭ-ﺖﺸﮐ
ﯽﻠﯿﻣ-ﯽﺑ: ﻦﺘﺷﺍﺪﻧ-ﺖﺳﻭﺩ
ﻥﺩﺮﻛ-ﺩﺭﺍﻭ: ﯽﻓﺮﻌﻣ
ﻞﻌﺸﻣ: 
ﻥﺎﺑﺯ-ﺭﻮﺘﺳﺩ: ﯼﺭﻮﺘﺳﺩ
ﯽﮑﻧﺎﺑ-ﻩﺩﺮﭙﺳ: ﻦﺘﺷﺎﺒﻧﺍ
ﯽﺗﺍﺮﻤﻌﺘﺴﻣ: 
ﯽﻧﺎﺑﺩﺎﺑ-ﻖﯾﺎﻗ: ﯽﺘﺸﮐ, ﻖﯾﺎﻗ
ﻢﻬﻣ: ﻪﺠﯿﺘﻧ, ﺖﻤﺴﻗ, ﺖﯿﻤﻫﺍ-ﺎﺑ, ﻪﺟﻮﺗ-ﻞﺑﺎﻗ, ﻥﺪﺷ-ﯽﻬﺘﻨﻣ, ﻪﺘﺴﺟﺮﺑ, ﯽﻬﺟﻮﺗ-ﻞﺑﺎﻗ-ﺭﻮﻄﺑ, ﻪﺟﻮﺗ-ﻞﺑﺎﻗ, ﻪﺟﻮﺗ-ﻞﺑﺎﻗ, ﺭﺍﺩ-ﺎﻨﻌﻣ
ﺪﺒﻨﮔ: 
ﺖﻣﺎﺨﺿ: 
ﻖﺷ-ﻪﻠﮐ: ﻩﺪﻨﻨﮐ-ﺭﺎﻬﻇﺍ
ﻪﻠﻀﻋ: 
ﻩﺯﺍﺪﻧﺍ: ﻩﺯﺍﺪﻧﺍ, ﻢﺠﺣ, ﻪﻨﻣﺍﺩ, ﻩﺯﺍﺪﻧﺍ, ﺭﺍﺪﻘﻣ
ﻥﺪﯿﻟﺎﻣ: 
ﺲﻔﻨﻟﺍ-ﻒﯿﻌﺿ: 
ﻪﻨﻫﺩ: ﻥﺩﺮﮐ-ﺪﺤﺘﻣ, ﻡﺎﻏﺩﺍ, ﻥﺩﺮﮐ-ﺪﺤﺘﻣ, ﻩﺩﺎﻔﺘﺳﺍ, ﺪﻨﺑﺮﻤﮐ
ﺖﺴﺗ-ﻥﺎﻧ: ﺮﺼﺘﺨﻣ-ﮎﺍﺭﻮﺧ
ﺱﻭﺎﻣ: ﺵﻮﻣ
ﺎﺠﻫ: 
ﻪﺑ-ﻥﺩﺯ-ﺖﺳﺩ ﻪﺘﺴﻫﺍ: ﻥﺩﺯ-ﻒﮐ, ﻥﺩﺯ-ﺭﺩ
ﺩﻮﻨﺷ-ﻭ-ﺖﻔﮔ: ﻥﺩﺮﻛ-ﺭﺍﺮﻗﺮﺑ-ﻁﺎﺒﺗﺭﺍ, ﻮﮕﺘﻔﮔ
ﯽﺜﻨﺧ: ﯽﺜﻨﺧ
ﯽﺷﻮﮐ-ﺖﺨﺳ: ﺐﺼﻌﺗ, ﻒﯿﻗﻮﺗ
ﺾﻗﺎﻨﺗ: ﺾﻗﺎﻨﺘﻣ, ﻝﺍﺪﺟ, ﻢﻬﺒﻣ, ﻩﺪﻨﻨﮐ-ﺞﯿﮔ, ﺰﯿﮕﻧﺍﺮﺑ-ﺚﺤﺑ, ﻡﺎﻬﺑﺍ, ﺩﺍﺪﺿﺍ, ﺾﻗﺎﻨﺗ, ﺲﻧﺎﯾﺭﺍﻭ, ﺽﺍﺮﺘﻋﺍ
ﻥﺪﯿﺳﺭ: ﻥﺪﯿﻤﻬﻓ, ﻪﺑ-ﻥﺪﯿﺳﺭ, ﻥﺪﯿﺳﺭ
ﺰﺑ: 
ﻥﺪﺷ-ﺎﻓﻮﮑﺷ: ﯽﺑﺎﯿﻣﺎﮐ, ﻖﻧﻭﺭ, ﺵﺮﻏ, ﺮﻫﺍﻮﺟ, ﺮﻫﻮﮔ
ﻞﯿﻤﺤﺗ: ﻥﺩﺮﻛ-ﺭﻮﺒﺠﻣ, ﯼﺍﺮﺟﺍ, ﻥﺪﺷ-ﻦﯿﯿﻌﺗ
ﺱﺎﻨﺷﺎﻧ: 
ﯽﻤﺳﺭ-ﻡﺎﻧ-ﺖﺒﺛ: 
ﻪﻟﺎﺳﻮﮔ: ﻪﻠﺠﻋ
ﯼﺎﻤﻨﻫﺍﺭ-ﻪﭽﺑﺎﺘﮐ: ﺎﻤﻨﻫﺍﺭ, ﺎﻤﻨﻫﺍﺭ, ﮎﺭﺎﻣ, ﯼﺮﺒﻫﺭ, ﯽﺳﺭﺩ-ﺏﺎﺘﮐ, ﻞﻤﻌﻟﺍ-ﺭﻮﺘﺳﺩ, ﺮﺒﻫﺭ, ﺖﺳﺮﭘﺮﺳ
ﻥﺪﺷ-ﺏﻭﺫ: ﻥﺪﺷ-ﺭﺎﺨﺑ, ﻥﺪﺷ-ﻡﺮﮔ, ﻡﺎﻏﺩﺍ
ﻥﺩﺮﮐ-ﻑﺬﺣ: ﻥﺩﺮﮐ-ﮎﺎﭘ, ﻥﺩﺮﮐ-ﻞﺣ, ﻥﺩﺮﮐ-ﻮﻐﻟ, ﻦﺘﺷﺍﺩﺮﺑ, ﻥﺩﺮﮐ-ﻡﻭﺮﺤﻣ, ﻥﺩﺮﺑ-ﻥﺎﯿﻣ-ﺯﺍ, ﻥﺩﺮﺑ-ﻦﯿﺑ-ﺯﺍ, ﻑﺬﺣ
ﺮﺘﭼ: ﺕﺎﺠﻧ-ﺮﺘﭼ
ﻦﯿﺗﻮﭘ: ﺶﻔﮐ, ﻪﻨﺗ
ﯽﻧﺪﻌﻣ: ﺪﯾ, ﯼﺬﻐﻣ-ﻩﺩﺎﻣ, ﺰﻠﻓ
ﻪﮐﺭﺎﺘﻣ: ﺲﺑ-ﺶﺗﺁ
ﮎﺩﺭﺍ: 
ﻱﺰﻳﺭ-ﻪﻣﺎﻧﺮﺑ: 
ﻥﻮﺑﺎﺻ: 
ﮏﺳﻭﺮﻋ: ﮎﺩﻮﮐ, ﯼﺯﺎﺑ-ﺏﺎﺒﺳﺍ
ﯼﺪﻨﺑ-ﻥﺍﻮﺨﺘﺳﺍ: 
ﻼ﻿ﯾﻭ: ﯼﺮﭘ-ﻭ-ﻦﺟ
ﯽﮔﺪﻧﺯﻭﺩ: ﻥﺩﺯ-ﻪﯿﺨﺑ, ﻦﺘﺧﻭﺩ
ﻥﺩﺍﺩ-ﯽﺘﺷﺁ: ﻥﺩﺮﮐ-ﺖﻃﺎﺳﻭ, ﻥﺩﺮﮐ-ﺪﺤﺘﻣ, ﻥﺩﺮﮐ-ﺪﺤﺘﻣ
ﯼﺮﺘﮐ: 
ﻎﻟﺎﺑ: ﻎﻟﺎﺑ
ﺵﻮﮔﺮﺧ: 
ﺮﺘﺴﮐﺭﺍ-ﺮﺒﻫﺭ: ﻥﺎﺑﺩﺮﻧ, ﺖﺳﺮﭘﺮﺳ, ﻩﺪﻨﻧﺍﺭ, ﺮﺒﻫﺭ
ﯽﮕﺘﺴﺑﺍﻭ: ﺩﺭﺍﺩ-ﯽﮕﺘﺴﺑ, ﺩﺎﻤﺘﻋﺍ, ﻪﺘﺴﺑﺍﻭ, ﺩﺎﺘﻌﻣ, ﯽﮕﺘﺴﺑﺍﻭ, ﺵﺮﮕﻧ
ﻦﮑﯾﺯﺎﺑ: ﺮﮕﯾﺯﺎﺑ
ﻩﺮﺸﺣ: ﺕﺎﻓﺁ
ﻥﺍﺭﻮﺘﺳﺭ: 
ﺪﻐﺟ: 
ﻝﺎﮑﯾﺩﺍﺭ: ﺐﻠﻃ-ﮓﻨﺟ, ﯽﻃﺍﺮﻓﺍ, ﯽﻗﺮﺘﻣ
ﻦﮐﺎﺳ: ﻦﮐﺎﺳ, ﯽﻣﻮﺑ, ﯽﮕﻧﺎﺧ, ﯽﻣﻮﺑ
ﺎﻫﺩﮊﺍ: ﮎﺩﺎﺑﺩﺎﺑ
ﯽﻌﻤﺳ-ﯽﮐﺭﺪﻣ: 
ﻪﻨﺸﺗ: 
ﻥﺪﻧﺎﻣ-ﺮﻈﺘﻨﻣ: ﺕﺪﻣ-ﯽﻧﻻ﻿ﻮﻃ
ﻪﺒﺳﺎﺤﻣ: ﻥﺩﺮﻛ-ﺏﺎﺴﺣ, ﻪﺒﺳﺎﺤﻣ, ﻪﺒﺳﺎﺤﻣ, ﻪﻠﺿﺎﻓ-ﻭ-ﻪﻌﻣﺎﺟ ﺏﺎﺴﺣ, ﻥﺩﺮﮐ-ﺏﺎﺴﺣ-ﯼﺰﯿﭼ ﯼﻭﺭ, ﺏﺎﺴﺣ, ﯼﺭﺎﻤﺷﺮﺳ
ﺕﺍﺭﺮﻘﻣ: ﺭﻮﺴﻧﺎﺳ, ﻝﺮﺘﻨﮐ, ﺖﯾﺩﻭﺪﺤﻣ, ﺖﯾﺩﻭﺪﺤﻣ, ﻥﺎﮑﺳﺍ
ﺭﺍﺩﺮﻬﺷ: 
ﺖﯿﻠﻗﺍ: 
ﺏﺎﺴﺘﮐﺍ: ﻥﺩﺭﻭﺁ-ﺖﺳﺩ-ﻪﺑ, ﻥﺩﺮﮐ-ﺐﺴﮐ, ﻥﺩﺭﻭﺁ-ﺖﺳﺩ, ﯽﺳﺮﺘﺳﺩ, ﯽﺳﺮﺘﺳﺩ
ﺯﺎﺑﺮﺳ-ﻪﻨﻬﮐ: ﺪﺷﺭﺍ
ﺮﺘﺴﮐﺭﺍ: 
ﻦﮑﯿﺑ: 
ﺭﺮﺿ: ﻥﺎﯾﺯ, ﺖﯿﻣﻭﺮﺤﻣ, ﺮﻀﻣ, ﺐﯿﻋ, ﺺﻘﻧ
ﻪﭼﺭﺎﭘ: ﻪﭼﺭﺎﭘ, ﺵﻮﭘ-ﻦﺗ, ﻪﻟﻮﺣ, ﯽﺷﺎﻘﻧ-ﻡﻮﺑ, ﺖﻓﺎﺑ
ﻥﺍﺩ-ﯽﻘﯿﺳﻮﻣ: ﺯﺎﺴﮕﻨﻫﺁ, ﯽﻘﯿﺳﻮﻣ
ﯽﻨﻫﺫ: ﯽﻧﺎﺣﻭﺭ, ﯽﻧﺍﻭﺭ, ﻪﯿﺣﻭﺭ, ﺎﻧﺎﻣ, ﯽﻨﻫﺫ
ﯽﮕﺘﺳﻮﯿﭘ: ﻥﺩﺮﮐ-ﯼﺭﺎﮑﻤﻫ, ﻝﺎﺼﺗﺍ, ﺐﯿﮐﺮﺗ, ﻦﻤﺠﻧﺍ, ﻪﺘﺴﺑﺍﻭ, ﻦﺘﺨﯿﻣﺁ, ﻢﺠﺴﻨﻣ, ﺭﺎﻨﮐ-ﺭﺩ, ﯽﮕﺘﺳﻮﯿﭘ, ﺮﮑﻨﯿﻟ
ﻩﺪﻨﺴﺑﺎﻧ: ﺪﻗﺎﻓ, ﯽﻓﺎﮐ, ﺩﻮﺒﻤﮐ, ﯽﺘﺨﺑﺪﺑ, ﺖﺴﭘ, ﺎﭘ-ﻭ-ﺖﺳﺩ ﯽﺑ, ﻥﺍﻭﺍﺮﻓ, ﻒﺳﺎﺗ-ﻪﯾﺎﻣ, ﺲﻧﺎﺠﺘﻣﺎﻧ, ﺐﺳﺎﻨﻣ-ﺎﻧ
ﺭﺎﻤﻌﻣ: 
ﻮﻤﯿﻟ: 
ﻥﺩﺮﮐ-ﻪﻓﺮﺳ: ﻪﻓﺮﺳ
ﺩﺭﺩﺮﺳ: 
ﺮﺟﺎﺘﺴﻣ: ﺶﮐ-ﻪﺸﻘﻧ
ﯼﺭﻭﺭﺎﺑ: ﻞﺜﻣ-ﺪﯿﻟﻮﺗ
ﺎﻔﺷ: ﻥﺎﻣﺭﺩ, ﻥﺩﺮﮐ-ﺮﺘﻬﺑ, ﻥﺩﺮﺑ-ﻻ﻿ﺎﺑ, ﺩﻮﺒﻬﺑ, ﻥﺎﻣﺭﺩ
ﺩﻮﻧ: 
ﯽﻓﺩﺎﺼﺗ: ﯽﻓﺩﺎﺼﺗ-ﺕﺭﻮﺻ-ﻪﺑ, ﻥﺩﺮﮐ-ﯽﻓﺩﺎﺼﺗ, ﯽﻓﺩﺎﺼﺗ
ﻖﺷﺎﻗ: ﻞﻄﺳ
ﻥﻮﻟﺎﺑ: 
ﭻﮔ: ﭻﮔ
ﯽﻃﺎﺒﻨﺘﺳﺍ-ﯽﮐﺭﺪﻣ: 
ﺮﺷﺎﻧ: ﺮﮕﺸﯾﺍﺮﯾﻭ
ﻪﮐﺮﺳ: 
ﺮﺘﺴﮐﺎﺧ: ﯼﺮﺘﺴﮐﺎﺧ, ﯼﺮﺘﺴﮐﺎﺧ
ﺮﯿﮕﯾﺎﺟ: ﻥﺩﺭﻮﺧ-ﻢﺴﻗ
ﯼﺎﯿﺣﺍ: ﺎﯿﺣﺍ
ﺱﺎﺴﺣ: ﺮﯾﺬﭘ-ﺐﯿﺳﺁ, ﺱﺎﺴﺣ, ﻝﻮﻘﻌﻣ, ﯽﻔﻃﺎﻋ, ﻝﻮﺌﺴﻣ
ﻞﻧﻮﺗ: ﻭﺮﺘﻣ
ﻝﺯﺎﭘ: ﻥﺩﺮﮐ-ﺞﯿﮔ, ﻩﺪﻨﻨﮐ-ﺞﯿﮔ
ﻡﺰﯿﻧﺎﮑﻣ: ﺵﻭﺭ, ﻝﺍﻭﺭ, ﯽﻟﻮﺻﺍ, ﻩﺎﮕﺘﺳﺩ
ﺕﺎﯿﺿﺎﯾﺭ: ﯽﺿﺎﯾﺭ, ﯽﺿﺎﯾﺭ
ﻥﺪﺷ-ﻮﺤﻣ: 
ﺪﺒﮐ: 
sublative-ﺩﺭﻮﻣ: 
ﺐﯿﺷ: ﻪﺟﺮﯿﺷ, ﻥﺩﺍﺩﺭﺍﺮﻗ, ﻥﺩﺮﮐ-ﺎﻫﺭ, ﻥﺩﺮﮐ-ﺰﯿﺧ-ﻭ ﺖﺴﺟ, ﻉﻮﻗﻭ, ﺐﯿﺷ, ﺐﯿﺷ, ﺐﯿﺷ, ﺐﯿﺷ, ﻥﺩﺭﻮﺧ-ﺲﯿﺧ
ﺪﺣﺍﻭ: ﺕﺪﺣﻭ, ﺩﻮﺟﻭ, ﺪﺣﺍﻭ, ﺭﺎﻘﻨﻣ, ﺩﺮﻔﻣ
ﺭﺎﺼﺤﻧﺍ: ﯼﺭﺎﺼﺤﻧﺍ
ﺭﺎﻤﻗ: ﺭﺎﻤﻗ, ﯼﺯﺎﺑ, ﻦﺘﺷﺍﺩ-ﯽﻧﺍﻮﺨﻤﻫ, ﮎﺮﻤﮔ-ﺯﺍ-ﻻ﻿ﺎﮐ ﺺﯿﺧﺮﺗ, ﯼﺯﺎﺑ-ﺏﺎﺒﺳﺍ
ﯽﯾﺎﯾﺭﺩ-ﺮﯾﺯ: ﺏﺁ-ﺮﯾﺯ
ﻪﻟﺰﻟﺯ: ﺞﻨﺸﺗ
ﻩﺎﮕﺸﯾﺎﻣﺯﺁ: ﻩﺎﮕﺸﯾﺎﻣﺯﺁ
ﻪﺒﻨﭘ-ﺏﻮﭼ: ﯽﮐﺍﺭﻮﺧ-ﭺﺭﺎﻗ, ﭺﺭﺎﻗ, ﺭﺍﺩ-ﻪﺒﻟ-ﻩﻼ﻿ﮐ
ﺩﻮﺧ-ﻝﺮﺘﻨﮐ: 
ﺍﺩﻮﺑ: 
ﻩﺮﮔ: ﯽﮔﺪﻨﻓﺎﺑ, ﺖﻓﺎﺑ, ﺭﺎﺸﻓ, ﯽﻨﺘﻓﺎﺑ, ﻩﺮﮔ, ﻩﺮﮔ, ﻦﺘﻓﺎﺑ-ﻭ-ﻥﺪﯿﺑﺎﺗ ﻢﻬﺑ
ﺕﺭﺎﻔﺳ: 
ﻦﯾﺮﺗﺭﻭﺩ: 
ﯽﻧﻼ﻿ﻋﺍ-ﺖﻟﺎﺣ: 
ﮎﺮﺤﻣ: ﻖﯾﻮﺸﺗ, ﻩﺰﯿﮕﻧﺍ, ﻞﻤﻌﻟﺍ-ﺭﻮﺘﺳﺩ, ﻩﺰﯿﮕﻧﺍ, ﻩﺰﯿﮕﻧﺍ
ﺕﻼ﻿ﮑﺷ: ﺕﺎﺒﻧ
ﯽﻗﺎﻔﺗﺍ: ﺲﻧﺎﺷ, ﺐﯿﮐﺮﺗ, ﻒﺳﺎﺗ-ﻪﯾﺎﻣ, ﯽﻓﺩﺎﺼﺗ-ﺕﺭﻮﺻ-ﻪﺑ, ﯽﻓﺩﺎﺼﺗ, ﻦﺘﺷﺍﺩ-ﯽﻧﺍﻮﺨﻤﻫ
ﺶﮑﺘﺳﺩ: 
ﻥﺩﺯ-ﻮﻧﺍﺯ: 
ﺎﯿﻓﺍﺮﻐﺟ: 
ﯼﺭﺍﺬﮔ-ﻪﯾﺎﻣﺮﺳ: ﯼﺭﺍﺬﮔ-ﻪﯾﺎﻣﺮﺳ, ﯼﺭﺍﺬﮔ-ﻪﯾﺎﻣﺮﺳ
ﯽﻫﺎﻔﺷ: ﯼﺭﺎﺘﻔﮔ, ﯽﻫﺎﻔﺷ, ﻦﯿﻫﻮﺗ
ﺱﺎﯿﻗ: ﯼﺮﺑﺍﺮﺑ, ﻪﺑﺎﺸﺗ, ﯽﮕﺘﺴﺑﺍﻭ, ﯼﺪﻧﻭﺎﺸﯾﻮﺧ, ﺖﺒﺴﻧ
ﺭﻻ﻿ﻮﮑﺳ: ﯽﻧﺎﺣﻭﺭ-ﺮﯿﻏ
ﻦﯿﻫﺎﺷ: ﺏﺎﻘﻋ
ﯽﺳﺎﻨﺷ-ﻥﺍﻭﺭ: 
ﻥﺩﺮﮐ-ﺖﻔﺳ: ﻁﺎﺒﺗﺭﺍ, ﻥﺩﺮﮐ-ﺮﯿﺳﺍ-ﻭ ﺭﺎﺘﻓﺮﮔ, ﻝﺎﺼﺗﺍ, ﯼﺪﻨﺑ-ﻢﺧﺯ-ﺭﺍﻮﻧ, ﺖﺷﺍﺩﺯﺎﺑ, ﻪﻤﯿﻤﺿ
ﻪﺿﺍﺮﻗ: ﻥﺩﺮﮐ-ﻮﻐﻟ, ﻪﻟﺎﺑﺯ, ﻪﻟﺎﺑﺯ, ﻪﻌﻄﻗ
ﺶﻘﻧ: ﻩﺮﻗﺮﻗ, ﻢﻬﺳ, ﺱﺭﻮﺑ-ﻥﺎﻣﺯﺎﺳ, ﻩﺪﻨﻨﮐ-ﺖﮐﺮﺷ
ﺭﺍﺪﻘﻣ: ﺭﺍﺪﻘﻣ
ﺩﺍﺯﺁ-ﯽﻫﺎﻣ: 
ﮓﻨﯾﺩﻮﭘ: 
ﯽﺴﯿﻃﺎﻨﻐﻣ: ﺏﺍﺬﺟ
ﻪﺒﻤﻠﺗ: ﺐﻤﺑ
ﻥﮋﯿﺴﮐﺍ: 
ﻪﻣﺎﻧ-ﯽﻫﺍﻮﮔ: 
ﻝﺍﺪﻣ: 
ﯽﻇﺎﻔﻟ: 
ﺵﺍﺮﺧ: ﺵﺍﺮﺧ, ﻥﺪﻧﺍﺮﭼ
ﻭﺭﺎﭘ: ﻞﯿﺑ, ﻪﻟﺎﺑ
ﭖﻮﮑﺴﻠﺗ: ﭗﮑﺳﻭﺮﮑﯿﻣ
ﺪﻨﺑ-ﻥﺩﺮﮔ: ﺖﺴﮑﺷ, ﺮﯿﻤﺧ
ﯽﺠﻫ: ﻥﺩﺮﮐ-ﯽﺠﻫ
ﯽﮑﺴﯾﻭ: 
ﺪﯿﺑ: ﻥﺪﯾﺮﭼ
ﺮﺘﺷ: 
ﺭﻮﺗﺎﻣﺁ: 
ﺝﻭﺮﺧ: ﺕﺍﺭﺩﺎﺻ, ﺰﯾﺮﭘ, ﺝﻭﺮﺧ, ﺪﯿﻟﻮﺗ
ﻪﻣﺎﻨﯿﮔﺪﻧﺯ: 
ﺮﺧ: 
ﻪﻧﺎﯿﻫﺎﻣ: 
ﯽﺷﻮﭘ-ﻢﺸﭼ: ﯽﻬﺟﻮﺗ-ﯽﺑ, ﻥﺩﺮﮐ-ﯽﺷﻮﭘ-ﻢﺸﭼ, ﺩﺭ, ﻞﻬﺟ
ﺕﻼ﻿ﯿﻄﻌﺗ: ﻥﺩﺮﮐ-ﮎﺮﺗ, ﻞﯿﻄﻌﺗ-ﺯﻭﺭ, ﺢﯾﺮﻔﺗ, ﯽﻗﺎﺑ
ﮏﯿﻠﮐ: ﻪﺘﺳﺩ, ﯽﻧﺎﻬﮔﺎﻧ-ﻭ-ﻢﮑﺤﻣ ﻪﺑﺮﺿ
ﯽﻀﯿﺑ: 
ﻥﺎﺴﺸﮐ: ﮏﯿﺘﺳﻻ﻿, ﺮﯾﺬﭘ-ﻑﺎﻄﻌﻧﺍ
ﺖﻐﻟ-ﮓﻨﻫﺮﻓ: ﯼﻮﻐﻟ, ﻥﺎﮔﮊﺍﻭ
ﻥﻮﺒﻣﺍﮊ: ﻥﺍﺭ, ﻞﻔﮐ
ﻥﺎﻤﻛ-ﻦﻴﮕﻧﺭ: 
ﻥﺩﺮﮐ-ﻑﺮﺼﻣ: ﻑﺮﺼﻣ, ﻩﺩﺎﻔﺘﺳﺍ, ﺵﺮﺘﺴﮔ
ﻦﻫﺩ-ﺏﺁ: ﺮﺴﻤﻫ, ﻥﺎﺑﺯ
ﻥﺰﺨﻣ: ﻥﺰﺨﻣ, ﻑﺮﻇ, ﻩﺮﻤﺧ
ﺭﺎﮑﻤﻫ: ﯽﻧﻭﺎﻌﺗ, ﺭﺎﮑﻤﻫ, ﺮﺴﻤﻫ, ﻪﺘﺴﺑﺍﻭ
ﻪﻧﺍﻭﺮﭘ: 
ﯽﻧﺎﻣﺯﺎﺳ-ﺕﺭﺎﭼ: ﺭﺍﺩﻮﻤﻧ, ﻑﺍﺮﮔ, ﮏﯿﻓﺍﺮﮔ, ﮏﯿﻓﺍﺮﮔ, ﻪﻣﺎﻧﺮﺑ, ﺡﺮﻃ
ﻮﻠﻗﻭﺩ: ﺮﺑﺍﺮﺑ-ﻭﺩ, ﻭﺩ
ﻞﻘﺘﺴﻣ-ﺭﻮﻃ-ﻪﺑ: ﻞﻘﺘﺴﻣ, ﻪﻧﺍﺩﺍﺯﺁ, ﺍﺪﺟ
ﻥﺍﺭﺰﯿﺧ-ﺏﻮﭼ: 
ﻝﻻ﻿ﺩ: ﺵﻭﺮﻓ-ﻩﺩﺮﺧ, ﻩﺪﻨﺷﻭﺮﻓ, ﻩﺪﻨﺷﻭﺮﻓ, ﺮﺟﺎﺗ
ﯽﮕﺘﺷﺎﺒﻧﺍ: ﻦﺘﺷﺎﺒﻧﺍ, ﻪﻋﻮﻤﺠﻣ, ﺰﮐﺮﻤﺗ
ﺱﺭﺯﺎﺑ: ﺰﯿﻤﻣ, ﺖﺳﺮﭘﺮﺳ
ﻪﻤﻘﻟ: ﻪﻌﻄﻗ, ﻪﮑﺗ, ﻩﺭﺫ
ﺱﻮﺑﺎﮐ: ﺏﺍﻮﺧ
ﺎﺑﺮﻣ: ﻪﻟﮊ
ﻩﺯﻮﻣ: 
ﺎﺒﻔﻟﺍ: ﯽﯾﺎﺒﻔﻟﺍ
ﻥﺩﺮﮐ-ﺶﺨﭘ: ﺵﺮﺘﺴﮔ, ﻥﺩﺍﺩ-ﺭﺎﺸﺘﻧﺍ
ﺵﺭﻮﯾ: ﻝﺎﻐﺘﺷﺍ, ﻢﺟﺎﻬﺗ, ﻪﻠﻤﺣ, ﻪﻠﻤﺣ, ﻉﻭﺮﺷ, ﺐﻟﺎﻏ, ﻥﺩﺮﮐ-ﺩﺮﻃ
ﻥﺩﺮﮐ-ﺵﺎﻓ: ﻡﻼ﻿ﻋﺍ, ﻦﺘﺧﺎﺳ-ﺭﺎﮑﺷﺁ, ﻒﺸﮐ, ﻦﺘﺷﺍﺬﮔ-ﺽﺮﻌﻣ-ﺭﺩ, ﻥﺩﺮﮐ-ﻞﻃﺎﺑ, ﺭﺎﺸﺘﻧﺍ, ﻥﺩﺮﻛ-ﻒﺸﻛ
ﻥﺪﺷ-ﺪﺳﺎﻓ: ﯽﮔﺪﯿﺳﻮﭘ, ﻥﺪﺷ-ﺪﺳﺎﻓ
ﺰﯿﻣﺁ-ﺖﻧﻮﺸﺧ: ﻥﺪﺷ-ﻢﺣﺍﺰﻣ, ﯽﮕﺘﺨﯾﺭ-ﻢﻬﺑ, ﻝﺎﻐﺘﺷﺍ, ﺯﻭﺎﺠﺗ, ﻪﻠﻤﺣ, ﻩﺪﻨﻨﮐ-ﺭﺎﻬﻇﺍ
ﮎﺎﮑﻄﺻﺍ: 
ﻪﻠﮑﺳﺍ: 
ﺕﻮﺒﮑﻨﻋ: 
ﯽﻨﯿﻣﺯ-ﺐﯿﺳ: 
ﺮﻈﻧ-ﺪﯾﺪﺠﺗ: ﻥﺩﺮﮐ-ﻢﯿﻈﻨﺗ, ﺡﻼ﻿ﺻﺍ, ﻥﺩﺮﮐ-ﺮﻈﻧ-ﺪﯾﺪﺠﺗ, ﺡﻼ﻿ﺻﺍ, ﺡﻼ﻿ﺻﺍ, ﯽﻨﯿﺑﺯﺎﺑ, ﯽﺳﺮﺑﺎﺴﺣ
ﺯﺁ-ﻭ-ﺹﺮﺣ: ﺺﯾﺮﺣ
ﺱﺭﺎﻧ: ﻪﯿﻟﻭﺍ, ﻩﺩﺎﺟ-ﺯﺍﺪﻧﺍ-ﺖﺳﺩ
ﻥﺩﺮﮐ-ﺮﯿﺜﮑﺗ: ﺖﺑﺎﺻﺍ, ﺩﺍﮋﻧ-ﺡﻼ﻿ﺻﺍ-ﻭ ﺵﺭﻭﺮﭘ, ﻩﺩﺎﺟ-ﺯﺍﺪﻧﺍ-ﺖﺳﺩ
ﺶﺧﺮﭼ: ﻥﺪﻧﺎﺧﺮﭼ, ﺶﺧﺮﭼ, ﭻﯿﭘﺭﺎﻣ, ﺦﻧ, ﭻﯿﭘ
ﻡﺎﻗﺭﺍ: ﯼﺭﺎﻣﺁ, ﻞﮑﺷ, ﻥﺩﺯ-ﭗﮔ
ﻢﯾﻮﻘﺗ: ﻪﻣﺎﻧﺮﺑ, ﯽﻧﺎﻣﺯ-ﻝﻭﺪﺟ, ﺕﺍﺮﻃﺎﺧ-ﺮﺘﻓﺩ, ﺯﺍﺪﻧﺍ-ﻢﺸﭼ
ﯼﺩﺰﻣﺎﻧ: ﻥﺩﺮﮐ-ﺩﺰﻣﺎﻧ, ﺏﺎﺼﺘﻧﺍ, ﺏﺎﺨﺘﻧﺍ, ﯼﺩﺰﻣﺎﻧ
ﻥﻮﯿﻠﯾﺮﺗ: 
ﯽﻧﺍﻭﺮﯿﺷ-ﺮﯾﺯ-ﻕﺎﺗﺍ: ﺩﺎﺑ
ﺖﺒﺜﻣ-ﺖﻟﺎﺣ: 
ﯼﺩﺮﺑﺭﺎﮐ-ﯼﺎﻫ-ﻪﻣﺎﻧﺮﺑ: 
ﯽﻤﺳﺍ: 
ﯽﺘﯾﺎﺿﺭﺎﻧ: 
ﺖﻧﻮﻔﻋ: ﻩﺩﻮﻟﺁ, ﯽﻧﻮﻔﻋ, ﻝﺎﻘﺘﻧﺍ, ﻝﺎﻘﺘﻧﺍ, ﯽﻧﻮﻔﻋ
ﭺﺭﺎﭘ: ﻪﺸﯿﺷ
ﻦﺘﺧﺍﺪﻧﺍ-ﻻ﻿ﺎﺑ-ﺍﺭ ﻪﻧﺎﺷ: ﯽﻧﺎﻬﮔﺎﻧ-ﺶﺸﮐ-ﺎﯾ ﺖﮐﺮﺣ
ﻡﺎﮕﺸﯿﭘ: ﮒﺭﺰﺑ, ﺪﺟﻮﻣ-ﻭ-ﻭﺮﺸﯿﭘ
ﻑﺬﺣ: ﺽﺮﻓ-ﺶﯿﭘ-ﺭﻮﻃ ﻪﺑ, ﻩﺎﺒﺘﺷﺍ, ﺩﻮﺒﻤﮐ, ﯼﺭﺎﮕﻧﺍ-ﻞﻬﺳ, ﯽﻬﺟﻮﺗ-ﯽﺑ, ﻑﺬﺣ
ﻢﻠﮐ: 
ﯽﺷﺯﺭﻭ: ﯽﻧﺍﻮﻠﻬﭘ, ﯽﺿﺎﯾﺭ, ﺭﺎﮑﺷﺯﺭﻭ
ﯽﺘﺴﻣ: ﺪﻨﻗ
ﺎﻫﺍﺪﺻﺩﻮﺧ: 
ﻡﺮﻫﺍ: ﯼﻭﺎﮑﺠﻨﮐ
ﺭﻮﺗﺎﻨﺳ: 
ﻦﺳﻮﺳ-ﻭ-ﻖﺒﻧﺯ ﺲﻨﺟ: 
ﻪﭼﺭﻮﻣ: 
ﻩﺮﺸﺣ: 
ﻪﻠﻣﺎﺣ: ﯼﺭﺩﺎﻣ
ﻥﺩﺮﮐ-ﻊﯾﺮﺴﺗ: ﺵﺭﺎﺑ, ﺏﻮﺳﺭ, ﺖﻋﺮﺳ, ﯼﺭﻮﻓ, ﻥﺪﯿﺸﺨﺑ-ﺖﻋﺮﺳ
ﺎﭘ-ﭻﻣ: 
ﯼﺪﻨﺑ-ﻢﯿﺴﻘﺗ: ﯼﺯﺎﺳ-ﺐﺗﺮﻣ, ﻥﺩﺮﮐ-ﯼﺪﻨﺑ-ﻪﺘﺳﺩ, ﯼﺪﻨﺑ-ﻪﻘﺒﻃ
ﺮﯿﻐﺘﻣ: ﺕﻭﺎﻔﺘﻣ
ﻥﺩﺮﮐ-ﯼﺪﻨﺑ-ﻪﺘﺴﺑ: ﻪﺘﺴﺑ, ﻪﺘﺴﺑ, ﻪﺘﺴﺑ, ﻪﺘﺴﺑ, ﻩﺮﻗﺮﻗ, ﯼﺪﻨﺑ-ﻪﺘﺴﺑ-ﺬﻏﺎﮐ, ﺶﺷﻮﭘ, ﺶﺷﻮﭘ
ﺪﻌﺠﻣ: ﻪﻘﻠﺣ, ﺏﺎﺗﺮﭘ, ﭻﯿﭘ-ﻢﯿﺳ, ﺭﺎﻣﻮﻃ, ﭻﯿﭘﺭﺎﻣ
ﺩﺮﮔﻮﮔ: ﺩﺮﮔﻮﮔ, ﻪﺘﺴﮑﺷ
ﻥﺩﺮﮐ-ﻪﺘﮑﯾﺩ: 
ﻥﺪﺷ-ﺭﺍﺪﯾﺪﭘ: ﺪﺳﺭ-ﯽﻣ-ﺮﻈﻧ ﻪﺑ, ﯼﺮﻫﺎﻇ-ﻞﮑﺷ, ﺪﻨﯾﺁ-ﯽﻣ-ﺩﻮﺟﻮﺑ, ﺝﻭﺮﺧ, ﮎﺮﺗ
ﻪﻏﺎﺑﺭﻮﻗ: 
ﻩﺯﺍﺪﻧﺍ-ﺯﺍ-ﺶﯿﺑ ﺩﺭﻮﻣ: 
ﺞﻨﻔﺳﺍ: ﭺﺭﺎﻗ, ﯽﮐﺍﺭﻮﺧ-ﭺﺭﺎﻗ
ﻩﺪﻨﻫﺩ-ﺭﺍﺯﺁ: ﻩﺪﻨﻨﻛ-ﺖﺣﺍﺭﺎﻧ, ﻥﺪﺷ-ﻢﺣﺍﺰﻣ, ﺖﻤﺣﺯ, ﻦﺘﻓﺮﮔ-ﺩﺍﺮﯾﺍ, ﻥﺩﺮﮐ-ﮏﯾﺮﺤﺗ, ﺮﺑ-ﺮﺳ-ﻪﻠﺻﻮﺣ, ﺪﻨﺴﭘ-ﻞﮑﺸﻣ, ﻥﺍﺮﮕﻧ
ﺏﺎﺠﻨﺳ: 
ﻥﺩﺮﮐ-ﺏﺎﯿﺳﺁ: ﻢﯿﻧ, ﻪﻤﯿﻧ
irrealis-ﺖﻟﺎﺣ: 
ﻥﺎﺸﻔﺸﺗﺍ: 
ﻪﻧﺎﺧ-ﻞﺧﺍﺩ-ﺭﺩ: ﯽﻠﺧﺍﺩ, ﻞﺧﺍﺩ, ﺩﻭﺪﺣ-ﺭﺩ-،ﻞﺧﺍﺩ ﺭﺩ, ﻞﺤﻣ
ﯼﺭﺍﺩﺮﺑ-ﻩﺮﻬﺑ: ﻩﺩﺎﻔﺘﺳﺍ, ﻥﺪﺷ-ﺏﺬﺟ, ﺖﯿﻘﻓﻮﻣ, ﻒﺸﮐ
ﯽﺳﺎﻨﺷ-ﻦﯿﻣﺯ: 
ﻪﻣﺎﻧﺭﺬﮔ: 
ﺪﺳﺎﻓ: ﺮﯾﺮﺷ, ﺪﺳﺎﻓ
ﺖﯾﻮﮑﺴﯿﺑ: ﯽﻨﯾﺮﯿﺷ
ﯼﺭﺎﮑﻤﻫ: ﻥﺩﺮﮐ-ﯼﺭﺎﮑﻤﻫ, ﺖﮐﺭﺎﺸﻣ, ﻡﺎﻏﺩﺍ, ﯼﺭﺎﮑﻤﻫ
ﺹﺮﻗ: ﻪﻟﻮﻠﮔ, ﺹﺮﻗ, ﮓﻨﺳ-ﻪﺘﺨﺗ
ﺏﺎﺼﻋﺍ-ﺩﺪﻤﺗ: ﻞﺷ, ﻡﺍﺭﺁ, ﺖﻏﺍﺮﻓ, ﺵﺎﺑ-ﻡﻭﺭﺁ, ﺶﺨﺑ-ﺶﻣﺍﺭﺁ, ﺢﯾﺮﻔﺗ
ﻢﺗﺍ: ﯽﻤﺗﺍ, ﻩﺭﺫ, ﯼﺩﺮﻓ
ﺯﺪﯾﺍ: ﮏﻤﮐ, ﻦﯿﮑﺴﺗ, ﯽﮑﻤﮐ
ﻡﺮﻫ: 
ﻪﺧﺮﭼ: ﻩﺮﯾﺍﺩ, ﺵﺩﺮﮔ, ﺲﻧﺎﮐﺮﻓ, ﺶﺧﺮﭼ, ﻥﺪﻧﺎﺧﺮﭼ, ﻪﺧﺮﭼﻭﺩ, ﻪﺧﺮﭼﻭﺩ
ﻥﺩﺯ-ﺕﺮﭼ: 
ﯽﻧﻮﻧﺎﻗ-ﺮﯿﻏ: ﯽﻧﻮﻧﺎﻗ-ﺮﯿﻏ
ﻪﺠﻨﭘ: ﻪﺠﻨﭘ, ﻪﺠﻨﭘ
ﯽﯾﻭﺮﻤﮐ: ﯽﺘﻟﺎﺠﺧ, ﺽﺎﺒﻘﻧﺍ
ﻥﺩﺍﺩ-ﺭﺍﺮﻗ-ﻉﺎﻌﺸﻟﺍ ﺖﺤﺗ: ﻢﻬﺒﻣ
ﺩﻮﻋ: ﺞﮐ
ﺏﻭﺭﺎﺟ: 
ﻮﻠﺑﺎﺗ: ﻪﺤﻔﺻ, ﮓﻨﺳ-ﻪﺘﺨﺗ, ﯼﺰﯿﻣﺁ-ﮓﻧﺭ, ﻪﺘﺨﺗ, ﻩﻭﺮﮔ, ﻥﻮﯿﺴﯿﻤﮐ
ﯽﺳﺎﻨﺷ-ﻩﺭﺎﺘﺳ: 
ﻢﺧ-ﻭ-ﭻﯿﭘ: 
ﯽﻠﯿﺼﺤﺗ-ﺱﺭﻮﺑ: ﺖﯾﺎﻤﺣ
ﺖﺸﭘ-ﮎﻻ﻿: 
ﺭﻭﺎﺸﻣ: ﯽﺑﺮﻣ, ﻪﯿﺻﻮﺗ
ﺮﺒﯿﻓ: ﺮﺒﯿﻓ, ﻪﺘﺴﺑ
ﮎﺮﯿﺟﺮﯿﺟ: 
ﺮﺗﻮﺒﮐ: 
ﻕﺎﺒﻄﻧﺍ: ﻕﺎﺒﻄﻧﺍ, ﯽﻧﺩﺮﮐ-ﺐﺼﻧ-ﻡﺯﺍﻮﻟ, ﻕﺎﺒﻄﻧﺍ, ﺡﻼ﻿ﺻﺍ, ﻥﺩﺮﮐ-ﻢﯿﻈﻨﺗ
ﺵﻮﮔ-ﻪﺳ: 
ﺭﺍﺩ-ﻪﻧﺍﺰﺧ: 
ﻥﮊﻭﺭﺪﯿﻫ: 
ﻩﺪﻨﻨﮑﺷ: ﻒﯾﺮﻇ, ﺩﺮﺗ
ﺮﮕﭘﺎﭼ: 
ﻥﺩﺮﮐ-ﻪﻔﺧ: 
ﻦﻣﺰﻣ: ﻡﻭﺎﻘﻣ
ﻪﻠﺑﺎﻘﻣ: ﺩﺭﻮﺧﺮﺑ, ﻕﺎﺒﻄﻧﺍ, ﺎﺑ-ﻥﺪﺷ-ﻭﺮﺑﻭﺭ, ﻑﺍﺮﺤﻧﺍ, ﺮﺑ-ﻪﺒﻠﻏ, ﺎﺑ-ﺩﺭﻮﺧﺮﺑ, ﻪﻠﺑﺎﻘﻣ, ﯽﮔﺪﯿﺳﺭ
ﯽﻫﺍﺭﻭﺩ: 
ﯽﺳﺪﻨﻬﻣ: ﮏﯿﻨﮑﺗ, ﯽﻨﻓ-ﻅﺎﺤﻟ-ﺯﺍ
ﻦﯿﺑﺭﻭﺩ: ﻕﺎﺗﺍ
ﻥﺩﺮﮐ-ﯽﻫﺍﻮﺧ-ﺭﺬﻋ: ﯽﻫﺍﻮﺧﺭﺬﻋ, ﺶﺸﺨﺑ
ﻥﺪﯿﺴﯿﻟ: 
ﺹﺎﻗﺭ: 
ﭺﻮﮐ: ﺕﺮﺟﺎﻬﻣ, ﺕﺮﺟﺎﻬﻣ
ﺲﯿﻨﺗ: 
ﺕﺍﺮﻘﻓ-ﻥﻮﺘﺳ: 
ﻥﺩﺮﮐ-ﺥﺮﺳ: 
ﯽﺟﺎﺴﻧ: ﻪﺘﺴﺑ, ﻥﺪﺷ-ﻪﺘﺴﺑ
ﻥﺩﺯ-ﻢﺧﺯ: ﺶﯿﻧ, ﻥﺩﺮﮐ-ﺥﺍﺭﻮﺳ, ﻦﺘﻓﺮﮔ, ﺶﺷﻮﮐ, ﺵﻼ﻿ﺗ
ﺭﻮﺒﻋ-ﺰﻣﺭ: ﻝﺎﻨﮕﯿﺳ, ﻒﺻ, ﺭﺎﻌﺷ
ﻩﺮﮑﻤﯿﻧ: ﻥﺎﺸﻧ-ﺮﻃﺎﺧ, ﻡﺎﻌﻧﺍ
ﯼﮋﺗﺍﺮﺘﺳﺍ: ﮏﯾﮋﺗﺍﺮﺘﺳﺍ
ﺰﺗﺭﺍﻮﮐ: 
ﯽﭽﯿﻗ: ﻥﺪﯿﺸﮐ, ﻥﺪﯿﺸﮐ
ﺖﺸﮔ: 
ﯽﻌﯿﺒﻃ-ﻝﺎﭽﺨﯾ: 
ﻩﺍﺭ-ﻪﻤﯿﻧ: ﻢﯿﻧ, ﯼﺪﺣﺎﺗ, ﻪﻤﯿﻧ, ﻂﺳﻮﺘﻣ, ﻪﻤﯿﻧ
ﺖﺷﺍﺩﺩﺎﯾ: ﻩﺪﻫﺎﻌﻣ, ﯼﺭﺎﮐ-ﺩﺍﺩﺭﺍﺮﻗ, ﺩﺍﺩﺭﺍﺮﻗ, ﻖﻓﺍﻮﺗ, ﻢﮑﺣ
ﻁﻭﺮﺨﻣ: ﯽﻃﻭﺮﺨﻣ
ﻥﺭﺎﻘﺗ: 
ﻩﺪﻧﺯﺎﺳ: ﻩﺪﻨﻨﮐ-ﺪﯿﻟﻮﺗ, ﻩﺪﻨﻨﻛ-ﻪﻴﻬﺗ, ﻩﺪﻧﺯﺎﺳ
ﻊﻓﺍﺪﻣ: ﻊﻓﺍﺪﻣ
ﺪﺠﺴﻣ: 
ﺞﻧﺮﻄﺷ: 
ﺽﺭﺍﻮﻋ: ﮊﺭﺎﺷ, ﺖﺧﺍﺩﺮﭘ, ﯽﻧﺎﺑﺮﻗ, ﻞﮑﺷ, ﺽﺭﺍﻮﻋ
ﺱﻼ﻿ﯿﮔ: 
ﻩﺩﺮﺘﺴﮔ: ﻊﯿﺳﻭ, ﻩﺩﺮﺘﺴﮔ-ﺭﻮﻃ-ﻪﺑ, ﻥﺩﺍﺩ-ﺭﺎﺸﺘﻧﺍ, ﻊﯿﺳﻭ, ﻦﻬﭘ
ﻥﺩﺭﻮﺧ-ﻮﻠﺗ-ﻮﻠﺗ: ﻥﺩﺮﮐ-ﺰﯿﺧ-ﻭ ﺖﺴﺟ
ﻥﻮﯿﻣﺎﮐ: ﻥﻮﯿﻣﺎﮐ, ﺭﺎﺑ, ﯼﺭﺎﺑ
ﻝﺩﺮﺧ: 
ﺪﺻ-ﺭﺩ: ﯼﺪﺻﺭﺩ, ﺪﺻﺭﺩ
ﺝﺍﺮﺣ: ﺵﻭﺮﻓ
ﻝﺎﺑﺮﻏ: 
ﻥﺍﺯﺮﻟ: ﺕﺎﺒﺛ-ﯽﺑ, ﯽﺗﺎﺒﺛ-ﯽﺑ, ﯽﻌﻄﻗ-ﺮﯿﻏ, ﺏﺮﻄﻀﻣ
ﺎﺑﺭ-ﻦﻫﺁ: 
ﻥﺩﺯ-ﮏﻣ: ﻥﺪﺷ-ﺏﺬﺟ, ﻥﺩﺭﻮﺧ-ﺲﯿﺧ
ﻡﻼ﻿ﺳﺍ: 
ﻪﺠﻨﭘ-ﮎﻮﻧ: ﻪﺠﻨﭘ, ﻥﺩﻮﺑ-ﻩﺩﺎﻣﺁ, ﻞﯾﺎﻣ
ءﺎﺸﻏ: 
ﻥﺪﯿﺷﺍﺮﺗ: 
ﺭﺎﺘﯿﮔ: 
ﻕﺍﺮﺑ: ﻦﺷﻭﺭ, .ﺢﺒﺻ, ﻥﺎﺸﺧﺭﺩ
ﺰﻣﺮﻗ-ﻥﻭﺭﺎﻧ: 
ﻦﺘﻓﺮﮔ-ﺝﻭﺍ: ﯼﻭﺭ-ﻩﺩﺎﯿﭘ, ﺭﻭﺎﻨﺷ, ﻮﻠﮔ, ﺯﺍﻭﺮﭘ
ﺮﯿﻤﺿ-ﺮﮕﻧﺎﺸﻧ: 
ﯼﺰﯿﭼ-ﺮﻫ-ﯽﻠﺻﺍ ءﺰﺟ: ﭗﯿﻠﮐ, ﺏﻼ﻿ﻗ, ﯼﺭﻭﺮﺿ, ﯽﺳﺎﺳﺍ, ﯽﺳﺎﺳﺍ, ﯽﻠﺻﺍ, ﮒﺭﺰﺑ, ﯽﯾﺎﻬﻧ, ﯽﻠﺻﺍ
ﻪﯾﻭﺩﺍ: ﻩﺰﻣ
ﺖﻧﺎﻤﺿ: ﻪﺿﺮﻗ-ﻕﺍﺭﻭﺍ, ﻦﯿﻤﻀﺗ, ﻭﺮﮔ, ﺖﻧﺎﻤﺿ
ﻞﻣﺎﺣ: ﺭﺍﺩﺮﺑ, ﯽﮐﺎﺷ, ﺮﺑﺭﺎﺑ
ﺵﺎﻌﺗﺭﺍ: ﺪﯾﺪﺸﺗ
ﻦﺘﺧﺍﺪﻧﺍ-ﺖﺳﺩ-ﺍﺭ ﯽﺴﮐ: ﻥﺩﺮﮐ-ﺍﻮﻏﺍ, ﻥﺩﺮﮐ-ﮏﯾﺮﺤﺗ, ﮏﯾﺮﺤﺗ, ﻥﺩﺮﮐ-ﺏﻭﺬﺠﻣ
ﻥﺩﺯ-ﻢﺨﺷ: ﻥﺩﺮﻛ-ﻞﺣ, ﻥﺩﺯ-ﻞﯿﺑ-ﺞﮐ, ﻥﺩﻮﺑﺭ
ﯽﮑﯾﮊﻮﻟﻮﯾﺰﯿﻓ: ﯽﻧﺪﺑ
ﻥﺪﺷ-ﻩﺮﻄﻗ-ﻩﺮﻄﻗ: ﯽﺸﮐ-ﻩﺯ
ﺭﺍﺩ-ﻪﻟﺎﺒﻧﺩ-ﻩﺭﺎﺘﺳ: ﻒﻠﺨﺘﻣ
ﯽﻄﺳﻭ-ﻥﻭﺮﻗ: ﻪﻤﯿﻧ
ﮏﺸﺠﻨﮔ: 
ﻥﺩﺮﮐ-ﻥﺍﺮﺒﺟ: ﻥﺩﺍﺩ-ﻥﺍﻭﺎﺗ, ﻥﺍﺮﺒﺟ, ﻑﺍﺮﺤﻧﺍ, ﻥﺩﺭﻭﺍ-ﺭﺩ-ﻭﺮﮔ ﺯﺍ, ﺶﯾﺍﺭﺁ, ﺶﯾﺍﺭﺁ
ﮏﯿﺘﺳﻼ﻿ﭘ: 
ﯽﻗﺭﻭﺎﭘ: 
ﺭﺍﺪﻣ: ﺱﻼ﻿ﮐ, ﺱﺭﺩ-ﺱﻼ﻿ﮐ, ﺮﯿﺴﻣ
ﻪﻓﺮﺻ-ﺎﺑ: ﻦﺗﻭﺮﻓ
ﻒﻠﮔ: 
ﺮﻔﺻ: null-ﺭﺍﺪﻘﻣ
ﻪﺷﺍﺮﺗ: ﻪﻌﻄﻗ, ﻪﻌﻄﻗ, ﻪﮑﺗ, ﻪﮑﺗ
ﻥﺩﺮﮐ-ﻢﺘﺳ: ﻥﺩﺮﮐ-ﺏﻮﮐﺮﺳ, ﻥﺩﺮﮐ-ﺏﻮﮐﺮﺳ, ﻥﺩﺮﮐ-ﻩﺩﺮﺴﻓﺍ, ﻥﺩﺮﮐ-ﻝﺎﻤﯾﺎﭘ
ﻩﺯﺎﯿﻤﺧ: ﻥﺪﺷ-ﺭﺎﺨﺑ
ﯼﺮﺑﺍﺮﺑﺎﻧ: 
ﻝﺎﺧ: ﺪﺠﻨﮐ, ﺱﺭ-ﮎﺎﺧ
ﯼﺮﮕﻟﺎﻔﺳ: 
ﺭﺍﺩ-ﻪﻧﺎﺧ-ﻢﻧﺎﺧ: 
ﺭﺍﺩﻭﺎﭼ: 
ﯽﻧﺎﻣﺮﻓﺎﻧ: ﺾﻘﻧ
ﺭﺎﺑﺩﺮﺑ: ﻞﻤﺤﺗ
ﻦﯿﻨﺟ: ﮏﯿﺘﺳﻻ﻿, ﮏﯿﺘﺳﻻ﻿, ﯽﻨﯿﻨﺟ, ﻦﯿﻨﺟ, ﻪﺘﺴﻫ
ﺶﯿﺧ: ﯽﺋﺰﺟ
ﻥﺩﺯ-ﻒﮐ: ﯽﻧﺍﺩﺭﺪﻗ, ﺪﯿﺠﻤﺗ-ﻭ-ﻖﯾﻮﺸﺗ, ﻥﺩﺯ-ﻒﮐ
ﺮﻤﺨﻣ: ﻢﯾﺰﻧﺁ, ﺮﯿﻤﺧ
ﻪﻤﯿﺑ-ﻖﺣ: ﻩﺰﯾﺎﺟ, ﻩﺰﯾﺎﺟ, ﻩﺰﯾﺎﺟ
ﻮﻟﺁ: 
ﯽﮕﺘﺴﮑﺷﺭﻭ: ﺖﺴﮑﺷ
ﯼﺭﺎﯿﺑﺍ: 
ﻉﺎﻨﻌﻧ: ﺕﺎﺒﻧ
ﺭﺍﺩ-ﻪﯾﺎﻣﺮﺳ: ﯼﺭﺍﺩ-ﻪﯾﺎﻣﺮﺳ
ﯽﻋﺎﺠﺗﺭﺍ-ﺖﯿﻠﺑﺎﻗ: ﯼﺮﯾﺬﭘ-ﻑﺎﻄﻌﻧﺍ
ﯽﻫﺎﻣ-ﻪﺳﻮﮐ: 
ﻥﺩﺮﮐ-ﻡﺍﺪﺨﺘﺳﺍ-ﺯﻮﻣﺍ ﻮﻧ: ﻦﻓ-ﻭ-ﺕﻮﻓ, ﺭﺎﮐ-ﻩﺯﺎﺗ
ﯼﺯﺎﺳ-ﻩﺮﯿﺧﺫ: ﻆﻔﺣ, ﻭﺮﺴﻨﮐ, ﻩﺎﮕﺷﻭﺮﻓ, ﻥﺩﺮﮐ-ﯽﯾﻮﺟ-ﻪﻓﺮﺻ
ﯽﯾﺍﺮﮔ-ﻊﻗﺍﻭ: 
ﻞﯿﺒﺠﻧﺯ: 
ﺲﻧﻻ﻿ﻮﺒﻣﺍ: 
ﻪﺴﯾﺎﻘﻣ-ﻞﺑﺎﻗ: ﺖﺒﺴﻧ-ﻪﺑ, ﻢﻫ-ﻪﯿﺒﺷ
ﻝﻮﭘ-ﻒﯿﮐ: ﻡﺎﻘﻣ
ﻝﻮﺻﺍ-ﻭ-ﺍﺩﺍ: ﻥﺍﻮﯿﻟ, ﺪﻨﺧﺯﻮﭘ, ﻥﺩﺭﻮﺧ-ﻝﻮﻟ
ﺪﻨﻤﺸﻧﺍﺩ: ﯽﻤﻠﻋ, ﻩﻭﮋﭘ-ﺶﻧﺍﺩ, ﻩﻭﮋﭘ-ﺶﻧﺍﺩ, ﻖﻘﺤﻣ
ﻩﺩﻭﺭ-ﻭ-ﻝﺩ: ﻩﺩﻭﺭ, ﻩﺩﻭﺭ
ﺖﻧﺎﺘﻣ: 
ﻮﯾﺩﺍﺭ: ﻡﻮﯾﺩﺍﺭ
ﻂﺒﺗﺮﻣ-ﺮﯿﻏ: ﺾﻗﺎﻨﺘﻣ, ﺐﺳﺎﻨﻣ-ﺎﻧ, ﺲﻧﺎﺠﺘﻣﺎﻧ, ﺖﯿﻤﻫﺍ-ﯽﺑ
ﺕﺎﺑﻮﺒﺣ: ﻩﺮﻬﻣ, ﺩﻮﺨﻧ, ﻲﻨﻴﻣﺯ-ﻡﺍﺩﺎﺑ, ﺕﺎﺑﻮﺒﺣ
ﯽﻤﺳﺭ-ﺮﯿﻏ: 
ﻩﻮﻧ: ﻩﻮﻧ, ﻩﻮﻧ, ﻩﺩﺍﺯ-ﺮﻫﺍﻮﺧ, ﻞﺴﻧ
ﺮﻈﻧ-ﻑﻼ﻿ﺘﺧﺍ: ﺽﺍﺮﺘﻋﺍ, ﻩﺮﻇﺎﻨﻣ, ﻉﺍﺰﻧ, ﻥﺩﻮﺑ-ﻒﻟﺎﺨﻣ
ﮏﯿﺘﺳﺍ: ﻥﺩﺮﮐ-ﻪﮑﺗ
ﻥﮊﻭﺮﺘﯿﻧ: 
ﯽﺷﺍﺮﺗ-ﺕﺭﻮﺻ-ﻎﯿﺗ: 
ﺩﺎﻀﺘﻣ: ﺩﺎﻀﺗ, ﻪﻠﺑﺎﻘﻣ, ﺾﻗﺎﻨﺘﻣ, ﻒﻟﺎﺨﻣ, ﻒﻟﺎﺨﻣ
ﺕﺎﻐﯿﻠﺒﺗ: ﻡﻼ﻿ﻋﺍ, ﺕﺎﻐﯿﻠﺒﺗ, ﺕﺎﻐﯿﻠﺒﺗ, ﺕﺎﻐﯿﻠﺒﺗ, ﺕﺎﻐﯿﻠﺒﺗ
ﯼﺯﺎﺑ-ﺶﺗﺁ: 
ﭖﺎﭘ: ﯽﻧﺎﻬﮔﺎﻧ-ﻭ-ﻢﮑﺤﻣ ﻪﺑﺮﺿ, ﺭﺎﺠﻔﻧﺍ
ﻥﺩﺮﮐ-ﻥﺎﯾﺮﻋ: 
ﺭﺎﯿﺷ: 
ﺭﻭﺁ-ﻥﺎﯾﺯ: ﻪﻣﺪﺻ, ﮎﺎﻧﺮﻄﺧ, ﺮﻀﻣ
ﺖﯾﺩﻮﻬﯾ: 
ﻩﺪﻨﻨﮐ-ﻞﯿﻤﮑﺗ: ﻞﻤﮑﻣ, ﻥﺩﺮﮐ-ﺰﻬﺠﻣ, ﻪﻓﺎﺿﺍ
ﯽﺳﺪﻋ: ﺱﺪﻋ, ﻩﻮﻗ-ﻍﺍﺮﭼ
pegative-ﺩﺭﻮﻣ: 
ﻥﺎﻃﺮﺳ: 
ﻭﺮﮔ: ﻦﻫﺭ, ﺯﺎﺑﺮﺳ, ﻭﺮﮔ
ﺱﺭﺪﻣ: 
ﺖﺸﻧ: ﺖﺸﻧ, ﻥﺎﯾﺯ, ﻥﺩﺮﮐ-ﺎﻫﺭ
ﻥﺪﺷ-ﻂﯾﺍﺮﺷ-ﺪﺟﺍﻭ: ﻂﯾﺍﺮﺷ-ﺪﺟﺍﻭ, ﯽﮕﺘﺴﯾﺎﺷ, ﻦﺘﺷﺍﺩ-ﻕﺎﻘﺤﺘﺳﺍ, ﻂﯾﺍﺮﺷ-ﺪﺟﺍﻭ, ﺖﯿﺣﻼ﻿ﺻ
ﻢﮐﺍﺮﺗ: ﻍﻮﻠﺷ, ﺕﺪﺷ
ءﺎﻘﻟﺍ: 
ﻥﺪﯾﻮﺟ: 
ﻑﺮﺣ-ﺮﭘ: ﯽﻃﺎﺒﺗﺭﺍ
ﯽﯾﺎﯾﺭﺩ-ﮓﻨﭼﺮﺧ: 
ﻒﯿﻔﺨﺗ: ﺖﯿﻓﺎﻌﻣ, ﺵﻭﺮﻓ, ﺯﺎﯿﺘﻣﺍ
ﯽﺴﮐﺎﺗ: 
ﺐﺗﺍﺮﻣ-ﻪﻠﺴﻠﺳ: ﯼﺮﺒﻫﺭ, ﻢﺘﺴﯿﺳ
ﻢﺸﯾ: 
ﻥﺩﺮﮐ-ﻪﭼﻭﺮﻗ-ﻥﺍﺪﻧﺩ: 
ﮏﻟﻮﻣﺭﺎﻣ: 
ﺭﺎﺸﺑﺍ: 
ﻩﺪﻨﻨﮐ-ﺪﯿﻣﺍﺎﻧ: ﻩﺩﺮﺴﻓﺍ, ﯼﺪﯿﻣﺍ-ﺎﻧ, ﺪﯿﻣﺍ-ﺎﻧ, ﺪﯿﻣﺍﺎﻧ, ﻩﺪﻨﻧﺯ-ﻭ-ﺪﻨﺗ
ﺩﺭ: ﺩﺭ, ﺩﺭ, ﺩﺭ, ﺩﺭ, ﺩﺭ, ﻁﺮﺷ, ﺶﺸﮐ
ﺖﺳﺎﯾﺭ: ﯼﺭﻮﻬﻤﺟ-ﺖﺳﺎﯾﺭ
ﺭﺍﺪﯾﺮﺧ: ﯼﺮﺘﺸﻣ
ﻦﻟﺎﮔ: 
ﻪﺸﭘ: 
ﻑﺍﺮﺤﻧﺍ: ﻑﺍﺮﺤﻧﺍ, ﺝﺎﺟﻮﻋﺍ, ﻑﺍﺮﺤﻧﺍ
ﻦﺘﻓﺮﮔ-ﯽﺘﺸﮐ: ﺖﺑﺎﻗﺭ
ﮏﯿﯾﺍﺯﻮﻣ: 
ﻦﯿﮔﻼ﻿ﭘ: ﻝﺎﺼﺗﺍ, ﺪﻨﺳ
ﻥﺩﺯ-ﻪﻤﺗﺎﺒﻤﭼ: ﻥﺪﺷ-ﻻ﻿ﻭﺩ
ﺭﺎﺑﺭﺍﻮﺧ: 
ﺖﺴﯿﻧﻮﻤﮐ: 
ﻥﺩﺮﮐ-ﺕﺎﻣ: ﻩﺪﻨﻨﮐ-ﺮﯿﮕﻠﻓﺎﻏ, ﺭﻭﺁ-ﺖﻔﮕﺷ, ﻩﺪﻨﻨﮐ-ﻩﺮﯿﺧ, ﻥﺩﺮﮐ-ﻩﺍﺮﻤﮔ, ﻥﺩﺮﮐ-ﺞﯿﮔ, ﻥﺩﺮﮐ-ﺲﺣ-ﯽﺑ, ﻥﺩﺮﮐ-ﺕﺎﻣ
prosecutive-ﺩﺭﻮﻣ: 
ﯽﮑﻠﻓ-ﺕﺭﻮﺻ: ﻥﺎﺸﮑﻬﮐ
ﺭﻮﺗﺎﺘﮑﯾﺩ: 
ﯽﮕﺘﻔﯿﺷ: ﻡﺍﺪﺨﺘﺳﺍ, ﺏﺍﺮﻄﺿﺍ, ﻥﺩﻮﺑ-ﻥﺍﺮﮕﻧ, ﻪﻗﻼ﻿ﻋ
ﻩﺭﺍﻮﻫﺎﻣ: 
ﯽﺘﺣﺍﺭ-ﺶﻔﮐ: ﻝﺪﻨﺻ
ﻥﺍﻮﺨﻤﻫ: 
ﯽﺒﯾﺮﻘﺗ: ﺐﯾﺮﻘﺗ, ﺎﺒﯾﺮﻘﺗ, ﯽﺒﯾﺮﻘﺗ
ﺭﺎﮐ-ﯽﺑ: ﻡﺍﺪﺨﺘﺳﺍ
ﯽﻣﺎﺣ: ﺭﺎﯿﺘﺳﺩ, ﯽﮑﻤﮐ, ﻞﻤﺤﺗ, ﺏﻼ﻿ﻗ
ﺭﺪﺳ-ﺖﺧﺭﺩ: 
ﻮﻫﺎﮐ: ﺩﻻ﻿ﺎﺳ, ﺝﺎﻨﻔﺳﺍ
ﺪﯾﺮﻠﮐ: 
ﯼﺮﺘﮐﺎﺑ: ﭺﺭﺎﻗ, ﯼﺮﺘﮐﺎﺑ
ﻩﺪﻨﺒﺴﭼ: ﮎﺎﻨﺒﺴﭼ
ءﺰﺟ: 
ﻪﺘﺴﻫ: 
ﻥﺩﺮﮐ-ﻞﻌﺟ: ﺮﻫﺎﻈﺗ, ﯼﺯﺎﺳ-ﻪﯿﺒﺷ
ﺖﯾﺎﺑ: 
ﺢﺷﺮﺗ: ﻥﺩﺮﮐ-ﻥﺎﻬﻨﭘ
ﺎﺤﯾﺮﺻ: ﯽﻨﺷﻭﺭ-ﻪﺑ, ﻩﺩﺮﭘ-ﯽﺑ, ﺍﺮﻫﺎﻇ, ﺺﺨﺸﻣ-ﺭﻮﻃ-ﻪﺑ, ﺎﻌﻄﻗ
ﻥﺪﺷ-ﻑﺩﺎﺼﻣ: ﻦﺘﺷﺍﺩ-ﯽﻧﺍﻮﺨﻤﻫ, ﺐﺳﺎﻨﻣ, ﺐﺳﺎﻨﻣ, ﻖﻓﺍﻮﺗ, ﻖﺑﺎﻄﺗ
ﻪﻟﺎﺑ: ﻪﻟﺎﺑ
ﺭﺍﺭﺩﺍ: ﺵﺎﺷ
ﺮﯿﺳ: 
ﻩﺪﺷ-ﯼﺮﭙﺳ: ﻪﺘﺷﺬﮔ, ﺭﻮﺒﻋ
ﺩﺎﺼﺘﻗﺍ-ﻢﻠﻋ: ﺩﺎﺼﺘﻗﺍ, ﯼﺩﺎﺼﺘﻗﺍ-ﻥﺍﺮﺤﺑ, ﻥﺩﺮﮐ-ﯽﯾﻮﺟ-ﻪﻓﺮﺻ
ﻂﺳﻮﺘﻣ-ﻪﻘﺒﻃ: 
ﺯﺮﻓ: ﻊﯾﺮﺳ, ﻊﯾﺮﺳ, ﻊﯾﺮﺳ, ﮓﻧﺭﺩ-ﯽﺑ
ﮎﺮﺒﻧﺍ: ﻞﯿﺑ, ﭗﯿﻠﮐ
ﯽﯾﻮﺸﮑﺸﺧ: ﯽﯾﻮﺸﺳﺎﺒﻟ
ﯽﮕﻧﺮﻓ-ﺕﻮﺗ: 
ﯼﺮﻬﺷ: ﯽﻧﺪﻣ
ﺭﺎﺴﻣﺮﺷ: ﻥﺩﺮﮐ-ﺩﺮﺴﻟﺩ, ﺺﻘﻧ, ﺭﻭﺁ-ﻡﺮﺷ, ﻥﺩﺮﮐ-ﺕﺎﻣ, ﻥﺩﺮﮐ-ﺞﯿﮔ
ﮎﻮﺑ-ﺕﻮﻧ: 
ﻡﻮﺒﻟﺍ: 
ﻝﺎﺑ-ﺲﯿﺑ-ﯼﺯﺎﺑ: 
ﻥﺪﯿﺸﮐ-ﻮﺑ: 
ﻪﻓﻮﺑ: 
ﯽﻔﺻﻭ-ﻪﺟﻭ: ﻩﺪﻨﻨﮐ-ﺖﮐﺮﺷ, ﻩﺪﻧﻮﺷ-ﺩﺭﺍﻭ
ﮊﺍﺭﺎﮔ: 
ﺺﯿﺨﺸﺗ: ﯽﺼﯿﺨﺸﺗ, ﻥﺩﺍﺩ-ﺺﯿﺨﺸﺗ, ﯽﺘﺧﺎﻨﺷ, ﺺﯿﺨﺸﺗ
ﻞﻐﺑ-ﺮﯾﺯ-ﺏﻮﭼ: 
ﻥﺩﺮﮐ-ﯼﺫﺎﺧﺍ: ﺪﯾﺪﻬﺗ, ﺕﺍﺮﺟ-ﻭ-ﻝﺩ, ﺩﻭﺪﺤﻣ
ﺖﺒﺛ: ﺩﺭﻮﮐﺭ, ﻡﺎﻧ-ﺖﺒﺛ, ﻂﺒﺿ, ﻢﺘﺴﯿﺳ-ﻪﺑ-ﺩﻭﺭﻭ
ﻝﻮﻠﺤﻣ: ﻥﺩﺮﮐ-ﻞﺣ
ﺮﻔﺴﻓ: 
ﯼﺭﺎﺘﺧﺎﺳ: ﺭﺎﺘﺧﺎﺳ, ﯼﺪﻨﺑ-ﺮﮑﯿﭘ, ﯼﺪﻨﺑﺮﮑﯿﭘ
ﺐﺴﭼ: 
ﻪﻣﺎﻧ-ﻥﺎﯾﺎﭘ: ﻪﻣﺎﻧ-ﻥﺎﯾﺎﭘ
ﺮﮔ-ﺖﻌﻨﺻ: ﮏﯿﻧﺎﮑﻣ
ﺯﻮﻣ: 
ﻞﺻﺍ: ﻪﯿﻀﻗ, ﺢﯾﺮﺻ, ﺮﻫﺎﻇ, ﺢﺿﺍﻭ, ﺢﯾﺮﺻ, ﻞﺻﺍ
ﻩﺪﻧﺩ: ﻩﺪﻧﺩ
ﻞﮑﯿﻧ: ﭻﯿﻫ
PI: ﻆﻓﺎﺣ-ﺍﺪﺧ, ﯼﺎﭘ, ﻥﻮﮑﯿﻠﯿﺳ
ﺱﻮﺑﻮﺗﺍ: ﺪﯿﻫﺩ-ﻩﺯﺎﺟﺍ
ﯽﭼﺭﻮﺴﻧﺎﺳ: ﺭﻮﺴﻧﺎﺳ
ﮏﺷﻮﻣ: ﮏﺷﻮﻣ
ﺲﯿﺳﻮﺳ: ﮒﺍﺩ-ﺕﺎﻫ
ﯼﺭﺎﮐ-ﺖﺳﺩ: ﻞﻤﻋ, ﻥﺩﺮﮐ-ﯼﺭﺎﮑﺘﺳﺩ, ﯽﺗﺎﯿﻠﻤﻋ, ﻦﻓ-ﻭ-ﺕﻮﻓ, ﻥﺩﺍﺩ-ﺐﯾﺮﻓ, ﯽﮔﺪﯿﺳﺭ
ﻲﮕﻧﺮﻓ-ﻪﺟﻮﮔ: 
ﺖﯾﻮﻘﺗ: ﻥﺩﺮﮐ-ﯽﮑﯾ, ﺪﯾﺪﺸﺗ, ﻥﺩﺮﻛ-ﺪﻴﻳﺎﺗ
ﺰﯾﺮﭘ: ﺏﺎﺴﺣ-ﺯﺍ-ﺖﺷﺍﺩﺮﺑ, ﺰﯾﺮﭘ, ﻝﺎﺼﺗﺍ, ﻪﻧﻻ﻿
ﻢﯿﺳﺎﺘﭘ: 
ﯽﺑﺎﯾﺯﺎﺑ: ﯽﺸﮐﺍﻭ, ﻦﺘﻓﺎﯾ-ﺩﻮﺒﻬﺑ, ﻥﺪﻧﺍﺩﺮﮔﺯﺎﺑ, ﻢﯿﻣﺮﺗ
ﯼﺯﺎﺠﻣ: ﯽﻌﻗﺍﻭ, ﯽﻌﻗﺍﻭ, ﯽﻌﻗﺍﻭ
ﺮﺒﺟ: 
ﮏﺷﺰﭙﻧﺍﺪﻧﺩ: ﻥﺍﺪﻧﺩ
ﯼﺮﺼﺑ: ﯼﺮﺼﺑ
ﻥﺩﺍﺩ-ﻥﺎﮑﺗ: ﺯﺎﯿﺘﻣﺍ, ﯽﻘﯾﺪﺼﺗ, ﺖﮐﺮﺣ, ﯽﺸﮐ-ﺙﺎﺛﺍ, ﻥﺩﺮﮐ-ﺎﺠﺑﺎﺟ
ﯽﺳﺎﻨﺷ-ﺖﺴﯾﺯ: 
ﯼﺭﺎﮑﯿﺑ: 
ﻡﺎﺷﺍ-ﻥﻮﺧ: 
ﮏﺗ: ﻪﻧﺎﮔﺍﺪﺟ, ﻩﺩﺎﻌﻟﺍ-ﻕﻮﻓ, ﻪﺘﺴﺴﮔ, ﮎﺎﺧ, ﺲﮐ-ﯽﺑ
ﺮﮔﺭﻭﺮﻣ: 
ﺭﻭﺩ-ﻩﺍﺭ-ﺯﺍ ﻪﺘﺷﺬﮔ ﺖﻔﺳ: 
ﯽﺨﯾﺭﺎﺗ-ﺖﻔﺳ: 
ﯽﻤﺗﺍ: ﻪﺘﺴﻫ, ﯽﻤﺗﺍ
ﻒﯿﻃ: 
ﻢﯾﺪﺳ: 
ﯼﺮﺘﺴﯿﻫ: 
ﯽﻟﻮﺘﻣ: ﺮﯾﺪﻣ
ﻥﺎﮔﻭﺮﮔ: ﻦﻫﺭ, ﻭﺮﮔ
ﻭﺪﮐ: ﻲﻳﺍﻮﻠﺣ-ﻭﺪﻛ, ﺰﻐﻣ
ﮎﻭﺮﭼ-ﻭ-ﻦﯿﭼ: ﺺﻘﻧ
ﺖﯿﻓﺎﻔﺷ: ﻑﺎﻔﺷ, ﺢﯾﺮﺻ, ﺖﺳﺍﺭ-ﺮﺳ
ﺦﯿﻣ: ﻩﻮﮔ, ﯼﺭﻮﺗ, ﻡﺎﻌﻧﺍ, ﻦﺧﺎﻧ
ﺖﯾﻮﻟﻭﺍ: ﻪﺟﻮﺗ
ﻩﺩﺎﯿﭘ-ﺮﺑﺎﻋ: ﯼﻭﺭ-ﻩﺩﺎﯿﭘ
ﺩﺎﺤﻟﺍ: 
ﺭﻮﺘﯿﻧﺎﻣ: ﺮﯿﺴﻣ, ﻥﺩﺮﮐ-ﺕﺭﺎﻈﻧ, ﻥﺩﺮﮐ-ﺎﺷﺎﻤﺗ, ﻥﺩﺮﮐ-ﻝﺎﺒﻧﺩ
ﯽﺗﺎﺑﺎﺨﺘﻧﺍ-ﻩﺯﻮﺣ: ﻩﺪﻨﻫﺩ-ﯼﺍﺭ, ﻪﯿﺑﺎﺨﺘﻧﺍ-ﻩﺯﻮﺣ
ﻩﺪﺸﻧ-ﻝﺮﺘﻨﮐ: 
ﺮﮕﺷﻭﺎﮐ: ﻪﻨﯾﺎﻌﻣ, ﻮﺟ-ﻭ-ﺱﺮﭘ, ﯽﺳﺭﺮﺑ-ﻭ-ﻖﯿﻘﺤﺗ, ﯽﺳﺭﺮﺑ, ﻮﺟ-ﻭ-ﺱﺮﭘ, ﻑﺎﺸﺘﮐﺍ, ﺶﯾﺎﻣﺯﺁ
ﻦﯿﺗﻼ﻿ﭘ: 
ﯽﯾﺎﺗﻭﺩ-ﺩﺪﻋ: 
ﻪﯾﺭ: 
ﻩﺩﺎﻌﻟﺍ-ﻕﻮﻓ: ﻩﺩﺎﻌﻟﺍ-ﻕﻮﻓ, ﻩﺩﺎﻌﻟﺍ-ﻕﻮﻓ, ﻩﺩﺎﻌﻟﺍ-ﻕﻮﻓ
ﯽﻗﺮﺑ-ﻦﮔﺍﻭ: ﻪﮑﺴﻟﺎﮐ, ﯼﺭﺎﮔ, ﻦﮔﺍﻭ
ﯽﻠﺤﻣ-ﺕﺭﻮﺻ-ﻪﺑ: ﯽﻠﺤﻣ
ﻥﺩﺮﮐ-ﮏﯾﺮﺤﺗ: ﻥﺩﺮﮐ-ﮏﯾﺮﺤﺗ, ﻥﺩﺮﮐ-ﮏﯾﺮﺤﺗ
ﻞﯿﺋﻭﺯﺎﮔ: ﻦﯾﺰﻨﺑ
ﻪﯿﻠﮐ: 
ﺕﺭﺎﻏ: ﺖﻗﺮﺳ, ﺕﺭﺎﻏ, ﺭﺎﮑﺷ, ﻥﺩﺮﺑ-ﻦﯿﺑ-ﺯﺍ, ﺕﺭﺎﻏ, ﻞﻘﻧ-ﻭ-ﻞﻤﺣ
ﯽﺑﺎﯾﺯﺭﺍ: ﻥﺩﺯ-ﻦﯿﻤﺨﺗ, ﻥﺩﺮﮐ-ﺩﺭﻭﺁﺮﺑ, ﯽﺑﺎﯾﺯﺭﺍ, ﻪﺟﺭﺩ
ﮏﯿﻨﺳﺭﺁ: 
ﻥﻭﺰﻠﺣ: ﭻﯿﭘﺭﺎﻣ
ﺦﻠﻣ: 
ﻪﻟﺩﺎﻌﻣ: ﻝﻮﻣﺮﻓ, ﯼﺮﺑﺍﺮﺑ
ﺖﺴﯿﻟﺎﯿﺳﻮﺳ: ﯼﺪﻧﻭﺎﺸﯾﻮﺧ
ﯽﻓﺎﺻ: 
ﯽﺴﺣ-ﯽﮐﺭﺪﻣ-ﺖﻟﺎﺣ: 
ﻥﺩﺮﮐ-ﻦﻬﭘ: ﻥﺩﺍﺩ-ﻪﻌﺳﻮﺗ, ﻊﯿﺳﻭ, ﻥﺩﺮﮐ-ﻪﻓﺎﺿﺍ, ﻥﺩﺮﺑ-ﻻ﻿ﺎﺑ, ﻥﺩﺮﺑ-ﻻ﻿ﺎﺑ, ﻥﺩﺮﻛ-ﺪﻳﺪﻤﺗ, ﻩﺩﺮﺘﺴﮔ-ﺭﻮﻃ-ﻪﺑ, ﺡﻮﺿﻭ, ﺵﺮﺘﺴﮔ, ﻪﻌﺳﻮﺗ
ﻦﺘﺨﯾﺭ-ﻥﻭﺮﯿﺑ: ﯼﺯﺍﺪﻧﺍ-ﻩﺍﺭ, ﻥﺩﺮﻛ-ﺕﺮﭘ, ﻥﺩﺍﺩ-ﻥﻭﺮﯿﺑ, ﻦﺘﺨﯾﺭ-ﻥﻭﺮﯿﺑ, ﺪﯿﻫﺩ-ﻩﺯﺎﺟﺍ
ﯽﯾﺎﺗ-ﻪﺳ-ﻪﺘﺳﺩ: ﻩﺭﺎﺟﺍ, ﻪﻤﺴﺗ
ﻪﺒﺗﺮﯿﻟﺎﻋ-ﻦﯾﺭﻮﻣﺎﻣ: 
ﻥﺪﺷ-ﯽﻧﺍﻭﺩ-ﺐﺳﺍ ﺭﺎﮐﺭﺍﻮﺳ: 
ﻪﯾﺮﻟﺍ-ﺕﺍﺫ: 
ﯽﮕﺘﺴﺒﻤﻫ: ﻥﺩﺮﮐ-ﺪﺤﺘﻣ, ﻊﻤﺠﺗ, ﯽﮕﺘﺴﺑﺍﻭ, ﺕﺪﺣﻭ, ﻪﺑﺎﺸﺗ
ﻻ﻿ﻮﻟ: ﻖﯿﻗﺩ, ﻪﻘﻠﺣ
ﯽﻟﻮﻃ: ﯼﺩﻮﻤﻋ
ﻡﺎﻬﺳ-ﺩﻮﺳ: ﺺﯿﺼﺨﺗ
ﻥﺩﺮﮐ-ﯼﺯﺎﺑ-ﺖﯿﮑﺳﺍ: ﯽﮑﺳﺍ
ﻥﺍﻮﺗ: ﺺﺧﺎﺷ, ﯽﯾﺎﻤﻧ
ﯽﻧﺍﻮﺗﺎﻧ: ﺺﻘﻧ, ﺰﺠﻋ, ﺺﻘﻧ, ﺺﻗﺎﻧ, ﻝﺎﻌﻓ-ﺮﯿﻏ, ﺐﯿﻋ, ﻥﺩﺮﮐ-ﺭﺍﺩ-ﻪﮑﻟ
ﺱﺍﻮﺳﻭ: ﻥﺩﺮﮐ-ﺖﯾﺫﺍ
ﺺﯿﺼﺨﺗ: ﺺﯿﺼﺨﺗ, ﻥﺩﺍﺩ-ﺹﺎﺼﺘﺧﺍ, ﮎﺭﺍﺪﺗ, ﻪﯿﻤﻬﺳ, ﯼﺭﺍﺬﮔﺍﻭ
ﺱﺎﮑﻋ: ﯽﺴﮑﻋ
ﺎﺘﻟﺩ: ﻥﺩﺮﮐ-ﺖﮐﺮﺷ
ﻝﺎﺘﯿﺠﯾﺩ: ﻞﮑﺷ, ﺩﺪﻋ, ﯼﺩﺪﻋ
ﻩﺩﺎﻣ-ﮓﺳ: 
ﮏﻠﭘ: 
ﺏﺭﻮﻣ: 
ﺭﺎﯿﺸﻫ-ﻪﻤﯿﻧ: 
ﻭﺮﺑﺍ-ﻂﺧ: 
ﻪﺴﻄﻋ: 
ﺭﺍﺩ-ﻩﺪﻨﺧ: ﺵﻮﺧ, ﯽﻣﺮﮔﺮﺳ, ﻝﺎﺤﺷﻮﺧ, ﺭﺍﺩ-ﻩﺪﻨﺧ, ﻩﺪﻨﻨﮐ-ﻡﺮﮔﺮﺳ, ﻩﺪﻨﻨﮐ-ﻡﺮﮔﺮﺳ, ﻝﺎﺤﺷﻮﺧ, ﯽﻫﺎﮑﻓ, ﮏﺤﻀﻣ
ﻭﺪﻨﻫ-ﻦﯿﯾﺁ: 
ﺮﺟﺎﻬﻣ: ﺮﺟﺎﻬﻣ
ﻞﺗﺎﺷ: ﯽﯾﺎﻀﻓ-ﻪﻨﯿﻔﺳ, ﻪﮑﺴﻟﺎﮐ, ﻞﻘﻧ-ﻭ-ﻞﻤﺣ, ﻞﻘﻧ-ﻭ-ﻞﻤﺣ
ﻦﻴﺌﺗﻭﺮﭘ: ﻍﺮﻣ-ﻢﺨﺗ-ﻩﺪﯿﻔﺳ
ﻪﻟﺎﺑﺯ: ﻩﺩﻮﺗ, ﻪﺘﺸﭘ, ﻥﺩﺮﮐ-ﺩﺮﻃ, ﻪﻟﺎﺑﺯ, ﻪﻟﺎﺑﺯ
ﻥﺩﻮﻟﺎﭘ: 
ﻥﺩﺮﮐ-ﻍﺍﺮﻔﺘﺳﺍ: 
ﻥﮊ: ﯽﮑﯿﺘﻧﮊ, ﮏﯿﺘﻧﮊ
ﻩﺪﮑﺸﻧﺍﺩ-ﻝﻭﺍ-ﻝﺎﺳ ﯼﻮﺠﺸﻧﺍﺩ: 
ﯽﺳﺎﻨﺷ-ﻪﻌﻣﺎﺟ: 
ﺵﺍﻮﮑﺳﺍ: ﻲﻳﺍﻮﻠﺣ-ﻭﺪﻛ, ﻥﺪﺷ-ﻪﻟ
ﺮﺸﯿﻓ: 
ﯼﺍ-ﻪﻘﻄﻨﻣ: ﻥﺎﺘﺳﺮﻬﺷ, ﻪﻘﻄﻨﻣ, ﻪﻘﻄﻨﻣ, ﺶﺨﺑ, ﻩﺮﮐ, ﺶﺨﺑ, ﯽﻧﻮﻣﺍﺮﯿﭘ
ﺖﮐﺮﺣ-ﺭﺍﻮﺷﺩ: 
ﺮﮕﻧ-ﻪﺘﺷﺬﮔ: ﻪﺘﺷﺬﮔ, ﯽﯾﺍﺮﮔ-ﻥﻭﺭﺩ
ﺩﺎﺑﺩﺮﮔ: 
ﯽﮕﻧﻭﺭﺍﻭ: ﻥﺩﺮﮐ-ﺱﻮﮑﻌﻣ, ﻒﻟﺎﺨﻣ, ﻞﺑﺎﻘﺘﻣ, ﺱﻮﮑﻌﻣ
ﻥﻮﯾﺰﯾﻮﻠﺗ: ﻥﻮﯾﺰﯾﻮﻠﺗ, ﻢﻠﯿﻓ
ﺐﻌﮑﻣ: 
ﯼﺭﻭ-ﻩﺮﻬﺑ: ﺩﺮﮑﻠﻤﻋ, ﺪﯿﻟﻮﺗ
ﺞﯾﻮﻫ: 
ﯽﻟﻮﮑﻟﻮﻣ: ﻝﻮﮑﻟﻮﻣ, ﻪﯾﻻ﻿
ﻁﻼ﻿ﺘﺧﺍ: ﻪﺘﺳﺩ, ﻩﻭﺮﮔ, ﻪﺷﻮﺧ
ﺐﺳﺎﺤﻣ: ﺰﯿﻤﻣ
ﺭﺎﯿﺧ: ﻪﻨﯾﺰﮔ, ﻮﻠﮔ
ﯽﺷﺎﯿﻋ: 
ﻝﻼ﻿ﺣ: ﻥﺩﺮﮐ-ﻞﺣ
ﺕﺎﻔﺴﻓ: 
ﺮﮔﺯﺎﻏﺁ: ﻪﻤﻌﻃ, ﯽﯾﺎﻨﺷﺁ, ﯽﻓﺮﻌﻣ
ﯽﯾﺎﯿﻠﻗ: 
ﮏﯿﺘﺳﺎﻨﻤﯾﮊ: ﻡﺍﺪﻧﺍ-ﺐﺳﺎﻨﺗ
ﻝﻮﮔﺮﯾﻭ: ءﺎﻤﻏﺍ, ﺏﺰﺣ
ﺖﮐﺮﺣ-ﯽﺒﯿﺷﺍﺮﺳ: 
ﻦﯿﻨﺟ-ﻂﻘﺳ: ﻦﯿﻨﺟ-ﻂﻘﺳ, ﻢﮐ, ﺖﺴﮑﺷ
ﻑﻼ﻿ﻏ: ﻪﺘﺳﻮﭘ, ﻑﻼ﻿ﻏ, ﻥﺪﻨﮐ-ﺖﺳﻮﭘ
ﻩﺪﻨﻫﺩ: 
ﺰﻨﮕﻨﻣ: 
ﺱﺎﻨﺸﻧﺍﻭﺭ: 
ﻦﯾﺮﻠﮐ: 
ﺪﯿﻠﮐ-ﻪﺤﻔﺻ: 
ﻪﺒﺨﻧ: 
ﺰﺘﻧﺍﺮﭘ: 
ﯽﺒﮔﺭ: 
ﻢﺧﺯ: ﻢﺧﺯ, ﻢﺧﺯ, ﻢﺧﺯ, ﺵﻮﺟ
ﻑﺮﺻ: 
ﻥﺩﺭﻮﺧ-ﮎﺪﻧﺍ-ﮎﺪﻧﺍ: 
ﯽﻣﻮﺘﻧﺍﻮﮐ: ﻥﺍﺰﯿﻣ, ﺭﺍﺪﻘﻣ, ﻪﯿﻤﻬﺳ, ﺖﺒﺴﻧ
ﺖﮐﺍﮊ: ﺖﮐﺍﮊ
ﯽﻠﻣﺎﮑﺗ: ﻪﻌﺳﻮﺗ, ﯽﻠﻣﺎﮑﺗ-ﺮﯿﺳ
ﯼﺭﺍﺬﮔ-ﻥﺎﺸﻧ: ﻥﺩﺮﮐ-ﺎﻀﻣﺍ, ﻞﺒﻤﺳ, ﺪﯿﺷﺎﺑ-ﻪﺘﺷﺍﺩ-ﻪﺟﻮﺗ
ﯽﯾﻮﮔ-ﻑﺍﺰﮔ: ﺵﺮﻏ, ﺵﺮﭘ
ﯽﻓﺎﮑﺷ-ﺪﺒﻟﺎﮐ: ﻥﺩﺍﺩ-ﺹﺎﺼﺘﺧﺍ, ﺶﺨﺑ
ﻩﺎﮕﻧﺎﻬﻧ: 
ﯽﻄﺧ: ﺖﺳﺍﺭ-ﺮﺳ
ﻪﻣﺮﺳ-ﮓﻨﺳ: 
superessive-ﺩﺭﻮﻣ: 
ﺭﻮﻣﻮﺗ: ﺭﻮﻣﻮﺗ, ﻢﺠﺣ, ﻩﺩﺎﺟ-ﺯﺍﺪﻧﺍ-ﺖﺳﺩ
ﺶﯾﺎﺳﺮﻓ: 
ﺎﻔﻟﺁ: 
ﻑﺎﻧ: ﻢﮑﺷ, ﺐﻄﻗ
ﻥﻮﺼﻣ: ﺲﻔﻨﺗ, ﻡﻭﺎﻘﻣ
ﺍﺰﻧﺍﻮﻠﻔﻧﺍ: ﺍﺰﻧﻻ﻿ﻮﻔﻧﺁ, ﻩﺪﻧﻭﺩ, ﺐﺗ, ﺮﯿﺛﺎﺗ
ﯼﺯﺎﺳﻮﺠﺑﺍ: 
ﻥﺩﺮﮐ-ﻩﺩﺎﺳ: 
ﻥﺩﺮﮐ-ﻩﺎﺗﻮﮐ: ﺪﺣ, ﻥﺩﺮﮐ-ﺩﻭﺪﺤﻣ, ﻥﺩﺮﮐ-ﺩﻭﺪﺤﻣ
ﻪﻧﺍﺪﻧﺩ: ﻩﺩﻮﺗ, ﻩﺩﺎﺟ-ﺯﺍﺪﻧﺍ-ﺖﺳﺩ, ﻥﺍﺪﻧﺩ
ﻥﺩﺮﮐ-ﺮﯿﺳﺍ: ﻦﺘﻓﺮﮔ, ﻥﺩﺮﮐ-ﺏﻭﺬﺠﻣ
ﻥﺩﺮﮐ-ﺮﯾﺰﮔﺎﻧ: ﺩﻭﺪﺤﻣ, ﻥﺩﺮﻛ-ﺭﻮﺒﺠﻣ, ﯼﺍﺮﺟﺍ, ءﺍﺮﺟﺍ
ﺏﺍﺭﻮﺟ: 
ﺎﻤﻨﯿﺳ-ﻢﻠﯿﻓ: ﻢﻠﯿﻓ, ﺎﻤﻨﯿﺳ, ﻥﺎﺑﻭﺭ, ﺭﺍﻮﻧ, ﻩﺍﺭ-ﻩﺍﺭ-ﻪﭼﺭﺎﭘ
ﻥﺎﻬﯿﮐ: ﻥﺎﻬﺟ
ﻩﺩﻮﻟﺁ: ﯽﮔﺩﻮﻟﺍ, ﻩﺩﻮﻟﺁ
ﻪﺷﻮﺧ-ﻪﺷﻮﺧ: 
ﺩﺮﻣ-ﯽﻠﺳﺎﻨﺗ-ﺖﻟﺁ: ﯽﺴﻨﺟ-ﻁﺎﺒﺗﺭﺍ
ﯼﺭﺍﺪﻠﮕﻨﺟ: 
ﻡﻮﯿﻨﯿﻣﻮﻟﺁ: ﻡﻮﯿﻨﯿﻣﻮﻟﺁ
ﻥﺎﺳﻮﻧ: ﻥﺎﺳﻮﻧ
ﻪﭽﯾﺍﺯ: 
ﻦﺘﺧﺍﺪﻧﺍ-ﻥﻭﺮﯿﺑ: ﺖﺟ, ﻦﺘﺧﺍﺪﻧﺍ-ﻥﻭﺮﯿﺑ, ﻥﺩﺮﮐ-ﺭﺎﻨﮐ-ﺮﺑ, ﻥﺩﺮﮐ-ﺝﺍﺮﺧﺍ, ﻥﺩﺮﮐ-ﻥﺎﻬﻨﭘ, ﻥﺩﺮﮐ-ﺎﺠﺑﺎﺟ, ﻥﺩﺮﮐ-ﻖﯾﺮﻔﺗ
ﻝﻮﻤﺷ: ﻂﺒﺿ, ﻡﺎﻏﺩﺍ, ﻥﺩﺍﺩﺭﺍﺮﻗ, ﺶﺷﻮﭘ, ﻞﻣﺎﺷ, ﺶﺷﻮﭘ, ﻡﻮﻬﻔﻣ, ﻞﻣﺎﺷ, ﯼﺮﯿﮔﺭﺩ
ﻊﻔﻨﯾﺫ: ﺖﻗﻭ, ﻩﺪﻨﻨﮐ-ﻩﺩﺎﻔﺘﺳﺍ
ﯽﯾﺎﯾﺭﺩ-ﺯﺍﺮﮔ: 
ﻞﺗﺎﻗ: 
ﺭﺍﺪﻧﺎﺘﺴﭘ: 
ﺺﺧﺎﺷ: ﺖﻟﺎﺣ, ﺺﺧﺎﺷ, ﺺﺧﺎﺷ, ﺖﺸﮕﻧﺍ-ﺺﺧﺎﺷ, ﻩﺯﺍﺪﻧﺍ
ﺪﯿﺴﮐﺍ-ﯼﺩ: 
ﮒﺭﺰﺑ-ﻩﺩﻭﺭ: 
ﯼﺭﻻ﻿ﺎﺳ-ﻥﺍﻮﯾﺩ: ﮏﯿﺗﺍﺮﮐﻭﺭﻮﺑ
ﻒﯾﺮﺤﺗ: ﻥﺩﺮﮐ-ﻩﺍﺮﻤﮔ, ﺵﻼ﻿ﺗ, ﺝﺎﺟﻮﻋﺍ
ﻝﺎﭽﺨﯾ: ﻪﻧﺎﺧﺩﺮﺳ
ﯽﺳﺎﻨﺷ-ﻥﺎﺘﺳﺎﺑ: ﯽﺳﺎﻨﺷ-ﻥﺎﺘﺳﺎﺑ, ﯽﺳﺎﻨﺷ-ﻥﺎﺘﺳﺎﺑ, ﻞﯿﺴﻓ
ﻝﻮﺒﻗ-ﻞﺑﺎﻗ-ﺮﯿﻏ: ﻥﺎﺷﺩﻮﻨﺸﺧﺎﻧ
ﺕﺎﺼﺨﺸﻣ: ﺭﺎﺠﻨﻫ, ﺩﺭﺍﺪﻧﺎﺘﺳﺍ
ﻩﻭﺰﺟ: ﻪﻣﺎﻨﺸﻫﻭﮋﭘ, ﻩﻭﺰﺟ, ﻕﺭﻭ
ﯽﺳﺎﻨﺷ-ﻡﺩﺮﻣ: 
ﻢﻌﻃ-ﺵﻮﺧ: ﺬﯾﺬﻟ---ﻩﺰﻤﺷﻮﺧ
ﯼﺪﻌﺘﻣ: ﻪﻧﺎﻬﺑ, ﻝﺎﻘﺘﻧﺍ
ﻥﺪﺷ-ﻻ﻿ﻭﺩ-ﺱﺮﺗ ﺯﺍ: ﻥﺪﯾﺰﺧ
ﻥﺍﺩﺮﮕﺑﺎﺘﻓﺁ: 
ﺶﭙﺷ: ﮏﯿﺗ, ﻩﺭﺫ
ﻥﻮﯾ: 
ﯼﺩﺮﮕﻧﺎﻬﺟ: ﺖﺴﯾﺭﻮﺗ, ﻦﺘﻓﺭ-ﺮﻔﺳ
ﻡﺩﻮﻣ: 
ﺏﺎﺘﺷ: ﺞﯾﻭﺮﺗ, ﻥﺩﺮﮐ-ﻞﯿﻬﺴﺗ, ﮏﯾﺮﺤﺗ
ﺭﺩ-ﻥﺩﺮﺑ-ﺖﺳﺩ: ﻥﺩﺮﮐ-ﺕﺎﻣ, ﻞﻌﺟ
ﺮﺸﻧ: ﻒﯿﺜﮐ, ﻪﻟﺎﺴﻣ
ﯽﯾﺎﺑﺭ-ﻡﺩﺁ: ﻥﺩﻮﺑﺭ, ﻝﺎﻘﺘﻧﺍ, ﻥﺩﻮﺑﺭ
ﻭ-ﻒﮐ: ﻞﺑﺎﻘﺘﻣ-ﺮﺛﺍ, ﯽﻠﻣﺎﻌﺗ
ﻥﺎﻤﻠﺳ: 
ﻪﻣﺎﻋ-ﮓﻨﻫﺮﻓ: ﻡﺪﻨﮔ-ﻪﺷﻮﺧ
ﮒﺮﯾﻮﻣ: 
ﻡﺰﯿﻟﺎﻧﻮﯿﺳﺎﻧ: ﺖﯿﻠﻣ
ﻦﯾﺮﺳ: ﻥﺍﺭ-ﻞﺼﻔﻣ, ﻞﻔﮐ
ﻒﯿﺗﻮﻣ: ﻉﻮﺿﻮﻣ, ﻉﻮﺿﻮﻣ, ﻩﺰﯿﮕﻧﺍ, ﻪﻨﯿﻣﺯ
ﻥﺩﺮﮐ-ﻪﯿﻔﺼﺗ: 
ﯼﺪﯿﻣﺍ-ﺎﻧ: ﺖﺴﮑﺷ, ﺱﺎﯾ, ﯼﺪﯿﻣﺍ-ﺎﻧ, ﻢﮔﺭﺩﺮﺳ, ﻥﺩﺮﮐ-ﻮﻐﻟ
ﺖﻟﺎﺒﮐ: 
ﺮﺳ-ﻭﺩ-ﻮﺟ: 
ﺖﮐﺮﺣ-ﻪﻧﺎﺧﺩﻭﺭ-ﯼﻻ﻿ﺎﺑ: 
ﺪﻌﻘﻣ: 
ﯼﻭﺎﮔ: 
ﺮﮕﻨﻠﺗ: ﻥﺩﺮﮐ-ﻪﻤﺟﺮﺗ, ﻥﺩﺮﮐ-ﻪﻤﺟﺮﺗ
ﯽﮕﻧﻭﺰﻓﺍ: ﻥﺍﻭﺍﺮﻓ, ﻩﺪﻧﺎﻣ-ﯽﻗﺎﺑ, ﺩﺍﺯﺎﻣ, ﺩﺭ, ﺝﺍﺮﺧﺍ, ﺖﯿﻓﺎﻌﻣ
ﯼﺮﯾﻮﺼﺗ: 
ﻢﯾﺮﺤﺗ: ﻥﺎﺘﺳﺮﻬﺷ, ﺩﺮﻃ, ﯽﻬﺟﻮﺗ-ﯽﺑ
ﻥﺎﺤﺘﻣﺍ: ﺶﺷﻮﮐ, ﻥﺎﺤﺘﻣﺍ, ﻪﻣﺎﻨﺸﺳﺮﭘ
ﯽﮐﺎﻫ: 
ﻥﺍﺰﯿﺗﺭﺎﭘ: 
ﻢﯾﺰﯿﻨﻣ: 
ﺭﺍﺩﺍﺭ: 
ﻩﺰﻧﺎﭙﻤﺷ: 
ﻥﺎﻨﯿﻤﻃﺍ-ﺖﯿﻠﺑﺎﻗ: ﺭﺎﺒﺘﻋﺍ
ﻞﯿﻄﺘﺴﻣ-ﻊﺑﺮﻣ: 
ﯽﯾﺎﯾﺭﺩ-ﻪﻨﺷﺍ: 
ﻥﺩﺍﺩ-ﻢﯿﻤﻌﺗ: ﻢﯿﻤﻌﺗ
ﺐﺷ-ﻦﯿﻌﻣ-ﺖﻋﺎﺳ ﺭﺩ ﯽﺷﻮﻣﺎﺧﻭ ﯽﻣﺎﻈﻧ ﺖﻣﻮﮑﺣ ﺕﺍﺭﺮﻘﻣ: 
ﺯﺎﺑ-ﺲﻨﺠﻤﻫ: 
ﻮﯾﺭﺎﻨﺳ: ﻂﺧ, ﺯﺍﺪﻧﺍ-ﻢﺸﭼ
ﯼﺪﻨﺑ-ﻝﻮﻣﺮﻓ: ﻦﺘﺧﺎﺳ, ﺭﺎﺘﺧﺎﺳ, ﻩﺪﻧﺯﺎﺳ, ﯼﺪﻨﺑ-ﻪﻠﻤﺟ, ﺩﺎﺠﯾﺍ, ﻞﯿﮑﺸﺗ, ﻪﻟﻮﻣﺮﻓ-ﻭ-ﻦﯾﻭﺪﺗ
ﻩﺯﺎﺗ-ﻢﺴﺟ-ﺭﺩ ﺦﺳﺎﻨﺗ: 
ﻥﺩﺮﮐ-ﻦﺷﻭﺭ: 
ﻡﻮﯿﻧﺍﺭﻭﺍ: 
ﻩﺪﻧﺮﯿﮔ: ﻩﺪﻧﺮﯿﮔ
ﻥﺩﺮﻛ-ﮓﻨﻫﺎﻤﻫ: ﯽﮕﻨﻫﺎﻤﻫ
ﻩﺪﻨﻫﺩ-ﺕﺎﯿﻟﺎﻣ: 
ﻪﭼﺭﺎﭙﮑﯾ: ﻝﺍﺮﮕﺘﻧﺍ
ﺭﺎﻬﻇﺍ: ﺯﺍﺪﻧﺍ-ﻢﺸﭼ, ﺮﻈﻧ, ﺭﺎﻬﻇﺍ
ﺎﻣﺎﮔ: 
ﺎﻘﯾﺮﻓﺍ-ﺭﺩ-ﯽﻓﺎﺸﺘﮐﺍ ﺖﺣﺎﯿﺳ: ﻥﺪﺷ-ﺭﺍﻮﺳ, ﺮﻔﺳ, ﺮﻔﺳ, ﺮﻔﺳ
ﺖﮐﺮﺣ-ﻪﻧﺎﺧﺩﻭﺭ: 
ﺐﯾﺮﺿ: ﻪﺟﺭﺩ, ﻞﻣﺎﻋ
ﻥﺍﻮﻨﻋ: ﻥﺍﻮﻨﻋ, ﻉﻮﺿﻮﻣ
ﺮﮕﻠﯿﻠﺤﺗ: ﻞﯿﻠﺤﺗ-ﻭ-ﻪﯾﺰﺠﺗ
ﺕﺎﻣ: 
ﺪﯾﺮﺧ-ﺰﮐﺮﻣ: ﺖﮐﺭﺎﻣ-ﺮﭘﻮﺳ
ﺕﻮﻤﺴﯿﺑ: 
ﻝﺎﺘﺴﭘ-ﺕﺭﺎﮐ: ﯽﺳﺮﭘ-ﻝﺍﻮﺣﺍ-ﻭ ﻡﻼ﻿ﺳ
ﯽﯾﺍﺮﮕﻤﻫ: ﺐﯾﺮﻘﺗ, ﺍﺮﮕﻤﻫ
ﻥﺪﺷ-ﺕﺮﭘ: ﯽﻨﯿﺸﻧ-ﺐﻘﻋ, ﮎﺮﺗ
ﻥﺍﺭﺍﺪﻣﺎﻬﺳ: ﮏﯾﺮﺷ
ﺏﺮﮑﯿﻣ: 
ﯽﻠﺳﺎﻨﺗ-ﻩﺎﮕﺘﺳﺩ: 
ﯽﮑﯾﮊﻮﻟﻮﻓﺭﻮﻣ: ﮏﯿﺘﻧﮊ, ﯽﺳﺎﻨﺷ-ﺖﺨﯾﺭ
ﺎﺘﺑ: 
ﻦﯿﺟ-ﺭﺍﻮﻠﺷ: 
ﻩﺩﺍﺩ-ﻩﺎﮕﯾﺎﭘ: 
ﺏﺎﺴﺣ-ﻦﯿﺷﺎﻣ: ﻪﺒﺳﺎﺤﻣ
ﺲﮑﯾﺍ-ﻪﻌﺷﺍ: 
ﻪﯾﺰﺠﺗ: 
ﯽﻄﯿﺤﻣ-ﺖﺴﯾﺯ: ﺯﺍﺪﻧﺍ-ﻢﺸﭼ, ﻑﺍﺮﻃﺍ-ﻂﯿﺤﻣ, ﻂﯿﺤﻣ, ﻪﻨﯿﻣﺯ, ﺖﺴﯾﺯ-ﻂﯿﺤﻣ, ﯽﮕﯾﺎﺴﻤﻫ, ﯽﮕﯾﺎﺴﻤﻫ, ﻞﺻﺎﻓ-ﺪﺣ
ﺎﻤﮕﯿﺳ: 
ﯽﯾﺍﺪﺟ: ﺍﻭﺰﻧﺍ, ﯽﯾﺍﺪﺟ, ﻦﺘﺴﮑﺷ-ﻢﻫﺭﺩ, ﮏﯿﮑﻔﺗ
ﻪﺴﻠﺟ-ﺭﻮﺘﺳﺩ: ﻪﻣﺎﻧﺮﺑ, ﻪﻣﺎﻧﺮﺑ, ﯽﻠﯿﺼﺤﺗ-ﻪﻣﺎﻧﺮﺑ
ﺍﺰﯾﻭ: 
ﺖﺧﺎﺳﺮﯾﺯ: 
ﺏﺎﺗ-ﺐﺷ-ﻡﺮﮐ: 
ﺏﺎﯾﺩﺭ: 
ﯽﻗﺎﺒﻄﻧﺍ: 
ﺱﺎﻨﺷ-ﺖﺴﯾﺯ: 
ﻥﺩﺮﮐ-ﻞﺼﺘﻣ-ﻢﻫﺎﺑ: ﻥﺩﻮﻤﻧ-ﻪﻓﺎﺿﺍ, ﺡﻼ﻿ﺻﺍ, ﻪﻤﯿﻤﺿ, ﻝﺎﺼﺗﺍ
ﻡﺮﺑ: 
ﻡﻮﯾﺩﻻ﻿ﺎﭘ: 
ﻪﮑﺴﮑﺳ: 
ﯽﮕﻧﺭ-ﺩﺍﺪﻣ-ﺎﺑ ﯽﺷﺎﻘﻧ: ﻩﺪﯾﺮﭘ-ﮓﻧﺭ
ﺶﺣﻭ-ﻍﺎﺑ: 
ﻩﺎﮕﻧﺎﻣﺭﺩ: 
ﯽﻨﻤﺿ-ﺖﻟﻻ﻿ﺩ: ﻡﻮﻬﻔﻣ, ﯽﻨﻌﻣ, ﯽﯾﺎﻨﻌﻣ, ﻡﻮﻬﻔﻣ, ﻡﻮﻬﻔﻣ, ﺲﺣ, ﻪﻨﯿﻣﺯ
ﺎﮔﻮﯾ: ﻉﻮﻤﺠﻣ
ﯽﺷﻭﺮﻔﺑﺎﺘﮐ: ﺏﺎﺘﮐ-ﻪﺴﻔﻗ
ﻥﺎﻣﺭﺩ: ﻥﺎﻣﺭﺩ, ﻥﺎﻣﺭﺩ, ﻥﺎﻣﺭﺩ, ﻥﺎﻣﺭﺩ, ﺱﺎﻨﺸﻧﺎﻣﺭﺩ
ﺖﺴﯿﻟﺎﻧﻮﯿﺳﺎﻧ: ﯽﻣﻮﻗ
ﻥﺪﯾﺮﺑ-ﺮﺳ: 
ﻩﺭﺁ: ﻪﻠﺑ
ﺯﺎﺳ-ﻞﮑﺸﻣ: ﻪﻟﺎﺴﻣ, ﻪﻠﺌﺴﻣ, ﺽﺭﺍﻮﻋ
ﺯﺎﺟ: 
ﻦﺘﺴﮕﻨﺗ: 
ﯽﺘﺴﯾﺭﻭﺮﺗ: ﺐﻠﻃ-ﮓﻨﺟ, ﺖﺸﺣﻭ
ﻥﺪﯿﻧﺎﮑﭼ: ﻞﮔ-ﻭ-ﻦﺠﻟ
ﺯﺎﺳﻭ-ﺖﺧﻮﺳ: 
ﻪﻘﻔﻧ: 
ﻪﺘﻔﻫ-ﺮﺧﺁ: 
ﯼﺩﻭﺍﺩ-ﻞﮔ: 
ﻦﺴﮐﺍﻭ: ﺮﯿﺴﻔﺗ, ﺶﺷﻮﭘ
ﺖﻠﻜﻴﺳ-ﺭﻮﺗﻮﻣ: ﺭﻮﺗﻮﻣ
ﺩﻭﺮﺳ: 
ﯽﻠﯿﺼﺤﺗ-ﻡﺮﺗ: ﺕﺪﻣ
ﻦﻴﺋﻭﺮﻫ: 
ﻪﺷﻮﭘ: 
ﺪﺗﺎﮐ: 
ﻱﮊﻮﻟﻮﺋﺪﻳﺍ: ﺮﮑﻓ
ﮓﻨﯿﮐﺭﺎﭘ: 
ﺎﺘﺗ: 
ﺝﻭﺍﺩﺎﭘ: ﯼﺪﯿﻣﺍ-ﺎﻧ
ﻡﻮﯿﻨﻠﺳ: 
ﻱﺭﺍﻮﺳ-ﻪﺧﺮﭼﻭﺩ: ﺵﺩﺮﮔ, ﻪﻘﻠﺣ, ﯼﺎﻬﺧﺮﭼ, ﻪﺧﺮﭼﻭﺩ, ﻪﺧﺮﭼﻭﺩ
ﺮﺸﻗ: ﮓﺳ-ﺱﺭﺎﭘ, ﻪﺘﺳﻮﭘ, ﻥﺪﻨﮐ-ﺖﺳﻮﭘ
ﯼﺯﺭﺍ-ﻢﻫ: ﯼﺮﺑﺍﺮﺑ
ﯼﺭﺎﺟ-ﻁﺎﺒﺗﺭﺍ-ﺮﮕﻧﺎﺸﻧ: 
ﻩﺎﮔﺩﻭﺮﻓ: 
ﻥﺩﺮﮐ-ﺍﺪﺟ: ﻥﺩﺮﮐ-ﻊﻄﻗ
ﻝﺎﺒﺘﮑﺴﺑ: 
ﺯﺎﺑ-ﻞﻏﺩ: 
ﻡﺎﻤﺣ-ﮏﺳﻮﺳ: 
ﻡﻭﺮﮐ: 
ﺮﺘﯿﻟ: ﺮﺘﯿﻟ
ﺩﻮﺟﻭ-ﻦﯾﺍ-ﺎﺑ: ﻑﺎﺻﻭﺍ-ﻦﯾﺍ-ﺎﺑ, ﻥﻮﻨﮐﺎﺗ, ﺎﻣﺍ, ﻝﺎﺣ-ﺮﻫ-ﻪﺑ
ﻥﻮﻣﺭﻮﻫ: 
ﺺﻗﺎﻧ: ﻡﺪﻋ, ﺩﻮﺒﻤﮐ, ﺺﻗﺎﻧ, ﻩﺎﺒﺘﺷﺍ, ﻂﻠﻏ, ﺪﻗﺎﻓ
ﻥﺩﺮﮐ-ﺥﺍﺭﻮﺳ: ﻥﺩﺮﮐ-ﺥﺍﺭﻮﺳ
ﯽﯾﺍﺮﮔ-ﻥﺎﺟ: 
ﯽﻌﻠﺿ-ﺪﻨﭼ: ﻪﯾﻭﺍﺯ
ﻥﺎﻧﺯ-ﻕﻮﻘﺣ-ﺭﺍﺪﻓﺮﻃ: 
ﺝﻭﺩﺰﻣ: ﺐﯿﺷ, ﻞﺼﺘﻣ
ﻭﺭﻮﯾ: 
ﻥﺎﺴﻨﺟﺎﯿﻬﺴﻨﺟ-ﺖﺧﺭﺩ: 
ﻢﺘﯾﺭﻮﮕﻟﺍ: 
ﺭﺰﯿﻟ: 
ﻪﻧﺎﺧﻭﺭﺍﺩ: 
ﺮﺘﻤﯿﻠﯿﻣ: ﺮﺘﻤﯿﻠﯿﻣ
ﻥﺩﺮﮐ-ﻢﺧ: ﻢﺧ, ﯽﻨﺤﻨﻣ, ﺮﯾﺬﭘ-ﻑﺎﻄﻌﻧﺍ, ﺏﻮﻠﻄﻣ, ﻞﺑﺎﮐ
ﺪﻧﺁ: 
ﻒﯾﺮﻇﻭ-ﻖﯿﻗﺩ-ﺕﺎﮑﻧ: ﻪﯾﺎﺳ
ﺖﻗﻭ-ﻩﺭﺎﭘ: 
ﺖﯿﺳﺎﺴﺣ: 
ﻩﺪﻨﻫﺩ-ﻥﺎﺸﻧ: 
ﻡﻮﯿﻠﻫ-ﺯﺎﮔ: 
ﻪﻧﺎﺑﺯ-ﻭﺩ: 
ﻒﻔﺨﻣ: ﺮﺼﺘﺨﻣ, ﻪﺻﻼ﻿ﺧ-ﺕﺭﻮﺻ-ﻪﺑ, ﻥﺪﺷ-ﮏﭼﻮﮐ
initialism: 
ﺭﺪﺼﻣ-ﻢﺳﺍ: 
ﺎﻤﺳﻼ﻿ﭘ: 
ﻡﻭﺯﻮﻣﻭﺮﮐ: 
ﯽﺒﯿﺗﺮﺗ: ﻝﺎﺼﺗﺍ, ﻒﯾﺩﺭ, ﻢﻈﻨﻣ, ﯽﭘ-ﺭﺩ-ﯽﭘ
ﺮﺘﻣﻮﻠﯿﮐ: ﺮﺘﻣﻮﻠﯿﮐ
ﺲﮑﻓ: 
ﮏﯿﺘﻧﮊ: ﮏﯿﺘﻧﮊ, ﯽﮑﯿﺘﻧﮊ
ﮏﻣ-ﮏﮐ: 
ﯽﺘﺷﻮﮔ-ﭻﯿﭘ: ﺭﺎﭼﺍ
ﯽﻠﮐﻭﺮﺑ-ﻢﻠﮐ: 
preterite: 
ﻦﯿﻣﺎﺘﯾﻭ: 
ﻡﻮﯿﻣﺩﺎﮐ: 
ﺯﺍﺪﻧﺍ-ﺐﻤﺑ: 
ﯽﮑﯿﻓﺍﺮﮔ: 
ﻡﻮﯿﻧﺎﺘﯿﺗ: 
ﺵﺎﭘ-ﻭ-ﺖﺨﯾﺭ: ﻥﺩﺯ-ﻑﻻ﻿
ﯽﻧﺎﻧﻮﯾ-ﯼﺎﺒﻔﻟﺍ-ﻑﺮﺣ ﻦﯿﻤﻫﺩﺯﺎﯾ: 
ﺮﺘﺧﺩ-ﺖﺳﻭﺩ: ﮏﯾﺮﺷ, ﺮﺴﭘ-ﺖﺳﻭﺩ, ﻖﺷﺎﻋ, ﺮﺘﺧﺩ
ﻥﺩﺮﮐ-ﯽﺴﻨﺟ-ﺖﺑﺭﺎﻘﻣ: 
ﯽﻨﺷ-ﺖﻋﺎﺳ: 
ﯽﻟﺪﮑﯾ: ﯼﺩﺭﺪﻤﻫ-ﺯﺍﺮﺑﺍ, ﺖﻘﻔﺷ, ﻥﺩﺮﻛ-ﻙﺭﺩ
ﺭﻮﺑ: 
ﺮﺘﭘﻮﮐ-ﯽﻠﻫ: 
ﻢﯾﺭﻮﻠﺗ: ﻢﯾﺪﻧﺎﮑﺳﺍ, ﻢﯿﻧﺎﺘﻧﻻ﻿
ﻞﺟﻻ﻿ﺍ-ﺏﺮﺿ: ﺕﺪﻣ
ﻦﯿﭼ: 
ﺮﺘﻣ-ﯽﺘﻧﺎﺳ: 
ﻡﻮﻧﺪﺒﯿﻟﻮﻣ: 
ﻡﻮﯿﺘﯿﻟ: 
ﯼﺮﯾﻮﺼﺗ-ﯽﺗﻮﺻ: 
ﯽﻧﺎﺳﺭ-ﺯﻭﺭ-ﻪﺑ: ﻥﺩﺮﮐ-ﻦﯾﻮﻧ, ﺪﯾﺪﺠﺗ
ﯼﺮﻟﺎﮐ: 
ﺕﺎﺑﺭ: 
ﻒﯿﻠﮑﺗ: 
ﻢﺘﯾﺭﺎﮕﻟ: 
ﮎﺪﻧﻮﺧﺍ: 
ﻥﺩﺮﮐ-ﺐﺼﻧ: ﻩﻮﮐ, ﺐﺼﻧ, ﺰﺘﻨﺳ
ﻪﻨﯿﻣﺁ: 
ﻩﺪﺷ-ﯼﺭﺎﺠﺣ-ﻥﺎﺸﻧ ﺎﯾ ﺖﻣﻼ﻿ﻋ: ﻦﯿﮑﺴﺗ
aorist: ﻦﯿﻌﻣ-ﺎﻧ
ﯽﺳﺎﻨﺷ-ﻡﻮﺑ: ﺖﺴﯾﺯ-ﻂﯿﺤﻣ
ﻥﺩﺮﮐ-ﻪﻄﺴﻔﺳ: ﻥﺩﺮﺑ-ﻦﯿﺑ-ﺯﺍ
ﺎﻧﺍﻮﺟ-ﯼﺭﺎﻣ: 
ﮏﭼﻮﮐ: ﻒﯿﻄﻟ, ﮏﭼﻮﮐ, ﮏﭼﻮﮐ, ﮏﭼﻮﮐ, ﻦﻓﻭﺮﮑﯿﻣ
ﻮﻠﯿﮐ: 
ﻥﺩﺭﻮﺧ-ﺮﭘ: 
ﯽﻨﯿﺑ-ﺶﯿﭘ-ﻞﺑﺎﻗ: ﯽﻨﯿﺑ-ﺶﯿﭘ, ﯽﻨﯿﺑ-ﺶﯿﭘ, ﯽﻨﯿﺑ-ﺶﯿﭘ
ﺍﺰﺘﯿﭘ: 
ﻥﺩﺮﮐ-ﻊﻤﺳ-ﻕﺍﺮﺘﺳﺍ: 
ﯽﺳﺎﻨﺷ-ﻥﺎﺑﺯ: ﯽﻧﺎﺑﺯ
ﻮﻣ-ﺡﻼ﻿ﺻﺍ: 
ﻡﻮﯾﺪﯾﺮﯾﺍ: 
ﯽﺘﺳﺮﭘ-ﺩﺍﮋﻧ: ﯼﺩﺍﮋﻧ
ﻪﻨﯿﻬﺑ: ﻻ﻿ﺎﺑ, ﻪﻨﯿﻬﺑ
ﯼﺯﺎﺳ-ﯽﺘﻌﻨﺻ: ﻥﺩﺮﮐ-ﯽﺘﻌﻨﺻ, ﯽﺘﻌﻨﺻ, ﺪﯿﻟﻮﺗ
ﺩﺎﺘﺳ: ﯽﻫﺪﻧﺎﻣﺮﻓ-ﺰﮐﺮﻣ, ﯽﻟﺪﻨﺻ
ﻢﯾﺮﺳ: 
ﺲﻧﺎﺠﺘﻣ: ﻪﻧﺎﺘﺳﻭﺩ, ﺐﺳﺎﻨﻣ, ﺏﻮﻠﻄﻣ, ﺭﺎﮔﺯﺎﺳ, ﻢﻫ-ﻪﯿﺒﺷ
ءﺰﺟ-ﻪﺑ-ﻪﺘﺴﺑﺍﻭ ﺩﺭﻮﻣ: 
ﺖﺳﺎﮐ: ﺭﺍﻮﻧ
ﻩﺩﺍﺭﺍ-ﯼﻭﺮﯿﻧ: ﻩﺩﺍﺭﺍ, ﻩﺩﺍﺭﺍ
ﯼﺪﻌﺑ: ﻩﺯﺍﺪﻧﺍ, ﻞﮑﺷ, ﺪﻌﺑ, ﯽﯾﺎﻀﻓ
ﺮﺘﻣﺍﺭﺎﭘ: 
ﯼﺯﺎﺳ-ﻡﺎﮕﻤﻫ: ﻡﺎﮕﻤﻫ
ﻦﺘﺧﺎﺳ-ﻪﻨﯿﺸﯿﺑ: ﻦﯾﺮﺘﺸﯿﺑ, ﻥﺩﺮﺑ-ﻻ﻿ﺎﺑ, ﻪﻐﻟﺎﺒﻣ
ﺭﺎﻨﯿﻤﺳ: ﻩﺎﮔﺭﺎﮐ
ﻮﮑﺴﯾﺩ: ﻪﺤﻔﺻ
ﻥﻮﺌﻧ: 
ﺪﯿﻔﺴﺑ-ﻞﯾﺎﻣ-ﯽﺑﺍ ﻭ ﺖﺨﺳ ﯼﺰﻠﻓ ﺮﺼﻨﻋ: 
ﯽﺴﯿﻋ-ﯽﻠﺠﺗ-ﻭ ﺭﻮﻬﻇ: 
ﻥﺩﺮﮐ-ﯽﻨﯿﭼ-ﻪﺷﻮﺧ: ﯼﺩﺯﺩ
ﻉﻮﻨﺼﻣ: 
ﺭﻮﺘﮐﺍﺭ: 
ﯽﻫﻮﮐ-ﻪﻧﻮﭘ: 
ﻡﻮﯿﻧﻮﺗﻮﻠﭘ: 
ﻢﯾﺮﺘﯾﺍ: 
ﻩﺪﻧﻮﺷ-ﻢﮐﺍﺮﺘﻣ: 
ﯼﺮﺑﺭﺎﮐ-ﻡﺎﻧ: 
ﺪﺷﺭﺍ-ﯽﺳﺎﻨﺷﺭﺎﮐ: 
ﺖﺳﺍﺭ-ﺖﻤﺳ-ﻝﺎﺑ: 
ﻥﻮﮔﺭﺁ: 
ﺭﺎﺟﺰﻧﺍ: ﺖﺸﺣﻭ, ﺖﺒﯿﻫ, ﺩﺎﯾﺯ-ﺪﺷ-ﻭ ﺪﻣﺍ, ﺭﺎﺟﺰﻧﺍ
ﻥﺩﺮﮐ-ﯽﻋﺎﻤﺘﺟﺍ: ﻥﺩﺮﻛ-ﺭﺍﺮﻗﺮﺑ-ﻁﺎﺒﺗﺭﺍ, ﻞﻣﺎﻌﺗ
ﻥﺪﺷ-ﯽﻧﺎﻬﺟ: 
ﺝﻮﻣ-ﻝﻮﻃ: 
ﻥﺩﺭﻭﺍﺭﺩ-ﺰﻣﺭ-ﺕﺭﻮﺼﺑ: ﺪﮐ
ﺖﻓﺎﯾﺯﺎﺑ: ﺪﺷ-ﻩﺩﺎﻔﺘﺳﺍ
ﻩﺭﺎﺑﻭﺩ-ﻉﻭﺮﺷ: ﺩﺪﺠﻣ-ﯼﺯﺍﺪﻧﺍ-ﻩﺍﺭ
ﺖﯿﺗﺎﭙﻫ: 
ﻪﭽﯿﻫﺎﻣ: ﻩﺩﻮﺗ
ﯽﻧﺎﻣﺭﺩ-ﯽﻤﯿﺷ: ﯽﻨﯾﺩ
ﻪﻧﺎﻤﯿﭘ: ﺐﻟﺎﻗ, ﺪﺣﺍﻭ
ﻥﻮﺗﻭﺮﭘ: 
ﮏﭼﻮﮐ-ﻩﺩﺮﮔ: 
ﻡﺮﮔ-ﻡﺭﺍﺰﻫ-ﮏﯾ: 
ﻞﺴﮑﯿﭘ: 
ﻢﻟﺎﺘﻧﺎﺗ: 
ﻝﻮﻠﺤﻣ-ﺭﺩ-ﺩﻮﺟﻮﻣ: ﻦﺘﻓﺮﮔ-ﻢﻴﻤﺼﺗ
ﻡﺎﻋ-ﻞﺘﻗ: 
ﻩﺪﻧﺭﺩ: ﻩﺪﻧﺭﺩ
ﻡﻮﯿﻟﺎﮔ: 
ﻡﻮﯿﻧﻮﮐﺮﯾﺯ: 
ﻩﺪﻧﺮﯿﮔ-ﻢﯿﻤﺼﺗ: ﻥﺪﺷ-ﻦﯿﯿﻌﺗ, ﻥﺩﺮﻛ-ﻒﻳﺮﻌﺗ, ﻖﻘﺤﻣ
ﯽﻄﺧ-ﺮﯿﻏ: 
ﺕﺍﺮﺸﺣ-ﻩﺪﻨﺸﮐ: 
ﻡﻮﯿﻠﯾﺮﺑ: 
ﯽﺒﺼﻋ-ﻪﺘﺧﺎﯾ: 
ﯼﺪﻨﺴﻣ: ﻩﺪﻨﻨﮐ-ﺭﺎﻬﻇﺍ
ﯼﺭﺍﻮﻠﺷ-ﺮﯾﺯ: ﯼﺭﺍﻮﻠﺷ-ﺮﯾﺯ
ﻞﯾﺭﻮﺘﮐﺎﻓ: ﻩﺪﮑﺸﻧﺍﺩ
ﻥﻭﺮﺗﻮﻧ: 
ﻢﯿﺑﻮﯿﻧ: 
ﻡﻮﯿﻧﺎﻣﺭﮊ: 
ﺰﻠﻓ-ﻪﺒﺷ: ﺰﻠﻓ-ﺮﯿﻏ
ﻥﺩﺍﺩ-ﺭﺍﺮﻗ-ﺮﺑ: 
prolative-ﺩﺭﻮﻣ: 
ﯽﺘﺴﯾﺯ-ﻉﻮﻨﺗ: 
ﮏﯿﺘﺳﺍ-ﯼﻮﺟ: 
ﮏﯿﺗﻮﯿﺑ-ﯽﺘﻧﺁ: 
ﻢﯿﻨﯿﺘﮐﺍ: 
ﺩﺭﻮﻧﺎﻀﻓ: ﺎﻀﻓ
ﻦﯿﻣﺯ-ﻂﯿﺤﻣ-ﺯﺍ ﻥﻭﺮﯿﺑ: ﻪﻧﺎﮕﯿﺑ
ﻞﺧ: ﻖﻤﺣﺍ, ﻪﻧﺍﻮﯾﺩ, ﻪﻧﺍﻮﯾﺩ, ﻪﻧﺍﻮﯾﺩ, ﯽﻌﯿﺒﻃ-ﺮﯿﻏ
ﻥﻮﺗﺍﺭﺎﻣ-ﻭﺩ-ﻪﻘﺑﺎﺴﻣ: 
ﻢﯿﺑﺮﺘﯾﺍ: 
ﻢﺴﯿﺗﻭﺍ: 
ﻥﺩﺮﮐ-ﻥﻮﯾ-ﻪﺑ ﻞﯾﺪﺒﺗ: 
ﻥﻭﺩﺍﺭ: 
nerium: 
ﯽﺳﺎﻨﺷﺮﯿﮕﻬﻤﻫ: 
ﻝﺎﺴﻨﻬﮐ: ﻦﺴﻣ-ﺩﺍﺮﻓﺍ
ﻥﺩﺯ-ﺭﺩﺎﭼ: ﻩﺎﮔﻭﺩﺭﺍ
ﻩﺍﺭ-ﻩﺍﺭ: ﻩﺍﺭ-ﻩﺍﺭ-ﻪﭼﺭﺎﭘ, ﺡﺮﻃ, ﺶﮐ-ﻪﺸﻘﻧ
ﻢﯾﺪﻨﯾﺍ: 
ﺺﻟﺎﺧ: ﻕﺩﺎﺻ, ﺺﻟﺎﺧ, ﺺﻟﺎﺧ
ﯽﺘﻧﺮﺘﻨﯾﺍ-ﺖﯾﺎﺳ: ﯽﺘﻧﺮﺘﻨﯾﺍ-ﺖﯾﺎﺳ, ﻞﺤﻣ, ﻞﯾﺎﻓﻭﺮﭘ
ﻥﺍﺮﻗ: 
ﺖﺨﺗ-ﺐﻟ-ﻑﻭﺮﻇ: 
ﻡﺍ-n-ﻪﺸﯾﺭ: 
ﻢﯿﺴﻧﺭﻻ﻿: 
ﯼﺪﻧﻭﺮﻬﺷ-ﻕﻮﻘﺣ: 
ﻩﺍﺮﻤﻫ-ﻦﻔﻠﺗ: ﻩﺍﺮﻤﻫ-ﻦﻔﻠﺗ, ﻩﺍﺮﻤﻫ-ﻦﻔﻠﺗ
ﺞﻠﻓ: 
ﻢﯿﻨﯿﺘﮐﺎﺗﻭﺮﭘ: 
ﺶﺑﺎﺗ: ﺶﺑﺎﺗ
ﺩﺭﺍﺩ-ﯽﮕﺘﺴﺑ-ﺮﺑ: 
ﻢﯾﺭﻮﺗ-ﻢﺗﺍ: ﻢﯿﻟﻮﺗ-ﻢﺗﺍ, ﻡﻮﯿﺑﺮﺗ-ﻢﺗﺍ, ﻡﻮﯾﺩﻭﺭ-ﻢﺗﺍ, ﻡﻮﯾﺪﯿﺑﻭﺭ-ﻢﺗﺍ, ﻡﻮﯾﺩﺎﻧﺍﻭ-ﻢﺗﺍ, ﻦﯾﺭﻮﻠﻓ-ﻢﺗﺍ, ﻡﻮﯿﻧﻮﻠﭘ-ﻢﺗﺍ, ﻡﻮﯿﻟﺎﺗ-ﻢﺗﺍ, ﻡﻮﯿﺘﻧﻭﺮﺘﺳﺍ-ﻢﺗﺍ, ﻢﯿﻨﺗﻭﺭ-ﻢﺗﺍ
ﯽﺑﺁ-ﻦﯿﺟ-ﺭﺍﻮﻠﺷ: 
ﯽﮕﻧﺎﺧ-ﻩﺎﯿﮔ: 
ﻪﻧﺎﮔﺍﺪﺟ-ﺭﻮﻃ-ﻪﺑ: ﺎﺼﺨﺷ, ﯼﺩﺮﻓ, ﯽﺼﺨﺷ, ﻪﻧﺎﮔﺍﺪﺟ-ﺕﺭﻮﺼﺑ
ﯽﻠﻌﻓ-ﻥﺎﯾﺮﺟ: 
ﻪﻄﻘﻧ-ﻪﺳ: 
ﻥﺎﺴﻧﺍ-ﻥﺪﺑ: 
ﮏﯾﺰﯿﻓ: ﯽﮑﯾﺰﯿﻓ, ﯽﻤﺴﺟ-ﻅﺎﺤﻟ-ﺯﺍ
ﯽﺷﻭﺮﻓ-ﻩﺩﺮﺧ-ﻩﺎﮕﺷﻭﺮﻓ: 
ﻢﯾﺰﺳ: 
ﯽﻧﻻ﻿ﻮﻃ-ﺶﯿﭘ: 
ﻩﺩﺮﺘﺴﮔ-ﻪﺤﻔﺻ: 
ﻡﺮﺟ-ﺪﺣﺍﻭ: 
ﯼﺭﻭﺁﺩﺮﮔ: 
ﺵﺯﺭﺍ-ﯽﯾﻭﺩﻭﺩ: 
ﻥﺎﺴﻧﺍ-ﺩﻮﺟﻭ: 
ﻂﺳﻮﺗ-ﯼﺎﻨﻌﻣ-ﻪﺑ ﺯﺍ: 
depan-dari: 
ﻡﻮﯿﻤﯾﺩﻮﺌﺳﺍﺮﭘ: 
ﺍﻮﻘﻣ: ﺕﺭﺎﮐ
ﺩﻭﺪﺤﻣ-ﻞﻌﻓ: 
ﺶﯾﺎﻣﺯﺁ-ﺩﺪﻋ: 
ﺭﺍﺰﻓﺍ-ﻡﺮﻧ-ﻪﻠﻤﺟ: ﺭﺍﺰﻓﺍ-ﻡﺮﻧ-ﺕﺭﺎﺒﻋ
ﺪﻘﺘﻨﻣ: ﯽﻧﺍﺮﺤﺑ, ﻪﻧﺍﺪﻘﺘﻨﻣ
ﯼﺪﻨﺑ-ﻪﺘﺴﺑ: ﯼﺪﻨﺑ-ﻪﺘﺴﺑ-ﺬﻏﺎﮐ, ﻪﺘﺴﺑ
ﯼﺭﺍﺪﯾﺎﭘﺎﻧ: ﺕﺎﺒﺛ-ﯽﺑ
ﺭﺩ-ﻦﯾﺮﺘﺸﯿﺑ: 
ﻒﺻﺍﻭ: ﺕﺎﺤﯿﺿﻮﺗ
ﻢﯿﻤﯾﺩﻮﺌﻧ: 
ﯽﺘﺳﻭﺩ: ﻪﻧﺎﺘﺳﻭﺩ, ﺪﺤﺘﻣ
ﻥﺪﻧﺍﻮﺧ-ﻂﻘﻓ: 
ﻪﺘﻓﺎﯾ: 
ﯽﻠﺜﻤﻟﺍ-ﺏﺮﺿ-ﺖﻟﺎﺣ: 
ﺝﺍﻭ: 
ﺖﯿﻧﻼ﻿ﻘﻋ: ﯼﺭﺎﯿﺷﻮﻫ, ﻖﻄﻨﻣ
ﯽﺟﺍﻭ: 
ﯼﺭﻮﺧ-ﺭﺎﻫﺎﻧ-ﻕﺎﺗﺍ: 
ﻥﺩﺮﻛ-ﻲﮔﺪﻧﺯ-ﻕﺎﺗﺍ: 
ﯽﻧﺎﯿﻣ-ﺩﺭﻮﻣ: 
hodiernal-ﺶﯿﭘ: 
ﺭﻮﺒﺻ-ﺩﺭﻮﻣ: 
ﺏﺭﻮﻣ-ﺩﺭﻮﻣ: 
ﯽﯾﺎﺘﺳﻭﺭ-ﻪﻘﻄﻨﻣ: 
RECURSE: 
ﻂﺳﻭ-ﺍﺪﺻ: 
ﻢﯾﺮﻨﺘﯿﻣ: 
ﻥﺎﺳﺭ-ﻪﻣﺎﻧ: 
ﻪﻧﺎﻓﺮﻃ: ﺖﺨﺗ
ﺱﺭﻮﺑ-ﻥﺎﻣﺯﺎﺳ-ﺭﺍﺯﺎﺑ: 
ﯽﯾﺎﺳﺎﻨﺷ-ﻞﺑﺎﻗ: ﺖﯾﻮﻫ-ﺺﯿﺨﺸﺗ, ﯽﯾﺎﺳﺎﻨﺷ
ﻑﺪﻫ-ﻪﺷﺎﻣ: 
ﻪﯿﻧﺎﺛ-ﮏﯾ: 
lative-ﺩﺭﻮﻣ: 
ﻩﺮﯿﺟ: ﺶﺨﺑ
ﺮﯿﻏ-ﻥﺎﺴﻧﺍ: 
ﻥﺩﺮﻛ-ﻲﮔﺪﻧﺯ-ﺰﯿﭼ: 
ﻢﻫ-ﯽﻤﮐ-ﺭﺍﺪﻘﻣ: 
ﺎﻤﻨﯿﺳ: ﺎﻤﻨﯿﺳ
ﻢﯿﺳﺎﻫ: 
attenuative: 
multal-ﺩﺪﻋ: 
ﯼﺮﯿﺷ-ﺮﯿﺴﻣ: 
ﻡﻮﯿﻧﻮﺘﭙﻧ: 
ﺪﺴﯾﻮﻨﯿﻣ-ﺰﯿﭼ-ﻥﺍﺮﮕﯾﺩ ﯼﺎﺠﺑ ﻪﮑﯿﺴﮐ: 
ﺲﻧﺍﺮﺗ-ﯼﺩﺪﻋ: 
ﻑﺍﺮﻃﺍ-ﺭﺩ-ﻖﻤﺣﺍ: 
ﻡﻮﯿﮑﯾﺮﻣﺁ: 
ﺢﺒﺻ-ﻩﻮﮑﺷ: 
ﯽﻧﺎﺸﻧ-ﺶﺗﺍ-ﺭﻮﻣﺎﻣ: 
ﻢﯿﻠﮐﺮﺑ: 
ﻥﺎﺸﮑﻬﮐ-ﺲﻨﺟ: 
ﻢﯿﻠﺑﻮﻧ: 
ﻆﻓﺎﺣﺍﺪﺧ: ﻆﻓﺎﺣ-ﺍﺪﺧ, ﯽﻈﻓﺎﺣﺍﺪﺧ, ﻪﮑﻨﯾﺍ-ﺎﺗ
ﺍﺩﻮﺑ-ﺐﻫﺬﻣ: 
ﻡﻮﯿﻣﺮﻓ: 
ﯼﺍ-ﻩﺯﻭﺮﯿﻓ: ﯽﻧﺍﻮﻏﺭﺍ
ﺎﯾﻮﺳ: 
ﻩﺪﻨﻨﮐ-ﻊﯾﺯﻮﺗ: 
ﺎﻬﺑﺎﺼﺘﻋﺍ: 
ﻩﺪﻧﺯﺍﺩﺮﭘ: 
abessive-ﺩﺭﻮﻣ: 
adessive-ﺩﺭﻮﻣ: 
ﻪﺑ-ﺩﺭﻮﻣ: ﺭﺩ-ﺩﺭﻮﻣ, ﯽﻓﺩﺎﺼﺗ-ﺕﺭﻮﺻ-ﻪﺑ
agentive-ﺩﺭﻮﻣ: 
ﻡﻮﯾﺩﺭﻮﻓﺭﺩﺍﺭ: 
ﻦﺗﺩﺎﭘ: 
ﺪﻨﻧﺎﻣ-ﺭﺎﯿﺴﺑ-ﺪﻨﻧﺎﻣ: 
ﻞﻣﺎﻋ-ﻪﺷﺎﻣ: 
ﺮﮕﯾﺯﺎﺑ-ﺶﻘﻧ: 
ﻡﻮﯾﺪﯿﺗﺍ: 
ﮎﺮﺘﺸﻣ-ﺲﻨﺟ: 
accompanier: 
ﮓﻧﺮﻠﮔ: 
ﻢﯿﺴﻧﺍﺮﻓ: 
ﻢﯿﺑﺭﺍ: 
ﻝﺎﻌﻓ-ﺮﯿﻏ-ﺍﺪﺻ: 
ﻦﯿﺗﺎﺘﺳﺍ: 
ﻥﺪﯾﻮﺟ-ﺲﻣﺍﺩﺁ: 
ﻩﺭﺎﺘﺳ-ﺲﻨﺟ: 
ﻝﻮﻗ-ﻞﻘﻧ-ﻡﺮﻓ: 
ﻢﯾﺭﻮﮐ: 
ﻥﻮﺗﺭﺎﮐ: 
ﯽﮕﻧﺭ-ﺭﻮﮐ: 
euler's-ﻩﺭﺎﻤﺷ: 
ﻦﮐ-ﻩﺎﮕﻧ-ﺭﺩ: 
ﻩﺩﺎﯿﭘ-ﺮﺑﺎﻋ-ﻂﺧ: ﻩﺎﮔﺭﺬﮔ
ﮓﻨﺟ-ﻥﺍﺪﯿﻣ: 
ﻥﺎﮔﺪﻨﻧﺍﺭ: ﻩﺪﻨﻧﺍﺭ
ﻩﺎﺗﻮﮐ-ﺭﺍﺪﻣ: 
ﯽﻫﺎﻔﺷ-ﻢﺳﺍ: 
ﻥﺩﺮﮐ-ﻪﯾﺮﮔ-ﺝﺭﺎﺧ: 
ﯼﺭﺎﻣﺁ: ﯼﺭﺎﻣﺁ
ﺖﺳﺎﻣ: 
ﻥﻮﻧﺰﮔ: 
ﻥﺩﺮﮐ-ﻡﺰﯿﺗﻮﻨﭙﯿﻫ-ﺏﺍﻮﺧ: 
ﻦﺘﻓﺮﮔ-ﺵﻮﻣﺎﺧ: 
ﻡﺩ-ﺪﻨﺑ: 
ﻢﯿﻘﺘﺴﻣ-ﻑﺪﻫ: ﻢﯿﻘﺘﺴﻣ-ﺮﯿﻏ-ﻑﺪﻫ
ﺭﺎﺑﺭﺍﻮﺧ-ﻩﺎﮕﺷﻭﺮﻓ: 
ﻞﻣﺎﺷ-ﺯﺍ: 
ergative-ﺩﺭﻮﻣ: 
ﻥﺎﺑﺯ-ﺭﺩ: 
ﻝﻭﺍ-ﺖﺳﺩ: ﻢﯿﻘﺘﺴﻣ
ﯽﻧﺎﮑﻣ-ﺩﺭﻮﻣ: 
ﺮﺨﺘﺳﺍ: ﺮﺨﺘﺳﺍ, ﻪﻧﺎﺧﺩﻭﺭ-ﻩﺯﻮﺣ
ﯼﺪﯿﻗ-ﺩﺭﻮﻣ: 
ﺵﺩﺮﮔ: ﺮﻔﺳ, ﯽﺳﺭﺯﺎﺑ, ﺵﺩﺮﮔ
ﻥﻮﯾﺰﯾﻮﻠﺗ-ﻢﯿﻈﻨﺗ: 
ﯽﯾﺎﻬﻧ-ﻩﺭﺫ: 
evitative-ﺩﺭﻮﻣ: 
ﯽﺸﺨﺒﻧﺍﻮﺗ: 
ﺖﻓﺮﺴﭘ: ﺖﺸﮔﺮﺑ, ﺏﺎﺴﺣ-ﺯﺍ-ﺖﺷﺍﺩﺮﺑ, ﯽﻨﯿﺸﻧ-ﺐﻘﻋ, ﺖﺴﮑﺷ
ﻥﺩﺮﮐ-ﺩﻭﺪﺴﻣ-ﺯﺍ ﻥﺎﻤﺗﺭﺎﭘﺁ: 
ﺭﺍﺪﯿﺑ-ﺏﺍﻮﺧ-ﺯﺍ ﻻ﻿ﺎﺑ: 
ﺲﯿﻠﭘ-ﺮﺴﻓﺍ: 
ﺭﺩ-ﻡﺭﻮﺧ-ﯽﻣ ﻢﺴﻗ: 
ﻪﺒﺣﺎﺼﻣ: ﻪﺒﺣﺎﺼﻣ
ﻢﯿﻧﺭ: 
ﻞﺳﻭﺮﺋﺁ: 
ﻪﯿﻟﺎﻓﺎﻀﻣ-ﺩﺭﻮﻣ: ﻪﯿﻟﺎﻓﺎﻀﻣ-ﺩﺭﻮﻣ
nominalization: ﻢﺳﺍ
ﺏﻭﺬﺠﻣ-ﺩﺭﻮﻣ: 
ﻥﺩﺮﮐ-ﻮﻠﻏ: 
ﯽﮑﻤﮐ-ﻞﻌﻓ: 
ﻪﯿﻟﻭﺍ-ﻑﺪﻫ: 
ﯼﺮﺗﻮﯿﭙﻣﺎﮐ-ﺱﻭﺮﯾﻭ: 
ﺮﺟﺎﺗ: ﺕﺭﺎﺠﺗ-ﺺﺨﺷ, ﺮﺟﺎﺗ
ﻡﺩﺮﻣ: ﺎﻫ-ﻥﺎﺴﻧﺍ, ﻡﺩﺮﻣ
antessive-ﺩﺭﻮﻣ: 
ﺮﯾﺯﻭ-ﺖﺴﺨﻧ: 
ﻢﺘﯿﺗﻮﻟ: 
ﻢﯿﭘﻭﺭﺍ: 
ﻥﺩﺍﺩ-ﻥﺎﺸﻧ-ﻥﺎﺠﯿﻫ: 
ﯽﻠﺤﻣ-ﯽﻘﯿﺳﻮﻣ: 
ﺮﻋﺎﺷ: 
ﺖﺴﭘ-ﻩﺭﺍﺩﺍ: ﺖﺴﭘ, ﻞﯿﻤﯾﺍ
ﺍﺮﻫﺎﻇ: ﺽﺮﻓ, ﻥﺩﺮﮐ-ﺽﺮﻓ, ﻻ﻿ﺎﻤﺘﺣﺍ, ﺍﺮﻫﺎﻇ, ﺩﺭﺍﺩ-ﻝﺎﻤﺘﺣﺍ
ﻥﺩﺮﮐ-ﻊﯿﺠﺸﺗ-ﻭ ﮏﯾﺮﺤﺗ ﺲﻨﺟ: 
subessive-ﺩﺭﻮﻣ: 
ﺯﺎﮔ-ﻝﺍﺪﭘ: 
ﺶﺒﻄﻗ: ﯽﺒﻄﻗ
ﻪﯿﻠﻘﻧ-ﻪﻠﯿﺳﻭ-ﺲﻨﺟ: 
ﯽﻧﺪﻌﻣ-ﺲﻨﺟ: 
ﺪﻧﻮﺴﭘ-ﻞﻌﻓ: 
ﯽﺗﺎﺳﺎﺴﺣﺍ: ﯽﻧﺎﺠﯿﻫ, ﯽﻔﻃﺎﻋ, ﯽﺴﺣ
ﻡﻮﯾﺭﺎﻣﺎﺳ: 
ﻩﺪﻨﻨﮐ-ﻞﯿﻬﺴﺗ: ﺮﯾﺪﻣ
ﺪﺣﺍﻭ-ﯽﻟﺎﯿﺧ: 
ﺭﻮﻧ-ﺖﻋﺮﺳ: 
ﯽﯾﺍﻮﻫ-ﯼﻭﺮﯿﻧ: 
ﻪﻧﻻ﻿ﺪﻤﻫ-ﺕﺬﻟ: 
ﯽﻧﺍﺮﺤﺑ-ﻪﻄﻘﻧ: 
ﺖﻗﻭ-ﻡﺎﻤﺗ: 
ﻢﯿﻨﻓﺎﻫ: 
ﯼﺭﺍﺩﺯﺎﺑ: ﻥﺩﺮﮐ-ﺭﺎﻬﻣ, ﻥﺩﺮﮐ-ﺩﻭﺪﺤﻣ, ﺭﺎﻬﻣ, ﺖﺳﺍ-ﻩﺩﺮﮐ-ﻉﻮﻨﻤﻣ
ﻥﺩﺍﺩ-ﺮﯿﯿﻐﺗ-ﺯﺍ ﻪﻌﻗﺍﻭ: 
ﻢﯿﻤﻟﻮﻫ: 
ﻥﺎﺴﻤﻫﺎﻧ-ﻪﻌﻗﺍﻭ: 
ﻥﺎﻬﺟ-ﺲﻨﺟ: 
ﻞﺤﻣ-ﺲﻨﺟ: 
ﯼﺯﺎﺠﻣ-ﻩﺎﮕﺘﺳﺩ: 
ﺶﻫﻭﮋﭘ-ﺲﻨﺟ: 
ﻪﻧﺍﺪﻨﻣﺮﻨﻫ-ﺲﻨﺟ: 
crastinal-ﺖﻔﺳ: 
ﻩﺪﯿﮑﭼ-ﺲﻨﺟ: 
exocentric-ﺩﺭﻮﻣ: 
ﯼﺪﻌﺘﻣ-ﻞﻌﻓ: 
ﮎﮊﺍﻭ: 
ﺐﺼﻌﺘﻣ-ﺖﺳﺮﭘ-ﻦﻬﯿﻣ: 
ﻪﺘﺷﺬﮔ-perfective: 
ﯼﺍ-ﻪﻓﺮﺣ-ﻭ ﯽﻨﻓ: ﺺﺼﺨﺗ, ﯼﺍ-ﻪﻓﺮﺣ, ﻝﺎﻐﺘﺷﺍ, ﺕﺭﺎﻬﻣ, ﯽﺼﺼﺨﺗ
ﻢﯿﻘﺘﺴﻣ-ﺮﯿﻏ-ﯽﻧﺍﺮﻨﺨﺳ: 
ﻦﯿﻣﻭﺩ-ﻥﺎﺑﺯ: 
ﻪﺑ-ﻥﺩﻮﺑ: 
ﻥﺎﺘﺳﺮﺒﻗ-ﻥﺎﮑﻣ-ﺮﯿﯿﻐﺗ: 
ﯽﻌﻤﺟ-ﻢﺳﺍ: 
absolutive-ﺩﺭﻮﻣ: 
ﺭﻮﺒﺻ-ﻪﺷﺎﻣ: 
ﺩﻮﺧ-ﺲﻔﻧ-ﻪﺑ ﺩﺎﻤﺘﻋﺍ: 
ﻉﻮﻓﺪﻣ: ﻉﻮﻓﺪﻣ, ﻥﺩﺍﺩ-ﺕﺭﻮﻗ, ﮎﺎﺧ
ﯽﺑﺎﺗﺯﺎﺑ-ﺍﺪﺻ: 
ﯽﺼﺨﺷﺮﯿﻏ-ﻞﻌﻓ: 
ﻢﯿﮔﺭﻮﺑ: 
ﺪﯿﻔﺳ-ﯼﺎﻀﻓ: 
ﯽﺘﯿﻔﯿﮐ-ﺩﺭﻮﻣ: 
ﻥﺎﺟ-ﯽﺑ-ﺲﻨﺟ: 
ﻩﺪﻧﻮﺷ-ﺐﺒﺳ: 
propositive-ﺖﻟﺎﺣ: 
ﯽﻗﺮﺑ-ﯼﺭﺎﺟ: 
ﯽﻨﻤﺠﻧﺍ-ﺩﺭﻮﻣ: 
ﯽﻟﺎﻋ-ﺩﺭﻮﻣ: 
ﻢﻫ-ﺭﺎﯿﺴﺑ: 
ﯽﻧﺎﻬﺟ-ﺲﻨﺟ: 
ﮎﺮﺤﺘﻣ-ﺭﻮﺗﺎﮑﯾﺭﺎﮐ: 
ﻞﺑﺎﻘﺘﻣ-ﺍﺪﺻ: 
ﻥﺩﺮﮐ-ﯽﻧﻮﻧﺎﻗ: ﻥﻮﻧﺎﻗ, ﻪﻨﻨﻘﻣ, ﻥﺩﺍﺩ-ﺐﯿﺗﺮﺗ, ﻥﺩﺍﺩ-ﻥﺎﻣﺯﺎﺳ
ﺭﺩ-ﻦﯾﺮﺘﻤﮐ: 
ﺩﺭﻮﻣ-ﯼﺭﻮﺘﺳﺩ: 
ﺮﺑﺭﺎﮐ: 
ﻪﺘﺴﻫ-benefactive: 
ﺮﻠﮔ: 
:-Except-for: 
ﺝﺮﺨﻣ: 
ﯼﺮﮕﯾﺩ-ﺮﮔﺍ: 
ﯼﺭﻭ-ﮏﯾ: ﺯﺍ-ﻪﺘﺷﺬﮔ
ﺮﮕﯾﺪﮑﯾ: ﺮﮕﯾﺩ-ﯽﮑﯾ, ﻞﺑﺎﻘﺘﻣ
ﯽﭘ-ﺭﺩ-ﯽﭘ ﺪﻨﺑ: 
ﻥﺩﺮﮐ-ﺱﺎﺒﻟ: 
ﻩﺎﺗﻮﮐ-ﺭﺍﻮﻠﺷ: 
ﻢﯾﺯﻭﺮﭙﺴﯾﺩ: 
ﯼﺩﻭﺯ-ﻪﺑ-ﻩﺪﻨﯾﺁ ﺖﻔﺳ: 
SI-ﺪﺣﺍﻭ: 
ﻥﻮﺘﭙﯾﺮﮐ: 
ﻢﯾﻮﻟﺪﻨﻣ: 
ﯽﻠﻤﻋ-ﺍﺪﺻ: 
antipassive-ﺍﺪﺻ: 
ﻡﻭﺍﺪﺗ-ﻪﺒﻨﺟ: 
ﯼﺭﺎﻤﯿﺑ-ﺶﺑﺎﺗ: 
necessitative-ﺖﻟﺎﺣ: 
ﺎﻬﻨﺗ-ﻞﻤﻋ-ﻞﻌﻓ: 
railcar-ﺖﻌﻨﺻ: 
ﯽﻟﺎﻋ-ﻪﺟﺭﺩ: 
ﯼﺩﻮﺟﻭ-ﺪﻨﺑ: 
ﻢﯿﻧﺮﻔﯿﻟﺎﮐ: 
ﺮﺿﺎﺣ-ﯽﻔﺻﻭ-ﻪﺟﻭ: 
ﻥﺎﺸﺧﺭﺩ-ﺕﺪﺷ: 
ﺩﺮﻔﻨﻣ-ﺩﺪﻋ: 
ﯽﺷ-ﯼﺭﻮﺘﺳﺩ: 
ﻝﺎﻌﻓ-ﺮﯿﻏ-ﯽﻔﺻﻭ ﻪﺟﻭ: 
ﻩﺯﺍﺪﻧﺍ-ﺯﺍ-ﺶﯿﺑ ﻥﺎﻣﺯ ﺕﺪﻣ: 
ﻝﺎﯿﺳ-ﯽﻧﺍﺮﺤﺑ-ﻕﻮﻓ: 
ﻥﺍﺰﯿﻣ-ﺯﺍ-ﻩﺩﺎﻣ: 
postpositional-ﺩﺭﻮﻣ: 
ﯽﺑﺎﺨﺘﻧﺍ-ﺞﻨﺳ-ﺖﯿﻤﮐ: 
ﻢﯿﻨﯿﻟﻭﺩﺎﮔ: 
epenthetic-ﮎﮊﺍﻭ: 
ﻩﺪﻨﻨﮐ-ﯽﺜﻨﺧ-ﺞﻨﺳ ﺖﯿﻤﮐ: 
ﻢﯿﻧﺎﺘﺸﻧﺍ: 
ﯽﻋﻮﻨﺼﻣ-ﻥﺎﺑﺯ: 
ﯼﺪﻧﻮﯿﭘ-ﻩﺭﺫ: 
ﺭﻭﺩ-ﻩﺍﺭ-ﺯﺍ ﻩﺪﻨﯾﺁ ﺖﻔﺳ: 
ﺭﺮﮑﻣ-ﻪﺒﻨﺟ: 
ﯽﻌﯾﺯﻮﺗ-ﺮﯿﻤﺿ: 
ﻪﺑﺎﻄﺧ-ﻖﻓﺍﻮﺗ: 
ﻮﻣ-ﻥﻭﺪﺑ: ﺖﺨﻟ
ﺮﻬﺷ-ﻪﻣﻮﺣ: ﻩﺪﮑﻫﺩ, ﺮﻬﺷ-ﻪﻣﻮﺣ
ﯽﻧﺎﻬﺟ-ﺞﻨﺳ-ﺖﯿﻤﮐ: 
ﺮﺗﻮﯿﭙﻣﺎﮐ-ﻲﺴﻳﻮﻧ-ﻪﻣﺎﻧﺮﺑ: 
ﻥﻮﯾﺰﯾﻮﻠﺗ-ﻪﻣﺎﻧﺮﺑ: 
ﻩﺭﺎﻤﺷ-ﺭﻭﺎﻨﺷ-ﺰﯿﻤﻣ: 
ﯼﺩﻮﺟﻭ-ﺞﻨﺳ-ﺖﯿﻤﮐ: 
ﺯﻭﺭ-ﺯﺍ-ﺲﭘ ﺍﺩﺮﻓ: 
ﻦﯾﺰﮕﯾﺎﺟ-ﺞﻨﺳ-ﺖﯿﻤﮐ: 
ﻕﻼ﻿ﺧﺍ-ﺪﺑ: ﻦﺸﺧ
ﻪﺘﺷﺬﮔ-ﻝﺎﻌﻓ-ﺮﯿﻏ ﯽﻔﺻﻭ ﻪﺟﻭ: 
ﺯﻭﺭ-ﺯﺍ-ﺶﯿﭘ ﺯﻭﺮﯾﺩ: 
ﯽﻧﺎﮑﻣ-ﯽﺘﯾﺍﺪﻫ-ﺩﺭﻮﻣ: 
ﻑﻼ﻿ﺧ-ﻁﻭﺮﺸﻣ: 
