bye: bye-Bye, Hei, pii, jäähyväiset
: 
of: välillä, noin, sen
että: tulla, täytyy
sisään: 
:-first-person: 
minä: minulle
:-third-person: 
että: se, joka
hänen: sen, oma
hän: se
kanssa: 
varten: noin, kohti
kuten: joka, esimerkki, miten
:-second-person: 
olla: 
hänen: sen
päällä: puhelu, noin
at: hevonen
mukaan: syöttö, ja, noin
olla: karhu
tai: eikä-myöskään
alkaen: 
tämä: se
häntä: sen
hän: ne, se
minun: minun, minulle
niiden: sen, ne
niin: siten, pian
: 
niitä: ne, sinä
me: meille, minulle
Kuka: kuka-tahansa, joka
olisi: ajatella, tuoda
tahtoa: tahdonvoima
ei: ei
jos: onko, mikäli
ylös: edellä, nousta, ulos, huonompi
osaksi: yksi
kaikki: nimittäin, joka, kaikki, kukin
sinun: sinun
mitä: eikä-myöskään, joka, asia
ohjeellinen-mieliala: direktiivi-mieliala
mies: henkilö, aviomies, uros-
kuin: lisää, noin, miten
meidän: kevät, meille
jotkut: jokseenkin
päälle: jälkeen, edellä, ulos
Toukokuu: pystyvät
nyt: esittää
pitää: miten, rakkaus, pitää
voida: pystyvät, voisi, laatikko
pitäisi: täytyy
teki: tehdä, tosiasia
sellainen: siten
: yksi
nämä: ne, se
yli: edellä, lisää
paljon: erittäin, tilavuus
Herra: sir, hallita
hyvä: kaunis, suuri, ystävällinen
suurin-osa: lisää, enimmäkseen, enemmistö, erittäin
on: täytyy
ne: ne, sen
itse: oma, sama, itse
elämä: elää, elinikä, vokaali, vyötärö
ilman: 
tehdä: tehdä, luoda
hyvin: mukava, oikea
esitelmä-merkki: 
kautta: syöttö, läpäistä
voima: teho, ehkä, voisi
liian: erittäin, jopa
uudelleen: sitten, takaisin, kerran
monet: enemmistö
joka: kukin, joka
ihmiset: henkilö, yhteisö, ihmiset
ajatus: ideologia, ajatus, ajatella
alle: alas
edelleen: lisää
paikka: paikka, sijainti, missä
sillä-aikaa: kun-taas, aika, väliaikainen
vain: vain, yksinkertainen
myös: jopa, samoin, lisää
vielä: mutta, eikä-myöskään, kuitenkin, lisää
vastaan: kohti, ennen
saada: tavata, ottaa, johtua
koskaan: ikuinen, ei-ikinä, aina
pois: kiinni, pois, ulos, katettu
kasvot: pinta-, sata, henkilö
toinen: kestää, muut
vasen: pois
uusi: neo, romaani, tuore, yhdeksän, nuori
rouva: 
laittaa: sarja, kestää, antaa
kertoa: sanoa
mieli: henkinen, ajatella
harvat: pari, vähän
jonka: joka, kuka-tahansa
pitkälle: pois, kauko-, erittäin
nimeltään: ajatella
koko: koko, kaikki
molemmat: kaksi
löytää: löytyi, haku
Katso: nähdä, tarkistaa, silmäys
päästää: bussi, päästää, antaa, mahdollistaa
herra: hallita, sir, kuningas
kotiin: talo
jotain: ei-mitään, jokseenkin
hetki: aika
isä: isä
keskuudessa: välillä
naiset: naaras-
äiti: äiti
pää: päättynyt, kestää, myöhään
pieni: vähän, mikro
sinä: sinä
haluta: täytyy
kuitenkin: mutta, kuitenkin, vaikka
melko: täysin, jokseenkin, erittäin, tarpeeksi
jonka: joka
parhaat: paremmin
itse: minulle, itse
asti: jopa, ennen, bye-Bye
koska: sitten, ensimmäinen, koska
käytetty: vanha, kierrättää
pikemminkin: sen-sijaan, jokseenkin, lisää
Vähemmän: lyhyt, alas, vähiten
sisällä: sisempi, syvä, sisällä
yhdessä: sarja
suuri: suuri, massiivinen
asia: asia, aihe, kysymys
tietty: määritetty, oikea
itse: itse
puoli: puolitiessä, jauhaa, puoli
totta: todella, tosiasia, oikea
mitä-tahansa: aivan-sama, jokseenkin, ei-mitään
pitää: pitää, sarja, säilyttää
vaimo: naaras-
välineet: tapa
lähellä: syöttö, melkein
osavaltio: kunto, astua, maa, hallitus
yksin: yksinäinen, yksin, yksi
tapaus: pudota, esimerkki, puku, tapaus, koska
sinua: sinä
korkea: edellä, lattia
tyttö: tytär, naaras-, tyttöystävä
kaikin-mokomin: vakuuttaa, oikea, todella
todellakin: todella, tosiasia
itse: itse, oma, onko
pitkin: liittyvä, pitkä, pituus
maa: maa
palata: regressio, takaisin, maksun-palautus
jättää: lähtö, loma, hylätty, pois, lupa
jompikumpi: jopa
laki: oikea, oikeudellinen, sääntö
asettaa: sarja, maallinen, auttaa
kohta: paikka, toiminta, vain, kohta
lapsi: lapset
haluta: toivoa, halu
puhua: sanoa, puhua
aikana: aika, kun-taas
useat: tusina, pari, lisää
liike: käydä-kauppaa, myymälä, yritys, tehdä-työtä, kaupallinen, liike
tapa: tapa, lähestyä
toinen: muut
yleinen: yhteinen, yleisesti, julkinen
takana: takaisin
tulla: tulla
kuollut: kuolla, kuolema
maa: maa
poika: poika
tuntea: tunne, kuulla
henki: sielu
totuus: tosiasia
maa: lattia, maa, paikka
ihan-oikeesti: todella, erittäin, tosiasia
levätä: muut, mukavuus, jäädä-eläkkeelle, jäännökset, loma
eri: eri, ero, muut
mahdollinen: ehkä
ihmisen: henkilö, ihmiskunta
kaupunki: kaupunki
jälkeen: seuraava, seurata, jälkeen
tarve: välttämätön, täytyy
aiheuttaa: syy, aiheuttaa, koska
ilta: yö-, iltapäivällä
viisi: viides, vuosi
vahva: teho, pystyvät, väkivaltainen
nainen: naaras-
noin: ympäröivä, melkein, noin, silmä
vuoro: puoli, sarja, tilata
tunne: tarkoittaa, tunne, konnotaatio
lähellä: kiinni, melkein
merkki: ominainen, persoonallisuus, merkki, luonto
järjestellä: luokittelu, ystävällinen
näky: visio, eteenpäin, näkymä, nähdä, silmäys
osapuoli: juhla, pilkku, maa
hieno: suuri, ohut
valmis: valmistella, jo, hiipiä-varpaisillaan, päättynyt
tili: syy, laskuttaa, laskeminen, laskea
kirjallinen: kirjoittaa
ikä: vanha, vuosisata
muu: muut, kestää, muualla, lisää
pakottaa: teho, hallita-pakolla, määrätä
poikki: edellä, vastapäätä
varhainen: ennenaikainen, alku, primitiivinen, pian
aurinko: 
myöhemmin: tulevaisuus, sitten, jälkeen, seuraava
kaikki: kaikki
ohi: kulunut, takautuva, kestää, jälkeen
toimia: laskuttaa, verbi, toiminta, tehdä-työtä, liike
edelleen: eteenpäin, lisää, lisä-
ulkopuolella: lisää, ulos
eikä: eikä-myöskään, joka
näkymä: opined, silmäys, nähdä, visio, näkymä, kalenteri
ääni: ääni
ei-mitään: ei-mitään, nikkeli
kirkas: avata, ilmeinen, huomiota-herättävä, valo
tie: valtatie, tapa
todellinen: virtuaali-, tosiasia, kuninkaallinen
lähes: melkein, noin
tuntemus: tiedot
kohti: kohti
huono: huonompi, paha, huono
elävä: elää, vyötärö, elinikä
rauha: huone
matala: lyhyt, halpa, keskenmeno
pohjois-: vastaus, pohjoinen, keskiyö
luonnollinen: luonto
melko: kaunis, erittäin, tarpeeksi
oikeudenmukainen: oikea, kertomus, kymmenen
palvelu: palvella, hoito
alla: alas
ilo: onnellinen
historia: tarina, päivämäärä, historiallinen
Huomautus: muistaa, merkintätapa
vaikka: vaikka
etuosa: vastapäätä, eteenpäin, ennen
iso: suuri, massiivinen
varmasti: tiukasti, kurssi, todella
tuuli: ilma, ullakko
ottaa-vastaan: kuitti, ottaa, johtua
Huomio: hoito, prioriteetti, fokus, ottaa-huomioon, painotus
vahvuus: teho
todennäköisesti: ehkä
iloinen: onnellinen, hilpeä, vakuuttunut
tärkeä: välttämätön, johtuva
sinä-itse: oma, itse
stipendiaatti: kollega, ystävä
lausunto: opined, ajatus
usko: uskoa, uskollisuus
sitten: itään, sitten, ennen, eteenpäin, takaisin
veloittaa: tietulli, kulu, ottaa
varsi: käsi, huono, hiha, aseet, olkapää
jälkimmäinen: kestää
esine: tarkoitus, ei-mitään, aihe
herrasmies: uros-, sir, hallita
erityinen: erityisesti, nimittäin
tuskin: ei, melkein, harvinainen
päällikkö: johtaja, pää-
mahdollisuus: sattuma, sijainti, tilaisuus, todennäköisyys
sopimus: suunnitelma, myymälä, sopimus
ajattelu: ajatella
raskas: toisto, paino, vakavasti, kova
tavallinen: avata, yksinkertainen, ontto
heti: kerran, pian
suu: henkilö
peloissaan: pelästynyt, pelko, ahdistunut
yksittäinen: yksi, yksinäinen
ilo: onnellinen, jännitys
rikki: rikki, leikata
ellei: paitsi
kuljettaa: karhu, pitää-päällä, tuoda, mahdollistaa
vaikutus: vaikutus, influenssa
näyttää: ilmaantua, näyttää
ulkopuolella: ulos, paitsi
Ole-hyvä: ystävällisesti, kysyä
ulkoinen-olemus: ilmaantua, näyttää
hitaasti: vähitellen, myöhään
aika: vaihe, aika
sisko: veli
taistelu: taistella, sota-
entinen: vanha
nuoret: nuori
vain: vain, yksinkertainen, yksinäinen
tavoittaa: lähestyä, saavuttaa, tulla
järjestelmä: tilata, hierarkia, organisaatio
päivällinen: yö-, lounas
jälkeenpäin: tulevaisuus, jälkeen
kävellä: askelma, mennä, lattia, jalka
ihme: ihme, outo, yllättynyt
tavallinen: yleisesti, yhteinen, aina
kuvio: digitaalinen, tilastotiedot, muotoinen, määrä, tietulli, kuva
muinainen: vanha, vanhanaikainen
kunnioittaminen: ottaa-huomioon, kunnia, vaara, kohti
kolmas: kolme, tiistai
jäädä: pysyä
yhteiskunta: sosiaalinen, yhteisö, yritys
tulos: johtopäätös, vaikutus
komento: tilata
pelkkä: vain, yksinkertainen
vieressä: syöttö, seuraava, paitsi
hiljainen: hiljainen
täydellinen: asianmukainen, suuri
katu: tapa
kirjoittaminen: kirjoittaa, kirje
puu-: puinen, puu, tikku
nopeasti: pian
ilmoitus: nähdä, ilmoitus, varoitus
kirkas: terävä, valo, kiiltävä, huomiota-herättävä
vene: laiva, kellua, jahti
jalo: suuri, loistava
äkillinen: yhtäkkiä
arvo: arvoinen, arvo, merkitys
maksettava: koska
lukeminen: lukea, kysymys
olla-samaa-mieltä: sopimus
Odota: odottaa, pitää, pysyä
pala: siru, osa, venyttää
entinen: vanha
keskustelu: puhua, vuoropuhelu
tilaisuus: tilaisuus, sijainti
maksaa: kulu, maksaa
huomattava: suuri, johtuva, huomiota-herättävä
istua: pysyä
ylin: optimaalinen, harjanne, edellä, huippukokous
avioliitto: naimisissa
vaihe: toiminta, askelma, vaihe
alkaa: alku
kohti: kukin, kohti
yksittäinen: henkilö, erikseen, atomi
vaikea: kova
bitti: osa, vähän, täi, suupala
puhe: puhua
auktoriteetti: toimivalta, teho
onnellisuus: onnellinen
säätää: mikäli, antaa, vakuuttaa
tutkimus: oppia, analyysi, studio
henkilökohtainen: yksityinen, erikseen, henkilöstö
katsella: tarkistaa, monitori, nähdä
tyytyväinen: vakuuttunut, onnellinen
kuuma: lämmin, antaa-potkut
ponnistus: yrittää, rasitus
valmis: valmistella, jo
yrittää: yrittää, tietokilpailu, puukottaa
nopeasti: pian, ketterä
alla: alas, jälkeen
tarkoitettu: aikovat, fokus, tarkoitus
suoraan: suoraan, yksinkertainen
todennäköisesti: helposti, todennäköisyys, ehkä, muka
oikeudenmukaisuus: oikea
yksinkertaisesti: vain, yksinkertainen
luottamus: uskoa, uskollisuus
kulku: osa, ylitys, sarake, syöttö, venyttää
suljettu: kiinni, kangaspuut, katettu
itse: itse
ohimenevä: syöttö, kulunut, ylitys
keskikokoinen: toissijainen, tarkoittaa
hallinta: omaisuus
miellyttävä: mukava, ystävällinen
täysin: täysin, todella
yleensä: yhteinen, yleisesti, yleensä
hauta: kova
kiinteä: korjata, vaikka, standardi, pysyvä
joukot: armeija
kokous: istunto, kokoonpano, tavata
leiri: telttailu, ala
kansakunta: maa, kansallinen
olemassaolo: läsnäolo
vastata: vastaus, maksun-palautus
taivas: ilmapiiri, taivas
yhtäläinen: sama, aste
onni: kohtalo, kunto, omaisuus
verkkotunnuksen: ala
tilanne: sijainti, kunto
keskimmäinen: tarkoittaa, puolitiessä, vyötärö
talvi-: kylmä
antaa-lupa: lupa, mahdollistaa
kalpea: keltainen, väri, heikko, pastellityö, avata, valo
juoksu: rotu, ajaa
uskonnollinen: uskonto, kemoterapiaa
johtaa: aiheuttaa, tuoda
liikkua: askelma, perustelu, perääntyä, liike, toiminta
Stop: tauko, seistä
suullinen: sanoa, sanallinen, puhua
lauta: nousta, paneeli, neuvot, reuna, komissio
turha: ilmaiseksi, tyhjä
menetys: haitta, menetetty, vuotaa
tarjous: mikäli, ehdottaa, antaa, näyttely, palvella, etuoikeus
luokka: ystävällinen, kiertorata, arvo
täydellinen: koko
pääsy: vierailla, lähestyä, hankinta
intohimo: innostusta, tunne
fyysinen: fysiikka, elin
esimerkki: esimerkki
alku: alku
huolimatta: suututtaa
vakava: suuri, vakavasti, äärimmäinen
hopea-: raha, perjantai
riittävä: tarpeeksi
tärkein: pää-, hallita, avain, alkuperäinen, nitoa
ihana: outo, väkivaltainen, suuri
polku: tapa
merkitys: konnotaatio, tarkoittaa, merkitys, aihe
sovittaa: puku, asianmukainen
erä: massa-, erittäin, kohtalo
istuin: tuoli, piiritys, pääkonttori
peli: uhkapeli, pelata
selvitys: ilmaisu, kertomus
unelma: painajainen, nukkua
rock: rantakallio, hame, kivi
erityinen: erityisesti, yksityinen, asiantuntija
maksu: kulu, tietulli, maksaa
jakaa: osa, panos, rooli, jakaa
levitä: yksityiskohta, laajalle-levinnyt, hajottaa, syy
kunnia: kunnia, kehua
tila: sijainti, sali, ala, astronautti
tavallinen: yhteinen, yksinkertainen
harkita: ajatella, ottaa-huomioon
suuresti: erittäin, enimmäkseen
upseeri: virallinen
hinta: standardi, kunnia, kurssi
merkki: merkintätapa, ele, merkki, paikka
syntyperäinen: luonto, alkuperäinen, asukas
työskentely: työntekijä, tehdä-työtä
naittaa: naimisissa
laajuus: sidottu, tilavuus, aste
menetelmä: tapa, kerran, lähestyä
erinomainen: paremmin, suuri
luottamus: uskoa
täsmälleen: todella, erityisesti, koko, täysin
valtava: suuri
mieltymys: mielikuvitus, kaunis
nopea: pian, ketterä
kyllä: Joo, siten
vapaus: ilmaiseksi, itsenäisyys
mielenkiintoinen: piirtää, utelias
syrjään: erotetaan, sivuttain, paitsi
puhdas: tuore, veridical
koskevat: edellä, noin, ottaa-huomioon
todistusarvo: näyttö, ilmeinen
kaukainen: pois, kauko-
samanlainen: muistuttaa, sama, yhtenevä, vertailukelpoinen
kapea: ohut, lyhyt
yhteensä: täysin
sivu: puoli, piha
erityisesti: erityisesti
vuori: mäki
ylpeä: ylpeys
selvästi: nimenomaisesti, avata, ilmeinen
hinta: kunnia
sairas: sairas
tuomio: päätös, tuomita, sääntö, tuomari, toimivalta, kriisi
hyväksyä: hyväksyttävä, myöntää, ottaa
laji: ystävällinen
etsiä: haku
kunnia: kunnia
korva: lupa
pohja: alas, lattia, pohja
tuki: aids, auttaa, tuki
täysin: koko, täysin
ilahduttaa: onnellinen, epämiellyttävä
määrä: kvantti, tilavuus, väkijoukko, määrä
saada: hankinta, johtua, ottaa
verottaa: vuokrata, linja
ylittää: ylitys, syöttö, ylittää
muukalainen: vieras, outo, ulkomainen, tuntematon
uskaltaa: rohkeus
kasvaa: nousta
väärä: valhe, väärässä, sairas, virheellinen
pitkä: pitkä, lattia
portti: ovi
vapaasti: itsenäisyys, ilmaiseksi, itsenäisesti, löysä
isku: järkyttää, tahti, laukaus, potkia
muoti: lähestyä, tulla
päivittäin: päivä
jakelu: jakaa
rikkaus: raha, omaisuus
vapaus: ilmaiseksi, itsenäisyys
edetä: edistyminen
lempeä: pehmeä, makea
varmasti: kurssi, todella
turvallinen: turvallinen, suojella, vakuuttaa
miehitetty: takavarikoida, rakeet, kihloissa
vaihe: foorumi, toiminta, vaihe, kunto, näkymä
osa: osa, säännöstellä
kieli: kieli, sylkeä
suuttunut: suututtaa
kuljetus: kouluttaa, johdinauto, sukkula
sää-: ilmasto, ilma, aika
välttämättömyys: merkitys
harjoitella: liikunta, toiminta, asiakassuhde
väite: pyyntö, puku
prinssi: herttua
ryhmä: sarja, monialayritys, parvi, bändi, paneeli
kauttaaltaan: kaikkialla
lisätä: laajentaa, lisä-, lisätä
rukoilla: kysyä
johtava: johtuva, hallita
harmaa: ruskea, tuhka
usein: usein, toistuva, pysyvä
kuuluisa: suosittu, tunnettu, vokaali
voimakas: teho, pystyvät
elossa: elää
heikko: heikko, huono
materiaali: pitoisuus, aihe
vilpitön: rehellinen, selviö
lämpö: kesä, lämmin
vartija: suojella, hoito
yhtä: saldo, sama, samoin
luonnollisesti: luonto
huomattava: outo, epätavallisen, suuri
kuu: kuukausi
hienoinen: vähän, helposti, valo, ohut, lyhyt
tyyli: valo
terävä: aivopuolisko, terävä
periaate: teoria, selviö, alku
välitön: pian, suoraan
halukas: jo, hiipiä-varpaisillaan, maili
seuraus: johtuva, vaikutus, johtopäätös
hellä: pehmeä, sopimus, rotu
kiinnostunut: aikovat, kiinnostaa
neljännes: jalka
kehittynyt: edellä, eteenpäin
ilmeisesti: nimenomaisesti, muka, näyttää
aktiivinen: tehdä-työtä, toiminta
tietoinen: tarkoituksella, tietää
vaarallinen: vaara, haitallinen, uhkaava
tyyni: hiljainen
pyhä: jumalallinen, pyhä
kuningaskunta: kuninkaallinen
koko: täysin, kaikki, koko
kiva: kaunis
tapa: ominainen, tapa, asiakassuhde
suoraan: ilmeinen, suoraan, ensi-käden
todella: todella, tosiasia
kuulo: kuulla
kävely: askelma, jalka, jalankulkija
heittää: päästää, heittää, laukaus
viisaus: henkinen
ajaa: ajo-, kertosäe, retkikunta, Työnnä, ajaa, levy
vika: syyttää, väärässä
asia: asia, aihe, suhteet
yhteyshenkilö: kirjeenvaihto, koskettaa
asema: seistä, keskusta, kausi
kuunnella: kuulla, kysyä, totella
satuttaa: vahinko, kipu, haavoittunut
ilmaista: ilmaisu, selittää
suosia: puoli, armo, edistää
korkeus: pituus
koko: ulotteinen, suuruus, koko
tehtävä: toiminta, tehdä-työtä, tulli
myötätunto: empatia, sääli
pukeutunut: pukeutua
kauemmas: eteenpäin
alus: väline, laiva
tunteet: rakkaus
kärsimys: kiduttaa, kurjuus, katkera, vaivata
liha: liha, elin
suuri: massiivinen, suuri
lähettää: arvo, postitoimisto, jälkeen, lähettää, sijainti
kokoelma: kertymä, sarja, galleria, johtopäätös
kuvitella: mielikuvitus, ajatella
saapuminen: tulla
äänekäs: vaatia, suuri, kova
ihana: kaunis, loistava
ylimääräinen: outo, epätavallisen
tapahtua: eikä-myöskään
aamiainen: aamu, lounas
väestö: väkijoukko
sarja: ketju, sarja
helpotus: aids, mukavuus, glyph
vaikutus: vaikutus, tunne, tehdä-vaikutus, painaa
tyytyväisyys: vakuuttunut
muoto: ulotteinen, muoto, muotoinen
syntymä: syntynyt
harkinta: ajatus, ottaa-huomioon
säännöllinen: ajoittainen, toistuva, järjestysluku
liikkuva: perääntyä, liike
kiireinen: kihloissa
laatu: massa-, aste
löytää: löytyi, haku, paljastaa
sisällä: sisempi, syvä, sisällä
maaperä: muta, lattia, yksin, maa
täysin: täysin
viesti: tiedot, uutiset
lauseke: ilmaisu, tuomita
mainita: uros-
pari: oikea, pari
otsikko: otsikko, pää-, aihe
ymmärtäminen: ymmärtää, empatia
sunnuntai: viikko
vihainen: hullu, typerys
täysin: täysin, tiukasti
hidas: hiljainen
armo: sääli, armo
sisältää: mukaan-lukien, pitoisuus
suru: suru, kipu
sotilas: armeija, sotilas
edellinen: itään
selitys: selittää, tiedot
rukous: pyyntö
usko: uskoa, uskollisuus
jatkuva: toistuva, standardi, korjata, pysyvä
lopullinen: kestää, vihdoin
ratsastaa: ratsastus, safari, nousta, ajo-
politiikka: poliittinen
piirustus: kuva, piirtää, suunnitelma
kuoleva: kuolema, kuolla
kysyntä: pyyntö, kysymys
ylempi: edellä
summa: ja, jooga, määrä
liike: liike, ehdottaa
apu: tuki, auttaa
arvokkuus: kunnia
saalis: pitää, ottaa, käsitys
keskuudessa: välillä
nykyinen: esittää, virta
mahdollisesti: todennäköisyys, ehkä, voisi
erillinen: erotetaan, ero, yksin
pahin: huonompi, huono
kauhu: pelko, terroristi
ohjaus: säätö, ohjattu, tarkistaa, hoitaa
kykenee: mahdollistaa, pystyvät, taitava, taito
yritys: yritys, vaikka
esimies: paremmin
henkinen: henkisesti, moraalinen, henkinen
todiste: todistaa, näyttö
suhde: suhteet, kertomus, ottaa-huomioon
huolestunut: hoito, ahdistunut, liittyvä
syvään: syvä, yksityiskohta
laulaa: lukea
ystävällinen: yhtenevä, ystävällisesti, ystävyys, ystävällinen
sisäänkäynti: ovi, kuitti
toimittaa: leveys, mikäli
puhdas: tuore, siisti
hyödyllinen: välttämätön, tehokas
herkkä: hauras, ohut, tyylikäs
poistaa: eroon, poistaa, piirtää
valinta: valita, vaalit, tarkistaa
valtava: massiivinen, suuri
kykenemätön: ei-pysty, ei, epäonnistua
kansi: takki, sisällyttäminen, viltti, kietoa, jalkakäytävä
kaksinkertainen: twin, kahdesti, pari
voitto: menestys
alituisesti: usein, toistuva, aina, jatkaa
taso: standardi, kunto, pinta-
julkaisu: päästö, julkaisu, ilmaiseksi
karkea: huonompi, pahantuulinen, töykeä
eteenpäin: eteenpäin, edellä
kytketty: sidottu, liitteenä, liittyvä, konjugaatti
saada: hankinta, etu
lisäys: lisä-, täydentää
kammio: huone, sali, kamera
tuttavuus: tuttu, pohjamaali
virhe: väärässä
pohjainen: pohja, ehdot
auto: kouluttaa
ei-kukaan: kukaan, ei-mitään
energia: teho
paljas: avata, baari, häpeä, ontto, kalju
osittain: puolitiessä, osa, jokseenkin
väri-: väri
turvallisuus: turvallinen, pelastus, hoito
kuvaus: kuvata, tiedot, avainsana, määritelmä
unessa: nukkua
pudota: sukeltaa, pudota, vuotaa
loistava: loistava, kiiltävä, suuri
lyhyt: akronyymi, lyhyt
harmaa: ruskea, tuhka
erittäin: erittäin
innoissaan: jännitys, ärtynyt
epätoivo: pettymys, heikko
helppous: mukavuus, vähentää
kaikki-yhteensä: brutto, kaikki
ystävällisyys: hyve, armo
ympyrä: sykli, huoneisto, pyöristää, pyörä
tylsä: porausreikä
aikomus: aikovat, tarkoitus
termi: ehdot, lukukausi, takaraja
perin-pohjin: mukava, täysin
käyttää: käyttää
työ: tehdä-työtä
älykkyys: henkinen
lakko: hyökkäys, huomiota-herättävä
melko: täysin, tarpeeksi, erittäin
noudatettava: tavata, totella, pitoisuus
tapahtuma: tapaus, tilaisuus, show
kevyesti: pehmeä, ystävällisesti
liitäntä: luettuna, liite, puhelu
suojaus: suojella, suoja, hoito
tajuissaan: hereillä, tarkoituksella, tunne
painos: kulu, painaa, julkaisu, lupa
lento: lintu, lentää, liidellä
lajike: ystävällinen, eri
erilleen: erotetaan, pois, paitsi, itsenäisesti
hirveä: kauhea, sääli
jokainen: kaikki, kukaan
työ: tehdä-työtä
rakastaja: rakas, tyttöystävä
laulu: laulu
innokas: halu, kärsimätön, utelias, ahdistunut
vaatia: kysyä, pyyntö, vaatia
aina-kun: milloin
onnistunut: menestys
korottaa: laajentaa, hissi, lisätä, nousta
kehitys: edistyminen
viileä: kylmä, kaunis
oikeudenkäynti: koetin, käsitellä-asiaa, tuomioistuin
ulkomailla: ulkomainen, maanpakolaisuus
omistautunut: uskollisuus, luotettava
kirjallisuuden-: kirjallisuus
kirjailija: kirjailija
kalusto: tikku, rooli, toiminta
tyyppi: ystävällinen, kirjoittaa, lehdistö
paljon: rikas, irtisanominen, tarpeeksi
välttää: estää
suosia: puoli, armo, edistää
henkinen: henkinen, henkisesti, sisempi
asenne: silmäys, seistä, ele, lähestyä, riippuvuus, kohta
ihailu: kehua
levottomuus: ahdistunut, pelko, huoli, jännitys
opettaa: tietää, oppia
näkyvä: tietää
opas: manuaalinen, näyttö, ajo-
todellinen: virtuaali-, tosiasia, kuninkaallinen
kurja: riittämätön, surullinen, onneton, kurjuus, avuton
vahingoittaa: paha, haitallinen, vahinko, sääli
Anteeksi: antaa-anteeksi, anteeksi, pyydä-anteeksi, armo
harvoin: joskus
tallentaa: rekisteröinti, levy, tallentaa
rasva: öljy, paksu
litteä: huoneisto, välttelevä, suunnitelma
lahja: palkinto, esittää
temppeli: talo, katedraali
lisenssi: lupa
suostumus: hyväksyminen, lupa
riittävästi: koko, tarpeeksi
haava: vahinko, haavoittunut, haava
rohkea: rohkeus, rohkea
missä-tahansa: jonnekin, kaikkialla
todistaja: näyttö
typerä: oppimaton, typerys
kukaan: kukaan, kuka-tahansa
itse: yksityinen, itse, oma
erittäin: erittäin, epätavallisen
hoito: terapia, hoito
kurkku: kaula, liidellä, kurkku
potilas: sairas
kasvu: lisätä
määrä: kvantti, massa-, väkijoukko, annos, määrä, suuruus
vaikea: tiukasti, väkivaltainen, kova
tekosyy: antaa-anteeksi, syy, transitiivinen, anteeksi
alkuperä: alkuperäinen, luonto
yleisö: passiivinen, julkinen
jäljellä-oleva: jäännökset
voittaa: menestys
neito: palvelija
pehmeästi: pehmeä, hiljainen
todellisuus: tosiasia
paikka: näkymä, verkkosivusto, paikka
purjehtia: laiva, huntu
kauppa: myymälä, varastointi, tallentaa
huomautus: opined, ottaa-huomioon
tauko: tauko
arvokas: arvoinen
siten: siten, siksi
kasvi: nousta, puu, mylly
jää: lumi
absoluuttinen: koko, täysin
helposti: helposti, pian
raju: terävä, väkivaltainen, kova, julma, petoeläin, villi
raivo: suututtaa
löytö: löytyi, haku, keksintö, aukko
liittyvä: liittyvä
rankaiseminen: tuomita
hieman: vähän, helposti, jokseenkin
salaperäinen: salaisuus, epämääräinen, näkymätön
sävy: varjo, sävy, vivahde
murhata: tappaa
tunne: tunne, intohimoinen
tuho: pilata, tuhota
kauhu: pelko
paikallinen: paikallisesti, sisempi, paikka
alue: eri, etäisyys, sarja
isäntä: armeija, vieras, väkijoukko
märkä: sade, kostea
mysteeri: salaisuus
omistaa: oma, karhu
tajunta: järkevyys, tunne, omatunto
ennen: ennen
tuotanto: tuottaa
kansi: silta
omaisuus: omaisuus
vallita: kuningas, royalty
noudattaminen: seurata, sovittaminen
hänen: sen
valitettava: valitettavasti, sattuma, onneton, sääli, riittämätön
kukka: viettää, kiinnostaa, muta
Kiitos: kiittää
kuulua: omaisuus, mukaan-lukien
markkinoida: ostaa
korkki: hattu, korkki
iloinen: onnellinen
talous: perhe, talo
laivasto: laiva, laivasto, kellua
vauva: lapset, nukke
alue: ala
tarkka: jauhot, asianmukainen, koko, varovainen
kuva: kuva
epäilys: epäillä, epäilyttävä
kieltäytyä: kieltää, veto, jätteet
vastuu: tulli, syyttää
häpeissään: häpeä
ateria: ruoka, syödä, jauhot
status: sijainti, kunto
osoittaa: astua, show
runo: runous, laulu
nousta: ilmaantua, nousta
matka: safari, retkikunta
käydä: liittyä-seuraan
antaa: ostaa, antaa, karhu
lahjoittaa: myötävaikuttaa, antaa
Job: tehdä-työtä
edetä: jatkaa, lisätä, edistyminen, syöttö
pahoitella: anteeksi
riski: vaara
nopea: pian, ketterä
selvä: erotetaan, ero
asianmukaisesti: asianmukainen, mukava
kuuluisuus: kehua
yksikkö: yhdistynyt, yksikkö
virhe: väärässä
maine: kehua
valitus: piirtää, puhelu
puute: leikata, virheellinen, poissaolo
väkivalta: väkivaltainen
tehdä: tehdä, esitellä, antaa
ura: ammatti, tehdä-työtä
design: käsitys, suunnitelma
ehdotus: tuomita, ehdottaa
täydellinen: lausua, koko
päätöslauselma: päätös, johtopäätös, analyysi, laajentaa
vapaa: vaihtoehtoinen, lisä-, korvata, keihäs
kotimainen: siviili-, sisempi, asukas, kansallinen
viite: viite, muisti
olla: läsnäolo, esittää
ongelma: ongelmallinen, ehdot, vaivata, aihe, kysymys, emissio
tarjoaminen: mikäli, antaa
liekki: antaa-potkut
tietämättömyys: oppimaton, jättää-huomiotta
silloin-tällöin: joskus, toistuva
lentävä: lentää
kangas: kangas, vaatteet
voitto: etu
neljäs: neljä, keskiviikko, huone
soittokello: hälytys, tunnin
hyöty: etu
luku: ovi, osa, pää-, kausi, pääoma, itse
reikä: porausreikä, kuoppa
kohtuullinen: asianmukainen, viisas, järkevä
sokeri: juoppous, tapa
korvaaminen: korvata, sen-sijaan, avustus, vaihtoehtoinen, vaihtaa-keskenään
työntövoima: vaatia, neuloa, maksaa, Työnnä, impulssi
kehys: asteikko, oikeudellinen, laukaus
aine: aihe
email: lähettää
jako: osa
orjuus: orja
jae: runous, kohta
todennäköinen: ehkä
tuskallinen: katkera, kipu
ikuisesti: aina, ikuinen
valtameri: meri
taka-: jälkeen, takaisin, käänteinen
johtaja: pää-, johtaja, kapellimestari, manuaalinen
innokas: aikovat, ahdistunut, terävä
onni: kohtalo
näennäinen: ilmeinen, selviö
kiire: pian, vasikka
järjestelmä: suunnitelma, raidallinen, kartoittaa
hyödytön: jätteet
siitä-huolimatta: vaikka, kuitenkin
sileä: pehmeä
vankka: demonstratiivinen, vakiintunut, vaikka, kompakti
välttämättä: täytyy, välttämätön
rakentaa: luoda, rakentaminen, muotoilu
yritettiin: yrittää, puukottaa
vastaava: sama
viimeaikainen: äskettäin, moderni, kestää
matkustaa: vierailla, matkailu
keskipäivä: iltapäivällä, etelä
sijaitsevat: pudota
ilmoitus: ilmoitus
lopettaa: estää
seikka: kunto, kirjekuori
teltta: hytti, näkymä
tiheä: toistuva, usein
ääneen: ääni
itsenäinen: itsenäisyys, löysä, itsenäisesti
olennainen: välttämätön, nitoa
havainto: tarkkailla
kiitollisuus: kiittää
säilyttää: säilyttää, varastointi, suojella
näkökohta: elementti, puoli
pelätä: pelko, fobia, pelästynyt
taitava: taitava, viisas
piiri: elää
vika: epäonnistua, väärässä, konkurssi, keskenmeno
sentti: penni, prosentti, sata
näkemys: tunne
agentti: tarkoittaa
epätoivoinen: heikko
liitto: liitto, yhdistynyt
myöntää: myöntää
osuma: moninkertaistaa, potkia, menestys
valtava: suuri, massiivinen
vakaumus: tuomita
kuume: antaa-potkut, influenssa
kohdella: terapia, käsitellä-asiaa, parantaa
meidän: kevät, meille
virheellinen: väärässä, väärinkäyttö, virheellinen
ihanteellinen: paremmin
kiire: väkijoukko, tahti
korjata: asianmukainen, oikea, luotettava, korjata
suorittaa: show, tehdä
jollakin-tavalla: jokseenkin
käsite: käsitys, konnotaatio, ajatus
keskustelu: pohtia, perustelu
lujasti: vakiintunut, vaikka
vakaa: standardi, korjata, johdonmukainen, pysyvä
imperiumi: kuninkaallinen
kynä: lyijykynä, pää-
lupa: lupa
ylläpitää: pitää, suojella, säilyttää
tungosta: väkijoukko, tiheys
rajoitus: sidottu, rajoitus
kamala: kauhea
portti: satama, ovi
kokenut: kokea, taitava, asiantuntija
vastakkainen: vastustus, vastapäätä, kohti, erottuva
sopimus: muistio, sopimus
tapahtua: tulla
etsivät: kerjätä, haku
käytännössä: melkein, todella, käytännön
jäljittää: merkki, veto
iloinen: onnellinen, hilpeä
järjestely: tilata, luonteenlaatu, järjestäytynyt, sopimus
western: länsi
paine: painotus, painaa, Työnnä, paino
politiikka: poliittinen
tieteellinen: tiede, tiedemies
ansio: kehua, pätevöityä, arvoinen
haastatella: vierailla, haastattelija
alue: ala
sukupuoli: penis, seksuaalinen, kuusi
luominen: luoda, muotoilu, vakiintunut
polku: merkki, vaalit, tapa
näkymä: toivoa, todennäköisyys, visio, näkymä
toiminta: ajelehtia, käsitellä-asiaa, toiminta, kirurgi
syvällinen: syvä
ottelu: uhkapeli, samaan-aikaan, sattuma, rotu
yhdenmukainen: pukeutua
velka: syyttää, uskonto, tulli, luotto
hanke: seikkailu, investointi, yritys
suoritus: toiminta
mieliala: tunne, huumori, luonteenlaatu
miehistö: henkilöstö
havaita: ymmärtää, käsitys, nähdä
julistaa: selittää
versio: kopioida, solu
pariton: outo, epätavallisen
kiitollinen: kiittää
ääretön: ikuinen, infinitiivi
turvallisuus: turvallinen, hoito
järkevä: viisas, järkevä, altis
mökki: kota, hytti
kapasiteetti: pystyvät, taito, tilavuus
asettua: pysyä
osallistuva: kihloissa, liittyä-seuraan
neuvosto: neuvot
tutkimus: koetin, tarkistaa, valita
teräs: rauta-
testata: tarkistaa, yrittää
hyväntekeväisyys: rakkaus
vuodattaa: kaataa, heittää
viestintä: kirjeenvaihto, suhteet
joku: kuka-tahansa, henkilö, kukaan
rivi: linja, järjestysluku, sarja, hallitus, tilata
köyhyys: huono
voimakas: reuna, äärimmäinen, väkivaltainen
riidellä: taistella
saatavissa: mikäli, esittää
vastus: vastustus
epätavallinen: epätavallisen, yhteinen
autio: hylätty, aavikko
äänestää: valita, ääni
kestää: karhu, tukija, kestää, kärsiä
onnistua: menestys
jalka: jalka, luu
tarjous: ehdottaa, pyyntö
sisusta: sisempi
kevyesti: helposti, valo
näyttö: show, näyttely, kuvaruutu, näkymä, näyttö
rajoitettu: rajallinen, vain
tavoite: tarkoitus, fokus
kriittinen: välttämätön, kriitikko
laukku: tasku-, säkki, kori
toistaa: toisto, takaisin, toistuva
seurata: monitori, laulu, tapa, seurata
asuinpaikka: suoja
hauska: onnellinen, hilpeä, viihde
puolustaa: suojella
raskaasti: paino, vakavasti
jutut: pitoisuus, tavarat, asia
jakso: osa, leikkely
tilitys: sopimus, suoja, säätö
levy: paneeli, levy, disko
voittaa: selviytyä, ylittää, lyödä
perustein: syy, ehdot, motiivi
marmori: kivi
kyky: pystyvät, taito, lahjakkuus
aalto: vuorovesi, epämääräinen
kansa: ihmiset, suosittu
mahdollisuus: todennäköisyys, pystyvät
voi: öljy
viha: ylenkatse, vihata
pyrkimys: haku
Vedä: piirtää, sakset
signaali: ele, merkki, salasana
turvallisesti: turvallinen
polttaa: palanut, polttaa-tupakkaa
oppitunti: koulutus, aihe, kurssi
vuotuinen: vuosi
kortti-: pahvi, kartta, lyhyt, paperi
hakemus: käyttää, ohjelmisto, pyyntö
älykäs: henkinen, viisas
lääni: boikotoida, alueellinen, kaupunki, maa
muoto: muoto, heittää
virtaus: virta
vahingoittaa: pilata, vahinko, sääli
lisäksi: lisä-, jopa, lisää
kaupankäynti: käydä-kauppaa
eteläinen: etelä
ulompi: ulos
keskimäärin: toissijainen, tarkoittaa
alasti: häpeä
ilmeinen: ilmeinen, avata, selviö
perusta: pohja, foorumi
koskea: hoito, ahdistunut, liittyvä, kiinnostaa, huoli
taika-: viehätys
kampanja: liike, retkikunta
liberaali: antelias
yleisesti: yhteinen, usein, yleisesti
metsästää: metsästys
opettaja: kirjailija
pian: pian, lyhyt, melkein
siunaus: siunata
pienen-pieni: vähän, mikro
jyrkästi: nopeus, terävä, vakavasti
rinta: rinta
syvyys: syvä
suorituskyky: show, tuottavuus
vauraus: kukoistaa, menestys, hyvinvointi
virkailija: työntekijä, virallinen
päättää: päätös, määritetty, ratkaiseva, liuenneen-aineen
uhri: metsästys, uhrata, tietulli
motiivi: aikovat, motiivi, moottori, tarkoitus, ärsyke
selvä: määritetty, ilmeinen
suuntaus: ominainen, maili, luonteenlaatu, ajelehtia
saada-valmiiksi: päättynyt, väri
lippu: lippu, tietää
hallinto: sääntö, hoitaa
harvoin: harvinainen
aito: virtuaali-, alkuperäinen
koulutus: koulutus, opetus
huonosti: väärässä, erittäin, huonompi, paha, sairas
rehu: syödä, edistää, ruoka
keskeinen: keskusta, liittovaltion-
kontrasti: erottuva, vastustus, konflikti
rakenne: rakentaminen, rakenteellinen, organisaatio
maksu: maksaa
vauhti: nopeus
tiedustelu: koetin, pyyntö, haku
minne-tahansa: missä
velkaa: syyllinen, tulli
kahva: käsitellä-asiaa, hoitaa, selviytyä, manipulointi
matka: vierailla, safari, sightsee, retkikunta
ammu: laukaus, maanpakolaisuus, päästää
työllisyys: työtön, huoli, tehdä-työtä
leikkaus: leikata
vastustaa: vastustus
määrätä: määritin, määritetty, ratkaiseva, määrätä, korjata
kauppias: kauppias, Bisneshenkilö, käydä-kauppaa
vilkas: elää
tuulahdus: ilma
suhteellinen: serkku
siten: siten
säännös: esitellä, mikäli, hyvinvointi, siirtolapuutarha, luonteenlaatu
suhteen: noin, ottaa-huomioon
valita: valita, ottaa
pilalla: tuhota
toimittaa: antaa, esitellä
odottamaton: yllätys
vastaanotto: taulukko, toimisto
kaista: linja, bändi
edustaa: edustaja, esimerkki
kunniallinen: kunnia
vastuu: tulli, syyttää
pettynyt: kunnianhimo, ikävä
sopiva: samaan-aikaan, asianmukainen
riippua: riippuvuus, sidottu
jättiläinen: suuri, hirviö
ymmärtää: ymmärtää, takavarikoida
saapua: tulla, saavuttaa
yksinkertaisuus: yksinkertainen, nöyryys
syksy: pudota
poissa: poissaolo, pois
synkkyys: tumma
epäilty: arvaus, epäillä, epäilyttävä
määritys: määritetty, päätös, kertomus, määritelmä
perusta: pohja, ehdot
tutkia: tarkkailla, tarkistaa, analyysi
palkinto-: palkinto, palkkio
ostaa: ostaa
joku: henkilö, kukaan, vaikka
ymmärtää: saavuttaa, ymmärtää
voittaa: lyödä, kaulakoru, epäonnistua
rikollinen: veri
typerä: typerys, oppimaton
muistaa: muistaa
ammatti: ratsia, ammatti, ammatillinen, aggressiivinen
esitelmä: moderni, puhua
auttaa: auttaa, tuki, yhteistyö
myynti: huutokaupata, myydä, alennus
kutsu: kutsu, puhelu
huonompi: riittämätön, alas, huonompi
tunnustaa: myöntää, diagnoosi
muotokuva: kuva
ehdottaa: ehdottaa, olettaa
pettymys: pettymys, kunnianhimo, antikliimaksi, ikävä, laskea
rakentaminen: rakentaminen
into: innostusta, ahkeruus
vastuullinen: tulli
parantaa: terapia, parantaa, hoito
sisältää: mukaan-lukien, astua, sisällyttäminen, ymmärtää, pitoisuus
tyydyttää: tavata, vakuuttunut, pitoisuus, langeta
tuska: katkera
tyhmä: hullu, oppimaton, typerys
nauttiminen: nauttia
salata: piilottaa
tarkasti: asianmukainen, koko
olettaa: kerjätä, olettaa, ottaa-huomioon
arvio: arviointi, arvaus
reitti: tapa
vierailija: matkustaja, vieras, tarkkailija
ei: ei
johdin: linja
enimmäkseen: erityisesti, enimmäkseen
tajuton: heikko
keskinäinen: toisiaan, yhteinen
ulkoinen: ulos, ulkomainen
maailmankaikkeus: maailmankaikkeus, maailman-
kello: tunnin
opetus: opetus, suunta, manuaalinen
kipeä: haava, sairas, kipu
kuri: aihe
käyttöönotto: esitellä, mikäli, edistäminen, pohjamaali, tuoda-maahan
erämaa: aavikko
sekava: hermostunut, pettymys
häät: naimisissa
puolesta: edustaja, puoli, armo, osa
arvella: uskoa, laskeminen, laskea
epävarma: epävarmuus, epävakaa, epämääräinen
sitoumus: kihloissa, nimitys
likainen: emissio, brutto
lääkäri: lääkäri
päällyste: katettu, sisällyttäminen, katto, kietoa
vilpitön: rehellinen, todella, veridical
tunne: tunne
erityinen: erityisesti, yksityinen, asiantuntija
majatalo: hotelli
jäykkä: kova
seurata: seurata
pisteet: merkki, kertomus
neitsyt-: tytär
nälkä: nälkäinen
suosikki-: suosikki
tulli: perinne, tuuma, tulli, asiakassuhde
vaikuttunut: tunne
saalis: metsästys, ryöstää, uhrata
musikaali: musiikki, muusikko
tyydyttävä: tauti
naurettava: oppimaton, hilpeä
arkki: paperi, lehti, esite
häpeä: häpeä
alun-perin: alkuperäinen
palkat: maksaa
laaja: laajalle-levinnyt, syvä
vapaa-: viihde, tyhjä, jäädä-eläkkeelle, rentoutuminen
leuka: parta
hehku: mulkoilla, valo, säteily, salama
mustasukkaisuus: mustasukkainen
rautatie: rautatie, kouluttaa
punta: kirja
itäinen: itään
kansalainen: siviili-
ranta: rannikko
ominaisuus: elementti, ominainen, omaisuus
varata: säilyttää, kirja
karjaisu: melu
omituisesti: outo
haukkua: aivokuori, iho
vastaanotto: Tervetuloa, kuitti
miellyttävä: epämiellyttävä, ystävällinen
herätä: hereillä
tutkimus: analyysi, haku
hallitsija: keisari, kuningas
vaatteet: kangas, pukeutua, vaatteet
sairaus: tauti, sairas
pila: vitsi, ironia, nauraa
kommentti: selittää
metalli-: rauta-, mineraali
ratkaisu: korjata, päätös, vastaus
tupakka: savuke, polttaa-tupakkaa
kokonaisuus: väline, yksikkö, läsnäolo, organisaatio, yritys, henkilö
lähteä: lähtö, eksyä, crack, mennä
karvaasti: katkera
rauhallinen: hiljainen
huolissaan: ahdistunut
temppu: rekrytoida, askelma, typerys, manipulointi, ovela
taloudellinen: raha, taloudellinen
valmistelu: valmistella
kuori: palko, aivokuori, iho
pesä: elää, pistorasia
ajatella: käsitys, ymmärtää, ajatella
nimittäminen: nimitys, lupaus
noutaa: tuoda, hakea, ottaa
kynttilä: valo, vaha
rikkomus: hyökkäys, rikollisuus, massa-
seos: sekoitettu
malli-: esimerkki
vika: syyttää, rypistyä, vammaisuus
vastalause: erimielisyys, vastustus, ristiriitaisuus
alus: taide, ammatillinen, taito
laiminlyödä: jättää-huomiotta, hylätty, laiminlyönti, boikotoida
tiedot: tiedot
ase: aseet, ase
vaaleanpunainen: ruusu-
käyttäjä: noin, edunsaaja
isoisä: kantaisä, isovanhempi
tyhjä: nolla-, tyhjä
voimakas: väkivaltainen
salama: elektroninen, pultti, salama
urheilu: liike, liikunta
jauhe: jauhot, pöly
maalaus: kuva, paneeli
huutaa: melu, veitsi, itkeä
varomaton: holtiton, välinpitämättömyys
johdannainen: johtua
oviaukko: ovi
mukava: yksinkertainen, käytännön, mukava, helposti, asianmukainen
posti: postitoimisto, kirje
maali-: väri
antautuminen: perinne
perustaa: esitellä, vakiintunut, korjata
lievä: pehmeä, valo
viipymättä: kerran, asianmukainen
osasto: osa
ansaita: arvoinen, pätevöityä
lopettaa: hylätty, ilmaantua, crack, heittää
varmuus: vakuuttaa, takaus
peili: lasi-
juoni: salaliitto, suunnitelma, tarina
ylöspäin: lisää
valitettavasti: surullinen, valitettavasti
vaatimaton: yhteinen, yksinkertainen, nöyryys, säästäväinen
ruokalaji: tuomioistuin, ruoka, syödä
netto: verkko, veridical, pyhä
lämpö: innostusta, lämmin
levoton: ahdistunut
kokeilu: lentäjä, kokea, yrittää
tänään: päivä
valtava: kauhea, suuri, massiivinen, erittäin
parannus: uudistaa, korjaus, edistyminen, elpyminen, parantaa
riita: erimielisyys, perustelu
ehdotus: ehdottaa, tuomita
voi-olla: ehkä, voisi
kivääri: ase
kilpi: suojella
käyttää: vuokrata, käyttää
toisin-kuin: eri
toipua: tallentaa, hakea, elpyminen
perämies: sylkeä, kollega, ystävä
järjestää: tilata, säätää-lakeja, järjestäytynyt
valiokunta: paneeli, komissio
ikäinen: vanha
aave: sielu
ilmestys: ilmaisu
tunnustaminen: myöntää, tunnustus
savi: muta, mooli
runko: heimo, matkatavarat, tavaratila
johto: hoitaa, ajo-
palauttaa: säilyttää, takaisin, elpyminen, hakea
protestoida: vastustus, maaliskuu
kasa: kaatopaikka, panos, väkijoukko
kohtalainen: toissijainen, tarkoittaa
loitsu: viehätys, oikeinkirjoitus
alue: ala, alueellinen, pinta-
muodollinen: virallinen
toimittaja: kirjailija, kustantaja
tunnustaa: tunnustus, myöntää
parannuskeino: lääketiede, terapia, korjata
harjoittaa: langeta, monitori, viettää, seurata
napa: anteeksi, sarake, äärimmäinen, napa
elintärkeä: välttämätön, ratkaiseva, avain
presidentti: pää-
osasto: siipi, alueellinen, osa
neiti: 
eläköön: sydän, innostusta
perusteltu: järkevä, oikea, perustella
ihailla: kehua
avoimesti: nimenomaisesti, avata, aukko
muutos: muuttaa, sovittaminen
dramaattinen: draama, demonstratiivinen
yläkerrassa: edellä, huonompi
vaihteleva: eri
laskeutuminen: luonto
kateus: mustasukkainen
ladata: paino, rasitus, baari, heimo
teeskennellä: teeskennellä, draama
sisäinen: sisempi
verho: huntu, kuvaruutu
terve: terveys
hämärä: epämääräinen, pimennys
keskusta: keskusta
kilpailu: rotu
muuttaa: muuntaa, muuttaa, korvata
vilaus: silmäys, visio
sopimus: muistio, tilata, pitää, sopimus
säästö: tallentaa, varastointi, taloustiede
jono: köysi, ketju, sarja
yhdistelmä: sattuma, sekoitettu, sarja, puhelu
pidätys: kiinnittyä, käsitys
lämpötila: lämmin
tiukka: tiukasti, terävä, kova
ammattilainen: ammatti, ammatillinen
loukkaantunut: haavoittunut, vahinko
naapuruus: ympäröivä, elää, ympäristö-
tupakointi-: polttaa-tupakkaa, savuke
lääketieteellinen: lääkäri
ilmoittaa: sanomalehti
näkyvä: suosittu, mieleenpainuva, johtuva, avain, tunnettu
laitos: järjestäytynyt, yritys, organisaatio
pakata: kietoa, kiinni, pakkaus
ahdistus: katkera, kurjuus, kipu, suru
ilmeisesti: ilmeinen, avata, nimenomaisesti
kaapata: valloittaa, ottaa, käsitys
runsas: tarpeeksi, riittämätön
makuuhuone: huone
puhtaasti: vain, täysin, pyhä
yhteinen: yhteinen, sekoitettu, puhelu
katso: viite, konsultoida
tunnistaa: identiteetti, tunnistettavissa, korjata
penkki: pankki
pelastaa: elpyminen, tallentaa
rajoittaa: sidottu, lyhentää
odotus: odottaa
ohjelmoida: suunnitelma, esityslista
sähköinen: elektroninen
intervalli: väliaikainen, tauko
ajaa-takaa: metsästys
miehittää: ottaa, takavarikoida
puku: takki, pukeutua, puku
lukko: linna
ehdotus: ehdottaa, tuomita, suunnitelma, johtopäätös
onneksi: onnellinen
myöhempi: seuraava
levoton: epävakaa, epämiellyttävä, ahdistunut, kova
loistaa: mulkoilla, salama
koneet: mekaaninen, kone, mekanismi
houkutteleva: magneettinen, piirtää, toivottava
tuote: tavarat
sairaus: tauti
moottori: moottori, kone
heidän: ne
nahka-: iho
hienovarainen: mikro, ohut
rinne: maili, sukeltaa, taipunut
huoli: ahdistunut, huoli
väkivaltaisesti: kova
määritetty: määritetty
puutavara: puinen, tikku, puu
laskea: laskeminen, laskea
tappaminen: tappaa
hauska: outo, hilpeä
loukkaus: ylenkatse, häpeä
kyvytön: pystyvät
ruokailla: syödä
herkkä: altis, avain
ruokahalu: halu
kohteliaisuus: kohtelias, kunnia
pallo: ala, pallo, alueellinen
kunniavirat: kunnia
syyllisyys: syyllinen, rikollisuus, syyttää, synti
herkullinen: maukas, maku
vehnä: kansanperinne, jyvä, maissi
huumori: huumori
kohdata: selviytyä, tavata, päivämäärä
iltahämärä: valjeta
pysäköidä: puutarha
talous: taloudellinen, taloustiede
hallita: hoitaa, sääntö, hallita
muodostus: koulutus, muotoilu
nojata: maili, ohut
lyödä: epäröidä, nokare, lyödä
yhtenäisyys: yhdistynyt, yksikkö, solidaarisuus
merkittävä: pioneeri, avain, vanhempi, suuri, nitoa
alustava: aukko, alkuperäinen
raja: sidottu, reuna
hengittää: hengitys
vapauttaa: ilmaiseksi, eroon, antaa-anteeksi
varakas: rikas
inspiraatio: impulssi, innostaa
jokainen: kaikki
runsas: rikas
taidemaalari: taiteilija
lasit: lasi-
ammunta: laukaus, metsästys
vaunut: kouluttaa, johdinauto
lainata: antaa, luotto, lainata
sitoutuvat: alku, tehdä
tiiviste: rengas
papisto: pappi
asentaa: asentaa, lisätä, mäki
ryhmä: sarake, sarja, tilata
aikakauslehti: lehdistö
ankara: kova, tiukasti
huolimatta: vaikka
tiukka: tiukasti
maisema: skenaario, ympäristö-, visio
luopua: hylätty
taiteellinen: taide
pääasiallisesti: erityisesti, enimmäkseen
uskollinen: uskollisuus, rehellinen, luotettava
sopiva: yhtenevä, samaan-aikaan, asianmukainen
neuvoa: neuvot, neuvonantaja
vakaa: vakiintunut, määritetty, standardi
maksimi: maksimoida, äärimmäinen
sitoutua: lupaus, tehdä
vaikuttaa: vaikutus, tehdä-vaikutus
talonpoika: maanviljelijä
huomattavasti: erittäin, johtuva
pidentää: yksityiskohta, laajentaa, venyttää
henkilökohtaisesti: erikseen, yksityinen, oma
moraali: moraalinen
kapina: kapinallinen, vallankumous
kierre: linja, kierre
kupari-: messinki
vastaus: reaktio, vastaus
keisarillinen: kuninkaallinen
tyhjä: tyhjä, ontto, valkoinen
vähäinen: toissijainen, vähän, kaivosmies
tinkiä: käydä-kauppaa, tilaisuus
väsymys: väsynyt, rasitus
vastenmielisyys: ylenkatse, vihata, haluttomuus
normaali: yhteinen
luonnos: ääriviivat, suunnitelma
hyveellinen: hyve
joka-tapauksessa: kuitenkin, jo
kuljettaja: autoilija, ajo-, kapellimestari
ilmoitus: ilmoitus
ylimäärä: lisä-, irtisanominen
erottaminen: disjunktio, etäisyys, erotetaan
inho: ylenkatse, fobia, vihata
oikeutetusti: sama, asianmukainen
väkijoukko: väkijoukko, massa-
tarpeeton: jätteet, täytyy
turkis: iho, takki
kannustaa: innostaa, Työnnä
kunnianosoitus: vuokrata
lievittää: vähentää, eroon, antaa-anteeksi
lainsäädäntö: säätää-lakeja, sääntö, lainsäätäjä
hanke: suunnitelma
keijukainen: enkeli, sininen, huvila
solmia: pitää, johtopäätös
onnekas: onnellinen
kierros: polvi, esiliina, pyöristää
pilata: ryöstää, pilata, hieno-ihminen
velvollinen: helposti, yleensä, altis
huomaavainen: varovainen, ahdistunut, viisas
suotuisa: yhtenevä, flex, toivottava
tina: pankki
riippuvainen: riippuvuus, liitteenä, työntekijä
oikeuttaa: vakuuttaa, perustella, muistio
valitus: valkoinen
sopimus: muistio, sopimus
kulma: nurkka, monikulmio
laajalti: laajalle-levinnyt, erittäin, yleisesti, enimmäkseen
lehmä: nautakarja
ennakkoluulo: vihata
kuisti: sali, parveke
yllättävä: outo, hämmästyttää, yllätys, huomiota-herättävä
suihkulähde: lähde
tarkoituksenmukainen: asianmukainen, puku, johdonmukainen
luottavainen: rohkeus, turvallinen, uskoa
elin: väline, jäsen, elementti, elin
valinta: valita, nimitys, vaalit
awe: fobia, pelko
vertailla: vertailu
koskevat: kiinnittyä, koukku, suhteet, liittyvä
olettaa: uskoa, arvaus, olettaa, ottaa-huomioon
puuttuva: menetetty
muodikas: moderni, tyylikäs
positiivisesti: positiivinen
perustelut: ajatus, perustelu
häiritä: hermostunut, aggressiivinen, häiritä, ärsyttävä
kumppani: tyttöystävä, yhteinen, osakas
yhdistys: luettuna, ottaa-huomioon
veljentytär: veljenpoika, tyttärentytär
ruumiillinen: fysiologinen, elin
tiedekunta: college, kertoma
tykki: pallo, tykistö, ase
purjehdus: laiva, huntu
fiksu: viisas
pikkumainen: rengas, triviaali, vähän
varovaisuus: varoitus, hoito
käsikirjoitus: laskuttaa
soturi: sankari
neste: vesi
käsite: käsitys, konnotaatio
erityisesti: erityisesti
hypätä: lentää, tanssi, kantapää, pomppia
haluton: aikovat
ylimääräinen: lisä-
piki: jalkakäytävä, sävy, ei
hankala: riittämätön, outo
arvostaa: kiitellä, nauttia
hengissä: elää, pysyä
lyhyesti: akronyymi, lyhyt
riisi: messinki
kaveri: henkilö
käytös: ominainen, käytös
hyväksyä: olettaa, ottaa
säännöllisesti: usein, toistuva, pysyvä, asianmukainen
tutkimus: koetin, haku
perustuslaillinen: perustuslaki
viimeisin: kestää
oppilas: opiskelija-
täysin: täysin
kierretty: taipunut
erota: erotetaan, ero, eri
katastrofi: pilata
veto: panos, kunto, veto
raaka: elää, lähde, brutto, vihreä
loki: astua, rekisteröinti, maila
vieraanvaraisuus: antelias
kärry: kouluttaa, johdinauto
kaapu: pukeutua
sitoutua: liitteenä, käyttää, vuokrata, säilyttää
lauma: parvi
kerätä: kerätä
panoroida: pannu
hyökkäys: hyökkäys, ratsia
pettää: typerys, pettää
suruaika: suru
peruuttaa: eroon, piirtää, jäädä-eläkkeelle
virittää: laulu, harmonia
myötätunto: empatia, sääli
peittää: piilottaa
transkriptio: kopioida
asiakirja: tiedosto
naapuri: ympäröivä
lohko: estää, tilavuus
velvollisuus: tulli
aleneminen: kieltää, pudota
kunnianhimoinen: kunnianhimo
loma-: loma, juhla
nyrkki: ensimmäinen
kotka: haukka, solmio
kunniallinen: kunnia
merkittävä: välttämätön, johtuva, huomiota-herättävä
tiheä: kompakti, paksu
kaunokirjallisuus: romaani, mielikuvitus, tarina
suositella: ehdottaa, esitellä, neuvot
koulutus-: koulutus
ylöspäin: lisää, edellä
sarvi: maissi
rahoittaa: laatikko, pääoma
jättää: kota, tiedosto, hytti
puku: pukeutua, puku, asiakassuhde
hinta: vuokrata, mennä, kartta
suosionosoitukset: kiitellä, hyväksyminen
muistuttaa: muistaa, muistuttaa
tyyny: joki
ei-mihinkään: paikka
ruumis: elin
olemus: solu, olento
korkeus: jyrkkä
valtakunta: ala, maailman-
portaikko: portaat, asteikko
sopimus: muistio, kompakti, puku, samaan-aikaan, sopimus
pitsi: piikki, tulo
tutkija: opiskelija-, tiedemies
hallitsija: herttua, kuvernööri
hullu: hullu, typerys
viihdyttää: Tervetuloa, huvittaa, viihde
tervehdys: Tervetuloa, postikortti
naisellinen: naaras-
hirvittävä: hirviö, kauhea
laitos: laitteet
ryöstää: varastaa, ryöstää
tikapuut: portaat, kapellimestari, asteikko, koulu
pääte: kestää
jakaa: ero, jakaa
uskomaton: outo, epätavallisen
kaari: keula-
valita: vaalit, valita
ujo: ujous, häpeä
sumu: sumu
värillinen: väri
varoittaa: varoitus, aiheuttaa
matala: syvä
rohkaisu: ärsyke, mukavuus
epäsäännöllinen: yhteinen, epätavallisen
uskollisesti: uskollisuus, luotettava, asianmukainen
siirtää: käännös
perusteellinen: pohja, nitoa
nippu: kiinni, kuitu
traaginen: kauhea
arvostelu: tarkistus, kritiikki
kamalan: kauhea, erittäin, huonompi
ruoanlaitto: kokki, keittiö
kapina: kapinallinen, vallankumous
parantaa: korjata, parantaa
tuhota: tuhota
vakuuttaa: suostutella, vakuuttaa
kulho: kuppi
kuva: esimerkki, kuva
hermo: suoni, rohkeus, hermostunut
tuijottaa: korjata
varmistaa: tietää, vakuuttaa, määritetty, tarkistaa, korjata
pantti: vakuuttaa, lupaus, panttivanki, takaus, sotilas
ansaita: palvella
valita: valita
teollinen: teollistuminen, teollisuus
tulkinta: käännös
haaste: puhelu
kieltää: estää, kieltää
teema: motiivi, aihe
sisäänpääsy: kuitti
pool: uima-allas, kuoppa
konferenssi: istunto, kokoonpano
tasa-arvo: analogia, saldo, vastaavuus, yhtälö
hiljattain: neo, äskettäin, romaani
ympäristö: ympäristö-, ympäröivä
invaasio: hyökkäys, ratsia
kuvio: esimerkki, kerran, standardi, muoto
paljastaa: paljastaa, pettää
ratkaista: löysä, korjata
saarnata: saarna
isoäiti: morsian, isovanhempi
villa-: puuvilla
ilmoittaa: vuoropuhelu, seurustella, suhteet
olennaisesti: ehdot
vastustaa: vastustus
yksilö: esimerkki
vetää: piirtää, sakset
sato: viljelykasvien, sato, leikata
tarkka: asianmukainen, jauhot, varovainen
lomakeskus: ottaa, suoja, tauko
epääminen: kieltää, jätteet
side: avain, takaus, copula
sympaattinen: sääli
palkkaus: maksaa
jatkuva: jatkaa
kiihottaa: aiheuttaa, yllyttää
villisti: villi, väkivaltainen
surullisuus: suru, tragedia
liittoutunut: yhdistynyt, liittyvä
katto: viltti, katto
tavoite: fokus, tarkoitus
kassa: raha
vapaa: avata, ilmaiseksi, tyhjä, löysä, epämääräinen
halveksia: ylenkatse
nurmikko: ruoho, niitty
Turkki: 
naapuri-: ympäröivä
perimmäinen: kestää, äärimmäinen, vihdoin, nitoa
jättämisestä: totella, lähettää
merkintä: astua
perusteellinen: syvä, koko
jännittävä: piirtää, utelias
voittoisa: menestys
konservatiivinen: ortodoksinen, kuvernööri
innostunut: innostusta, ahdistunut
alakerrassa: alas
kiehua: kokki, haava
kauniisti: kauneus, kaunis
huomenna: eilen
epämiellyttävä: ahdistunut, epämiellyttävä
laitteet: laitteet
puolustaa: vaatia
lausahdus: lausua, ilmaisu
rautatie: rautatie, kouluttaa
epätäydellinen: koko, vammaisuus, virheellinen
hankkia: hankinta, johtua, ostaa
hyökkäys: ratsia, hyökkäys, aggressiivinen
kylmästi: kylmä
luento: kurssi
jonka-mukaan: missä
havaitseminen: tunne, silmäys, käsitys
kehittää: kehittää
toiminto: seremonia, tehdä-työtä, toimintaa
luoti: tabletti, laukaus, pallo
sitoa: kiinnittyä, sidottu
identtinen: sama
merkittävä: demonstratiivinen, suuri, johtuva, huomiota-herättävä
irto-: massa-, suuruus, tilavuus, kasvain
pitkittynyt: pitkä, viipyä
vihainen: ärtynyt, epämiellyttävä
allapäin: hermostunut, surullinen
nippu: copula, bändi
heinä: ruoho, olki
keskustelu: erimielisyys, perustelu
hiljaisuus: hiljaisuus
osittainen: poikkeus, osa
naudanliha: liha
yhdistää: solidaarisuus, valjaat, sovittaa-yhteen, liittyä-seuraan
terä: lehti, miekka, veitsi
tehdas: mylly
tyhjä: nolla-, tyhjä
aikakauslehti: sanomalehti, lehdistö
rehellisesti: uskollisuus, rehellinen
laillinen: oikeudellinen
aksentti: lausua, painotus, fokus
vilpittömästi: vakavasti
liiga: liitto
hyväksyä: hyväksyminen
raaja: jäsen, äärimmäinen
stuertti: johtaja, palvelija
evoluutio: uudistaa, evoluutio-
tutkimus: tarkistaa, haku
nykyajan: moderni
skandaali: korruptio
tarkoituksellinen: tarkoituksella
symboli: merkintätapa, ele
pesu: pestä, pesula
tarkka: asianmukainen, jauhot, varovainen
esiintyminen: tapaus, tilaisuus
akseli: oja, olkapää, puu
varsi: kuiva, heimo, juuri
yhtiö: yritys, organisaatio
etusija: etuoikeus, mieluummin, etu, valita
halu: aiheuttaa, impulssi, halu
poistaminen: etäisyys
väite: hyväksyminen, painotus
pääsy: vierailla, löytyi
komedia: huumori
väri: väri, jännitys
koodi: piha, koodittaa
riittävä: tarpeeksi, asianmukainen
jakaa: jakaa
historioitsija: historiallinen
intensiteetti: tiheys, rasitus
demokratia: tasavalta
uskontunnustus: tunnustus
nähtävyys: viehätys, painovoima
konsertti: festivaali
alaspäin: alas
kanava: kanava, putki
nopea: pian, pyyntö, ketterä
pronssi: messinki, ruskea
vaate: vaatteet
katumus: surullinen, sääli
yksinomainen: monopoli, yksityinen
portteri: pitää-päällä, kantaja
kojelauta: linja
kaistale: bändi
lopulta: vihdoin
joukkue-: kertosäe
kallis: rakas
päämaja: pääkonttori, keskusta
akuutti: terävä
hämmentynyt: hermostunut, häpeä
jälkeläiset: lapset
verkko: verkko
kone: lintu, pinta-, kone
osittain: osa
ylpeänä: ylpeys
terassi: parveke, katto
pito: pitää, ansa
räjähdys: räjähtää
joukko: armeija, sotilaallinen
tiukasti: tiukasti
rangaistus: sääli, tuomita
lika: kostea, ulosteet, muta
aikakausi: kausi
suurlähettiläs: sanansaattaja
rotu: moninkertaistaa, rotu
häiriö: häiritä, harmi, häiriö
muodostuvat: syöttö, pitoisuus
hyväksyminen: hyväksyttävä, hyväksyminen, kuitti
insinööri: mekaaninen
pysäyttää: jalka
vaihtoehto: vaihtoehtoinen, korvata
leima: rengas
laskuri: levy, vastustus, vastapäätä
Venus: perjantai
kuvitteellinen: mielikuvitus
kiipeily: nousta, hiipiä
vetää-puoleensa: piirtää, tehdä-vaikutus
hämmästyttävä: yllätys, huomiota-herättävä
kilpailu: kilpailija
kristalli-: lasi-
suihku: kylpy, sade
filosofinen: filosofi, filosofia
meluisa: melu
laite: laitteet
kuljetus: liikenne, sukkula
lopulta: vihdoin
kauhean: erittäin, kauhea
miettiminen: heijastaa, heijastus
valmistus: teollisuus, tuottaa
mukavasti: mukava
näyttely: näyttely, kertomus
maatalous-: maatalous, maatila
etsintä: haku
laajentaminen: yksityiskohta, laajentaa
kiista: ristiriitaisuus, perustelu
karkeasti: melkein
yläpuolella: edellä
hillitä: esto, estää, rajoitus, säilyttää
säilytys: tallentaa, hoito, säilyttää
pub: baari
pesuallas: laakso, uima-allas, pesuallas
melodia: sävy
vuokraus: vuokrata
huolestunut: ahdistunut, hermostunut
vanhukset: vanhuus, vanha
yliopisto: college
varovainen: varovainen
ennen: itään, ennen
monimutkainen: monimutkainen, kova, kehittää
anteeksipyyntö: pyydä-anteeksi, anteeksi
pelästynyt: pelästynyt, pelko
korvike: vaihtoehtoinen, avustus, korvata
käyttö: käyttää
palauttaminen: korjaus, elpyminen, hakea
hedge: aita
ensisijainen: hallita, pohja, alkuperäinen, nitoa
palkki: säde
kiertue: vierailla, retkikunta
liioiteltu: suolaa
pätevä: mahdollistaa, pystyvät
kiireellinen: pian, saostaa
hälytys: varoitus, hälytys, hereillä
uuni: liesi
pyöristetty: pyöristää
tavanomainen: yhteinen
anoa: kerjätä, perustella
johto: köysi
rinnalla: yhdensuuntainen, seuraava, luettuna
ote: lainata, mehu
sytytin: valo
pint: olut
putki: putki
katu: tilaisuus
tehokas: taitava, tehokas, vaikutus
sekoittaa: sekoitettu, herättää
häiriö: häiriö, harmi
johtaja: johtaja
kymmenes: kymmenen
vertaileva: vertailu
aamupäivällä: aamu, kiiltävä
häkki: linna, solu
vankila: vankila, ketju
taitava: taitava, ovela, pystyvät
huutaa: itkeä
vaarantaa: sopimus, harmonia
ammukset: laukaus
avustaja: tukija, auttaa
ruoko: tikku
väitellä: pohtia, vaatia
logiikka: perustelu, järkevä, järkevyys
paniikki: pelko
verenkierto: pyöräily, sykli, liikenne, sightsee
korostaa: rasitus
kulutus: käyttää, kuluttaa, syödä
pitää-yllä: tuki, säilyttää, pitää, kärsiä
romahdus: pudota, konflikti
puuttuva: riittämätön, leikata, virheellinen
asteittainen: vähitellen
murskata: tuhota, painovoima, squash
ilmiö: tapaus, asia
suorittaa: ajaa, toiminta
tervehtiä: terveys, Tervetuloa, rakeet
monarkia: kuninkaallinen, omaisuus
käyttäytyä: elää
este: este, kynnys
käyrä: keula-
luottaa: laskea
sopivuus: helposti, mukavuus
lammas: lammas, hiipiä
looginen: järkevä
ruokavalio: ruoka
oikeus-: tuomioistuin, oikeudellinen
epäluottamus: epäillä, uskollisuus
sulka: kevät, sääli
vapaaehtoinen: vapaaehtoinen
takki: takki, villapaita
uima-: uida
vaikuttava: huomiota-herättävä
alla: alas, jälkeen
maakunta-: maaseudun, maakunta
korvaus: hyvittää, avustus
Tarjoilija: palvelija
edistää: kiihtyvyys, edistäminen, edistää, Työnnä, myötävaikuttaa
omistaa: aikovat
vihamielisyys: vihamielinen
plantaasi: maatila, lastentarha
paljastaa: ääriviivat, paljastaa, avata
läikkä: paikka, liite
keskeytys: tauko, harmi
peukalo: tuuma
vallankumouksellinen: vallankumous
hämmästyttävä: outo, hämmästyttää
kärki: aivopuolisko, piikki, äärimmäinen, parta, huippukokous, neuvot
uhkaus: uhkaava, vaara
viidakko: metsä
tyypillinen: yhteinen, ominainen
polttoaine: öljy
rauhallinen: hiljainen
määränpää: toisto, tarkoitus, kohtalo
tappi: salaisuus, neula
Mars: maaliskuu
kumppani: liittyvä, kollega, luettuna, yhteinen, yhdensuuntainen, liitteenä
häijy: moraaliton, paha
banketti: juhla
yksityiskohtainen: kehittää, syvä, sarana, yksityiskohta, varovainen
komero: kaappi
lainsäädännöllinen: säätää-lakeja, lainsäätäjä
marginaali: reuna, ala
mestari: sankari
pulssi: impulssi
pakenevat: ajaa, paeta
lauseke: virta, kohta
yhdiste: luettuna, monimutkainen
solmu: pitää, neuloa
yhteys: suhteet, kertomus, ottaa-huomioon
toimisto: organisaatio, yritys, toimisto
virne: hymy, irvistys
esittely: show, maaliskuu
masennus: suru
ajoneuvo: kone
lainata: luotto, lainata
turvotus: turvota
aihe: motiivi, aihe, otsikko
tuomio: päätös, sääntö
sapatti: lauantai
henkilöllisyystodistus: tunnistettavissa, identiteetti, määritelmä
valokuva: kuva, laukaus
liittolainen: ystävä, ystävyys, yhdistynyt
alue: tapa, venyttää, perustelu
nauha: bändi, elokuva
plus: lisää
läpinäkyvä: läpinäkyvyys, ilmeinen
hajuvesi: haju
vaivautua: vaivata, häiritä, ärsyttävä, harmi
pätevä: pystyvät, pätevöityä, taitava
essee: artikla, kertomus
ratsastaja: ritari, ratsastus
yksinäisyys: yksinäinen
ranne: käsi
hienoksi: pehmeä, ohut, vihdoin
tyhjä: nolla-, tyhjä
tuomita: tuomita
leuka: mänty
ainutlaatuinen: yhdistynyt
väistämättä: väistämätön
rumpu: tanssi, tyhjä
astia: laatikko, kori
kesto: väliaikainen, pysyvä, aika, pituus
punnita: mitata, paino
luostari: luostarikirkko
julkaista: julkaisu, jakaa, paljastaa
oivallus: visio
ehdottomasti: ilmeinen, tiukasti, kurssi, todella, nimenomaisesti
siirtää: muuttaa
tänä-iltana: päivä
tekijä: syy, työntekijä, kerroin
sotku: aggressiivinen, häiriö, sekaannus
harjoitella: liikunta, toiminta
pyhäkkö: alttari
kutistua: akronyymi, kerätä
menot: kulu, käyttää, viettää
rohkaiseva: sydän, innostaa
valotus: ilmaisu, näyttely, kertomus, vaikutus
raakaöljy: brutto, vihreä
lippu: lippu, kartta
taaksepäin: takaisin
kenkä: kengät, tavaratila
petos: illuusio
räjähdys: räjähtää
takka: savupiippu
purkki: lasi-, pullo, syöttäjä, pannu
kastike: pukeutuminen
mätä: laiska, moraaliton, huono
käytös: ominainen, käytös
lainata: luotto, lainata
kohtuuton: järkevä, järjettömyys
himo: kunnianhimo
vuosittain: vuosi
neste: vesi
lapsi: lapset
mielenvikainen: hullu, typerys
kaataa: kaataa
saavutus: menestys, arvo, hyödyntää
olettamus: olettaa, mielikuvitus, muka
humoristinen: huumori, hilpeä
ekstaasi: innostusta
eläke: jäädä-eläkkeelle, eroaminen, eläke
eduskunta: lainsäätäjä, senaatti
hätä-: ahdistunut, kriisi
paketti: kietoa, osa, kiinni
laatikko: laatikko, portaat
panos: myötävaikuttaa, panos
linkki: liite
nyppiä: rohkeus, kiristää
painaminen: julkaisu, painaa, lehdistö
puolestapuhuja: lakimies, perustella, vastaaja
ympäristö: ilmapiiri, ympäristö-
vahvistaa: todistaa, vakuuttaa, vahvistaa
ilmoittaa: paljastaa, julkaisu
erota: eroaminen, jäädä-eläkkeelle
hylätä: kieltää, veto
kova: kova, julma
katkelma: siru, suupala, romu, venyttää
meditaatio: hoito, heijastaa
tahra: paikka
hautaaminen: hautajaiset, haudata
hypoteesi: olettaa
hypoteettinen-mieliala: keinotteleva-mieliala, assumptive-mieliala, ehdollinen-mieliala
kauppa: toimintaa, käydä-kauppaa
skandaali: suututtaa, ylenkatse, häpeä
vaihdella: muuttuja, eri, korvata
asianajaja: lakimies, edustaja
loukata: syyllinen
paketti: kietoa, tasku-, kiinni
klassinen: klassinen
karjatila: maatila
piirakka: kakku, pii
tarkasti: oikea, tarkkuus, tiukasti
sinkauttaa: heittää
meren-: laivasto, meri
laulaja: lukija
sähkö: elektroninen, virta
ulkomaalainen: ulkomainen, vieras, avaruusolento
säröillä: räjähtää, crack
masentunut: surullinen, suru
paksusti: paksu
kohtuullisen: syy, järkevä
kaapeli: ontto, flex
valaista: selittää, heijastaa
hyväksyminen: hyväksyminen, kuitti
pahamaineinen: tunnettu
vahingoittaa: vahinko
oikein: tarkkuus, asianmukainen, oikea
laidun: paju, niitty
mato: naamio, syvä
arviointi: arviointi, arvaus
asu: organisaatio, vaatteet, laitteet, pukeutua
onneton: onneton, valitettavasti
kahdeksas: kahdeksan
rento: mukavuus, rentoutuminen, hiljainen
viereiset: melkein, ympäröivä
vanhempi: veteraani-, vanhempi, pää-
pelotella: hälytys
tutor: valmentaja
ryöstö: ryöstää, varastaa
kaupankäynti: käydä-kauppaa, kaupallinen
Sukupuuttoon-kuollut: kadota
kyhmy: massa-, torus, lommo
satunnainen: satunnainen, väliaikainen, sattuma, yllätys
tilat: talo, paikka, rakentaminen, sisällä
toimitus: esitellä
kaareva: taipunut, flex
tuottava: valmistaja, tuottaa
turvonnut: turvota
viljellä: edistää, maatila
vaihtelu: muuttaa, ero
vastustaja: kilpailija, vastustus
pojanpoika: tyttärentytär, veljenpoika
naulata: kynnet, piikki, pultti
hyväntahtoisuus: antelias, hyvinvointi, hyve, armo
tarkkuus: tarkkuus
osoitus: merkki
vähentäminen: vähentää, leikata
vatsa: vatsa, napa
tympääntynyt: vihata
säveltää: kirjoittaa, luoda
matkustaja: matkustaja
pisto: puukottaa, katkera, purra
samanaikaisesti: sillä-välin
episodi: johtuva, osa
sinnikäs: johdonmukainen, jatkaa, pysyvä
nähdä-nälkää: nälkäinen
neuvottelu: konsultoida, neuvot
hapan: happo
korostaa: vaatia, painotus
paraati: maaliskuu
kypärä: hattu
julistaa: propaganda, julkaisu
majoitus: hotelli
spray: lääketiede
muodollisesti: virallinen
järkyttävä: hermostunut, häiritä, ahdistunut, ärsyttävä
ennakointi: odotettu, odottaa
luokka: silta, kerroin, arvo, arviointi, aste
jakkara: ulosteet, tuoli
oikeutus: perustella
ulkomaalainen: ulkomainen, vieras
kuljetus: liikenne, sukkula
ymmärtäminen: ymmärtää
johtaja: johtaja, pää-
ajallinen: väliaikainen, aika
kauniisti: kaunis
valvoa: määrätä, hallita-pakolla, mahdollistaa, valvoa
kattava: syvä, koko
uhata: uhkaava
etenevä: edistyminen, radikaali
resurssi: lähde
rajoittaa: rajallinen, takavarikoida, lyhentää, vähentää
onnitella: kehua
vakuutus: turvallinen
nimittää: silmä
keskeyttää: este, leikata, häiritä, amputoida, tauko
tukahduttaa: sortaa, estää
kerros: sarake
vihje: näyttö, avain
hammas: hampaat, hammaslääkäri, lommo
takuu: vakuuttaa, takaus
menettely: käsitellä-asiaa, mekanismi, toiminta, lähestyä
suositus: neuvot
aukko: tauko, aukko
vihjata: tarkoittaa
liittää: liitteenä, liitos, kiinnittyä
ryhti: ele, osoitin, sijainti, seistä
sviitti: siipi, sarja, huoneisto
helmi: aarre, kukoistaa
tunteellinen: tunne, intohimoinen, altis
betoni: demonstratiivinen, johdonmukainen
yhdistää: liitto, luettuna
huippu: huippukokous
valuutta: raha, kolikko
tavoite: tarkoitus, fokus
muistomerkki: muisti, varoitus
erikseen: erotetaan, ero, erikseen, yksinäinen
tarjotin: levy
vaakasuora: saldo
vuokrata: perustuslaki, paperi, vuokrata
erä: tavarat, artikla, elementti, ääni, ystävällinen, sijainti
laajeneminen: yksityiskohta, laajentaa
kierre: pultti, kierre, ironia
perinteinen: perinne, klassinen
sisältää: mukaan-lukien, sisällyttäminen, pitoisuus
rutiini: yhteinen, mekanismi
ratkaista: aura, löysä, korjata
houkutella: härnätä, aiheuttaa
epäonnistunut: epäonnistua
poliitikko: poliittinen
kansi: katto
rikkominen: vahinko
liittymä: järjestysluku, ylitys
pomo: omistaja, johtaja, työnantaja, pää-, varas
laitteisto: laitteet
säie: rannikko, bändi
Brink: reuna, rantakallio, huuli
kauppatavara: käydä-kauppaa, tavarat
syrjässä: erotetaan, pois, kauko-
turvapaikka: sairaala, suoja
vakuuttaa: todistaa, vakuuttaa
ajoittaa: taulukko, kalenteri, kartoittaa, luonteenlaatu
kaivanto: oja
kunnallinen: kaupunki
mellakka: herättää
todistaa: todistaa
äidin: raskaana, äiti
veistos: patsas
maku: maku
merkki: manuaalinen, merkki
matkatavarat: matkatavarat
roskat: järjettömyys, romu, kaatopaikka
työkalu: väline
kaaos: häiriö, sekaannus
syyte: puku
jännittynyt: hermostunut, aika
kana: kana
leikata: ornamentti, vähentää, leikata
hienovarainen: viisas
surra: itkeä
murre: kiillottaa
alkeis-: pohja
rahti: matkatavarat, baari, kuorma-auto
pyyhkiä: lakaista
kieltäminen: kieltää
maanalainen: salaisuus
väli-: tarkistaa
kaava: yhtälö, lehdistö
huijata: typerys, manipulointi
kummitella: epäröidä, fobia
ilmoittautua: lista, rekisteröinti
epämääräinen: epämääräinen, aoristi
ylijäämä: lisä-
väristys: vapista
kudos: organisaatio, verkko, kangas
luonnos: ääriviivat
lelu: nukke, pelata, uhkapeli
rappu: portaat, asteikko
siirtyminen: infektio, muuttaa, transitiivinen, ylitys
nappi: avain
epäystävällinen: töykeä
ohjelmoida: suunnitelma, esityslista
valmistus: teollistuminen, mylly, tuottaa
vyöhyke: ala, alueellinen, bändi
yhdeksäs: yhdeksän
alkoholi: viini
ahne: kunnianhimo, ahneus
ohjata: hoitaa
vaikutusvaltainen: tehokas, läpäistä
ympäröidä: kaulus, piiritys
hukkua: pesuallas, nurkka
dia: lipsahdus
kylvää: nousta, leipä, sika
hallitseva: suuri, ratsia
johto: hierarkia, manuaalinen
päiväkirja: sanomalehti, kalenteri
juhlia: suostutella
hälinä: jännitys, melu, ärsyttävä, sekaannus
sijainen: edustaja, vaihtoehtoinen
auto: moottori
muutos: tarkistus, muuttaa
pystysuora: seistä, pitkittäinen
riittämätön: riittämätön, tarpeeksi
pahuksen: ohut
päättely: arvaus, johtopäätös
inferential-mieliala: induktiivinen-mieliala
mainos: ilmoitus, kaupallinen, propaganda
varkaus: varastaa, plagioida
spontaani: vaisto, mielivaltainen
apuohjelma: organisaatio, käyttää, väline
kytkeä: kiinnittyä, koukku, liitos, liittyä-seuraan
alaspäin: alas
interventio: häiritä
elpyminen: elvyttää, elpyminen
Internet: käydä-kauppaa
fyysisesti: fysiikka, elin
piste: paikka
järkyttävä: järkyttää
tylysti: töykeä
tasapainoinen: johdonmukainen
indeksi: eksponentti, lista, osoitin
lähettää: lähettää, jakaa
päälle: edellä, ulos, eteenpäin
jutella: puhua, tilastotiedot
keltainen: keltainen
tonni: sävy
sujuvasti: mukava
jännitys: rasitus, jännitys
valas: vaalit
myrkyllinen: myrkyttää
myönnytys: perääntyä, etuoikeus, alennus
työntekijä: työntekijä
rinne: sukeltaa, konjugaatti
WC: kaappi
rikkomus: hyökkäys, rikollisuus
kauna: vihata, kosto
rohkeus: kärsivällisyys, rohkeus
ennakoida: toivoa, odottaa
rytmi: lyödä
rotta: hiiri
vastata: kirjeenvaihto, puku, asianmukainen, vastaus
pidättää: estää, takavarikoida, säilyttää
tulkita: selittää
salonki: sali
toimia: manipulointi, tehdä-työtä, ajaa, toiminta
valua: räystäskouru, ajaa
palkka: maksaa
ikävä: vihata, paha, epämiellyttävä, ikävä, ruma
hautausmaa: hautajaiset
kipsi: liitu-
hana: putki, maito
erottaa: säkki, jättää-huomiotta, kieltää, veto, erottaa, irtisanominen, antaa-anteeksi
provosoida: jännitys, ärtynyt
asua: pysyä, elää
koristelu: ornamentti
varvas: hiipiä-varpaisillaan, jalka, sormi, tassu
kykenemättömyys: vammaisuus, heikkous
keksiä: keksintö
määritellä: määritin, kehittää, kuvata
rajoitettu: rajallinen, sidottu
kaappi: kaappi, hylly
teline: hylly
tarkastaja: kapellimestari, tarkastaja
esittely: esitellä, show, näyttely, edistäminen
kumi: pallo, joustava
sulkea: riistää, poistaa, erottaa
etuoikeutettu: etuoikeus
erakko: askeettinen
naarmu: kaapia, alku
ruuvi: pultti
tutkia: tarkkailla, hyödyntää
taata: vakuuttaa
sylinteri: levy
yhteenveto: ääriviivat, abstrakti
epätodennäköinen: todennäköisyys
parvi: parvi, poika
systemaattinen: mekanismi
käytännössä: todella, melkein, käytännön
asiakas: asiakassuhde, vieras
luettelo: lista, taulukko
kemia: kemiallinen
leipoa: leipä, kokki
puhkaista: puukottaa, läpäistä, porausreikä, lävistää
siepata: repiä, takavarikoida, siepata
käynnistää: päästää, heittää
viljely: maatalous
näyttelijä: näyttelijä
teatteri: teatteri, sali
lääke: lääketiede
haitallinen: huonompi, haitta, käänteinen, negatiivinen, haitallinen
karamelli: minttu, suklaa, makea
tahna: sarja, kaulakoru
tuomittu: ansa, rangaista, syyllinen
tutkia: koetin, tarkkailla, tarkistaa
paketti: kietoa, sarja, kiinni
ryömiä: hiipiä, kyyristyä
napsahtaa: pop-, napsauttaa, kuva, vuorovesi, pian
rengas: alkio, rengas
huomattava: huomiota-herättävä, ilmeinen
ydin: pohja
edeltäjä: kantaisä
samoin: samoin, sama
pato: pöly
liukas: lipsahdus
muutos: muuttaa
hapsut: reuna
sijainti: sijainti, paikka
rykelmä: monialayritys, massa-, bändi
lainaus: lainata
huolto: ahkeruus, hoito
uskottava: hyväksyttävä
nakata: heittää
askelma: askelma
keskittyminen: kertymä, fokus
kätevä: käytännön, mukava
syötti: maku, pohjamaali
monipuolinen: eri
viipale: siru, levy, suupala
porata: porausreikä, kaivaa
vastata: reaktio, maksun-palautus, vastaus
kuolleisuus: kuolema
rikkaruoho: ruoho
suhteellisesti: tilavuus
matemaattinen: matematiikka, urheilu-
moraalisesti: moraalinen
huohottaa: huokaus, hengitys
kilpa-: rotu
eristäminen: disjunktio, erotetaan
jonkin-aikaa: joskus
aikuinen: kypsä
vaikeus: katkera, kurjuus, vaivata, harmi
huhu: juoru, ääni
kestää: säilyttää, karhu, kestää
nuorempi: nuori
neulominen: neuloa
epäsuora: suoraan
ennakkotapaus: esimerkki
käytävä: säde, sali, ylitys
ristiriidassa: ristiriitaisuus, kieltää
lunastaa: tallentaa, hyvittää
polku: tapa, suojatie
vaihde: laitteet, hampaat, kylkiluu, ajaa
juhla: juhla
tyköistuva: lämmin, mukava
kustannustoiminta: julkaisu, jakaa
asiakas: vieras, ostaja
matto: matto, lattia, viltti
väliseinä: laskea
näkymät: silmäys, visio
esteettinen: kauneus
paheksua: vihata
aiheuttaa: ehdottaa, aiheuttaa, seistä
tyytyväisyys: vakuuttunut
organismi: olento
käsittämätön: ymmärtää
painokas: painotus
keskipäivä: iltapäivällä, etelä
lilja: lukea
substantiivi: nominalization, nimi
taitto: taittaa, taipunut
hyödyllinen: auttaa
jatkua: vaatia, jatkaa, kestää
pistorasia: poistua, pistorasia, lähtö
periä: perillinen
nopeus: nopeus, saostaa
loukkaavia: sanallinen
puute: riittämätön, leikata, laiminlyönti, virheellinen
varmistaa: vakuuttaa
epäoikeudenmukainen: oikea
sub: korvata
ämpäri: tynnyri, lusikka
organisaatio: organisaatio
pääasiallisesti: erityisesti
rituaali-: seremonia, palvonta
reisi: kinkku, jalka
vaatekaappi: vaatteet, kaappi
rakenne: organisaatio
turbulentti: väkivaltainen
marsh: suo
tietämätön: oppimaton
alustava: aukko, alkuperäinen, alku, ensimmäinen, primitiivinen
minimi: vähiten
korjaus: uudistaa, tarkistus, korjaus
unohtaa: jättää-huomiotta, unohtaa
yksimielinen: yhdistynyt
hiili: kivihiili
kela: tiedosto, rulla, kihara
terävä: hauras, terävä
sanasto: sanakirja
kävely: vaeltaa
kunto: liikunta, voimistelu, kunto
kansalaisuus: nationalismi, kansallinen
maku: maku
merkityksetön: välttämätön, triviaali, merkityksetön
booli: lyödä
harppaus: edistyminen, askelma
akseli: olkapää, painaa
tyydyttävä: tauti, vakuuttunut
luotettava: luotettava
inhottava: vihata, ruma
eettinen: moraalinen
romahdus: pudota
tyyny: joki
hämmentää: väärentää, tuhota, hämmästyttää, epäonnistua, nolata
myytti: tarina, legenda
omistaminen: omaisuus
pelästyttää: pelästynyt, kauhea, pelko
jarru: tauko
mutteri: papu, siemen
suurentaa: turvota, lisätä
aurinko-: auringonpaiste
nokka: huuli, yksikkö
vuokrata: talutushihna, vuokrata
suhde: suhteet, vertailu, asteikko, kertomus, analogia
kampa: harjata, olkapää, harjanne
kääntää: käännös, kääntää
virkistys: viihde, loma, rentoutuminen
päähänpisto: väri
näyte: esimerkki, yrittää
monikko: massa-
aloite: suunnitelma, yrittää
hyytelö: hillo, maito
anarkia: häiriö
profiili: ääriviivat, tiedosto, verkkosivusto
rahoittaa: raha
perustiedot: pohja, nitoa
karkottaa-maasta: kaatopaikka, ratsia
sähköinen: elektroninen
yrtti: ruoho
menestyä: kukoistaa
samankaltaisuus: analogia, muistuttaa, solidaarisuus
yksityisyys: yksityinen
areena: ala
matkustaja: matkustaja
hiukkanen: atomi, siemen
synnynnäinen: alkuperäinen
asukas: asukas
huilu: pilli
jäljentäminen: hedelmällisyys
jänneväli: pituus
salaatti: lehtisalaatti, teho
väriaine: väri
osoittaa: todistaa
etiikka: moraalinen
virallisesti: virallinen
ärsyttää: häiritä, ärsyttävä, härnätä, yllyttää, porausreikä
liukua: lipsahdus
piirre: ominainen, omaisuus, venyttää
säveltäjä: muusikko
jalkapallo: potkia
kumppanuus: yhteistyö, liitto, myötävaikuttaa
jatkaminen: jatkaa
poikkeava: epätavallisen, hullu
järjestys: ketju
puristaa: Työnnä
puuttua: takavarikoida, selviytyä, laitteet
hillitä: esto, jalkakäytävä, rajoitus
mainonta: ilmoitus, propaganda
vetäytyminen: regressio, pistorasia, johtopäätös
kiinnitys: panttivanki, luotto, sotilas
kärsivällisyys: kärsivällisyys, karhu
tukahduttaa: estää, sortaa
puoliso: aviomies
pätevä: tehokas
venttiili: pakettiauto
rakentaa: luoda, rakentaminen, muotoilu, vaihe
höyry: höyry, pari
maila: tikku, maila, eteenpäin
ristiriitainen: ristiriitaisuus, merkityksetön, erottuva
automaattinen: suoraan
täsmällinen: avata, läpinäkyvyys, selviö
tehokkaasti: tehokas, vaikutus
riippuvuus: riippuvuus
tarkastaa: tarkkailla, tarkistaa, sightsee, analyysi
omituisesti: outo, epätavallisen
saalis: piirtää, ryöstää
kiusallinen: häpeä, nolata
vammaiset: vammaisuus, passiivinen
ylimielinen: ylpeys
kiemura: kihara, rengas
helmi: kivi, kukoistaa
vuosipäivä: syntymäpäivä
arvovalta: luotto
huolimattomuus: laiminlyönti, ylenkatse, välinpitämättömyys
itse-: yksityinen
syrjintä: poikkeus, erottaa
mannermainen: maanosa
tavoite: tarkoitus
pilttuu: myymälä, seistä
investoida: investointi
risteily: laiva
ralli: solidaarisuus, toiminta
huhu: juoru, ääni
aktiivisesti: vakavasti
tarkistaa: tarkistaa
lokero: huoneisto
erityisesti: erityisesti
pamaus: pop-, räjähtää, laukaus
aggregaatti: brutto, yhteinen
jae: osa, panos
laiton: laiton, villi
liueta: poistaa, liukeneva, liuotin
tasapaino: saldo
tutkiminen: koetin, analyysi
sipuli: keula-
affiniteetti: analogia, solidaarisuus, riippuvuus
epärehellinen: luotettava
yhteentörmäys: konflikti, järkyttää, häiritä
nojatuoli: tuoli, sohva
taikina: jauhot, massa-, hiiva, kakku
alukseen: liittyä-seuraan
transsi: visio
hylkäys: kieltää, jätteet
vaihtelu: ero, asianmukainen, ristiriitaisuus
imeytyminen: iho
kollektiivinen: massa-
ajankohtainen: aika
hyökätä: hyökkäys
hylkääminen: säkki, irtisanominen
merkittävästi: enimmäkseen
kokeellinen: lentäjä
elokuva: elokuva, TV, kuva
julkisuus: propaganda, edistäminen, ilmoitus
laajentaa: laajentaa, yksityiskohta
rojahtaa: kompastella, pudota, sukeltaa, vaatteet
väärentää: luoda, väärentää
fossiilinen: öljy, arkeologinen
rajoitus: este, säätö, rajoitus
kuori: innostusta, mauste, kokea, maku, iho
nirso: ärsyttävä
Hamlet: lähiö, kylä
puomi: kukoistaa, pomppia, räjähtää
jäljentää: kopioida, jäljitellä
kongressi: kokoonpano
viinirypäle: viini
työpaja: studio, seminaari
vähentää: vähentää, leikata, pudota
ääntäminen: lausua
tuomio: päätös, tuomita, sääntö, tuomari, toimivalta, kriisi
keskittää: varovainen, fokus
purkaa: paljastaa, takaisin
lautta: jahti, laiva
suora: yksinkertainen, suoraan, helposti, läpinäkyvyys, lineaarinen
korkeus: pituus
tarkoittaa: show, tarkoittaa
viedä: poistua
rikollinen: komeetta, syyllinen
paheksunta: vastustus, veto
par: pari, saldo
poistaa: poistaa
säätää: tarkistus, korjata, sovittaminen
jäsenyys: jäsen
arvioida: mitata, asteikko, suuruus, ohut, osoitin
sietää: antaa-anteeksi
lonkka: takapuoli, vyötärö
noudattaa: seurata, liittyä-seuraan, tikku, säilyttää
hylkiä: estää
levottomuus: häiriö
siveys: tarkkuus, puhtaus
löysä: rentoutuminen, löysä
supistuminen: ujous
toimittaja: reportteri
oire: näyttely
polkupyörä: pyöräily, sykli
terva: jalkakäytävä
kierre-: kierre
selostus: rokote, määritelmä
lähetys: infektio
äänestys: ääni, vaalit
mahdollinen: pystyvät
oikeutettu: pystyvät, oikea, pätevöityä, asianmukainen
silmukka: pyöräily, sarana, rengas
työmies: työntekijä
syyttää: syyttää
lisenssi: lupa
luovuttaa: päästö
ego: itse, hengitys
suihku-: eject, lintu, virta
rikkoa: rikkoa, leikata
riippuvainen: riippuvuus
eloonjääminen: elinikä, vokaali
jäädyttää: jäädytetty
kutoa: neuloa
vakiintunut: vakiintunut, edunsaaja
apatia: välinpitämättömyys
järjestää: organisaatio, valmistella, säätää-lakeja, järjestäytynyt
oletettavasti: ehkä, muka
sointu: sopimus
vuotaa-verta: veri, verinen
havaitseminen: löytyi, haku, paljastaa
murskata: tuhota, tauko
helpottaa: kiihtyvyys, edistää, myötävaikuttaa
taajuus: sykli, epäröidä
ommel: ompelu
hakemisto: näyttö
pilkkoa: purra, leikata, pihvi
lämmitys: lämmin
masentava: ikävä, surullinen
vallankaappaus: vallankumous, laukaus, tahti
myötätuntoinen: sääli
ajattelija: henkinen
talousarvio: saldo
kansalais-: siviili-, kaupunki-
lisätä: astua, lisätä
mietiskellä: heijastaa, ajatella
joustava: yksinkertainen, flex, joustava
laatta: paneeli, tabletti, liesi
pätevyys: lahjakkuus, pätevöityä
kytkin: käänteinen, muuntaa, avain
pyyhe: kangas
vuosikymmen: kymmenen, pitää
moninkertainen: eri, lisää
side: pukeutuminen, kiinnittyä
siisti: siisti
taputtaa: nokare, kiitellä
vaahtera: palmu
harava: lakaista
tyhjyys: tyhjä
kurpitsa: öljy, aivot, kurpitsa
tuppi: takki, kirjekuori, palko
omaksua: hyödyntää, imeminen, omaksua
ennustus: ennustettavissa, arvaus
kouluttaa: koulutus, kouluttaa, opetus
tiedustelu: koetin, pyyntö, haku
ylivalta: sääntö
vanhempien: vanhempi
osallistua: delta, liittyä-seuraan, kihloissa
hissi: hissi
sivu-: puoli
lykätä: viive
inho: ylenkatse, vihata
tuma: ydinaseiden, solu, alkio
metafora: esimerkki
pikkuriikkinen: vähän, mikro
pommi: pumppu
kriittisesti: syvä, kriitikko
ruoste: syöttö
varaus: säilyttää, takavarikoida
ommella: ompelu
kemisti: kemiallinen
aula: tauko, sali
puhkeaminen: alku, ratsia, hyökkäys
sukeltaa: sukeltaa
epäystävällinen: vihamielinen
väestönlaskenta: laskeminen
tuomita: moittia, tuomita
pellava: liinavaatteet
keskeyttää: estää
läimäys: lyödä
ottaa-rennosti: rentoutuminen
kosiskelu: piha
hyödyke: tavarat
jatkuvuus: luettuna
vastavuoroinen: vaihtaa-keskenään, inversio
resepti: lääketiede, kopioida
kupla: vaahto
lapio: pihdit, airo
käyttää: hyödyntää, käyttää, viettää, valjaat, kuluttaa
kestävä: pitkä
sukuperä: tuttu
sinkki: pesuallas
kumpi: aivan-sama, joka
rajallinen: rajallinen, vihdoin, päättynyt
apu-: tukija, aids
ryntäily: vääristää, taistella, tahti
akateeminen: koulutus
rengas: alkio, rengas
kuluttaja: käyttää
voimassaolo: arvoinen, luotto
suunnilleen: melkein, lähentää
kudottu: neuloa
mikroskooppi: teleskooppi
siviili-: siviili-
hihna: talutushihna, köysi
symbolinen: ele, identiteetti
sopeuttaa: sovittaminen, selviytyä, litteroida
todennäköisyys: todennäköisyys, pystyvät
subjektiivinen: henkisesti
pronomini: omatunto
väärin: väärässä, väärinkäyttö
lannistaa: nolata, kunnianhimo
tulokas: vieras
äärettömyys: infinitiivi
graafinen: kartoittaa
kuva: muotoinen, kuva
markkinarako: johdonmukainen, avain
pettää: ikävä, pettää, epäonnistua
projektio: suunnitelma, show
vapauttaminen: päästö, pelastus
resepti: ärsyke
toimilupa: etuoikeus
sopimaton: järjettömyys, merkityksetön, riittämätön
kierto: sykli, vallankumous, kierre
nuppi: nuppu
metri: mitata
rajoitus: sidottu, rajoitus, säätö
luokka: yhteisö, arvo
rodullinen: rotu, rasismi
korvaaminen: sen-sijaan, korvata, muuttaa
innovaatio: keksintö
kohdata: selviytyä
kieltää: kieltää
koriste-: ornamentti
aula: aiheuttaa, sali
heittää: heittää, kihara
vierittää: kirja, rulla, kihara
mekaanikko: mekaaninen, käsityöläinen
aggressio: hyökkäys, aggressiivinen, ylittää
Hei: Hei, Tervetuloa
mittaus: mitata
kilpailla: painia, kilpailija
akatemia: college
noviisi: rekrytoida, tuore
eronnut: avioero
meijeri: maito
varasto: säiliö
ostokset: myymälä, käydä-kauppaa
implisiittinen: johdonmukainen
strateginen: strategia
muotti: modulo, muoto, painaa, heittää
harjoitus: liikunta, toisto
vaatimus: vaatia
edeltää: ennen
keski-: keskiaikainen, puolitiessä, vyötärö
turisti: matkustaja, matkailu
juoma: juoda
tietoinen: varovainen
artikuloitu: selittää, ilmaisu
takaisin: sitten, takaisin
muuttaa: tarkistus, muuttaa, korvata, liitos, uudistaa
kaavio: kartoittaa, kartta
deduktiivinen-mieliala: induktiivinen-mieliala
musertaa: sortaa
mobile: puhelin, solu
ylentää: edistäminen, hissi
paradoksi: ristiriitaisuus
liioitella: suolaa, maksimoida
vaalea: keltainen
vihje: merkki, salasana, tikku
juoksija: sali
neuvotella: puhua, pohtia
järjestelmä: sääntö
toleranssi: suvaitseva, karhu
vaihtoehto: vaihtoehtoinen, kurkku
ristiretki: liike
epidemia: tragedia, käännös
tekniikka: tekninen, lähestyä, tekniikka, laitteet
terminaali: vihdoin
valmistua: syöttö
ulostulo: kulu, johtopäätös, julkaisu, lähtö, tuottavuus, poistua
paikantaa: paikka
oletusarvo: laiminlyönti, standardi
konteksti: ympäristö-, näkymä, konnotaatio
koalitio: liitto
virhe: syyttää, väärässä, vammaisuus, haitta
myöntää: myöntää
lähettää: julkaisu, lähettää
valitsin: valita, rengas, kerätä
yleisyys: suosittu
yhä-useammin: kaikki
muuttaa: muuttaa, muuntaa
leija: lohikäärme
epäselvä: epämääräinen, ristiriitaisuus
kahvila: kahvi, baari
myöntää: palkinto, palkkio, myöntää
etiketti: studio, merkki
hyväksyvä: hyväksyminen, myöntää
sukulaisuus: analogia, sosialistinen
realistinen: todella
matelija: käärme
ulko-: ulos, avata
poliittisesti: poliittinen
jäännös: jäännökset, jätteet
nauha: kasetti, bändi, elokuva
mitäänsanomaton: pehmeä, makea
oraalinen: sanallinen, huuli
spekuloida: arvaus
karkottaa: eject, päästö
tahra: paikka, vammaisuus
hyppiä: tanssi, viettää
muki: kuppi, irvistys
kiila: piikki, panos, nurkka
vapautus: alennus, poikkeus, irtisanominen
kannettava: vähän
kääre: pakkaus, kietoa
loisto: lahjakkuus, kauneus, mulkoilla
evä: airo, baletti
mutista: kuiskaus
marja: lahti
maahanmuutto: muutto
kuokka: aura
leikkaus: kirurgi
kerätä: kertymä, tallettaa, kerätä
perä: ulosteet, putki
vatsa: vatsa
epäsuorasti: konnotaatio, sisällyttäminen, johtopäätös
kannustin: ärsyke
jakoavain: ruuvimeisseli, avain
maaseutu: maaseudun, lähiö, ala, kylä
hajota: tuhota, vähentää
kotoperäinen: luonto, alkuperäinen, asukas
pino: kaatopaikka, harjanne, savupiippu
levy: levy
suuntaus: käytös, suunta, taipunut, luonteenlaatu, ajelehtia
yritys-: yritys, yhteinen
vapauttaa: eroon
epävakaa: epävakaa, väliaikaisuuden
yhteensopiva: johdonmukainen, yhdensuuntainen, yhtenevä
puhelin: puhelin
tyhjiö: tyhjä
napata: puukottaa, ottaa, takavarikoida
puuska: maanjäristys, räjähtää
tylsä: kyllästynyt, porausreikä, ärsyttävä
salkku: sarja, lompakko
rako: crack
komplikaatio: ongelmallinen, tietulli
puuttua: häiritä
polaarinen: vastakkaisuus, äärimmäinen
valtuutettu: edustaja, sanansaattaja
tahto: tahdonvoima, halu
ennustaa: ennustettavissa, arvaus
optimismi: toivoa, uskoa
kuori: iho, palko, aivokuori
paloitella: purra
leijua: kellua, liidellä, epäröidä
sektori: ala, teollisuus, alueellinen, osa
sukunimi: nimi, ne
instituutti: järjestäytynyt, yritys, organisaatio
kiireellisyys: ahdistunut
nautittava: ystävällinen
estää: estää
negaatio: kieltää
voittaja: menestys
yhdistelmä: sekoitettu
vaikutus: vaikutus, konflikti
kuitu: kuitu
siemailla: niellä
visuaalinen: optinen, näkymä
kynsiä: tassu
kantaja: näyttelijä, kantaja, syy
valittaa: sääli
johtaa-harhaan: vääristää, hämmästyttää, typerys
kieltää: esto, estää, kieltää
esiintyjä: näyttelijä, taiteilija, pelaaja
turnaus: rotu
vaatimus: pyyntö, kunto
miinus: vähiten
epäsiisti: holtiton
tarttuva: infektio
painottaa: vaatia, painotus
housut: housut
sekoittaa: palapeli, hämmästyttää, nolata
omistaa: vapaaehtoinen, aikovat
kirurginen: kirurgi
totuudellisuus: tosiasia, tarkkuus
sadasosa: sata
kalteva: jyrkkä, sukeltaa, taipunut
lähistöllä: melkein, pian, ympäröivä
yleensä: yhteinen, usein, yleisesti, yleensä
sekava: ristiriitaisuus, palapeli, sekaannus
verrannollinen: vertailukelpoinen, saldo
olla-eri-mieltä: erimielisyys
ärsyttää: suututtaa, häiritä, härnätä, ärtynyt
maksamatta: paremmin, huomiota-herättävä
aloittamista: alku
sademäärä: saostaa
kauhistuttaa: hälytys
harraste: viihde
kieliopin: kielioppi
numeerinen: määrä, digitaalinen
kriteeri: standardi
ennuste: ennustettavissa, arvaus
hylkää: kieltää
eksoottinen: ulkomainen, outo
polttimo: lamppu
parantaa: laajentaa, lisätä, maksimoida, parantaa
fuusio: sulaa, puhelu
äänestys: vaalit
lahjakas: lahjakkuus, taitava
sulaa: sulaa
suoristaa: venyttää, korjata
koristella: ornamentti
presidentin-: puheenjohtajuus
kolahtaa: ennenaikainen, moninkertaistaa, potkia, lommo, kasvain
onnittelu: kehua
skannata: lakaista
oikeuttavat: mahdollistaa, oikea
vedonlyönti: kunto
teknisesti: tekninen, tekniikka
empiirinen: kokea
hallita: hallita
mainostaa: ilmoitus, propaganda
diffuusio: jakaa, julkaisu
laiduntaa: kaapia
pakki: laitteet, laatikko, sarja
lääkäri: lääkäri, valmentaja
liota: imeminen, sukeltaa
säilyttäminen: suojella, tallentaa, hoito
lima: muta, jalkakäytävä, tiputtaa
haastava: kova
saastuminen: saastuttaa, korruptio
kemikaalit: kemiallinen
erä: parvi, impulssi, tilavuus
äiti: äiti
pelottava: kauhea, uhkaava
asiantuntija: asiantuntija
kaivata: halu
kylpyhuone: kylpy
uhkapeli: uhkapeli, pelata, seikkailu
olennainen: välttämätön, integroitu
poistaa: eroon, poistaa
herne: papu
liite: liite, lisä-, avustus
kiertää: jakaa
täydellinen: yhdistynyt
myyjä: kauppias
häiritä: hermostunut, häiritä, pakkomielle
räjähtää: räjähtää
urkkia: uteliaisuus, vipu
läikkyminen: vuotaa, kaataa
ilmaiseksi: ilmaiseksi
ainesosa: elementti
alijäämä: avata
järkyttävä: hermostunut, ärsyttävä, epämiellyttävä, surullinen, häiriö
kotelo: talo
valokuvaus-: vaihe, kuva, valokuvaaja
tuhoeläin: hyönteinen
pilleri: tabletti
tällä-hetkellä: esittää
tiedotusvälineet: lehdistö
hylky: pilata
corpus: elin, sarja
valikko: lista
murtuma: crack
foorumi: foorumi, porausreikä, tuomioistuin
vauhti: nopeus, impulssi
näkökulma: luuttu, taipunut
laatta: tiili
kirjahylly: kirjasto, kirjakauppa
laskeminen: laskeminen
tuottaja: valmistaja
raha-: raha
kuvata: kuvata, heijastaa, esitellä
inflaatio: turvota
marginaalinen: reuna
fantasia: mielikuvitus
heikentää: tuhota
johdonmukainen: tiukasti, luettuna, johdonmukainen
pohjimmiltaan: ehdot
tahallinen: tarkoituksella
perhe: perhe
virtaus: joki, virta
kilpailukykyinen: kilpailija
korut: ornamentti
alkoholisti: humalassa, viini
syrjiä: erottaa
militantti: radikaali, terroristi, sotilaallinen
riisua-aseista: aseet
ratkaiseva: välttämätön, ratkaiseva
toimeksianto: tehdä-työtä, liikunta, tulli, siirtolapuutarha
kiintiö: etuoikeus, siirtolapuutarha, kvantti
kaivanto: kuoppa, kaivaa
kalsium: potkia
muistoksi: suostutella
historiallisesti: historiallinen
Moi: Hei, Tervetuloa, pelastus
eliminointi: eroon, laiminlyönti, poistaa
kireä: siisti
rentouttava: mukavuus, mukava, rentoutuminen
tehokkuuden: tehokas, vaikutus, taito
haavoittuva: altis
urheilija: urheilu-
raita: raidallinen, linja, bändi, elokuva
julkisivu: naamio, visio
klipsi: nitoa, pihdit
prototyyppi: esimerkki, alkuperäinen
offset: selviytyä, hyvittää, poikkeama
tyhjä: nolla-, tyhjä
rajoittaa: estää, lyhentää, vähentää
rasti: merkki, täi
alv: säiliö
raiskata: ylittää
tyhjä: nolla-, tyhjä
ehdollinen: liitteenä
kulttuurinen: kulttuuri
teknologia: tekninen, laitteet
markkinointi: käydä-kauppaa
kravatti: solmio
taloudellisesti: taloudellinen
ylläpitäjä: johtaja, edunvalvoja
kuvata: kuvata, esitellä
lapsenlapsi: tyttärentytär, veljenpoika
kaksois-: kaksi, pari, twin
synteesi: alkuperäinen, asentaa, sarja
erikoisuus: ammatillinen, ominainen
outo: outo
hakija: ehdokas
kielellinen: kieli, kielitiede
sieni: korkki, sieni
kurpitsa: squash, kurpitsa
kohottaa: hissi, nousta, edistyminen
ilmiömäinen: epätavallisen, yksin, Super
dynaaminen: teho
tarkistaa: tarkistus, korjata, tarkistaa
hajota: disjunktio, pudota, analyysi
rasittava: väsynyt
kampus: college, koulu
väitöskirja: tutkielma
tilastollinen: tilastotiedot, tilastollisesti
muotoilla: valmistella, muotoilu
voileipä: leipä
tyhjä: nolla-, tyhjä
stimulaatio: kiihtyvyys, jännitys, ärtynyt
sensuuri: sensuroida, säätö
varustaa: täydentää
nimittää: nimitys, ehdottaa
peruuttaa: poistaa, romu, pettymys
metri: mitata
masentaa: sortaa
herra: sir, hallita
rekonstruoida: korjaus, elpyminen
tuomari: sääntö, tuomari
atomi-: atomi, ydinaseiden
kiistanalainen: ristiriitaisuus
hienostunut: monimutkainen, moderni
nykiä: olankohautus
sopimaton: merkityksetön, riittämätön
sedimentti: saostaa
tölväistä: ylenkatse, syyttää
variantti: eri
arvostella: kritiikki
ikävystyminen: kyllästynyt, harmi, kurjuus
tehdä-yhteistyötä: yhteistyö, luettuna
analysoida: analyysi, analyytikko
sademäärä: sade
versoa: nuppu
lentokone: lintu
mausteinen: terävä
joustavuus: jousto
raketti: ohjus
adverbi: kirjekuori
epävakaisuus: epävakaa
riistäminen: riistää, haitta
kyhjöttää: kyykky
synnyttää: tuottaa, luoda
likiarvo: lähentää, lähestyä, lähentyminen
moraali: hereillä, moraalinen, henkisesti
optimistinen: toivoa, uskoa
luokitella: luokittelu, jakaa
opetussuunnitelma: kurssi, esityslista
ulkona: ulos
suhtautua: reaktio, verbi
käsikirjoitus: skenaario, linja, kirjoitusten
kiristää: kiristää
bonus: palkinto, palkkio
etu: omaisuus, läsnäolo, etu, pääoma
vaihtelevuus: ero
epäselvyys: epämääräinen, ristiriitaisuus, epävarmuus
tyhjä: nolla-, tyhjä
neutri: neutraali
haitta: nolata, este, vammaisuus, haitta
valokuvaus: kuva
puute: leikata, poissaolo
siirtymä: korvata
sieni: bakteerit, sieni, korkki
sanamuoto: muotoilu, teksti
diplomaatti: diplomaattinen, sanansaattaja
aloittaa: esitellä
yhdistää: valjaat
särkeä: tauko
hengittää-sisään: innostaa
talja: rooli
luiseva: ohut
äänestäjä: vaalipiiri
liittovaltio: liittovaltion-
liikkuvuus: liike
purkaa: päästö
elinympäristö: suoja
herättää: herättää, aiheuttaa
laimentaa: ohut
Hyvästi: bye-Bye, jäähyväiset
purkaa: tuhota
syntaksi: eläke
hevosenkenkä: hevonen
vääristymä: poikkeama, vääristää
läimäyttää: lyödä
merkityksellinen: johdonmukainen, asianmukainen, liittyvä
toiminnallinen: käytännön, tehdä-työtä
syrjäyttää: korvata, eject, perääntyä
autonomia: itsenäisyys
haista: haju
erilaistuminen: erottaa
saatavuus: hankinta
opiskelija: opiskelija-
kaavio: kartoittaa, kartta
hurmata: valloittaa, härnätä
söpö: kaunis, makea
vatsan-: vatsa
lukutaito: koulutus
synteettinen: keinotekoinen
kouluttaja: valmentaja
säästää: varastointi, tallentaa, suojella, säilyttää
roskat: romu, kaatopaikka, jätteet
kuva: kuva, laukaus
oppikirja: manuaalinen, kirja
lujittaa: vahvistaa
rajoittaa: hallita-pakolla, rajallinen, kiristää
ekonomisti: taloudellinen
yleisurheilu: urheilu-, liikunta
kiemurrella: irvistys
jodi: mineraali
tartuttaa: infektio, saastuttaa
suunnittelija: määritetty
erittää: eritys, piilottaa, eject, salaisuus, erottaa
pinaatti: edistää, lehtisalaatti
intensiivinen: äärimmäinen, väkivaltainen
vakuuttava: demonstratiivinen
debyytti: ensimmäinen, alku
tuhannesosa: tuhat
sisä-: sisempi, syvä, sisällä, katettu
peruuttaa: riistää
amplitudi: suuruus
ulottuvuus: suunta, jälkeen, ulotteinen, seuraava
raamattu: kirjoitusten
juliste: lippu, verkko
kiihdyttää: saostaa
tehostaa: vahvistaa, vahvistussana
abortti: keskenmeno
tyypillisesti: yleisesti, yhteinen, usein, yleensä
sitoutuminen: lupaus
jonottaa: pyrstö, tilata
kannatin: nitoa, kyynärpää, koukku, tukija, tuki
entinen: vanha
käänteinen: käänteinen, inversio
haihtua: sulaa, haukotus
ilmailu: ilmapiiri, ilma, lentää
korrelaatio: vertailu
etninen: nationalistinen, kansallinen
kauttaviiva: leikata, vähentää
hankala: ovela, kehittää, monimutkainen, kova
luonnehdinta: kuvata, ominainen
kiinnittää: liitos, yhdensuuntainen
molekyyli: molekyyli-
kokoonpano: luonteenlaatu, rakenteellinen, kokoonpano
vuorovaikutus: puhua, päällekkäisyys
määrällinen: tilavuus
itsetutkiskelun: takautuva
suunnata: itään
sperma: siemen
hyväksyä: tuki, myöntää, hyväksyminen
ei-: eikä-myöskään, ei
uskottavuus: uskollisuus, luotettavuus, luotto
kumouksellisuus: pilata
poikkeama: ajelehtia, poikkeama
injektio: neula
sandaali: tohveli, kengät
kimpale: siru, kohta, venyttää
televisio: TV
vilja: jyvä, papu
säiliö: väline, säiliö, pannu
siirtyä: muutto, vaeltaa
terminologia: ehdot
äänestäjät: vaalipiiri
pyyhkiä: poistaa, tuhota
sovitella: sovittaa-yhteen
kapitalismi: kapitalisti
hiihtää: luistella
raivaaminen: uhkapeli, lupa
valikoiva: valita
staattinen: standardi
yhtyä: tavata, lähentyminen, fokus
aakkosellinen: aakkoset
maailmanlaajuinen: kansainvälinen, maailman-
uhri: uhrata
kunnossa: sama, korjata, erittäin
käytännöllinen: käytännön
tuomari: sääntö, tuomari
ero: ero
hengittää: päästää, hengitys
vedenjakaja: vesi
telineeseen: sovittaminen, laitteet
asentaa: asentaa, vakiintunut, kiinni
resonanssi: värähtely
perinteisesti: perinne
luokkahuone: kiertorata
protokolla: sopimus
laskenta: laskeminen, laskuttaa
gramma: lämmin, ruoho
bensiini: bensiini
galaksi: tähdistö
nuori: nuori
vaivata: vaivata
radium: radio
ohut: ohut
lentokone: lintu
polkea: askelma
noin: melkein, noin
taskulamppu: linssi
matkalaukku: laatikko, matkatavarat
vaihtaa: vaihtaa-keskenään
valinnainen: asiakassuhde
matriisi: vatsa
kuvaus: olkapää, kuva
pre: itään, ennen, niitty
ilmoitus: ilmoitus
tainnuttaa: hämmästyttää
esiintyvyys: tapaus, sukeltaa
kaataa: kaataa, sydän
aisti-: tunne, intohimoinen
konsensus: sopimus
valvoa: hoitaa, monitori, valvoa
siirto: vaihtoehtoinen
alumiini: alumiini
vaihtelu: värähtely
simuloida: jäljitellä, teeskennellä
hankaloittaa: monimutkainen
opastaja: neuvonantaja, valmentaja
aukko: aukko
torni: varis, torni, linna, ase
manipuloida: manipulointi, herättää
kasvissyöjä: vihannes
normi: määrittely, standardi, sääntö
metro: tunneli
hengitys-: hengitys
simulointi: jäljitellä
ruisku: neula
mutaatio: muuttaa, muuntaa
alusvaatteet: alushousut, liinavaatteet
vagina: lahti
eriyttää: erottaa, ero
kausiluonteinen: kausi
kyläläinen: maaseudun
seesami: mooli
kooma: pilkku
inverttisokeri: inversio, käänteinen
ohjaaja: tarkkailija, manuaalinen
syrjäyttää: eject
tarkastaa: tarkistaa, tarkistus
vaellus: liidellä, vaeltaa, hissi
paikka: paikka
lama: taloustiede
ryöstelyä: ryöstää
iskulause: salasana
sikiö: alkio
integraatio: yhteistyö, sisällyttäminen
purppura: violetti, syaani
minimoida: vähiten, vähentää
asuin-: suoja
numero: digitaalinen, määrä
suolainen: suolaa
tyhjä: nolla-, tyhjä
teoreetikko: teoria
akvaario: kalastaa
veto: veto
laskuvarjo: sateenvarjo
merkittävästi: välttämätön
yleinen: yleisesti, kaikki, yhteinen
heiketä: laho
tyhjä: nolla-, tyhjä
seksuaalisuus: seksuaalinen
kela: tilavuus, kietoa
pääasiallisesti: enimmäkseen
viskoosi: tahmea
suoli: tyhjentää
arkeologia: arkeologinen
maapähkinä: papu
appositio: avustus
liesi: liesi, keittiö
housu-: housut
kriteerit: standardi, osoitin
yleiskatsaus: ääriviivat
laadullinen: ominainen
silmälasit: lasi-
geneettinen: morfologiset, genetiikka, geeni
osallistuja: liittyä-seuraan, rooli, partisiippi
ohjelmisto: lahjakkuus, ohjelmisto
kiertää: sykli, kierre
layout: organisaatio, suunnitelma, luonteenlaatu
tosite: pistoke, kuitti
lause: tuomita, teoria, selviö
kognitiivinen: diagnoosi
selventää: kehittää, selittää
myrkyllinen: myrkyttää
stressaantunut: painotus
neula: neula
lama: kriisi
tyydyttää: palvella, mikäli, vakuuttaa
anti-: vastustus
kestävä: krooninen, vastustus, immuuni
välipala: malja
elokuva: elokuva, elokuvateatteri
hana: putki
merkki: merkki
perifeerinen: ympäröivä, alueellinen
itsevarma: määritetty, predikatiivinen, aggressiivinen, ratkaiseva, itsepäinen
solmu: neuloa
liikalihava: paksu
vähentää: eject, vähentää, piirtää, riistää
intransitiivinen: välttämätön
helix: etana, kihara
pikkuleipä: keksi, kakku
paisuttaa: turvota
elektroniikka: elektroninen
kirjoittaa-uudelleen: litteroida
laboratorio: laboratorio
työperäinen: ammatti, kaupallinen, ammatillinen, tehdä-työtä
kaltevuus: maili, sukeltaa
värikäs: väri
kattavuus: katettu, rokote, hoito, viltti, katto, ottaa-huomioon, tilavuus
osallistuminen: liittyä-seuraan, sisällyttäminen
suuntautuminen: suunta
valmistaa: luoda, tuottaa
lämpö-: öljy
stereotypia: poikkeus
teknologia: tekninen
jäljelle-jäävä: jäännökset, irtisanominen
kuorma-auto: kuorma-auto
stadion: ala
koordinaatio: koordinoida
bakteeri-: bakteerit
liitäntä: lähestyä
pii: pii
muistaa: muisti, tallentaa, muistaa
diagnostinen: diagnoosi
opetussuunnitelma: abstrakti
johtuminen: linja, siepata
miljoonas: miljoona
jälleenmyyjä: kauppias
barium: baari
valtavirta: avain, toissijainen
mielekäs: tarkoittaa, johtuva
audio-: ääni
käsitteellinen: käsitys
ruudukko: verkko
tila: ilmapiiri, ulotteinen
tentti: tietokilpailu
keski-: toissijainen, vyötärö
meikki: hyvittää
erillinen: erotetaan, yksin
estää: esto, estää
multi: eri, lisää, erittäin
hiostava: kostea, lämmin
morfologia: morfologiset
määrittää: diagnoosi
flunssa: influenssa
grafiikka: kartoittaa
sepelvaltimo-: tauti
pakara: takapuoli, kinkku
arkisto: tiedosto
yhteenotto: taistella, konflikti, vertailu
rahtialus: kuorma-auto
optimaalinen: optimaalinen, suuri
pohjimmiltaan: ehdot
motivaatio: ärsyke
kives: muna
rikki: rikki
toiminta-: manipulointi, toiminta
lentorata: kiertorata, tapa
merkityksellisyys: liittyvä, merkitys, suhteet
pyörä: pyöräily, sykli, pyörä
direktiivi: demonstratiivinen
lentoyhtiön: lintu, ilma
litra: litra
takaisku: pettymys, järkyttää, regressio, epäonnistua, este
yhtenäistää: valjaat, sovittaa-yhteen
asenne: seistä, sijainti, kohta
minimaalinen: vähiten
syklinen: pyöräily, ajoittainen
alustan: molekyyli-
vedenalainen: sukellusvene
asiantuntemus: kokea, taito
tyhjä: nolla-, tyhjä
elektroni: elektroninen
interaktiivinen: päällekkäisyys
ensin: alkuperäinen
sabotoida: tuhota
olla-vuorovaikutuksessa: puhua, seurustella
matematiikka: matematiikka
sikiö-: alkio
nykyaikaistaa: moderni, päivittää
äärimmäinen: radikaali, äärimmäinen
kusta: virtsa
käpertyä: omaksua
Okei: korjata, erittäin
napata: varastaa
päättäväinen: tarkoituksella
puoliperävaunu: puolitiessä, myydä, jauhaa, leveys
hermo-: hermostunut
anti: vastustus
linssi: linssi
proksimaalinen: melkein
ravintoaine: mineraali, ruoka
epäselvä: epämääräinen, ilmeinen
trauma: järkyttää, vahinko, haava
vaihtokauppa: vaihtaa-keskenään
vektori: kantaja
taktiikka: lähestyä
arvioida: arviointi
tyhjä: nolla-, tyhjä
klooni: kopioida
kannattava: etu, tehokas
replikointi: kopioida
reagoiva: reaktio
aikataulu: kalenteri, aika, luonteenlaatu
syntaktinen: kohtalo
vakauttaa: hiljainen
toisinajattelija: kilpailija
palaute: reaktio
kyselylomake: tietokilpailu
hapettua: puhelu
millimetri: millimetri
psykiatrinen: henkinen
oireyhtymä: tauti
paradigma: esimerkki
aktivoida: mahdollistaa, tehdä, toiminta
satunnaisesti: satunnainen, sattuma, että-tapaus
häpeäpaaluun: erotetaan, boikotoida
alaryhmä: osa
metodologia: tapa, lähestyä, kerran
kuvamateriaali: tehdä-työtä
peräkkäinen: johdonmukainen, järjestysluku
takavarikoida: pitää, takavarikoida, kiinni
kilometri: kilometri
monikansallinen: kansainvälinen
suunnittelija: vuokralainen, raidallinen, suunnitelma
räjähdysmäinen: eksponentti
panna-väärään-paikkaan: menettää
tutkija: tiedemies
supermarket: ostoskeskus
jakaa: siirtolapuutarha, erottaa, jakaa, leikkely
tyhjä: nolla-, tyhjä
jalkapallo: potkia
oikeus: oikea, asianmukainen
ruoantähteet: jäännökset, jätteet
kestävä: standardi
avaruusalus: sukkula
kokemusperäinen: kokea
semanttinen: konnotaatio, aihe
sisäpiirin: sisempi, jäsen
tonni: sävy
moduuli: modulo, yksikkö, tilavuus
entsyymi: hiiva
elämäntapa: elinikä
pasta: massa-
ylioppilasasuntola: suoja
teini-ikäinen: nuori
kohokohta: merkki
kieltää: kieltää, tuhota
poikaystävä: tyttöystävä, ystävä
käyttäytymiseen: käytös
Kiitos: kiittää
sielu: aivot, sielu
ekologinen: ekologia, ympäristö-
maahanmuuttaja: pakolainen
upottaa: sisällyttäminen, sukeltaa, haudata
valokopio: kopioida, kuva
aktivisti: toiminta
t---paita: paita
terapeutti: lääkäri, terapia
pohatta: kuningas
kiihottumisen: jännitys
synkronoida: synkronoida
hapan: happo
leksikaalinen: sanakirja, sana
murtautua-sisään: tauko
luokittelija: luokittelu
avantgarden: pioneeri
puheenjohtaja: pää-
luentomoniste: esite
karismaattinen: viehätys
skandium: telluuria
ohje: manuaalinen
hypothesize: olettaa, muka
jääkaappi: jääkaappi
reboot: uudelleenkäynnistää
neronleimaus: ravistaa, ajatus
toistaa: kopioida, jäljitellä, toisto
angst: pelko
tulitaukoa: aselepo
tahdittomuus: laiminlyönti, väärässä
teollistaa: teollistuminen, teollisuus
sisar: veli
tiedottaja: kaiutin, edustaja
kaapata: siepata, aura
ei-metalliset: metalloidi
vuotava: influenssa, kostea, ajaa
puoli: suunta, muotoinen, puoli
alkaen-tapaus: 
hyvyys: hyve, etu
löyhästi: löysä, ilmaiseksi
jälkeenpäin: tulevaisuus, sitten, jälkeen
vaikeus: vaivata
ryhmä: bändi
laajalti: leveys, laajentaa, yleisesti
korreloida: liittyvä, koukku
mukaan: takaisin
tyhjä: nolla-, tyhjä
tiedotuslehti: esite, tiedot
tuomitseva: hyväksyminen, mahdoton-hyväksyä
kylpyamme: kylpy
viihteellinen: viihde, huvittaa, hilpeä
lukuun-ottamatta: paitsi
syntyminen: ilmaantua, poistua, nousta
tyhjä: nolla-, tyhjä
poski: pelata
täytyy: täytyy, tulli
per--sentin: prosentti
oikeudenkäynti: puku
tyhjä: nolla-, tyhjä
kautta: syöttö, edellä
sopraano: lapsellinen
huvittava: hilpeä
iltapäivällä: iltapäivällä, yö-
munanvalkuainen: proteiini
verenvuodatus: verinen
tulium-atomi: torium-atomi
mutka: taipunut, flex
linkkeri: luettuna
exhortative: hortative
terbium-atomi: torium-atomi
vuokrattu: vuokrata
meikki: hyvittää
vitsailla: vitsi
config: rakenteellinen
ohi: kestää
jakaa: erottaa, jakaa
professori: hallita
rodium-atomi: torium-atomi
osavaltio-merkki: 
tila-merkki: 
byrokraattinen: byrokratia
vyö: bändi, valjaat
tyhjä: nolla-, tyhjä
myyjä: kauppias
tyhjä: nolla-, tyhjä
lantaani: telluuria
aihe-tapaus: aihe-tapaus
rakentava: luoda, muotoilu, valmistaja
tyhjä: nolla-, tyhjä
naisellinen: naaras-
tilintarkastaja: tarkastaja, kirjanpitäjä
mikrofoni: mikro
ulkopuolella: ulos, paitsi
äänitys: sisällyttäminen, rekisteröinti
etusormi: osoitin
sponsorointi: apuraha, hoito
oppimaton: oppimaton
tyhjä: nolla-, tyhjä
standardisoida: määrittely, standardi
kello: paikka, tunnin
vuokraisäntä: omistaja
tutkija: määritin, tiedemies, etsivä
levenevät: palanut
tyhjä: nolla-, tyhjä
valtuuttaa: mahdollistaa
puolustus: hoito
käytävä: sali
neuvottelu: puhua
virkeänä: tuore, päivittää
polveileva: taipunut
lähtien: ensimmäinen, seuraava, eteenpäin
hengittäminen: immuuni, hengitys
tyhjä: nolla-, tyhjä
eteneminen: edistyminen
intransitiivinen: välttämätön
euforia: innostusta
leveä: laajentaa, leveys, laajalle-levinnyt
intransitiivinen: välttämätön
contrastive: erottuva, selviytyä
hämmästynyt: yllättynyt
lähete: esitellä
jälkeläinen: tuttu, tyttärentytär, sukupolvi
jäätelö: kerma
säde: säde
vaihtoehtoisesti: muuten
naapuruus: ympäröivä, elää, ympäristö-
tottunut: asiakassuhde
hämmennys: häpeä, häiriö
merkittävästi: enimmäkseen
juuri: tuore, äskettäin, juuri
tanssi: pelata, tanssi
tyhjä: nolla-, tyhjä
määrä-merkki: 
sosiaalinen-merkki: 
kritiikki: kritiikki
rubidium-atomi: torium-atomi
taistelu: taistella, konflikti, sota-
kannella: noin
tyhjä: nolla-, tyhjä
vanadiinia-atomi: torium-atomi
neutri-sukupuoli: maskuliini--sukupuoli
fluori-atomi: torium-atomi
matka: vierailla, safari, retkikunta
maskuliini-: uros-
tyhjä: nolla-, tyhjä
kehitys-: evoluutio-, edistyminen
soveltava: käytännön
sulkea: kiinni
kerskailla: törsätä
taaksepäin: takaisin
esittää: esittää
tyhjä: nolla-, tyhjä
Satunnaista: satunnainen
osuuskunta: kollega
eläkkeellä: jäädä-eläkkeelle
tyhjä: nolla-, tyhjä
huvittunut: onnellinen, hilpeä, huvittaa
likimääräinen: lähentää
dyadic: binaarinen
lisä-: täydentää, lisä-
communicative: kirjeenvaihto, puhelias
tyhjä: nolla-, tyhjä
at-tapaus: että-tapaus
polonium-atomi: torium-atomi
hajota: disjunktio, analyysi
rusketus: ruskea
ongelma: ongelmallinen, vaivata
kääntää: käännös, kääntää
tyhjä: nolla-, tyhjä
tallium-atomi: torium-atomi
klikki: monialayritys, napsauttaa
helppo: helposti, yksinkertainen
hidastin: helpottajana, johtaja
sosiaalisesti: sosiaalinen
matching: puku, samaan-aikaan
onnettomuus: tapaus
se-noita: joka
kiinnostavaa: piirtää
ylösalaisin: käänteinen
rikkaruohomyrkky: myrkyttää
tyhjä: nolla-, tyhjä
osanottaja: partisiippi
esimerkiksi: esimerkki
kasvain: kasvain
rappeutuminen: laho
tyhjä: nolla-, tyhjä
verkkosivusto: verkkosivusto
valtavasti: massiivinen, erittäin, Super
tulee-olemaan: 
suhteellinen-tapaus: suhteellinen-tapaus
tavoite-tapaus: määränpää-tapaus
palkita: hyvittää, maksaa
kohdella-huonosti: väärässä
punos: harjanne, neuloa
sijasta--of: sen-sijaan
arkeologia: arkeologinen
liitin: copula, pistoke, liite, pistorasia
tyhjä: nolla-, tyhjä
yleistys: yleistää
strontium-atomi: torium-atomi
rutenium-atomi: torium-atomi
lukuun-ottamatta: paitsi
tyhjä: nolla-, tyhjä
vetäytyä: eksyä, regressio, jäädä-eläkkeelle
eläkeläinen: jäädä-eläkkeelle
yksi-toinen: toisiaan, muut
laaja: laajalle-levinnyt
tietojenkäsittely: laskeminen, tietokone, laskin
liiketoiminta-henkilö: Bisneshenkilö
kuuma-koira: makkara
valta-asema: vaikutus, teho, etu
lainaus-päättyy: lainata
omistushaluinen-tapaus: genetiivi-tapaus, omistushaluinen-tapaus
geneettisesti: geeni, genetiikka
konsessiivinen: perääntyä, pehmeä
epäsuora-esine: suoraan-esine
ehkäisevä-mieliala: ehkäisevä-mieliala
treenata: liikunta, tehdä-työtä, kehittää
rajattu: rajallinen, erotetaan
päinvastainen: käänteinen, vastustus, vastapäätä, inversio, erottuva
kiivetä: nousta
uskomattoman: epätavallisen, Super
tyhjä: nolla-, tyhjä
päättäminen: kiinni, kangaspuut
halvalla: halpa
kangas: kangas, verkko
sivistynyt: koulutus, kohtelias
villieläimet: luonto, villi
vastakkainen: vastustus, vastapäätä, kohti
tyhjä: nolla-, tyhjä
kaivaa: kaivaa
tartunnan: infektio
tyhjä: nolla-, tyhjä
aseistettu: aseet
toisin-sanoen: nimittäin
ei-kukaan: ei-mitään
kiroilua: vannoa, voimasana
suippeneva: ohut, kartio
viihdyttäjä: viihde, taiteilija
jne.: 
paitsi: paitsi
muoto: ääriviivat, ympäristö-, muoto
kännykkä: kännykkä, solu
neiti: leikata, menettää, viettää
hälyttävä: kauhea, ahdistunut
tulevaisuus: tulevaisuus
konjunktiivi-mieliala: ehdollinen-mieliala, optative-mieliala
pitäisi: täytyy
moottoripyörä: moottoripyörä, moottori
luottokortti: luotto
tyhjä: nolla-, tyhjä
julkinen: julkinen
kännykkä: kännykkä, solu
tyhjä: nolla-, tyhjä
suolet: tyhjentää
sijoittaa: jakaa, hajottaa, kuluttaa
karkottaa: eject
osa: panos, osa, kvantti
pätevyys: taito, toimivalta
maanomistaja: enkeli
prepositio--tapaus: 
jako: siirtolapuutarha, osinko, avustus
huolestuttava: ahdistunut
selvä: sama, erittäin
täytäntöönpano: hallita-pakolla
ammattilainen-lauseke: ammattilainen-tuomita
reseptoriin: sieppari
pistää: esitellä
upeita: hämmästyttää, huomiota-herättävä
yskä: yskä
vieressä: seuraava
