infinitiivi: ääretön, äärettömyys
nominatiivi-tapaus: 
akkusatiivi-tapaus: 
aihe-tapaus: aihe-tapaus
vanhempi: vanhempien, merkittävä, vanhempi
isä: isä
äiti: äiti, äiti, äidin
Hei: bye, Moi, Hei
kantaisä: edeltäjä, isoisä
isovanhempi: isoisä, isoäiti
nälkäinen: nälkä, nähdä-nälkää
genetiivi-tapaus: omistushaluinen-tapaus
adjektiivi: 
ja: summa, mukaan
minulle: itse, minä, minun, me
sinä: niitä, sinua, sinä
meille: me, meidän, meidän
se: hän, että, hän, tämä, nämä
määränpää-tapaus: tavoite-tapaus
datiivi-tapaus: 
sisusta-konteksti: 
henkilö-konteksti: 
riippuvainen-lauseke: 
perfektiivinen-näkökohta: 
ohi-jännittynyt: 
maskuliini--sukupuoli: neutri-sukupuoli
komitatiivi-tapaus: 
esittää-jännittynyt: 
benefactive-tapaus: 
essiivi-tapaus: 
ei: ei, ei, tuskin, kykenemätön, ei-, piki
sen: niiden, hänen, hänen, häntä, ne, hänen, of
pinta--konteksti: 
adpositional-tapaus: 
sijainti-tapaus: 
tila-konteksti: 
tapa-tapaus: 
instrumentaalinen-tapaus: 
joka: Kuka, kuten, jonka, kaikki, eikä, että, jonka, se-noita, mitä, joka, kumpi
kysyvä-mieliala: 
ja-tai: 
XOR-: 
lähde-tapaus: 
ablatiivi-tapaus: 
demonstratiivinen: vankka, merkittävä, betoni, vakuuttava, direktiivi, dramaattinen
mutta: vielä, kuitenkin
kaikki: jokainen, jokainen, kaikki-yhteensä, koko, yleinen, koko, kaikki, kaikki, yhä-useammin
naisellinen-sukupuoli: 
ne: niitä, hän, ne, niiden, heidän, sukunimi, nämä
monikko-määrä: 
yksi: yksittäinen, , osaksi, yksin
tulevaisuus-jännittynyt: 
sosiaalinen-konteksti: 
milloin: aina-kun
imperfective-näkökohta: 
siellä: 
ehdollinen-mieliala: konjunktiivi-mieliala, hypoteettinen-mieliala
lisää: yli, suurin-osa, edelleen, ulkopuolella, ylöspäin, ylöspäin, multi, kuin, pikemminkin, myös, lisäksi, plus, edelleen, vielä, muu, useat, moninkertainen
ulos: ulkopuolella, ulompi, ulkoinen, ulko-, ulkona, pois, ulkopuolella, ulkopuolella, ylös, päälle, päälle
suhteellinen-tapaus: suhteellinen-tapaus
illatiivi-tapaus: 
tehdä: tehdä, suorittaa, sitoutuvat, tehdä, aktivoida, teki, sitoutua
direktiivi-mieliala: ohjeellinen-mieliala
deontic-mieliala: 
kysymys-sana: 
copula: liitin, side, nippu
henkilö: mies, ihmiset, yksittäinen, joku, joku, kaveri, ihmisen, kasvot, suu, kokonaisuus
uros-: maskuliini-, mainita, herrasmies, mies
voisi: voida, voima, mahdollisesti, voi-olla
muut: muu, levätä, toinen, toinen, eri, yksi-toinen
määrä: määrä, summa, kuvio, numeerinen, numero, määrä
erittäin: suuresti, erittäin, kauhean, paljon, liian, kamalan, laajalti, erittäin, ihan-oikeesti, huonosti, valtava, huomattavasti, erä, multi, valtavasti, suurin-osa, melko, melko, pitkälle, melko, kunnossa, Okei, selvä
aika: sillä-aikaa, hetki, aikana, ajankohtainen, kesto, ajallinen, jännittynyt, aikataulu, aika, sää-
aika-konteksti: 
ajallinen-tapaus: 
noin: suhteen, koskevat, lähes, noin, of, mukaan, kuin, noin, varten, käyttäjä, kannella, päällä
episteemiset-mieliala: 
vain: vain, vain, yksinkertaisesti, kohta, pelkkä, puhtaasti, rajoitettu
vähän: pieni, pienen-pieni, hienoinen, hieman, bitti, vähäinen, pikkumainen, pikkuriikkinen, kannettava, harvat
sitten: uudelleen, takaisin, ya, koska, sitten, myöhemmin, jälkeenpäin
hortative-mieliala: 
takautuva-näkökohta: 
suuri: suuri, iso, jalo, vakava, valtava, äänekäs, valtava, jättiläinen, valtava, hallitseva, hyvä, hieno, huomattava, valtava, merkittävä, ihana, erinomainen, optimaalinen, suuri, merkittävä, täydellinen, huomattava, loistava
tahallisuutta-mieliala: 
ennen: ennen, pre, sitten, edeltää, asti, etuosa, ennen, vastaan
täytyy: pitäisi, välttämättä, tarpeeton, täytyy, tarve, on, pitäisi, haluta, että
kaksi: kaksois-, molemmat
nähdä: Katso, näkymä, näky, ilmoitus, havaita, katsella
tietää: varmistaa, tietoinen, opettaa, lippu, näkyvä
alas: alaspäin, alaspäin, alle, alla, alla, alla, Vähemmän, pohja, huonompi, alakerrassa
jälkeen: taka-, päälle, lähettää, ulottuvuus, myöhemmin, jälkeenpäin, jälkeenpäin, jälkeen, ohi, alla, alla
ensimmäinen: debyytti, alustava, koska, lähtien, nyrkki
oma: itse, sinä-itse, omistaa, henkilökohtaisesti, hänen, itse, itse
riistää-hallinta: 
ei-ikinä: koskaan
luovuttamaton-hallinta: 
vanha: käytetty, muinainen, ikäinen, vanhukset, entinen, entinen, entinen, ikä
neuvotteleva-mieliala: 
päivä: päivittäin, tänään, tänä-iltana
missä: minne-tahansa, jonka-mukaan, paikka
tulla: että, tavoittaa, saapuminen, saapua, tulla, muoti, tapahtua
tapa: menetelmä, metodologia, välineet, polku, reitti, alue, polku, polku, tapa, tie, katu, sokeri, seurata, lentorata, tapa
tehdä-työtä: Job, toimeksianto, aktiivinen, tehtävä, työ, työ, ura, toiminto, toimia, toiminnallinen, liike, toimia, treenata, työllisyys, työperäinen, työskentely, kuvamateriaali
vokaali: kuuluisa, elämä, eloonjääminen
mennä: kävellä, hinta, lähteä
perlative-tapaus: 
etenevä-näkökohta: 
pitkä: pitkittynyt, kestävä, pitkä, pitkin
sanoa: suullinen, kertoa, puhua
miten: pitää, kuten, kuin
jopa: myös, jompikumpi, asti, lisäksi, liian
takaisin: takana, taka-, taaksepäin, taaksepäin, palata, takaisin, palauttaa, purkaa, uudelleen, toistaa, sitten, mukaan
tässä: 
ajatella: ajattelu, ajatus, harkita, kuvitella, ajatella, mietiskellä, olisi, nimeltään, mieli
sama: identtinen, samanlainen, yhtäläinen, vastaava, oikeutetusti, kunnossa, selvä, itse, yhtä, samoin
kestää: pää, jälkimmäinen, lopullinen, perimmäinen, toinen, muu, viimeisin, viimeaikainen, pääte, ohi, ohi, kestää, kestää, laittaa, jatkua
pois: pitkälle, kaukainen, pois, erilleen, syrjässä, vasen, jättää, poissa
alle-konteksti: 
ottaa: lomakeskus, miehittää, noutaa, hyväksyä, napata, saada, ottaa-vastaan, valita, saalis, kaapata, hyväksyä, saada, veloittaa
löytyi: löytää, löytää, löytö, havaitseminen, pääsy
käsi: varsi, ranne
nuori: nuoret, nuorempi, nuori, teini-ikäinen, uusi
vaikka: vaikka, siitä-huolimatta, kiinteä, yritys, vankka, lujasti, huolimatta, kuitenkin, joku
antaa: lainata, säätää, tarjous, tarjoaminen, toimittaa, tehdä, antaa, laittaa, lahjoittaa, päästää
jumala: 
delative-tapaus: 
ei-mitään: jotain, esine, ei-kukaan, mitä-tahansa, ei-mitään, ei-kukaan
oikea: pari, korjata, tarkasti, oikeudenmukainen, oikeudenmukaisuus, perusteltu, epäoikeudenmukainen, oikeutettu, oikeus, laki, oikein, totta, tietty, kaikin-mokomin, oikeuttavat, hyvin
kerran: heti, viipymättä, menetelmä, kuvio, metodologia, uudelleen
semelfactive-näkökohta: 
osa: jakso, osittain, osa, osittain, paketti, jae, jakaa, bitti, pala, kulku, alaryhmä, luku, osasto, episodi, osittainen, jako, osasto, sektori, osa, puolesta
saha: 
talo: kotiin, tilat, temppeli, kotelo, talous
maailman-: valtakunta, maailmanlaajuinen, maailmankaikkeus
pää-: otsikko, tärkein, päällikkö, luku, johtaja, presidentti, puheenjohtaja, johtaja, pomo, vanhempi, kynä
kolme: kolmas
neo: uusi, hiljattain
fokus: tarkoitettu, tavoite, tavoite, tavoite, keskittää, Huomio, keskittyminen, aksentti, yhtyä
rakkaus: tunteet, hyväntekeväisyys, pitää
aina: ikuisesti, alituisesti, koskaan, tavallinen
yö-: ilta, päivällinen, iltapäivällä
kukin: kohti, joka, kaikki
kuningas: vallita, herra, hallitsija, pohatta
välillä: keskuudessa, keskuudessa, of
sydän: eläköön, rohkaiseva, kaataa
paucal-määrä: 
koska: maksettava, koska, tapaus, aiheuttaa
kausaalinen-tapaus: 
asia: asia, asia, ilmiö, jutut, mitä
sarja: ryhmä, laittaa, pitää, asettaa, tahna, kokoelma, yhdistelmä, ryhmä, sviitti, paketti, salkku, synteesi, yhdessä, sarja, vuoro, alue, rivi, jono, pakki, corpus
nimi: sukunimi, substantiivi
asianmukainen-substantiivi: 
hortative: exhortative
maa: kansakunta, maa, maa, osavaltio, maa, lääni, maaperä, osapuoli
pyysi: 
näkyvä-todistusarvo: 
paremmin: esimies, parhaat, erinomainen, ihanteellinen, maksamatta
puoli: sivu-, suosia, suosia, puolesta, vuoro, sivu, näkökohta, puoli, puoli
kurssi: opetussuunnitelma, oppitunti, luento, varmasti, varmasti, ehdottomasti, hinta
naaras-: nainen, naisellinen, naisellinen, naiset, tyttö, vaimo
tarpeeksi: riittävä, riittävästi, riittävä, runsas, melko, paljon, riittämätön, melko, melko
pian: pian, nopea, nopea, nopeasti, nopeasti, välitön, nopea, kiire, kiireellinen, niin, heti, helposti, lähistöllä, varhainen, napsahtaa
koko: täysin, riittävästi, absoluuttinen, täydellinen, epätäydellinen, koko, täsmälleen, tarkka, täydellinen, tarkasti, perusteellinen, koko, kattava, koko
huone: kammio, neljäs, makuuhuone, rauha
melkein: lähes, käytännössä, suunnilleen, noin, lähellä, noin, lähellä, viereiset, käytännössä, lähistöllä, pian, proksimaalinen, karkeasti, tuskin
ei-pysty: kykenemätön
vesi: neste, neste, vedenjakaja
desiderative-mieliala: 
valo: hehku, kirkas, kynttilä, hienoinen, tyyli, kevyesti, lievä, sytytin, kalpea, kirkas
eikä-myöskään: eikä, ei-, vielä, mitä, tapahtua, tai
sana: leksikaalinen
ovi: portti, oviaukko, sisäänkäynti, luku, portti
käyttää: käyttää, käyttö, kulutus, menot, kuluttaja, sitoutua, hakemus, apuohjelma, käyttää, käyttää
aamu: aamupäivällä, aamiainen
terminative-tapaus: 
teho: vahvuus, energia, voima, vahva, pakottaa, voimakas, dynaaminen, salaatti, valta-asema, auktoriteetti
itse: itse, sinä-itse, itse, itse, itse, itse, itse, ego, luku
esittää: nykyinen, esittää, nyt, tällä-hetkellä, lahja, olla, saatavissa
ääni: ääni, ääneen, äänestys, audio-, äänestää, erä, huhu, huhu
valkoinen: tyhjä, valitus
raha: rikkaus, hopea-, taloudellinen, kassa, valuutta, rahoittaa, raha-
seuraava: vieressä, rinnalla, vieressä, jälkeen, myöhemmin, ulottuvuus, lähtien, myöhempi
huono: varsi, köyhyys, huono, pahin, mätä, heikko
kuolema: kuolleisuus, kuoleva, kuollut
muoto: muoto, muotti, muoto, muoto, kuvio
inessiivi-tapaus: 
ystävällinen: luokka, järjestellä, laji, lajike, tyyppi, ystävällinen, erä, hyvä, miellyttävä, miellyttävä, nautittava
usein: usein, alituisesti, säännöllisesti, tiheä, yleisesti, yleensä, tyypillisesti
vuosi: vuotuinen, vuosittain, viisi
ystävä: liittolainen, poikaystävä, stipendiaatti, perämies
tilata: järjestelmä, järjestely, järjestää, sopimus, ryhmä, komento, vuoro, rivi, jonottaa
pakottava-mieliala: 
pyöristää: pyöristetty, ympyrä, kierros
uskoa: luottamus, arvella, olettaa, usko, usko, luottamus, luottavainen, optimismi, optimistinen
julkinen: julkinen, yleinen, yleisö
osavaltio-konteksti: 
poika: parvi, poika
sata: sadasosa, kasvot, sentti
lapset: lapsi, jälkeläiset, lapsi, vauva
siten: siten, niin, siten, sellainen, kyllä
toivoa: haluta, näkymä, ennakoida, optimismi, optimistinen
edellä: ylös, yli, yläkerrassa, korkea, ylin, kehittynyt, ylempi, poikki, koskevat, kautta, päälle, yläpuolella, päälle, eteenpäin, ylöspäin
rakas: rakastaja, kallis
lukea: lukeminen, laulaa, lilja
kaupunki: kaupunki, kunnallinen, lääni
jo: valmis, valmis, halukas, joka-tapauksessa
tosiasia: totuus, todellisuus, totuudellisuus, totta, todellinen, todellinen, todellakin, ihan-oikeesti, todella, teki
factive-todistusarvo: 
kuulla: kuunnella, kuulo, tuntea
vähiten: minimaalinen, minimi, minimoida, miinus, Vähemmän
ehkä: todennäköisesti, voi-olla, oletettavasti, voima, mahdollisesti, mahdollinen, todennäköisesti, todennäköinen
avata: kirkas, tavallinen, selvästi, paljas, ilmeisesti, vapaa, täsmällinen, ilmeinen, ulko-, alijäämä, kalpea, avoimesti, paljastaa
elin: liha, ruumiillinen, fyysinen, fyysisesti, corpus, elin, ruumis
ilma: tuuli, tuulahdus, ilmailu, sää-, lentoyhtiön
luonto: luonnollinen, syntyperäinen, luonnollisesti, alkuperä, laskeutuminen, kotoperäinen, villieläimet, merkki
auttaa: auttaa, hyödyllinen, tuki, apu, avustaja, asettaa
kirje: posti, kirjoittaminen
neljä: neljäs
optative-mieliala: konjunktiivi-mieliala
antaa-potkut: kuuma, liekki, kuume
siksi: siten
tunnin: kello, kello, soittokello
ilmaiseksi: vapaus, vapaus, vapauttaa, ilmaiseksi, turha, vapaasti, vapaa, löyhästi, julkaisu
sota-: taistelu, taistelu
onko: jos, itse
syy: aiheuttaa, tili, tekijä, kohtuullisen, tekosyy, perustein, levitä, kantaja
yhdistynyt: yksikkö, yhtenäisyys, täydellinen, liitto, liittoutunut, liittolainen, ainutlaatuinen, yksimielinen
puhelu: haaste, hapettua, valitus, päällä, liitäntä, yhdistelmä, yhteinen, fuusio, kutsu
Miksi: 
menetetty: menetys, puuttuva
tuhat: tuhannesosa
perhe: talous, perhe
sielu: henki, aave, sielu
kysymys: ongelma, kysyntä, lukeminen, asia
hoito: huolestunut, koskea, Huomio, meditaatio, palvelu, sponsorointi, vartija, turvallisuus, suojaus, turvallisuus, säilytys, säilyttäminen, kattavuus, puolustus, varovaisuus, parantaa, hoito, huolto
REALIS-mieliala: 
tarkoittaa: vihjata, tunne, merkitys, mielekäs, tarkoittaa, keskimmäinen, agentti, keskikokoinen, keskimäärin, kohtalainen
mahdollinen-mieliala: 
kohti: kohti, vastaan, vastakkainen, vastakkainen, kohti, kunnioittaminen, varten
allative-tapaus: 
ihmisen-toiminnasta-sukupuoli: 
lyhyt: Vähemmän, matala, lyhyt, pian, lyhyesti, kortti-, kapea, hienoinen
pystyvät: voida, pätevä, oikeutettu, kykenee, kapasiteetti, kyky, kyvytön, pätevä, mahdollinen, mahdollisuus, todennäköisyys, vahva, voimakas, taitava, Toukokuu
elää: elämä, hengissä, käyttäytyä, elävä, pesä, piiri, naapuruus, naapuruus, elossa, vilkas, raaka, asua
aihe: kuri, teema, aihe, oppitunti, aine, ongelma, esine, merkitys, materiaali, semanttinen, asia, asia, otsikko
sama-aihe-merkki: 
eri-aihe: 
vastaus: pohjois-, vastata, vastaus, ratkaisu, vastata, vastata
meri: valtameri, meren-
pelko: pelätä, peloissaan, kauhu, awe, pelästynyt, paniikki, levottomuus, angst, kauhu, pelästyttää
ymmärtää: ymmärtäminen, ymmärtäminen, havaita, ymmärtää, ajatella, käsittämätön, sisältää, ymmärtää
kova: vaikea, jäykkä, monimutkainen, ankara, äänekäs, väkivaltaisesti, raju, kova, tiukka, haastava, hankala, raskas, hauta, vaikea, levoton
ehdot: termi, terminologia, ongelma, pohjainen, perustein, perusta, olennaisesti, pohjimmiltaan, pohjimmiltaan
epäillä: epäilys, epäluottamus, epäilty
dubitative-mieliala: 
kysyä: rukoilla, vaatia, kuunnella, Ole-hyvä
aseet: ase, riisua-aseista, aseistettu, varsi
musta: 
tuoda: noutaa, kuljettaa, olisi, johtaa
kaunis: hyvä, kiva, ihana, kauniisti, kauniisti, melko, mieltymys, viileä, söpö
tumma: synkkyys
pitää: pitää, ylläpitää, saalis, pito, sopimus, solmia, solmu, vuosikymmen, takavarikoida, Odota, pitää, pitää-yllä
kymmenen: vuosikymmen, kymmenes, oikeudenmukainen
show: näyttö, suorittaa, suorituskyky, esittely, esittely, osoittaa, tarkoittaa, tapahtuma, projektio
tarina: myytti, historia, kaunokirjallisuus, juoni
yhteinen: yleinen, tavallinen, rutiini, yleensä, tavallinen, epätavallinen, yleisesti, vaatimaton, normaali, epäsäännöllinen, tavanomainen, tyypillinen, yleensä, tyypillisesti, yhteinen, kumppani, kumppani, aggregaatti, yleinen, keskinäinen, yritys-
kirja: vierittää, varata, punta, oppikirja
elektroninen: elektroniikka, elektroni, salama, sähköinen, sähkö, sähköinen
puhua: keskustelu, jutella, neuvotella, vuorovaikutus, olla-vuorovaikutuksessa, neuvottelu, puhua, puhe, suullinen, esitelmä
merkki: merkki, jäljittää, polku, pisteet, kohokohta, rasti, merkki, signaali, osoitus, vihje, merkki, merkki, etiketti
kiinnostaa: kukka, kiinnostunut, koskea
kirjoittaa: säveltää, kirjoittaminen, tyyppi, kirjallinen
vuode: 
välttämätön: olennainen, tärkeä, hyödyllinen, kriittinen, elintärkeä, merkittävä, merkityksetön, olennainen, ratkaiseva, merkittävästi, tarve, välttämättä, intransitiivinen, intransitiivinen, intransitiivinen
ajatus: ajatus, harkinta, perustelut, lausunto, käsite, neronleimaus
taide: alus, taiteellinen
Vialis-tapaus: 
veli: sisar, sisko
joskus: harvoin, silloin-tällöin, jonkin-aikaa
linja: johdin, kierre, rivi, kaista, johtuminen, kojelauta, raita, verottaa, käsikirjoitus
taulukko: vastaanotto, ajoittaa, luettelo
joki: tyyny, tyyny, virtaus
silmä: nimittää, noin
tiedot: viesti, selitys, kuvaus, tiedotuslehti, tuntemus, tiedot
yhtäkkiä: äkillinen
outo: omituisesti, yllättävä, omituisesti, pariton, ihme, ihana, huomattava, ylimääräinen, uskomaton, hämmästyttävä, outo, hauska, muukalainen, eksoottinen, hankala
syvä: syvään, syvyys, laaja, matala, perusteellinen, yksityiskohtainen, kattava, kriittisesti, syvällinen, sisällä, sisällä, sisä-, mato
muuttaa: muutos, vaihtelu, muutos, muuttaa, mutaatio, siirtää, muuttaa, muuttaa, siirtyminen, muutos, korvaaminen
tunne: tuntea, tunne, havaitseminen, vaikutus, tunne, mieliala, vaikuttunut, tunteellinen, aisti-, näkemys, tunne, intohimo, tajuissaan, tajunta
tavata: saada, yhtyä, kohdata, noudatettava, tyydyttää, kokous
tarkoitus: esine, tavoite, tavoite, tavoite, määränpää, aikomus, tarkoitettu, motiivi, tavoite
onnellinen: iloinen, huvittunut, ilo, iloinen, ilo, onnellisuus, ilahduttaa, iloinen, hauska, onneksi, onnekas, tyytyväinen
näyttää: ulkoinen-olemus, näyttää, ilmeisesti
veri: vuotaa-verta, rikollinen
ruusu-: vaaleanpunainen
etelä: eteläinen, keskipäivä, keskipäivä
kylmä: talvi-, viileä, kylmästi
eteenpäin: edelleen, kauemmas, eteenpäin, näky, etuosa, kehittynyt, sitten, maila, päälle, lähtien
sijainti: sijainti, tilanne, status, mahdollisuus, tilaisuus, tila, asenne, ryhti, paikka, lähettää, erä
myöhään: hitaasti, pää
seistä: asema, pystysuora, asenne, asenne, Stop, ryhti, aiheuttaa, pilttuu
olettaa: olettamus, hypoteesi, olettaa, hyväksyä, olettaa, hypothesize, ehdottaa
tytär: tyttö, neitsyt-
minun: minun
leikata: puute, puuttuva, vähentäminen, puute, vähentää, puute, neiti, leikkaus, keskeyttää, pilkkoa, kauttaviiva, sato, leikata, rikki, rikkoa
kopioida: jäljentää, replikointi, toistaa, transkriptio, valokopio, klooni, versio, resepti
aviomies: mies, puoliso
kuusi: sukupuoli
muistaa: Huomautus, muistaa, muistuttaa, muistaa
vaikutus: vaikutus, vaikuttaa, vaikutus, vaikutus, valta-asema, tehokas, tehokkaasti, tehokkuuden, seuraus, tulos, valotus
pudota: syksy, tapaus, sijaitsevat, romahdus, rojahtaa, hajota, romahdus, pudota, aleneminen, vähentää
paitsi: ellei, ulkopuolella, ulkopuolella, paitsi, erilleen, lukuun-ottamatta, vieressä, syrjään, lukuun-ottamatta
hiukset: 
syöttö: mukaan, kautta, ohimenevä, kautta, lähellä, vieressä, muodostuvat, valmistua, ruoste, ylittää, kulku, edetä
tekijänoikeus: 
armeija: joukot, joukko, isäntä, sotilas
ajaa: pakenevat, valua, juoksu, suorittaa, toimia, ajaa, vuotava, vaihde
hevonen: hevosenkenkä, at
tulevaisuus: tulevaisuus, myöhemmin, jälkeenpäin, jälkeenpäin
länsi: western
maksaa: palkat, palkka, palkkaus, työntövoima, maksu, palkita, maksu, maksaa
punainen: 
kulta-: 
halu: tahto, innokas, ruokahalu, haluta, kaivata, halu
pelata: tanssi, uhkapeli, peli, poski, lelu
hallita: herra, ensisijainen, tärkein, professori, hallita, hallita, Herra, herrasmies, johtava, herra
toimisto: toimisto, vastaanotto
hallitus: osavaltio, rivi
kirkko: 
pituus: korkeus, korkeus, jänneväli, pitkin, kesto
yritys: yritys, yhtiö, yhteiskunta, liike, yritys-, kokonaisuus, laitos, toimisto, instituutti, hanke
paperi: arkki, kortti-, vuokrata
todennäköisyys: mahdollisuus, todennäköisyys, todennäköisesti, mahdollisesti, epätodennäköinen, näkymä, mahdollisuus
erityisesti: erityinen, erityisesti, erityisesti, erityisesti, erityinen, täsmälleen, pääasiallisesti, enimmäkseen, pääasiallisesti, erityinen
karhu: kuljettaa, kestää, kestää, kärsivällisyys, toleranssi, olla, omistaa, antaa
ikkuna: 
sopimus: protokolla, tilitys, vaarantaa, konsensus, sopimus, olla-samaa-mieltä, sopimus, sopimus, hellä, sointu, sopimus, sopimus, järjestely
kauneus: kauniisti, loisto, esteettinen
tulli: vastuu, vastuu, velvollisuus, vastuullinen, tulli, tehtävä, toimeksianto, velka, velkaa, täytyy
lähettää: lähettää, jättämisestä, lähettää, lähettää, email
etäisyys: poistaminen, alue, erottaminen
hiljaisuus: hiljaisuus
jalka: jalka, pysäyttää, reisi, varvas, neljännes, kävellä, kävely
villi: villisti, laiton, raju, villieläimet
kuolla: kuollut, kuoleva
tallentaa: säästö, säilytys, toipua, säästää, säilyttäminen, muistaa, kauppa, lunastaa, pelastaa, tallentaa
vihreä: raaka, raakaöljy
vaivata: vaivautua, ongelma, ongelma, vaikeus, vaikeus, vaivata, kärsimys
hymy: virne
väärässä: virhe, virhe, virheellinen, huonosti, kohdella-huonosti, väärä, vika, vika, virhe, väärin, tahdittomuus
eri: eri, vaihteleva, moninkertainen, alue, monipuolinen, multi, toisin-kuin, variantti, erota, vaihdella, lajike
nukkua: unessa, unelma
quotative-tapaus: 
alku: alkaa, alku, sitoutuvat, naarmu, puhkeaminen, varhainen, alustava, aloittamista, debyytti, periaate
toiminta: tehtävä, kohta, vaihe, vaihe, toimia, menettely, aktiivinen, toiminta, toiminta-, aktivoida, aktivisti, liikkua, harjoitella, harjoitella, toimia, kalusto, ralli, suoritus, suorittaa
vierailla: pääsy, haastatella, pääsy, matkustaa, matka, matka, kiertue
seurata: noudattaminen, noudattaa, jälkeen, harjoittaa, seurata, seurata
yrittää: yrittää, yritettiin, ponnistus, aloite, kokeilu, testata, näyte
läsnäolo: olemassaolo, olla, kokonaisuus, etu
makea: karamelli, lempeä, mitäänsanomaton, söpö
rikas: paljon, runsas, varakas
vihollinen: 
laiva: vene, purjehtia, laivasto, purjehdus, alus, risteily, lautta
kunto: veto, vedonlyönti, osavaltio, tilanne, seikka, status, onni, vaihe, taso, kunto, vaatimus
mukaan-lukien: sisältää, sisältää, sisältää, kuulua
täydellinen-henkilö: 
salaisuus: salaperäinen, mysteeri, tappi, maanalainen, erittää
precative-mieliala: 
kohtelias-ilmoittautua: 
paha: vahingoittaa, ikävä, häijy, huono, huonosti
maaliskuu: paraati, protestoida, esittely, Mars
aivan-sama: mitä-tahansa, kumpi
pysyä: jäädä, istua, asettua, hengissä, asua, Odota
sen-sijaan: sijasta--of, pikemminkin, korvaaminen, korvaaminen
sininen: keijukainen
mahdoton: 
koulu: kampus, tikapuut
tilaisuus: tilaisuus, tapahtuma, esiintyminen, mahdollisuus, katu, tinkiä
naimisissa: avioliitto, naittaa, häät
ruoka: ateria, ruokavalio, ruokalaji, rehu, ravintoaine
kaksikymmentä: 
hiljainen: tyyni, rauhallinen, vakauttaa, hiljainen, rauhallinen, hidas, rento, pehmeästi
helposti: todennäköisesti, helposti, velvollinen, helppo, sopivuus, hienoinen, hieman, kevyesti, mukava, suora
mahdollinen-näkökohta: 
kieli: kielellinen, kieli
ilmaisu: ilmaista, selvitys, lauseke, artikuloitu, ilmestys, valotus, lausahdus
viikko: sunnuntai
sali: kuisti, teatteri, käytävä, tila, kammio, salonki, aula, käytävä, juoksija, aula
vaara: vaarallinen, riski, kunnioittaminen, uhkaus
omaisuus: etu, kuulua, omistaminen, monarkia, hallinta, ominaisuus, piirre, omaisuus, onni, rikkaus
syntynyt: syntymä
tuomioistuin: oikeus-, ruokalaji, foorumi, oikeudenkäynti
yleisesti: tavallinen, tyypillisesti, yleinen, yleinen, laajalti, yleensä, yleisesti, yleensä, laajalti
genomisen-näkökohta: 
arvoinen: ansaita, arvo, arvokas, voimassaolo, ansio
yksinkertainen: yksinkertaisuus, suora, mukava, joustava, helppo, vain, yksinkertaisesti, tavallinen, vaatimaton, vain, pelkkä, suoraan, tavallinen
puu: kasvi, puu-, akseli, puutavara
taistella: taistelu, taistelu, yhteenotto, riidellä, ryntäily
seinä: 
taivas: taivas
inchoative-näkökohta: 
jussive-mieliala: 
sävy: piki, melodia, tonni, tonni, sävy
ottaa-huomioon: kunnioittaminen, olettaa, olettaa, Huomio, harkinta, harkita, suhde, yhdistys, yhteys, koskevat, suhteen, huomautus, kattavuus
odotettu: ennakointi
kuukausi: kuu
kokea: empiirinen, kokemusperäinen, kokenut, asiantuntemus, kuori, kokeilu
täysin: täysin, täysin, täysin, täysin, melko, yhteensä, täysin, absoluuttinen, koko, perin-pohjin, melko, puhtaasti, täsmälleen
tuore: juuri, puhdas, puhdas, virkeänä, uusi, noviisi
herttua: hallitsija, prinssi
katettu: päällyste, kattavuus, pois, suljettu, sisä-
sidottu: laajuus, rajoitus, rajoittaa, raja, rajoitus, rajoitettu, kytketty, riippua, sitoa
itään: itäinen, sitten, edellinen, ennen, pre, suunnata
kivi: marmori, rock, helmi
jokseenkin: jotain, mitä-tahansa, jotkut, melko, pikemminkin, hieman, osittain, jollakin-tavalla
suunta: suuntautuminen, ulottuvuus, suuntaus, puoli, opetus
tuoli: istuin, nojatuoli, jakkara
tuki: pitää-yllä, hyväksyä, apu, auttaa, kannatin, tuki
päivämäärä: historia, kohdata
kylä: Hamlet, maaseutu
ala: pallo, valtakunta, alue, alue, alue, vyöhyke, sektori, verkkotunnuksen, areena, stadion, tila, marginaali, maaseutu, leiri
lupa: antaa-lupa, korva, lupa, raivaaminen, jättää, lisenssi, lisenssi, suostumus, painos
salliva-mieliala: 
menestys: onnistunut, onnistua, vauraus, saavutus, voitto, voittaa, osuma, voittoisa, voittaja
asianmukainen: asianmukaisesti, korjata, kohtuullinen, tarkoituksenmukainen, tarkka, tarkka, oikeus, tarkka, tarkasti, viipymättä, uskollisesti, oikeutetusti, oikein, vaihtelu, sovittaa, sopiva, mukava, sopiva, vastata, oikeutettu, merkityksellinen, täydellinen, riittävä, säännöllisesti
mäki: vuori, asentaa
musiikki: musikaali
distaalinen-demonstratiivinen: 
iltapäivällä: iltapäivällä, keskipäivä, keskipäivä, ilta
itkeä: surra, huutaa, huutaa
kunnia: kunnia, kunnioittaminen, arvokkuus, kunniallinen, kunniallinen, kunniavirat, kohteliaisuus, kunnia, hinta, hinta
seitsemän: 
yksityinen: henkilökohtainen, itse, henkilökohtaisesti, itse-, erityinen, yksityisyys, erityinen, yksinomainen
uutiset: viesti
näkymä: paikka, näky, konteksti, näyttö, visuaalinen, vaihe, näkymä, näkymä, teltta
puutarha: pysäköidä
rotu: rodullinen, kilpa-, juoksu, kilpailu, turnaus, hellä, rotu, ottelu
jakelu-tapaus: 
oppia: tutkimus, opettaa
poliittinen: politiikka, poliittisesti, poliitikko, politiikka
valhe: väärä
heittää: heittää, heittää, sinkauttaa, nakata, muoto, muotti, käynnistää, vuodattaa, lopettaa
syödä: ateria, rehu, ruokalaji, ruokailla, kulutus
lattia: matto, maa, pohja, maaperä, kävellä, korkea, pitkä
sairas: sairas, potilas, kipeä, sairaus, väärä, huonosti
alkuperäinen: alkuperä, alun-perin, alustava, alustava, synteesi, ensin, syntyperäinen, aito, synnynnäinen, kotoperäinen, tärkein, ensisijainen, prototyyppi
kesä: lämpö
uskonto: uskonnollinen, velka
kuva: muotokuva, maalaus, kuva, valokuva, valokuvaus-, valokuvaus, kuva, valokopio, piirustus, napsahtaa, elokuva, kuva, kuvaus, kuva, kuvio
paeta: pakenevat
kirjailija: kirjailija, opettaja, toimittaja
ruskea: harmaa, harmaa, rusketus, pronssi
määritetty: määritys, päättää, määrätä, selvä, itsevarma, suunnittelija, määritetty, varmistaa, vakaa, tietty
kipu: satuttaa, ahdistus, tuskallinen, suru, kipeä
kevät: sulka, meidän, meidän
vuosisata: ikä
pehmeä: konsessiivinen, sileä, hienoksi, hellä, kevyesti, pehmeästi, lempeä, mitäänsanomaton, lievä
nurkka: kulma, kiila, hukkua
tuottaa: tuotanto, synnyttää, tuottava, valmistaa, valmistus, valmistus
nauraa: pila
unohtaa: unohtaa
Eurooppa: 
kahdeksan: kahdeksas
pukeutua: puku, vaatteet, puku, kaapu, pukeutunut, yhdenmukainen, asu
kauhea: hirveä, kamala, kamalan, pelottava, valtava, traaginen, hälyttävä, pelästyttää, hirvittävä, kauhean
hengitys: hengitys-, hengittää, hengittäminen, hengittää, ego, huohottaa
viisas: kohtuullinen, järkevä, hienovarainen, huomaavainen, taitava, fiksu, älykäs
omistushaluinen-merkki: 
muisti: muistaa, viite, muistomerkki
moderni: nykyajan, hienostunut, nykyaikaistaa, muodikas, viimeaikainen, esitelmä
paikka: kohta, piste, kello, sijainti, tahra, tahra, läikkä, paikka, ei-mihinkään, tilat, paikka, paikka, paikallinen, paikantaa, merkki, maa
nousta: kasvi, kiipeily, kylvää, kiivetä, ylös, lauta, ratsastaa, kohottaa, nousta, korottaa, syntyminen, kasvaa
tauko: murtautua-sisään, jarru, lomakeskus, aula, keskeytys, intervalli, aukko, murskata, särkeä, Stop, tauko, keskeyttää
viisikymmentä: 
saari: 
koskettaa: yhteyshenkilö
lupaus: sitoutua, sitoutuminen, pantti, nimittäminen
commissive-mieliala: 
aste: yhtäläinen, laajuus, luokka, laatu
suunnitelma: järjestelmä, sopimus, ohjelmoida, ohjelmoida, aloite, suunnittelija, ehdotus, hanke, juoni, luonnos, projektio, layout, litteä, piirustus, design
käytös: suuntaus, käytös, käytös, käyttäytymiseen
yllätys: hämmästyttävä, odottamaton, satunnainen, yllättävä
minuutti: 
laukaus: ammu, ammunta, luoti, ammukset, valokuva, kuva, isku, pamaus, vallankaappaus, heittää, kehys
huonompi: huono, pahin, karkea, haitallinen, huonosti, kamalan, huonompi, ylös, yläkerrassa
lasi-: peili, kristalli-, purkki, lasit, silmälasit
esimerkki: esimerkki, kuva, malli-, kuvio, metafora, prototyyppi, kuten, edustaa, yksilö, tapaus, ennakkotapaus, näyte, paradigma, esimerkiksi
turvallinen: turvallinen, turvallisuus, turvallisuus, turvallisesti, luottavainen, vakuutus
lääkäri: lääkäri, terapeutti, lääkäri, lääketieteellinen
completive-näkökohta: 
toistuva: usein, säännöllinen, jatkuva, alituisesti, silloin-tällöin, tiheä, säännöllisesti, toistaa
sotilaallinen: joukko, militantti
lämmin: kuuma, tyköistuva, lämpö, lämpö, lämpötila, lämmitys, gramma, hiostava
juoda: juoma
kysymykset: 
suututtaa: suuttunut, raivo, skandaali, ärsyttää, huolimatta
suoraan: suoraan, suoraan, epäsuora, automaattinen, suora, välitön
hattu: korkki, kypärä
koira: 
palvelija: stuertti, Tarjoilija, neito
ylpeys: ylimielinen, ylpeä, ylpeänä
väkijoukko: kiire, tungosta, väkijoukko, määrä, määrä, väestö, isäntä, kasa
kouluttaa: kuljetus, auto, vaunut, kärry, rautatie, rautatie, kouluttaa
moraalinen: moraali, moraalisesti, eettinen, etiikka, moraali, henkinen
liittyvä: kumppani, merkityksellisyys, korreloida, liittyvä, huolestunut, koskea, merkityksellinen, pitkin, kytketty, koskevat, liittoutunut
astua: loki, merkintä, osavaltio, osoittaa, lisätä, sisältää
sääntö: hallinto, ylivalta, järjestelmä, tuomio, tuomio, tuomio, tuomari, tuomari, hallita, laki, lainsäädäntö, normi
miekka: terä
hyökkäys: invaasio, hyökätä, aggressio, rikkomus, hyökkäys, rikkomus, lakko, puhkeaminen, hyökkäys
terveys: terve, tervehtiä
kohta: jae, lauseke, kimpale, kohta, asenne, asenne
sosiaalinen: yhteiskunta, sosiaalisesti
maksun-palautus: vastata, vastata, palata
anteeksi: pahoitella, napa, Anteeksi, tekosyy, anteeksipyyntö
rohkeus: nyppiä, rohkea, luottavainen, hermo, rohkeus, uskaltaa
armo: suosia, suosia, armo, ystävällisyys, hyväntahtoisuus, puolesta, Anteeksi
virallinen: muodollinen, muodollisesti, virallisesti, upseeri, virkailija
mikäli: säätää, tarjous, tarjoaminen, käyttöönotto, saatavissa, toimittaa, säännös, tyydyttää, jos
pyyntö: rukous, kysyntä, väite, vaatia, vaatimus, tiedustelu, tiedustelu, nopea, tarjous, hakemus
silmäys: vilaus, näkymä, asenne, havaitseminen, näkymät, näky, Katso
liike: liike, kampanja, urheilu, ristiretki, toimia, liikkua, liikkuvuus, liike, liikkuva
odottaa: odotus, ennakointi, ennakoida, Odota
vastapäätä: etuosa, vastakkainen, päinvastainen, vastakkainen, poikki, laskuri
kaksitoista: 
kihloissa: sitoumus, kiireinen, osallistuva, osallistua, miehitetty
viini: viinirypäle, alkoholi, alkoholisti
maku: maku, maku, herkullinen, syötti, kuori
rauta-: teräs, metalli-
jakaa: lähettää, sijoittaa, julkaista, kustannustoiminta, diffuusio, kiertää, jakelu, jakaa, jakaa, jakaa, jakaa, jakaa, luokitella
käydä-kauppaa: kaupankäynti, liike, kaupankäynti, kauppatavara, Internet, tinkiä, kauppa, kauppias, ostokset, markkinointi
etu: saada, voitto, hyöty, kannattava, hyvyys, etu, etusija, valta-asema
vaatteet: vaatekaappi, kangas, vaatteet, asu, vaate, rojahtaa
tuomari: tuomio, tuomio, tuomari, tuomari
ero: ero, eriyttää, eri, erillinen, selvä, erota, vaihtelu, erikseen, vaihtelevuus, vaihtelu, jakaa
ahdistunut: hätä-, kiireellisyys, huolestunut, huolissaan, huolestunut, levottomuus, koskea, huoli, huomaavainen, epämiellyttävä, huolestuttava, peloissaan, innokas, järkyttävä, hälyttävä, innostunut, innokas, levoton, levoton
kapteeni: 
päättynyt: saada-valmiiksi, pää, rajallinen, valmis
lakkaaminen-näkökohta: 
utelias: innokas, mielenkiintoinen, jännittävä
ulkomainen: ulkomailla, ulkomaalainen, ulkomaalainen, eksoottinen, muukalainen, ulkoinen
vahvistussana: tehostaa
merkitys: välttämättömyys, merkityksellisyys, merkitys, arvo
vihdoin: lopulta, lopulta, rajallinen, lopullinen, perimmäinen, terminaali, hienoksi
laskuttaa: toimia, käsikirjoitus, tili, laskenta
todistaa: todiste, vahvistaa, vakuuttaa, osoittaa, todistaa
estää: lopettaa, kieltää, pidättää, tukahduttaa, rajoittaa, estää, lohko, hillitä, estää, kieltää, välttää, hylkiä, tukahduttaa, keskeyttää
kaula: kurkku
oikeudellinen: oikeus-, laki, laillinen, kehys
kuiva: varsi
palvella: palvelu, ansaita, tyydyttää, tarjous
menettää: neiti, panna-väärään-paikkaan
näyttö: todistusarvo, todiste, opas, vihje, hakemisto, näyttö, todistaja
todistusarvo-tapaus: 
edistyminen: harppaus, eteneminen, kehitys, etenevä, kehitys-, edetä, edetä, parannus, kohottaa
rakentaminen: rakentaa, rakenne, rakentaa, rakentaminen, tilat
haku: löytää, löytää, löytö, etsintä, havaitseminen, etsivät, etsiä, tutkimus, tutkimus, pyrkimys, tiedustelu, tutkimus, tiedustelu
surullinen: masentunut, valitettavasti, kurja, järkyttävä, allapäin, katumus, masentava
synti: syyllisyys
kolmekymmentä: 
rehellinen: vilpitön, uskollinen, rehellisesti, vilpitön
kiinni: lähellä, suljettu, päättäminen, pois, asentaa, sulkea, pakata, nippu, paketti, paketti, paketti, takavarikoida
pankki: penkki, tina
kohtalo: onni, onni, syntaktinen, määränpää, erä
metsä: viidakko
mitata: arvioida, mittaus, punnita, metri, metri
muuten: vaihtoehtoisesti
virta: virtaus, lauseke, nykyinen, sähkö, virtaus, suihku-
leipä: leipoa, kylvää, voileipä
lisä-: ylimääräinen, vapaa, lisäksi, ylimäärä, ylijäämä, edelleen, lisäys, lisä-, lisätä, liite
valita: valinta, valinta, valita, valikoiva, valita, valita, valitsin, äänestää, tutkimus, etusija
eläin: 
Zoic-Kahvi-sukupuoli: 
eventive-mieliala: 
sama-tapahtuma-merkki: 
multiplikatiivinen-tapaus: 
paksu: liikalihava, paksusti, tiheä, rasva
olento: organismi, olemus
sade: märkä, sademäärä, suihku
pinta-: kasvot, taso, kone, alue
pyhä: pyhä, netto, puhtaasti
heinäkuu: 
kertomus: määritys, selvitys, suhde, suhde, yhteys, oikeudenmukainen, näyttely, essee, valotus, pisteet
rannikko: säie, ranta
tiedosto: asiakirja, kela, jättää, profiili, arkisto
olkapää: akseli, akseli, kuvaus, kampa, varsi
yllättynyt: hämmästynyt, ihme
kuninkaallinen: keisarillinen, monarkia, kuningaskunta, imperiumi, todellinen, todellinen
laulu: virittää, seurata, laulu, runo
mukavuus: helppous, rento, rentouttava, rohkaisu, sopivuus, levätä, helpotus
kukaan: kukaan, joku, joku, ei-kukaan, jokainen
ruoho: heinä, rikkaruoho, yrtti, nurmikko, gramma
piirtää: vetää, Vedä, saalis, mielenkiintoinen, valitus, houkutteleva, peruuttaa, jännittävä, vetää-puoleensa, kiinnostavaa, piirustus, poistaa, vähentää
aukko: alustava, alustava, löytö, aukko, aukko, avoimesti
kesäkuu: 
kalastaa: akvaario
pääoma: luku, rahoittaa, etu
rinta: rinta
lumi: jää
koulutus: kouluttaa, oppitunti, koulutus-, lukutaito, muodostus, koulutus, sivistynyt, akateeminen
terävä: kirkas, raju, tiukka, jyrkästi, mausteinen, terävä, akuutti, innokas, terävä
sääli: armo, myötätunto, myötätunto, sympaattinen, myötätuntoinen, hirveä, rangaistus, sulka, valitettava, valittaa, vahingoittaa, vahingoittaa, katumus
kulu: maksu, menot, maksaa, painos, ulostulo, veloittaa
sinun: sinun
miljoona: miljoonas
väsynyt: väsymys, rasittava
tappaa: murhata, tappaminen
varjo: sävy
paino: ladata, raskas, raskaasti, punnita, paine
massa-: laatu, kollektiivinen, määrä, irto-, monikko, erä, kyhmy, rykelmä, väkijoukko, rikkomus, taikina, pasta
vakiintunut: asentaa, vankka, lujasti, vakaa, luominen, perustaa, vakiintunut
rohkea: rohkea
ohut: luiseva, laimentaa, suippeneva, kapea, nojata, hieno, hienovarainen, hienoksi, hienoinen, pahuksen, ohut, herkkä, arvioida
vakuuttunut: tyytyväinen, tyytyväisyys, tyytyväisyys, iloinen, tyydyttää, tyydyttävä
tarkistaa: tarkistaa, Katso, katsella, valinta, tutkia, tarkastaa, tutkimus, testata, tarkastaa, väli-, tutkimus, tutkia, varmistaa, tarkistaa, ohjaus
hyve: ystävällisyys, hyveellinen, hyvyys, hyväntahtoisuus
kansallinen: kansakunta, kansalaisuus, etninen, kotimainen
jumalallinen: pyhä
laakso: pesuallas
arvaus: päättely, epäilty, olettaa, arvio, arviointi, ennustus, ennustaa, ennuste, spekuloida
keinotteleva-mieliala: hypoteettinen-mieliala
keltainen: kalpea, keltainen, vaalea
jäännökset: jäännös, jäljelle-jäävä, jäljellä-oleva, ruoantähteet, levätä
taipunut: kaareva, mutka, polveileva, suuntaus, kierretty, rinne, kalteva, näkökulma, taitto
laatikko: matkalaukku, laatikko, rahoittaa, pakki, voida, astia
kausi: kausiluonteinen, luku, asema, aikakausi
tiede: tieteellinen
porausreikä: reikä, porata, tylsä, tylsä, puhkaista, ärsyttää, foorumi
setä: 
lista: indeksi, luettelo, valikko, ilmoittautua
elokuu: 
suosittu: yleisyys, kuuluisa, näkyvä, kansa
tuntematon: muukalainen
tuttu: tuttavuus, sukuperä, jälkeläinen
tuttu-ilmoittautua: 
lukija: laulaja
lähestyä: tavoittaa, pääsy, tekniikka, taktiikka, metodologia, asenne, tapa, menetelmä, muoti, menettely, likiarvo, liitäntä
kahdesti: kaksinkertainen
henkinen: mieli, älykkyys, henkinen, älykäs, psykiatrinen, ajattelija, viisaus, henkinen
todella: ihan-oikeesti, todellakin, täsmälleen, todella, käytännössä, käytännössä, totta, vilpitön, realistinen, täysin, ehdottomasti, kaikin-mokomin, varmasti, varmasti
pappi: papisto
haavoittunut: loukkaantunut, haava, satuttaa
suru: suru, surullisuus, masennus, masentunut, suruaika, ahdistus
palatsi: 
lyödä: voittaa, booli, läimäys, lyödä, läimäyttää, rytmi, voittaa
eh?: 
typerys: typerä, temppu, pettää, huijata, tyhmä, typerä, vihainen, hullu, mielenvikainen, johtaa-harhaan
reuna: Brink, hapsut, marginaalinen, voimakas, raja, marginaali, lauta
yhdeksän: yhdeksäs, uusi
räjähtää: räjähdys, räjähdys, räjähtää, säröillä, puomi, puuska, pamaus
kärsiä: kestää, pitää-yllä
melu: meluisa, huutaa, hälinä, karjaisu
kirjallisuus: kirjallisuuden-
neuvot: neuvosto, suositella, suositus, neuvoa, neuvottelu, lauta, kärki
tyhjä: tyhjä, vapaa, rumpu, vapaa-, tyhjä, tyhjyys, tyhjiö, turha
arvo: lähettää, luokka, saavutus, luokka, arvo, luokka
myrsky: 
tasku-: laukku, paketti
mielikuvitus: mieltymys, kuvitella, olettamus, fantasia, kaunokirjallisuus, kuvitteellinen
tuomita: tuomio, tuomio, ehdotus, lause, ehdotus, ehdotus, rankaiseminen, vakaumus, lauseke, tuomita, tuomita, rangaistus
marraskuu: 
joulukuu: 
poissaolo: poissa, puute, puute
kiittää: kiitollisuus, kiitollinen, Kiitos, Kiitos
osoite: 
lintu: lento, kone, suihku-, lentokone, lentokone, lentoyhtiön
omistaja: pomo, vuokraisäntä
takki: puku, tuppi, kansi, takki, turkis
valmistella: valmis, valmis, järjestää, valmistelu, muotoilla
suhteet: suhde, yhteys, suhde, merkityksellisyys, koskevat, asia, viestintä, ilmoittaa
polttaa-tupakkaa: tupakointi-, tupakka, polttaa
tammikuu: 
kone: koneet, moottori, kone, ajoneuvo
pitoisuus: materiaali, jutut, noudatettava, tyydyttää, sisältää, sisältää, muodostuvat, sisältää
hampaat: hammas, vaihde
häpeä: häpeä, häpeissään, ujo, hämmentynyt, kiusallinen, hämmennys, paljas, alasti, loukkaus, skandaali
lahti: marja, vagina
aivot: sielu, kurpitsa
rengas: pikkumainen, valitsin, kiemura, silmukka, rengas, rengas, tiiviste, leima
lauseke-merkki: 
neliö-: 
hedelmä: 
tee: 
selittää: selitys, valaista, ilmaista, artikuloitu, julistaa, selventää, tulkita, kommentti
Tervetuloa: tervehdys, vastaanotto, viihdyttää, Hei, Moi, tervehtiä
runous: runo, jae
ostaa: ostaa, hankkia, antaa, markkinoida
luotettava: epärehellinen, uskollinen, uskollisesti, omistautunut, korjata, luotettava
jännitys: stimulaatio, innoissaan, hälinä, jännitys, provosoida, ilo, kiihottumisen, väri, levottomuus
neljäkymmentä: 
huhtikuu: 
ystävällisesti: Ole-hyvä, ystävällinen, kevyesti
lokakuu: 
katkera: vaikeus, tuska, ahdistus, karvaasti, kärsimys, tuskallinen, pisto
orja: orjuus
löysä: itsenäinen, löyhästi, ratkaista, ratkaista, löysä, vapaa, vapaasti
teksti: sanamuoto
luotto: kiinnitys, luottokortti, velka, lainata, lainata, lainata, arvovalta, voimassaolo, uskottavuus
viisitoista: 
julma: raju, kova
liittyä-seuraan: osallistua, käydä, osallistuva, alukseen, noudattaa, osallistuja, osallistuminen, yhdistää, kytkeä
käsitellä-asiaa: kahva, menettely, kohdella, toiminta, oikeudenkäynti
rikollisuus: syyllisyys, rikkomus, rikkomus
pöly: pato, jauhe
käytännön: toiminnallinen, käytännöllinen, käytännössä, mukava, käytännössä, kätevä, soveltava
väri: väri-, maali-, päähänpisto, väriaine, kalpea, värillinen, värikäs, väri, saada-valmiiksi
tuhota: tuhota, heikentää, sabotoida, hajota, purkaa, murskata, murskata, pilalla, hämmentää, pyyhkiä, kieltää, tuho
lisätä: edetä, parantaa, asentaa, korottaa, lisätä, lisätä, kasvu, suurentaa
nenä: 
myöntää: tunnustaminen, myöntää, hyväksyä, tunnustaa, tunnustaa, hyväksyvä, hyväksyä, myöntää, myöntää
eilen: huomenna
hesternal-jännittynyt: 
epäonnistua: vika, epäonnistunut, voittaa, takaisku, kykenemätön, hämmentää, pettää
jatkaa: edetä, jatkuva, sinnikäs, jatkaminen, alituisesti, jatkua
pitää-päällä: kuljettaa, portteri
sokea: 
tusina: useat
lentää: lentävä, hypätä, lento, ilmailu
kehua: ihailu, ihailla, maine, ansio, onnitella, onnittelu, kunnia, kuuluisuus
paholainen: 
vähitellen: hitaasti, asteittainen
uhrata: uhri, saalis, uhri
liikunta: yleisurheilu, treenata, toimeksianto, harjoitella, harjoitella, urheilu, kunto, harjoitus
omatunto: pronomini, tajunta
teoria: periaate, teoreetikko, lause
ministeri: 
vihata: ikävä, inhottava, viha, vastenmielisyys, ennakkoluulo, kauna, paheksua, tympääntynyt, inho, inho
järvi: 
keskusta: keskeinen, keskusta, asema, päämaja
heikko: tajuton, epätoivo, epätoivoinen, heikko, kalpea
järkevä-sukupuoli: 
varovainen: huomaavainen, tietoinen, keskittää, varovainen, tarkka, tarkka, tarkka, yksityiskohtainen
nauttia: nauttiminen, arvostaa
palvonta: rituaali-
tavarat: tuote, erä, kauppatavara, hyödyke, jutut
iho: nahka-, imeytyminen, haukkua, kuori, kuori, turkis, kuori
katto: terassi, katto, päällyste, kattavuus, kansi
kruunu: 
linna: häkki, torni, lukko
valtaistuin: 
liitteenä: sitoutua, ehdollinen, liittää, kytketty, riippuvainen, kumppani
maili: suuntaus, rinne, nojata, kaltevuus, halukas
äärimmäinen: maksimi, perimmäinen, napa, polaarinen, äärimmäinen, vakava, voimakas, intensiivinen, raaja, kärki
vankila: vankila
kuppi: muki, kulho
jäsen: elin, jäsenyys, raaja, sisäpiirin
siviili-: kotimainen, kansalainen, kansalais-, siviili-
kaikkialla: kauttaaltaan, missä-tahansa
ilmeinen: ilmeinen, ilmeisesti, todistusarvo, suoraan, näennäinen, ehdottomasti, selvä, kirkas, selvästi, läpinäkyvä, epäselvä, huomattava
pari: pari, par, kaksinkertainen, kaksois-, harvat, useat, höyry
tilavuus: kela, paljon, laajuus, määrä, suhteellisesti, määrällinen, lohko, erä, moduuli, irto-, kapasiteetti, kattavuus
asiakassuhde: asiakas, valinnainen, puku, tulli, harjoitella, tapa, tottunut
keula-: kaari, sipuli, käyrä
puku: sovittaa, puku, tarkoituksenmukainen, sopimus, vastata, matching, tapaus, syyte, oikeudenkäynti, puku, väite
liha: liha, naudanliha
maito: meijeri, hana, hyytelö
kasviperäistä-sukupuoli: 
visio: näky, transsi, oivallus, julkisivu, näkymä, vilaus, näkymä, maisema, näkymät
harvinainen: harvoin, tuskin
serkku: suhteellinen
silta: luokka, kansi
suojella: suojaus, säilyttäminen, vartija, kilpi, puolustaa, säilyttää, ylläpitää, säästää, turvallinen
suolaa: liioiteltu, liioitella, suolainen
viaton: 
kuningatar: 
laskea: väliseinä, arvella, laskea, luottaa, pettymys, tili
uteliaisuus: urkkia
tanssi: rumpu, tanssi, hypätä, hyppiä
hotelli: majoitus, majatalo
täyttää: 
vanki: 
myymälä: kauppa, pilttuu, liike, sopimus, ostokset
portaat: portaikko, rappu, tikapuut, laatikko
kerjätä: etsivät, olettaa, anoa
hiekka: 
väkivaltainen: väkivalta, raju, turbulentti, ihana, vaikea, vahva, voimakas, voimakas, villisti, intensiivinen
syyskuu: 
lähtö: jättää, lähteä, pistorasia, ulostulo
pilata: tuho, kumouksellisuus, vahingoittaa, pilata, katastrofi, hylky
taito: kyky, kykenee, kapasiteetti, tehokkuuden, pätevyys, alus, asiantuntemus
nautakarja: lehmä
laitteet: laitteet, laite, pakki, vaihde, asu, puuttua, laitteisto, tekniikka, teknologia, laitos, telineeseen
keittiö: ruoanlaitto, liesi
myydä: myynti, puoliperävaunu
nopeus: nopeus, vauhti, vauhti, jyrkästi
johtopäätös: päättely, vetäytyminen, ulostulo, epäsuorasti, päätöslauselma, tulos, seuraus, kokoelma, solmia, ehdotus
tietokone: tietojenkäsittely
ikuinen: koskaan, ikuisesti, ääretön
rajallinen: rajallinen, rajoitettu, rajoittaa, rajattu, rajoitettu, rajoittaa
kirjasto: kirjahylly
pohja: perusta, perusta, pohjainen, perusteellinen, ensisijainen, alkeis-, ydin, perustiedot, pohja
sekaannus: sotku, kaaos, hälinä, sekava
loistava: loistava, ihana, jalo
samoin: samoin, myös, yhtä
pelästynyt: peloissaan, pelästynyt, pelätä, pelästyttää
onneton: valitettava, onneton, kurja
artikla: essee, erä
kokki: ruoanlaitto, leipoa, kiehua
bändi: vyö, nauha, nauha, ryhmä, ryhmä, kaistale, raita, vyöhyke, säie, nippu, rykelmä, kaista
aavikko: erämaa, autio
suudella: 
pallo: kumi, pallo, tykki, luoti
tikku: kalusto, ruoko, noudattaa, puu-, puutavara, maila, vihje
perustelu: logiikka, liikkua, perustelut, kiista, keskustelu, keskustelu, riita, alue
tarkkailla: tarkastaa, tutkia, tutkia, tutkia, havainto
siunaus-mieliala: 
huomiota-herättävä: maksamatta, upeita, lakko, huomattava, merkittävä, merkittävä, huomattava, vaikuttava, yllättävä, hämmästyttävä, kirkas, kirkas
syyllinen: syyllisyys, velkaa, loukata, rikollinen, tuomittu
ase: kivääri, ase, tykki, torni
valvoa: valvoa, valvoa
piilottaa: salata, erittää, peittää
retkikunta: kampanja, ajaa, matka, matka, matka, kiertue
oppimaton: tietämättömyys, tietämätön, oppimaton, typerä, typerä, tyhmä, naurettava
antelias: liberaali, vieraanvaraisuus, hyväntahtoisuus
pilvi: 
jätteet: hyödytön, tarpeeton, kieltäytyä, epääminen, hylkäys, jäännös, ruoantähteet, roskat
helmikuu: 
tauti: sairaus, sairaus, sepelvaltimo-, tyydyttävä, tyydyttävä, oireyhtymä
viettää: kukka, käyttää, menot, harjoittaa, hyppiä, neiti
lähde: resurssi, raaka, suihkulähde
aloite-tapaus: 
täti: 
viive: lykätä
myöhässä-pakottava: 
raportoitu-todistusarvo: 
keskiyö: pohjois-
sankari: soturi, mestari
filosofia: filosofinen
sormi: varvas
mukava: hyvin, perin-pohjin, asianmukaisesti, sujuvasti, mukavasti, mukava, rentouttava, miellyttävä, tyköistuva, kätevä
jonnekin: missä-tahansa
lehdistö: tiedotusvälineet, aikakauslehti, aikakauslehti, painaminen, tyyppi, kaava
henkilöstö: miehistö, henkilökohtainen
palkinto: palkinto-, lahja, myöntää, bonus
syyttää: vika, vika, virhe, velka, syyllisyys, tölväistä, syyttää, vastuu, vastuu
kurjuus: vaikeus, kärsimys, ahdistus, kurja, ikävystyminen
otsa: 
ilmoitus: mainos, mainonta, mainostaa, ilmoitus, ilmoitus, julkisuus, ilmoitus, ilmoitus
enkeli: maanomistaja, keijukainen
yksikkö-määrä: 
valjeta: iltahämärä
kaupallinen: työperäinen, mainos, kaupankäynti, liike
antaa-anteeksi: tekosyy, Anteeksi, sietää, vapauttaa, lievittää, erottaa
lammas: lammas
kärsivällisyys: rohkeus, kärsivällisyys
maatila: karjatila, viljellä, plantaasi, maatalous-
viite: viite, katso
maissi: vehnä, sarvi
avain: side, nappi, jakoavain, kytkin, tärkein, elintärkeä, näkyvä, herkkä, merkittävä, markkinarako, valtavirta, vihje
enemmistö: monet, suurin-osa
heikkous: kykenemättömyys
ilmapiiri: ympäristö, taivas, ilmailu, tila
huokaus: huohottaa
ihmiskunta: ihmisen
vastustus: vastakkainen, vastustaa, vastakkainen, kontrasti, vastustaa, protestoida, päinvastainen, vastus, laskuri, vastustaja, paheksunta, anti-, kestävä, anti, vastalause
levy: levy, viipale, laskuri, sylinteri, levy, tallentaa, tarjotin, ajaa
yksinäinen: yksin, yksinäisyys, erikseen, yksittäinen, vain
taiteilija: esiintyjä, taidemaalari, viihdyttäjä
ritari: ratsastaja
viehätys: karismaattinen, nähtävyys, taika-, loitsu
päätös: päättää, tuomio, tuomio, tuomio, määritys, päätöslauselma, ratkaisu
kuvernööri: konservatiivinen, hallitsija
haara: 
luonteenlaatu: järjestely, kokoonpano, suuntaus, suuntaus, säännös, layout, mieliala, ajoittaa, aikataulu
innostusta: into, lämpö, innostunut, kuori, euforia, intohimo, ekstaasi, eläköön
induktiivinen-mieliala: inferential-mieliala, deduktiivinen-mieliala
yhteisö: yhteiskunta, luokka, ihmiset
öljy: rasva, polttoaine, fossiilinen, kurpitsa, lämpö-, voi
putki: putki, hana, hana, perä, kanava
painaa: painos, paine, painaminen, akseli, muotti, vaikutus
Oi: ya
esitelmä-konteksti: 
vocative-tapaus: 
hytti: mökki, teltta, jättää
hälytys: soittokello, hälytys, pelotella, kauhistuttaa
hermostunut: jännittynyt, sekava, häiritä, allapäin, hämmentynyt, järkyttävä, häiritä, järkyttävä, hermo-, huolestunut, hermo
pysyvä: kesto, usein, säännöllisesti, sinnikäs, jatkuva, kiinteä, vakaa
veitsi: huutaa, terä
silkki: 
ylenkatse: halveksia, viha, vastenmielisyys, inho, inho, tölväistä, loukkaus, skandaali, huolimattomuus
helvetti: 
erotetaan: erillinen, syrjään, erilleen, selvä, erota, erikseen, syrjässä, erillinen, eristäminen, häpeäpaaluun, rajattu, erottaminen
vakavasti: vakava, vilpittömästi, raskas, raskaasti, jyrkästi, aktiivisesti
sekoitettu: seos, yhdistelmä, yhdistelmä, sekoittaa, yhteinen
puinen: puu-, puutavara
mieluummin: etusija
varoitus: varovaisuus, varoittaa, hälytys, muistomerkki, ilmoitus
kehotus-mieliala: 
impulssi: inspiraatio, pulssi, erä, halu, vauhti, työntövoima
kunnianhimo: pettynyt, pettymys, himo, ahne, lannistaa, kunnianhimoinen
kieltää: epääminen, hylätä, kieltäminen, hylkäys, negaatio, kieltäytyä, kieltää, aleneminen, hylkää, erottaa, kieltää, kieltää, kieltää, ristiriidassa
perustuslaki: vuokrata, perustuslaillinen
väline: työkalu, alus, kokonaisuus, elin, säiliö, apuohjelma
jatkuva-näkökohta: 
vuorovesi: aalto, napsahtaa
college: tiedekunta, akatemia, kampus, yliopisto
pyrstö: jonottaa
sukupolvi: jälkeläinen
kissa: 
suoraan-todistusarvo: 
hylätty: laiminlyödä, jättää, autio, lopettaa, luopua
yksitoista: 
vaisto: spontaani
ominainen: piirre, erikoisuus, merkki, tapa, suuntaus, käytös, käytös, ominaisuus, luonnehdinta, laadullinen, tyypillinen
heimo: runko, varsi, ladata
levoton-mieliala: 
suoja: lomakeskus, asuinpaikka, tilitys, elinympäristö, asuin-, suojaus, ylioppilasasuntola, turvapaikka
töykeä: tylysti, karkea, epäystävällinen
ratsastus: ratsastaa, ratsastaja
ravistaa: neronleimaus
teollisuus: sektori, valmistus, teollinen, teollistaa
ammatti: työperäinen, ura, ammatti, ammattilainen
lamppu: polttimo
kahvi: kahvila
totella: jättämisestä, noudatettava, kuunnella
pohjoinen: pohjois-
sairaanhoitaja: 
vakuuttaa: varmuus, oikeuttaa, pantti, takuu, taata, varmistaa, varmistaa, vahvistaa, säätää, tyydyttää, kaikin-mokomin, vakuuttaa, vakuuttaa, turvallinen
ketju: järjestys, sarja, jono, vankila
opetus: opetus, kouluttaa, koulutus
kengät: kenkä, sandaali
piha: koodi, sivu, kosiskelu
epämääräinen: epäselvyys, hämärä, epäselvä, epäselvä, salaperäinen, epävarma, epämääräinen, aalto, vapaa
muualla: muu
huoneisto: litteä, ympyrä, lokero, sviitti
toimintaa: kauppa, toiminto
lauantai: sapatti
auringonpaiste: aurinko-
leski: 
elementti: näkökohta, ominaisuus, erä, ainesosa, elin
heijastus: miettiminen
organisaatio: kudos, organisaatio, järjestää, asu, yhtiö, apuohjelma, toimisto, kokonaisuus, järjestelmä, rakenne, rakenne, layout, laitos, instituutti
tähti: 
tapaus: tapahtuma, esiintyminen, ilmiö, esiintyvyys, onnettomuus, tapaus
vieras: muukalainen, vierailija, ulkomaalainen, ulkomaalainen, tulokas, asiakas, asiakas, isäntä
baari: paljas, pub, ladata, rahti, kahvila, barium
pullo: purkki
siunata: siunaus
herättää: manipuloida, sekoittaa, herättää, mellakka
sisempi: sisällä, sisällä, sisusta, sisäinen, paikallinen, kotimainen, sisä-, henkinen, sisäpiirin
korjata: kiinteä, säätää, tarkistaa, ratkaisu, ratkaista, ratkaista, parannuskeino, parantaa, suoristaa, kunnossa, Okei, jatkuva, vakaa, tuijottaa, korjata, määrätä, perustaa, tunnistaa, varmistaa
johtua: saada, hankkia, johdannainen, saada, ottaa-vastaan
ontto: tavallinen, paljas, tyhjä, kaapeli
maakunta: maakunta-
sivistys: 
ripustaa: 
järkyttää: isku, takaisku, trauma, järkyttävä, yhteentörmäys
poikkeus: osittainen, syrjintä, stereotypia, vapautus
rasitus: korostaa, jännitys, ladata, väsymys, ponnistus, intensiteetti
standardi: kriteeri, kriteerit, hinta, taso, oletusarvo, normi, kiinteä, jatkuva, vakaa, vakaa, staattinen, kestävä, standardisoida, kuvio
ajo-: ajaa, kuljettaja, opas, johto, ratsastaa
eroon: poistaa, peruuttaa, poistaa, eliminointi, vapauttaa, lievittää, vapauttaa
vannoa: kiroilua
aarre: helmi
siemen: sperma, mutteri, hiukkanen
torni: torni
suosikki: suosikki-
äskettäin: viimeaikainen, juuri, hiljattain
viimeaikainen-ohi-jännittynyt: 
hereillä: tajuissaan, moraali, herätä, hälytys
huonekalut: 
köysi: johto, jono, hihna
seikkailu: hanke, uhkapeli
royalty: vallita
juhla: osapuoli, juhla, banketti, loma-
kuvata: kuvaus, luonnehdinta, kuvata, kuvata, määritellä
kuusikymmentä: 
asteikko: kehys, arvioida, suhde, tikapuut, portaikko, rappu
seremonia: rituaali-, toiminto
metsästys: metsästää, uhri, saalis, ajaa-takaa, ammunta
kuiskaus: mutista
enimmäkseen: merkittävästi, merkittävästi, suurin-osa, pääasiallisesti, enimmäkseen, suuresti, laajalti, pääasiallisesti
kristinusko: 
lakimies: asianajaja, puolestapuhuja
yksityiskohta: levitä, pidentää, laajentaminen, laajeneminen, laajentaa, syvään, yksityiskohtainen
prinsessa: 
alttari: pyhäkkö
verkko: verkko, netto, ruudukko, kudos, kangas, juliste
violetti: purppura
kerätä: kerätä, kerätä, kutistua, valitsin
vaalit: valinta, valita, polku, äänestys, valas, valinta, äänestys
käsitys: käsite, käsite, ajatella, havaitseminen, havaita, käsitteellinen, design, saalis, pidätys, kaapata
humalassa: alkoholisti
kaataa: kaataa, vuodattaa, läikkyminen, kaataa
hissi: hissi, ylentää, kohottaa, korottaa, vaellus
ele: merkki, signaali, symboli, symbolinen, asenne, ryhti
hoitaa: johto, valvoa, kahva, hallinto, hallita, ohjata, ohjaus
vaihtaa-keskenään: vaihtaa, vastavuoroinen, vaihtokauppa, korvaaminen
selvä-artikla: 
keisari: hallitsija
kauko-: kaukainen, pitkälle, syrjässä
ruma: ikävä, inhottava
harmiton: 
rulla: vierittää, kela
tuuma: tulli, peukalo
sanomalehti: aikakauslehti, ilmoittaa, päiväkirja
parta: kärki, leuka
repiä: siepata
komissio: valiokunta, lauta
kun-taas: sillä-aikaa, aikana
ylitys: ylittää, liittymä, kulku, ohimenevä, siirtyminen, käytävä
itsenäisyys: itsenäinen, vapaus, vapaasti, vapaus, autonomia
haju: haista, hajuvesi
kahdeksantoista: 
historiallinen: historiallisesti, historia, historioitsija
brutto: kaikki-yhteensä, aggregaatti, likainen, raaka, raakaöljy
juuri: varsi, juuri
muta: maaperä, lima, savi, lika, kukka
morsian: isoäiti
huntu: verho, purjehtia, purjehdus
teatteri: teatteri
vertailu: vertailla, vertaileva, korrelaatio, suhde, yhteenotto
kilpailija: vastustaja, toisinajattelija, kilpailu, kilpailukykyinen, kilpailla
saldo: tasapaino, yhtä, tasa-arvo, vaakasuora, verrannollinen, par, talousarvio
valmentaja: kouluttaja, lääkäri, tutor, opastaja
huumori: huumori, humoristinen, mieliala, komedia
romaani: kaunokirjallisuus, uusi, hiljattain
kosto: kauna
mustasukkainen: mustasukkaisuus, kateus
pyörä: pyörä, ympyrä
palanut: polttaa, levenevät
salama: salama, hehku, loistaa
luoda: luominen, rakentaa, rakentaa, rakentava, tehdä, valmistaa, säveltää, väärentää, synnyttää
konflikti: yhteentörmäys, taistelu, yhteenotto, kontrasti, romahdus, vaikutus
kirous: 
imprecatory-mieliala: 
avuton: kurja
positiivinen: positiivisesti
maila: maila, loki
tulva: 
jyvä: vilja, vehnä
välinpitämättömyys: apatia, varomaton, huolimattomuus
horisontti: 
assumptive-mieliala: hypoteettinen-mieliala
jyrkkä: korkeus, kalteva
harmonia: vaarantaa, virittää
ukkonen: 
lapsuus: 
polvi: kierros
ohjelmisto: hakemus, ohjelmisto
vahinko: satuttaa, vahingoittaa, vahingoittaa, vahingoittaa, haava, trauma, loukkaantunut, rikkominen
kuitti: ottaa-vastaan, sisäänkäynti, vastaanotto, sisäänpääsy, hyväksyminen, tosite, hyväksyminen
mahdollistaa: kykenee, pätevä, aktivoida, antaa-lupa, oikeuttavat, kuljettaa, valvoa, päästää, valtuuttaa
protasis: 
lipsahdus: liukas, dia, liukua
vallankumous: vallankumouksellinen, vallankaappaus, kierto, kapina, kapina
maanviljelijä: talonpoika
tahti: isku, vallankaappaus, kiire, ryntäily
foorumi: vaihe, foorumi, perusta
sanansaattaja: valtuutettu, suurlähettiläs, diplomaatti
etuoikeus: etuoikeutettu, etusija, kiintiö, toimilupa, tarjous, myönnytys
järjestäytynyt: laitos, järjestää, instituutti, järjestely, järjestää
opiskelija-: oppilas, tutkija, opiskelija
luola: 
perinne: perinteinen, perinteisesti, tulli, antautuminen
tragedia: epidemia, surullisuus
jäähyväiset: Hyvästi, bye
kritiikki: arvostella, kritiikki, arvostelu
puuvilla: villa-
sairaala: turvapaikka
vuokrata: hinta, vuokraus, verottaa, kunnianosoitus, vuokrata, käyttää, sitoutua, vuokrattu, vuokrata
kaasu: 
väistämätön: väistämättä
tappava: 
lehti: arkki, terä
julkaisu: julkaista, kustannustoiminta, painaminen, julistaa, lähettää, julkaisu, ulostulo, diffuusio, painos, ilmoittaa
vihamielinen: epäystävällinen, vihamielisyys
käännös: kääntää, kääntää, tulkinta, epidemia, siirtää
hautajaiset: hautaaminen, hautausmaa
jauhot: jauhe, taikina, tarkka, tarkka, tarkka, ateria
kirjeenvaihto: vastata, yhteyshenkilö, viestintä, communicative
romanttinen: 
kota: mökki, jättää
ehdottaa: aiheuttaa, tarjous, liike, ehdotus, ehdotus, ehdottaa, suositella, ehdotus, tarjous, nimittää
miiminen: 
dollari: 
päivänvalo: 
kuusitoista: 
kokoonpano: kokous, konferenssi, kongressi, kokoonpano
siirtomaa: 
siipi: osasto, sviitti
leijona: 
kulttuuri: kulttuurinen
sarake: ryhmä, kerros, napa, kulku
ovela: hankala, temppu, taitava
draama: teeskennellä, dramaattinen
vitsi: pila, vitsailla
sumu: sumu
lääketiede: lääke, parannuskeino, spray, resepti
neljätoista: 
happo: hapan, hapan
nimittäin: kaikki, toisin-sanoen, erityinen
tulo: pitsi
piispa: 
oranssi: 
kylpy: kylpyhuone, suihku, kylpyamme
primitiivinen: varhainen, alustava
kori: astia, laukku
sihteeri: 
olki: heinä
kärsimätön: innokas
pelastus: turvallisuus, vapauttaminen, Moi
hodiernal-jännittynyt: 
aikovat: tarkoitettu, aikomus, kiinnostunut, innokas, motiivi, haluton, omistaa, omistaa
höyry: höyry
myrkyttää: myrkyllinen, myrkyllinen, rikkaruohomyrkky
lahjakkuus: loisto, lahjakas, pätevyys, kyky, ohjelmisto
ilmasto: sää-
tehokas: pätevä, tehokkaasti, tehokas, tehokkuuden, vaikutusvaltainen, hyödyllinen, kannattava
erottaa: eriyttää, syrjiä, syrjintä, erilaistuminen, jakaa, jakaa, erottaa, sulkea, erittää
pestä: pesu
tunnustus: tunnustaa, uskontunnustus, tunnustaminen
järjettömyys: roskat, kohtuuton, sopimaton
kivihiili: hiili
kanootti: 
väliaikainen: intervalli, kesto, ajallinen, satunnainen, sillä-aikaa
delimitative-näkökohta: 
luu: jalka
maanantai: 
tiistai: kolmas
keskiviikko: neljäs
liittovaltion-: liittovaltio, keskeinen
toivottava: houkutteleva, suotuisa
edustaja: edustaa, puolesta, valtuutettu, asianajaja, sijainen, tiedottaja
liinavaatteet: pellava, alusvaatteet
pesuallas: hukkua, pesuallas, sinkki
veljenpoika: veljentytär, pojanpoika, lapsenlapsi
verinen: verenvuodatus, vuotaa-verta
piiritys: ympäröidä, istuin
vatsa: vatsa, vatsa, vatsan-, matriisi
messinki: pronssi, kupari-, riisi
huippukokous: huippu, ylin, kärki
viides: viisi
halpa: halvalla, matala
yksinomainen-henkilö: 
takavarikoida: puuttua, rajoittaa, pidättää, varaus, siepata, miehitetty, miehittää, takavarikoida, napata, ymmärtää
aita: hedge
patsas: veistos
tykistö: tykki
omaksua: omaksua, käpertyä
ympäröivä: noin, naapuruus, naapuri, naapuri-, naapuruus, perifeerinen, ympäristö, viereiset, lähistöllä
tiukasti: tiukka, johdonmukainen, tarkasti, tiukka, vaikea, varmasti, täysin, ehdottomasti, tiukasti, ankara
peura: 
pensas: 
rautatie: rautatie, rautatie
päästö: vapauttaminen, purkaa, julkaisu, luovuttaa, karkottaa
perillinen: periä
tammi-: 
epämiellyttävä: ilahduttaa, miellyttävä, levoton, vihainen, järkyttävä, ikävä, epämiellyttävä
keksintö: keksiä, löytö, innovaatio
piano: 
suostutella: vakuuttaa, juhlia, muistoksi
näkymätön: salaperäinen
tunnettu: kuuluisa, pahamaineinen, näkyvä
julmuus: 
houkutus: 
telic-näkökohta: 
taloudellinen: talous, taloudellisesti, ekonomisti, taloudellinen
kansainvälinen: maailmanlaajuinen, monikansallinen
häiritä: häiriö, interventio, puuttua, häiritä, vaivautua, järkyttävä, keskeyttää, ärsyttää, ärsyttää, häiritä, yhteentörmäys
filosofi: filosofinen
tyylikäs: muodikas, herkkä
hyvinvointi: hyväntahtoisuus, vauraus, säännös
kalastus: 
varastaa: varkaus, ryöstää, ryöstö, napata
huuli: nokka, oraalinen, Brink
jäädä-eläkkeelle: eläke, eläkkeellä, eläkeläinen, vetäytyä, levätä, vapaa-, peruuttaa, erota
venyttää: suoristaa, pidentää, alue, piirre, pala, kulku, katkelma, kimpale
galleria: kokoelma
yhdensuuntainen: rinnalla, yhteensopiva, kumppani, kiinnittää
atelic-näkökohta: 
maanosa: mannermainen
ehkäisevä-mieliala: ehkäisevä-mieliala
solmio: kravatti, kotka
solu: olemus, tuma, häkki, versio, mobile, kännykkä, kännykkä
muna: kives
keinotekoinen: synteettinen
sillä-välin: samanaikaisesti
kriisi: lama, tuomio, tuomio, hätä-
kohtelias: kohteliaisuus, sivistynyt
lounas: aamiainen, päivällinen
mänty: leuka
Työnnä: puristaa, ajaa, kannustaa, edistää, työntövoima, paine
liitto: liitto, liiga, koalitio, yhdistää, kumppanuus
vyötärö: lonkka, elämä, elävä, keskimmäinen, keski-, keski-
ihme: ihme
merimies: 
puhtaus: siveys
tasavalta: demokratia
puhelin: puhelin, mobile
ruoska: 
paita: t---paita
esitellä: käyttöönotto, esittely, perustaa, aloittaa, tehdä, säännös, suositella, lähete, pistää, toimittaa, toimitus, kuvata, kuvata
sohva: nojatuoli
lakaista: pyyhkiä, harava, skannata
varas: pomo
säilyttää: säilyttää, varata, varaus, palauttaa, pitää, hillitä, pidättää, kestää, sitoutua, säilytys, pitää-yllä, säästää, ylläpitää, noudattaa
kanava: kanava
persoonallisuus: merkki
uudistaa: parannus, korjaus, evoluutio, muuttaa
uhkaava: uhkaus, uhata, vaarallinen, pelottava
palmu: vaahtera
kaiutin: tiedottaja
kynnys: este
aiheuttaa: aula, halu, aiheuttaa, varoittaa, kiihottaa, aiheuttaa, johtaa, houkutella, herättää
keihäs: vapaa
siisti: siisti, puhdas, kireä
istunto: kokous, konferenssi
kiduttaa: kärsimys
kostea: lika, märkä, vuotava, hiostava
harjanne: ylin, punos, pino, kampa
matkustaja: vierailija, matkustaja, turisti, matkustaja
mylly: tehdas, valmistus, kasvi
kartta: kortti-, kaavio, kaavio, hinta, lippu
kaulus: ympäröidä
korvata: korvaaminen, syrjäyttää, vapaa, vaihtoehto, korvike, korvaaminen, siirtymä, muuttaa, vaihdella, muuttaa, sub
tarkoituksella: tahallinen, tarkoituksellinen, tietoinen, tajuissaan, päättäväinen
olut: pint
sametti: 
painovoima: nähtävyys, murskata
saarna: saarnata
väärinkäyttö: virheellinen, väärin
parvi: ryhmä, lauma, erä, parvi
kolmetoista: 
perustella: oikeuttaa, anoa, puolestapuhuja, oikeutus, perusteltu
perjantai: hopea-, Venus
harjata: kampa
download: 
kerma: jäätelö
rantakallio: rock, Brink
tuomaristo: 
hirviö: jättiläinen, hirvittävä
jäädytetty: jäädyttää
pannu: panoroida, purkki, säiliö
penni: sentti
vaatia: äänekäs, työntövoima, puolustaa, korostaa, painottaa, jatkua, vaatimus, vaatia, väitellä
omena: 
pohtia: keskustelu, neuvotella, väitellä
tausta: 
litteroida: sopeuttaa, kirjoittaa-uudelleen
ajoittainen: säännöllinen, syklinen
viihde: virkistys, viihdyttäjä, vapaa-, viihteellinen, viihdyttää, hauska, harraste
virus: 
lapsellinen: sopraano
heijastaa: miettiminen, meditaatio, mietiskellä, valaista, kuvata
muuntaa: muuttaa, muuttaa, kytkin, mutaatio
ääriviivat: profiili, muoto, yhteenveto, luonnos, paljastaa, yleiskatsaus, luonnos
ooppera: 
hyväksyminen: hyväksyvä, tuomitseva, suostumus, hyväksyminen, väite, hyväksyä, hyväksyä, hyväksyminen, suosionosoitukset
pettää: paljastaa, pettää, pettää
rangaista: tuomittu
kyynärpää: kannatin
liite: liite, liitäntä, läikkä, linkki, liitin
korjaus: palauttaminen, parannus, rekonstruoida, korjaus
epäilyttävä: epäilys, epäilty
seitsemänkymmentä: 
kirjoitusten: raamattu, käsikirjoitus
kuoppa: reikä, kaivanto, pool
häiriö: kaaos, anarkia, levottomuus, häiriö, sotku, järkyttävä, häiriö, hämmennys
binaarinen: dyadic
luostarikirkko: luostari
nuoli: 
yleensä: velvollinen, yleensä, yleensä, tyypillisesti
kehittää: yksityiskohtainen, määritellä, selventää, kehittää, monimutkainen, hankala, treenata
uskollisuus: omistautunut, uskollinen, luottamus, uskollisesti, rehellisesti, epäluottamus, uskottavuus, usko, usko
kolikko: valuutta
vapista: väristys
maanpakolaisuus: ammu, ulkomailla
mekaaninen: koneet, mekaanikko, insinööri
ansa: pito, tuomittu
kakku: piirakka, pikkuleipä, taikina
sir: Herra, herra, herra, herrasmies
epäröidä: lyödä, kummitella, taajuus, leijua
seitsemäntoista: 
hunaja: 
panos: veto, osa, kiila, kasa, jakaa, jae, panos
askelma: liikkua, temppu, kävellä, kävely, polkea, vaihe, harppaus, askelma
tiili: laatta
kahdeksankymmentä: 
valitettavasti: valitettava, onneton, valitettavasti
konsultoida: neuvottelu, katso
legenda: myytti
sato: sato
edistäminen: ylentää, edistää, käyttöönotto, esittely, julkisuus
liesi: liesi, laatta, uuni
kapinallinen: kapina, kapina
vanhanaikainen: muinainen
turvota: paisuttaa, turvonnut, inflaatio, turvotus, suurentaa
suo: marsh
pukeutuminen: kastike, side
askeettinen: erakko
johtaja: stuertti, päällikkö, pomo, ylläpitäjä, johtaja, hidastin, johtaja, johtaja
kertosäe: ajaa, joukkue-
järkevä: perusteltu, logiikka, looginen, kohtuuton, järkevä, kohtuullisen, kohtuullinen
jalostus: 
susi: 
matto: matto
antiikin: 
hedelmällinen: 
pilli: huilu
juusto: 
purra: pilkkoa, paloitella, pisto
kutsu: kutsu
katedraali: temppeli
satama: portti
vaeltaa: kävely, siirtyä, vaellus
viljelykasvien: sato
laivasto: meren-, laivasto
naamio: julkisivu, mato
lyijykynä: kynä
vihannes: kasvissyöjä
näyttely: näyttely, tarjous, näyttö, esittely, oire, valotus
housut: housu-, housut
korruptio: skandaali, saastuminen
kaappi: kaappi, komero, vaatekaappi, WC
keitto: 
kirurgi: leikkaus, kirurginen, toiminta
avustus: korvaaminen, korvike, korvaus, appositio, jako, liite
vakooja: 
holtiton: varomaton, epäsiisti
juoru: huhu, huhu
symbolinen: 
abstrakti: yhteenveto, opetussuunnitelma
torstai: 
liikenne: verenkierto, kuljetus, kuljetus
arkkitehtuuri: 
crack: rako, säröillä, lähteä, lopettaa, murtuma
ornamentti: koristelu, koriste-, koristella, korut, leikata
käänteinen: päinvastainen, käänteinen, kytkin, inverttisokeri, haitallinen, ylösalaisin, taka-
huvittaa: viihdyttää, viihteellinen, huvittunut
elpyminen: palauttaminen, pelastaa, parannus, elpyminen, toipua, palauttaa, rekonstruoida
jalkakäytävä: hillitä, piki, terva, lima, kansi
ratkaiseva: ratkaiseva, elintärkeä, määrätä, päättää, itsevarma
negatiivinen: haitallinen
festivaali: konsertti
vähentää: vähentäminen, vähentää, helppous, lievittää, minimoida, hajota, kauttaviiva, leikata, vähentää, rajoittaa, rajoittaa
maanpetos: 
metsästäjä: 
käärme: matelija
akku: 
vaha: kynttilä
etsivä: tutkija
analyysi: analysoida, tutkimus, tutkimus, tutkia, tarkastaa, tutkiminen, päätöslauselma, hajota, hajota
painotus: painokas, paine, korostaa, painottaa, stressaantunut, aksentti, väite, Huomio
uida: uima-
kirjekuori: seikka, adverbi, tuppi
kuka-tahansa: Kuka, joku, jonka, kukaan
savuke: tupakointi-, tupakka
moottori: auto, moottori, motiivi, moottoripyörä
vapaaehtoinen: omistaa, vapaaehtoinen
reaktio: reagoiva, vastaus, vastata, suhtautua, palaute
matkatavarat: matkatavarat, rahti, runko, matkalaukku
kuuro: 
mehu: ote
nöyryys: yksinkertaisuus, vaatimaton
ministeriö: 
seksuaalinen: sukupuoli, seksuaalisuus
halkaisija: 
kirves: 
timantti-: 
vaihtoehtoinen: vapaa, vaihtoehto, korvike, vaihtoehto, sijainen, korvaaminen, siirto
kaiku: 
rajoitus: hillitä, hillitä, rajoitus, rajoitus, rajoitus
identiteetti: tunnistaa, henkilöllisyystodistus, symbolinen
kuvaruutu: näyttö, verho
laiska: mätä
momentane-näkökohta: 
kompakti: sopimus, vankka, tiheä
ajelehtia: toiminta, poikkeama, suuntaus, suuntaus
kadota: Sukupuuttoon-kuollut
säde: palkki, käytävä, säde
muste: 
massiivinen: suuri, suuri, valtava, valtava, valtava, iso, valtavasti
kellari: 
mieleenpainuva: näkyvä
mulkoilla: hehku, loistaa, loisto
senaatti: eduskunta
ruumisarkku: 
anteeksianto: 
niellä: siemailla
langeta: harjoittaa, tyydyttää
swing: 
niitty: laidun, pre, nurmikko
monimutkainen: monimutkainen, hankaloittaa, hienostunut, yhdiste, hankala
eroaminen: erota, eläke
nöyrä-ilmoittautua: 
salaliitto: juoni
pippuri: 
poni: 
ehdokas: hakija
kettu: 
savupiippu: takka, pino
toimivalta: auktoriteetti, tuomio, tuomio, pätevyys
maatalous: viljely, maatalous-
tarkkuus: tarkkuus, siveys, tarkasti, oikein, totuudellisuus
entinen-kuollut: 
demokraattinen: 
nuppu: nuppi, versoa
viltti: katto, kansi, matto, kattavuus
rakeet: miehitetty, tervehtiä
sika: kylvää
muotoinen: kuvio, muoto, kuva, puoli
norsunluu: 
klassinen: klassinen, perinteinen
tarkkailija: ohjaaja, vierailija
norsu: 
kynnet: naulata
mehiläinen: 
haudata: hautaaminen, upottaa
näyttelijä: näyttelijä, esiintyjä, kantaja
hiki: 
kiillottaa: murre
illuusio: petos
epävarmuus: epävarma, epäselvyys
toissijainen: vähäinen, keskikokoinen, keskimäärin, kohtalainen, valtavirta, keski-
taittaa: taitto
maaseudun: maakunta-, maaseutu, kyläläinen
notkua: 
muistuttaa: samanlainen, samankaltaisuus, muistuttaa
lainata: ote, lainaus, lainaus-päättyy, lainata, lainata, lainata
säkki: erottaa, hylkääminen, laukku
harmi: häiriö, häiriö, keskeytys, vaikeus, ikävystyminen, vaivautua
neula: injektio, ruisku, neula, tappi
ohjattu: ohjaus
kana: kana
johdonmukainen: sinnikäs, yhteensopiva, betoni, implisiittinen, tarkoituksenmukainen, markkinarako, merkityksellinen, johdonmukainen, peräkkäinen, tasapainoinen, vakaa
tynnyri: ämpäri
tavanomainen-näkökohta: 
asiantuntija: asiantuntija, kokenut, erityinen, erityinen
tehdä-vaikutus: vaikuttaa, vaikutus, vetää-puoleensa
oliivi-: 
pakettiauto: venttiili
este: keskeyttää, rajoitus, haitta, este, takaisku
nyökkäys: 
edistää: viljellä, pinaatti, edistää, helpottaa, rehu, suosia, suosia
määritelmä: selostus, henkilöllisyystodistus, kuvaus, määritys
syntymäpäivä: vuosipäivä
vasara: 
tuoksuva: 
toisto: raskas, määränpää, toistaa, toistaa, harjoitus
triviaali: pikkumainen, merkityksetön
potkia: osuma, kolahtaa, jalkapallo, kalsium, jalkapallo, isku
kaivaa: kaivaa, porata, kaivanto
lemmikki-: 
kallo: 
lainsäätäjä: eduskunta, lainsäädännöllinen, lainsäädäntö
kantapää: hypätä
rypistää-otsaansa: 
patentti-: 
miljardi: 
kemiallinen: kemia, kemikaalit, kemisti
lentäjä: kokeilu, kokeellinen
jäljitellä: simuloida, simulointi, toistaa, jäljentää
hame: rock
epätavallisen: epätavallinen, poikkeava, pariton, huomattava, ylimääräinen, uskomaton, epäsäännöllinen, ilmiömäinen, uskomattoman, erittäin, omituisesti
viikoittain: 
tekninen: tekniikka, teknologia, teknisesti, teknologia
kasvillisuus: 
varis: torni
auringonnousu: 
elinikä: elämä, eloonjääminen, elämäntapa, elävä
myötävaikuttaa: panos, lahjoittaa, kumppanuus, edistää, helpottaa
koukku: koskevat, kytkeä, korreloida, kannatin
tiikeri: 
läpäistä: puhkaista, kautta, vaikutusvaltainen
hiha: varsi
valtatie: tie
miliisi: 
oja: kaivanto, akseli
eheys: 
yhdeksäntoista: 
orgaaninen: 
teologia: 
kellua: vene, leijua, laivasto
noita: 
kyllästynyt: tylsä, ikävystyminen
diplomaattinen: diplomaatti
studio: etiketti, työpaja, tutkimus
ylittää: aggressio, raiskata, voittaa, ylittää
samppanja: 
innostaa: kannustaa, inspiraatio, rohkaiseva, hengittää-sisään
lippu: lippu, juliste, lippu
avioero: eronnut
pultti: salama, naulata, kierre, ruuvi
suoni: hermo
passiivinen: yleisö, vammaiset
vaahto: kupla
sora: 
esiliina: kierros
planeetta: 
hylly: teline, kaappi
tuuletin: 
trooppinen: 
vaihe: valokuvaus-, vaihe, aika, rakentaa, vaihe
mielivaltainen: spontaani
lausua: ääntäminen, aksentti, lausahdus, täydellinen
elohopea: 
hiipiä: ryömiä, kiipeily, lammas
itsemurha: 
reportteri: toimittaja
riistää: riistäminen, peruuttaa, sulkea, vähentää
taitava: taitava, tehokas, kykenee, lahjakas, kokenut, pätevä, taitava
parveke: terassi, kuisti
haarukka: 
työntekijä: työntekijä, työmies, työskentely, tekijä, riippuvainen, virkailija
työnantaja: pomo
leveys: laajalti, toimittaa, leveä, puoliperävaunu
ärtynyt: vihainen, innoissaan, ärsyttää, provosoida, stimulaatio
moittia: tuomita
eläke: eläke, syntaksi
verbi: toimia, suhtautua
apina: 
hyväksyttävä: hyväksyä, hyväksyminen, uskottava
allekirjoitus: 
ortodoksinen: konservatiivinen
ironia: pila, kierre
lastentarha: plantaasi
haluttomuus: vastenmielisyys
tuoda-maahan: käyttöönotto
soihtu: 
kielioppi: kieliopin
tallettaa: kerätä
siirtomaa-: 
jahti: lautta, vene
johtuva: seuraus, episodi, tärkeä, huomattava, johtava, näkyvä, huomattavasti, merkittävä, merkittävä, mielekäs
kupoli: 
paksuus: 
itsepäinen: itsevarma
lihas: 
suuruus: koko, irto-, amplitudi, arvioida, määrä
hieroa: 
raukkamainen: 
valjaat: yhdistää, yhdistää, yhtenäistää, käyttää, vyö
malja: välipala
hiiri: rotta
tavu: 
nokare: taputtaa, lyödä
vuoropuhelu: ilmoittaa, keskustelu
neutraali: neutri
ahkeruus: into, huolto
ristiriitaisuus: ristiriitainen, kiista, epäselvä, sekava, kiistanalainen, epäselvyys, paradoksi, ristiriidassa, vaihtelu, vastalause
saavuttaa: ymmärtää, tavoittaa, saapua
vuohi: 
kukoistaa: vauraus, menestyä, puomi, helmi, helmi
määrätä: pakottaa, valvoa, määrätä
anonyymi: 
muodollinen-ilmoittautua: 
vasikka: kiire
manuaalinen: opas, ohje, merkki, johto, oppikirja, opetus, johtaja, ohjaaja
sulaa: haihtua, sulaa, fuusio
poistaa: pyyhkiä, liueta, peruuttaa, poistaa, sulkea, poistaa, poistaa, eliminointi
sateenvarjo: laskuvarjo
tavaratila: kenkä, runko
mineraali: jodi, ravintoaine, metalli-
aselepo: tulitaukoa
ankka: 
suunnittelu: 
saippua: 
nukke: vauva, lelu
luuranko-: 
huvila: keijukainen
ompelu: ommel, ommella
sovittaa-yhteen: sovitella, yhdistää, yhtenäistää
kattila: 
kypsä: aikuinen
kani: 
kapellimestari: tikapuut, tarkastaja, kuljettaja, johtaja
riippuvuus: riippua, riippuvuus, riippuvainen, riippuvainen, affiniteetti, asenne
pelaaja: esiintyjä
hyönteinen: tuhoeläin
ravintola: 
pöllö: 
radikaali: militantti, äärimmäinen, etenevä
asukas: asukas, syntyperäinen, kotimainen, kotoperäinen
lohikäärme: leija
auditiivinen-todistusarvo: 
janoinen: 
viipyä: pitkittynyt
laskeminen: laskea, laskeminen, tietojenkäsittely, laskenta, arvella, tili, väestönlaskenta
säätö: sensuuri, ohjaus, rajoitus, rajoitus, tilitys
pormestari: 
vähemmistö: 
hankinta: saada, saada, hankkia, pääsy, saatavuus
veteraani-: vanhempi
orkesteri: 
pekoni: 
haitta: menetys, riistäminen, haitallinen, virhe, haitta
kangas: kangas, vaatteet, pyyhe, kangas, kudos
muusikko: säveltäjä, musikaali
henkisesti: henkinen, henkinen, moraali, mana, subjektiivinen
luettuna: tehdä-yhteistyötä, liitäntä, yhdiste, yhdistys, kumppani, yhdistää, johdonmukainen, rinnalla, jatkuvuus, linkkeri
riittämätön: puuttuva, riittämätön, puute, kurja, huonompi, hankala, runsas, valitettava, sopimaton, sopimaton
arkkitehti: 
sitruuna: 
yskä: yskä
päänsärky: 
vuokralainen: suunnittelija
hedelmällisyys: jäljentäminen
parantaa: parantaa, parantaa, parantaa, parannus, kohdella
yhdeksänkymmentä: 
satunnainen: satunnaisesti, Satunnaista, satunnainen
lusikka: ämpäri
ilmapallo: 
liitu-: kipsi
inferential-todistusarvo: 
kustantaja: toimittaja
etikka: 
tuhka: harmaa, harmaa
voimasana: kiroilua
elvyttää: elpyminen
altis: haavoittuva, herkkä, järkevä, tunteellinen, velvollinen
tunneli: metro
palapeli: sekoittaa, sekava
mekanismi: menettely, rutiini, systemaattinen, koneet
matematiikka: matematiikka, matemaattinen
häivyttää: 
maksa: 
sublative-tapaus: 
sukeltaa: sukeltaa, upottaa, pudota, rojahtaa, esiintyvyys, rinne, rinne, kalteva, kaltevuus, liota
yksikkö: yhtenäisyys, kokonaisuus, moduuli, nokka, yksikkö
monopoli: yksinomainen
uhkapeli: uhkapeli, peli, ottelu, raivaaminen, lelu
sukellusvene: vedenalainen
maanjäristys: puuska
laboratorio: laboratorio
korkki: sieni, sieni, korkki
itse-ohjaus: 
buddha: 
neuloa: neulominen, kutoa, työntövoima, kudottu, solmu, solmu, punos
suurlähetystö: 
kauimpana: 
declarative-mieliala: 
ärsyke: rohkaisu, kannustin, resepti, motivaatio, motiivi
suklaa: karamelli
sattuma: mahdollisuus, yhdistelmä, valitettava, satunnaisesti, satunnainen, ottelu
käsine: 
polvistua: 
maantiede: 
investointi: investoida, hanke
sanallinen: suullinen, oraalinen, loukkaavia
analogia: tasa-arvo, samankaltaisuus, affiniteetti, sukulaisuus, suhde
maallinen: asettaa
haukka: kotka
psykologia: 
kiinnittyä: koskevat, sitoa, kytkeä, side, pidätys, liittää
romu: peruuttaa, roskat, roskat, katkelma
rooli: talja, jakaa, kalusto, osallistuja
annos: määrä
lohi: 
vanukas: 
magneettinen: houkutteleva
pumppu: pommi
happi: 
todistus: 
mitali: 
retoriikka: 
kaapia: naarmu, laiduntaa
airo: lapio, evä
teleskooppi: mikroskooppi
kaulakoru: voittaa, tahna
oikeinkirjoitus: loitsu
viski: 
paju: laidun
kameli: 
amatööri: 
poistua: viedä, pistorasia, syntyminen, ulostulo
elämäkerta: 
aasi: 
kuukausittain: 
jättää-huomiotta: laiminlyödä, unohtaa, erottaa, tietämättömyys
loma: jättää, loma-, virkistys, levätä
napsauttaa: klikki, napsahtaa
soikea: 
joustava: kumi, joustava
sanakirja: leksikaalinen, sanasto
kinkku: reisi, pakara
sateenkaari: 
kuluttaa: kulutus, käyttää, sijoittaa
sylkeä: perämies, kieli
säiliö: varasto, säiliö, alv
kollega: osuuskunta, stipendiaatti, perämies, kumppani
perhonen: 
kartoittaa: kaavio, kaavio, graafinen, grafiikka, ajoittaa, järjestelmä
twin: kaksinkertainen, kaksois-
itsenäisesti: itsenäinen, vapaasti, erilleen
bambu: 
kauppias: jälleenmyyjä, myyjä, myyjä, kauppias
kertymä: kerätä, kokoelma, keskittyminen
tarkastaja: tilintarkastaja, tarkastaja
suupala: katkelma, viipale, bitti
painajainen: unelma
hillo: hyytelö
museo: 
aakkoset: aakkosellinen
hajottaa: sijoittaa, levitä
ratsia: ammatti, invaasio, hyökkäys, hyökkäys, puhkeaminen, hallitseva, karkottaa-maasta
paljastaa: ilmoittaa, paljastaa, havaitseminen, paljastaa, purkaa, julkaista, löytää
laho: rappeutuminen, heiketä
aggressiivinen: häiritä, sotku, ammatti, aggressio, hyökkäys, itsevarma
kitka: 
laituri: 
hämähäkki: 
peruna: 
tarkistus: säätää, muutos, tarkistaa, korjaus, muuttaa, arvostelu, tarkastaa
ahneus: ahne
ennenaikainen: varhainen, kolahtaa
moninkertaistaa: osuma, rotu, kolahtaa
kierre: kiertää, kierto, kierre-, kierre, kierre
tilastotiedot: tilastollinen, kuvio, jutella
kalenteri: ajoittaa, aikataulu, päiväkirja, näkymä
nimitys: nimittää, nimittäminen, valinta, sitoumus
biljoona: 
ullakko: tuuli
myöntävä-mieliala: 
sovellukset: 
nimellinen: 
tyytymättömyys: 
infektio: tartuttaa, tartunnan, siirtyminen, lähetys, tarttuva
syöttäjä: purkki
olankohautus: nykiä
pioneeri: merkittävä, avantgarden
laiminlyönti: oletusarvo, tahdittomuus, puute, huolimattomuus, laiminlyödä, eliminointi
kaali: 
urheilu-: yleisurheilu, matemaattinen, urheilija
juoppous: sokeri
idiofoni: 
vipu: urkkia
senaattori: 
iiris: 
muurahainen: 
vika: 
raskaana: äidin
saostaa: sademäärä, sedimentti, nopeus, kiireellinen, kiihdyttää
nilkka: 
luokittelu: järjestellä, luokitella, luokittelija
muuttuja: vaihdella
kietoa: pakata, paketti, paketti, paketti, kela, kääre, kansi, päällyste
kihara: kiemura, heittää, kela, vierittää, helix
rikki: rikki, rikki
sanella: 
ilmaantua: näyttää, ulkoinen-olemus, nousta, syntyminen, lopettaa
sammakko: 
liiallinen-tapaus: 
sieni: sieni, sieni
ärsyttävä: järkyttävä, häiritä, vaivautua, hälinä, ärsyttää, tylsä, nirso, järkyttävä
orava: 
jauhaa: puoli, puoliperävaunu
irrealis-mieliala: 
tulivuori: 
sisällä: sisä-, sisällä, sisällä, tilat
hyödyntää: käyttää, omaksua, saavutus, tutkia
geologinen: 
passi: 
moraaliton: häijy, mätä
keksi: pikkuleipä
yhteistyö: tehdä-yhteistyötä, kumppanuus, integraatio, auttaa
tabletti: luoti, pilleri, laatta
rentoutuminen: löysä, rento, vapaa-, ottaa-rennosti, rentouttava, virkistys
atomi: atomi-, hiukkanen, yksittäinen
aids: tuki, helpotus, apu-
pyramidi: 
sykli: ympyrä, verenkierto, taajuus, kierto, kiertää, polkupyörä, pyörä
torkut: 
laiton: laiton
tassu: kynsiä, varvas
ujous: ujo, supistuminen
pimennys: hämärä
luuttu: näkökulma
luuta: 
paneeli: levy, laatta, maalaus, lauta, ryhmä, valiokunta
tähtitiede: 
sokkelo: 
apuraha: sponsorointi
kilpikonna: 
neuvonantaja: opastaja, neuvoa
kuitu: kuitu, nippu
kriketti: 
kyyhkynen: 
sovittaminen: sopeuttaa, telineeseen, noudattaminen, muutos, säätää
kolmio: 
rahastonhoitaja: 
vety: 
hauras: herkkä, terävä
kirjoitin: 
tukehtua: 
krooninen: kestävä
selviytyä: kohdata, sopeuttaa, kohdata, offset, voittaa, puuttua, contrastive, kahva
dilemma: 
tekniikka: tekniikka, teknisesti
kamera: kammio
pyydä-anteeksi: anteeksipyyntö, Anteeksi
nuolla: 
tanssija: 
muutto: siirtyä, maahanmuutto
tennis: 
selkä: 
paistaa: 
kangaspuut: suljettu, päättäminen
puukottaa: pisto, puhkaista, napata, yrittää, yritettiin
salasana: signaali, vihje, iskulause
aivopuolisko: terävä, kärki
strategia: strateginen
kvartsi: 
sakset: Vedä, vetää
partio: 
jäätikkö: 
puolitiessä: puoli, osittain, puoliperävaunu, keskimmäinen, keski-
muistio: sopimus, sopimus, sopimus, sopimus, oikeuttaa
kartio: suippeneva
symmetria: 
valmistaja: tuottava, tuottaja, rakentava
vastaaja: puolestapuhuja
moskeija: 
shakki: 
tietulli: veloittaa, maksu, uhri, kuvio, komplikaatio
kirsikka: 
laajalle-levinnyt: laaja, laajalti, levitä, leveä, laaja
kompastella: rojahtaa
kuorma-auto: kuorma-auto, rahti, rahtialus
sinappi: 
prosentti: per--sentin, sentti
huutokaupata: myynti
seula: 
epävakaa: epävakaa, epävakaisuus, epävarma, levoton
magneetti: 
imeminen: omaksua, liota
islam: 
hiipiä-varpaisillaan: varvas, valmis, halukas
kalvo: 
parranajo: 
kitara: 
kiiltävä: kirkas, aamupäivällä, loistava
jalava: 
liidellä: vaellus, leijua, kurkku, lento
pronomini-merkki: 
nitoa: klipsi, kannatin, olennainen, perusteellinen, perustiedot, tärkein, merkittävä, perimmäinen, ensisijainen
mauste: kuori
takaus: side, varmuus, pantti, takuu
kantaja: vektori, kantaja, portteri
värähtely: resonanssi
härnätä: houkutella, ärsyttää, ärsyttää, hurmata
aura: ratkaista, kuokka, kaapata
fysiologinen: ruumiillinen
räystäskouru: valua
komeetta: rikollinen
keskiaikainen: keski-
varpunen: 
hyvittää: palkita, korvaus, offset, lunastaa, meikki, meikki
muovi-: 
alaviite: 
kiertorata: luokka, luokkahuone, lentorata
säästäväinen: vaatimaton
golf: 
nolla-: tyhjä
siru: pala, katkelma, viipale, kimpale
sortaa: tukahduttaa, tukahduttaa, masentaa, musertaa
haukotus: haihtua
eriarvoisuus: 
mooli: seesami, savi
keramiikka: 
kotiäiti: 
ruis: 
rikkoa: rikkoa
suvaitseva: toleranssi
alkio: rengas, rengas, sikiö-, sikiö, tuma
kaivosmies: vähäinen
kiitellä: arvostaa, suosionosoitukset, taputtaa
hiiva: entsyymi, taikina
palkkio: bonus, palkinto-, myöntää
luumu: 
konkurssi: vika
kastelu: 
minttu: karamelli
kapitalisti: kapitalismi
jousto: joustavuus
hai: 
rekrytoida: temppu, noviisi
varastointi: säilyttää, säästää, kauppa, säästö
realismi: 
inkivääri: 
ambulanssi: 
vertailukelpoinen: verrannollinen, samanlainen
lompakko: salkku
irvistys: muki, virne, kiemurrella
tiedemies: tieteellinen, tutkija, tutkija, tutkija
tyhjentää: suolet, suoli
mielentyyneys: 
radio: radium
merkityksetön: ristiriitainen, sopimaton, sopimaton, merkityksetön
papu: mutteri, herne, maapähkinä, vilja
epävirallinen: 
tyttärentytär: pojanpoika, lapsenlapsi, veljentytär, jälkeläinen
erimielisyys: vastalause, keskustelu, riita, olla-eri-mieltä
pihvi: pilkkoa
typpi: 
partakone: 
erottuva: kontrasti, contrastive, ristiriitainen, vastakkainen, päinvastainen
propaganda: julistaa, julkisuus, mainos, mainonta, mainostaa
ilotulitus: 
pop-: napsahtaa, pamaus
riisua: 
vako: 
haitallinen: vahingoittaa, vaarallinen, haitallinen
juutalaisuus: 
täydentää: lisä-, varustaa, lisäys
linssi: linssi, taskulamppu
pegative-tapaus: 
syöpä: 
sotilas: kiinnitys, sotilas, pantti
lehtori: 
vuotaa: läikkyminen, menetys, pudota
pätevöityä: oikeutettu, ansio, ansaita, pätevä, pätevyys
tiheys: tungosta, intensiteetti
induktio: 
pureskella: 
puhelias: communicative
hummeri: 
alennus: vapautus, myynti, myönnytys
Taksi: 
hierarkia: johto, järjestelmä
jade: 
sotkea: 
lisko: 
vesiputous: 
ikävä: masentava, pettymys, pettää, pettynyt, ikävä
veto: kieltäytyä, jäljittää, hylätä, erottaa, paheksunta, veto, veto
puheenjohtajuus: presidentin-
ostaja: asiakas
gallona: 
hyttynen: 
poikkeama: poikkeama, vääristymä, offset
painia: kilpailla
mosaiikki: 
pistoke: liitin, tosite
kyykky: kyhjöttää
ruokakauppa: 
kommunistinen: 
hämmästyttää: yllättävä, hämmästyttävä, upeita, johtaa-harhaan, sekoittaa, tainnuttaa, hämmentää
prosecutive-tapaus: 
tähdistö: galaksi
diktaattori: 
huoli: työllisyys, levottomuus, huoli, koskea
satelliitti: 
tohveli: sandaali
konsonantti: 
lähentää: likiarvo, suunnilleen, likimääräinen
työtön: työllisyys
tukija: avustaja, apu-, kestää, kannatin
lootus: 
lehtisalaatti: salaatti, pinaatti
kloridi: 
bakteerit: sieni, bakteeri-
tahmea: viskoosi
komponentti: 
ydin: 
teeskennellä: teeskennellä, simuloida
tavu: 
eritys: erittää
nimenomaisesti: selvästi, avoimesti, ilmeisesti, ilmeisesti, ehdottomasti
samaan-aikaan: ottelu, sopiva, sopiva, sopimus, matching
baletti: evä
virtsa: kusta
valkosipuli: 
kulunut: ohi, ohimenevä
taloustiede: talous, lama, säästö
keskiluokka: 
ketterä: nopeasti, nopea, nopea, nopea
pihdit: lapio, klipsi
pesula: pesu
mansikka: 
kaupunki-: kansalais-
nolata: lannistaa, haitta, kiusallinen, hämmentää, sekoittaa
muistikirja: 
albumi: 
baseball: 
haistella: 
noutopöytä: 
partisiippi: osallistuja, osanottaja
autotalli: 
diagnoosi: diagnostinen, määrittää, kognitiivinen, tunnustaa
kainalosauva: 
kiristää: kiristää, nyppiä, rajoittaa
rekisteröinti: tallentaa, ilmoittautua, äänitys, loki
liukeneva: liueta
fosfori: 
rakenteellinen: rakenne, kokoonpano, config
liima: 
tutkielma: väitöskirja
käsityöläinen: mekaanikko
banaani: 
selviö: lause, vilpitön, näennäinen, ilmeinen, täsmällinen, periaate
kylkiluu: vaihde
nikkeli: ei-mitään
pii: bye, piirakka, pii
bussi: päästää
sensuroida: sensuuri
ohjus: raketti
makkara: kuuma-koira
manipulointi: toimia, manipuloida, toiminta-, temppu, huijata, kahva
tomaatti: 
vahvistaa: lujittaa, tehostaa, vahvistaa
pistorasia: vetäytyminen, pistorasia, liitin, pesä
kalium: 
hakea: noutaa, toipua, palauttaa, palauttaminen
virtuaali-: todellinen, todellinen, aito
algebra: 
hammaslääkäri: hammas
optinen: visuaalinen
perääntyä: myönnytys, konsessiivinen, liikkua, liikkuva, syrjäyttää
biologia: 
työttömyys: 
toukka: 
yksin: erillinen, ilmiömäinen, erillinen, maaperä, yksin
selain: 
kauko--ohi-jännittynyt: 
historiallinen-jännittynyt: 
ydinaseiden: tuma, atomi-
spektri: 
natrium: 
hysteria: 
edunvalvoja: ylläpitäjä
panttivanki: kiinnitys, pantti
kurpitsa: kurpitsa, kurpitsa
rypistyä: vika
läpinäkyvyys: läpinäkyvä, täsmällinen, suora
piikki: kiila, pitsi, kärki, naulata
prioriteetti: Huomio
jalankulkija: kävely
ateismi: 
monitori: seurata, valvoa, katsella, harjoittaa
vaalipiiri: äänestäjä, äänestäjät
kontrolloimaton: 
koetin: tutkimus, tiedustelu, tutkimus, tutkia, tiedustelu, tutkiminen, oikeudenkäynti
platina: 
kaksois--määrä: 
keuhko: 
Super: ilmiömäinen, valtavasti, uskomattoman
johdinauto: kuljetus, kärry, vaunut
paikallisesti: paikallinen
yllyttää: kiihottaa, ärsyttää
bensiini: bensiini
munuainen: 
ryöstää: ryöstö, ryöstelyä, saalis, pilata, ryöstää, saalis
arviointi: arvio, arviointi, arvioida, luokka
arsenikki: 
etana: helix
heinäsirkka: 
yhtälö: kaava, tasa-arvo
sosialistinen: sukulaisuus
suodattaa: 
aisti--todistusarvo-mieliala: 
laajentaa: laajentaa, leveä, lisätä, korottaa, parantaa, pidentää, laajalti, päätöslauselma, laajentaminen, laajeneminen
päästää: käynnistää, heittää, hengittää, ammu, päästää
talutushihna: vuokrata, hihna
mandariini: 
kuski: 
keuhkokuume: 
solidaarisuus: yhdistää, ralli, affiniteetti, yhtenäisyys, samankaltaisuus
sarana: yksityiskohtainen, silmukka
pitkittäinen: pystysuora
osinko: jako
luistella: hiihtää
eksponentti: indeksi, räjähdysmäinen
vammaisuus: haitta, kykenemättömyys, vika, epätäydellinen, vammaiset, virhe, tahra
pakkomielle: häiritä
siirtolapuutarha: jako, jakaa, säännös, kiintiö, toimeksianto
valokuvaaja: valokuvaus-
delta: osallistua
digitaalinen: kuvio, numero, numeerinen
narttu: 
silmäluomi: 
diagonaalinen: 
alitajunta: 
kulmakarva: 
aivastus: 
hilpeä: iloinen, hauska, iloinen, hauska, viihteellinen, huvittava, huvittunut, humoristinen, naurettava
hindulaisuus: 
pakolainen: maahanmuuttaja
sukkula: avaruusalus, kuljetus, kuljetus, kuljetus
proteiini: munanvalkuainen
kaatopaikka: kasa, pino, karkottaa-maasta, roskat, roskat
jalostaa: 
oksentaa: 
geeni: geneettisesti, geneettinen
fuksi: 
sosiologia: 
squash: kurpitsa, murskata
kalastaja: 
alueellinen: lääni, alue, vyöhyke, osasto, pallo, sektori, perifeerinen
liike-ylämäkeä: 
takautuva: ohi, itsetutkiskelun
tornado: 
inversio: inverttisokeri, päinvastainen, vastavuoroinen, käänteinen
TV: televisio, elokuva
kuutio: 
tuottavuus: suorituskyky, ulostulo
porkkana: 
molekyyli-: molekyyli, alustan
monialayritys: klikki, ryhmä, rykelmä
kirjanpitäjä: tilintarkastaja
kurkku: vaihtoehto, kurkku
vimma: 
liuotin: liueta
fosfaatti: 
pohjamaali: syötti, tuttavuus, käyttöönotto
emäksinen: 
voimistelu: kunto
pilkku: kooma, osapuoli
liike-alamäkeä: 
keskenmeno: abortti, matala, vika
palko: kuori, tuppi, kuori
luovuttaja: 
mangaani: 
psykologi: 
kloori: 
näppäimistö: 
eliitti: 
sulkumerkki: 
Rugby: 
haava: kipeä, haava, trauma, kiehua
taivutettu: 
napostella: 
kvantti: määrä, määrä, kiintiö, osa
villapaita: takki
evoluutio-: kehitys-, evoluutio
merkintätapa: merkki, symboli, Huomautus
pomppia: puomi, hypätä
leikkely: jakaa, jakso
kätkö: 
lineaarinen: suora
antimoni: 
superessive-tapaus: 
kasvain: kasvain, irto-, kolahtaa
eroosio: 
alpha: 
napa: vatsa, napa
immuuni: hengittäminen, kestävä
influenssa: flunssa, vuotava, kuume, vaikutus
panimo: 
yksinkertaistaa: 
lyhentää: rajoittaa, rajoittaa, rajoittaa
lommo: kyhmy, kolahtaa, hammas
valloittaa: kaapata, hurmata
hallita-pakolla: rajoittaa, pakottaa, valvoa, täytäntöönpano
sukka: 
elokuva: elokuva, elokuva, nauha, nauha, raita
maailmankaikkeus: maailmankaikkeus
saastuttaa: saastuminen, tartuttaa
seuraa-rakastava: 
penis: sukupuoli
metsänhoito: 
alumiini: alumiini
värähtely: vaihtelu
horoskooppi: 
eject: suihku-, karkottaa, syrjäyttää, karkottaa, erittää, syrjäyttää, vähentää
sisällyttäminen: äänitys, integraatio, upottaa, kansi, sisältää, päällyste, epäsuorasti, sisältää, osallistuminen
edunsaaja: vakiintunut, käyttäjä
delfiini: 
tappaja: 
nisäkäs: 
osoitin: ryhti, indeksi, kriteerit, etusormi, arvioida
dioksidi: 
kaksoispiste: 
byrokratia: byrokraattinen
vääristää: johtaa-harhaan, ryntäily, vääristymä
jääkaappi: jääkaappi
arkeologinen: arkeologia, arkeologia, fossiilinen
mahdoton-hyväksyä: tuomitseva
määrittely: normi, standardisoida
esite: tiedotuslehti, luentomoniste, arkki
antropologia: 
maukas: herkullinen
transitiivinen: tekosyy, siirtyminen
kyyristyä: ryömiä
auringonkukka: 
täi: rasti, bitti
ioni: 
matkailu: turisti, matkustaa
modeemi: 
kiihtyvyys: edistää, helpottaa, stimulaatio
väärentää: hämmentää, väärentää
emissio: likainen, ongelma
siepata: kaapata, johtuminen, siepata
päällekkäisyys: vuorovaikutus, interaktiivinen
kampaaja: 
kansanperinne: vehnä
kapillaari: 
nationalismi: kansalaisuus
takapuoli: lonkka, pakara
motiivi: teema, aihe, motiivi, perustein
sublimoida: 
pettymys: takaisku, epätoivo, pettymys, sekava, peruuttaa
koboltti: 
kaura: 
liike-yläjuoksulle: 
peräaukko: 
nauta: 
kääntää: kääntää, kääntää
irtisanominen: paljon, jäljelle-jäävä, ylimäärä, erottaa, hylkääminen, vapautus
video-: 
boikotoida: lääni, häpeäpaaluun, laiminlyödä
tietokilpailu: yrittää, tentti, kyselylomake
jääkiekko: 
sissi: 
magnesium: 
tutka: 
simpanssi: 
luotettavuus: uskottavuus
suorakulmio: 
rakkolevä: 
yleistää: yleistys
ulkonaliikkumiskielto: 
homoseksuaalinen: 
skenaario: käsikirjoitus, maisema
muotoilu: rakentaa, rakentaa, rakentava, sanamuoto, luominen, muodostus, muotoilla
reinkarnaatio: 
sytyttää: 
uraani: 
sieppari: reseptoriin
koordinoida: koordinaatio
veronmaksaja: 
integroitu: olennainen
opined: näkymä, lausunto, huomautus
gamma: 
safari: ratsastaa, matka, matka, matka
liike-alajuoksulla: 
kerroin: luokka, tekijä
otsikko: otsikko, aihe
analyytikko: analysoida
Shakki-Matti: 
ostoskeskus: supermarket
vismutti: 
postikortti: tervehdys
lähentyminen: likiarvo, yhtyä
eksyä: vetäytyä, lähteä
osakas: kumppani
mikrobi: 
sukupuolielinten: 
morfologiset: geneettinen, morfologia
beeta: 
farkut: 
tietokanta: 
laskin: tietojenkäsittely
röntgen: 
jäsentää: 
ympäristö-: maisema, ympäristö, ympäristö, konteksti, ekologinen, naapuruus, naapuruus, muoto
sigma: 
disjunktio: eristäminen, erottaminen, hajota, hajota
esityslista: ohjelmoida, ohjelmoida, opetussuunnitelma
Visa: 
infrastruktuuri: 
tulikärpänen: 
ilmaisin: 
mukautuva: 
biologi: 
liitos: kiinnittää, muuttaa, liittää, kytkeä
bromi: 
palladium: 
hikka: 
pastellityö: kalpea
eläintarha: 
klinikka: 
konnotaatio: epäsuorasti, merkitys, semanttinen, käsite, käsite, tunne, konteksti
jooga: summa
kirjakauppa: kirjahylly
terapia: hoito, kohdella, parantaa, parannuskeino, terapeutti
nationalistinen: etninen
mestata: 
Joo: kyllä
ongelmallinen: ongelma, ongelma, komplikaatio
jazz: 
volframi: 
terroristi: militantti, kauhu
tiputtaa: lima
aineenvaihdunta: 
elatusapu: 
viikonloppu: 
krysanteemi: 
rokote: selostus, kattavuus
moottoripyörä: moottoripyörä
mantra: 
lukukausi: termi
heroiini: 
kansio: 
katodi: 
ideologia: ajatus
pysäköinti: 
theta: 
antikliimaksi: pettymys
seleeni: 
pyöräily: verenkierto, silmukka, syklinen, polkupyörä, pyörä
aivokuori: haukkua, kuori, kuori
vastaavuus: tasa-arvo
nykyinen-merkityksellisyys-merkki: 
lentokenttä: 
amputoida: keskeyttää
koripallo: 
huijarin: 
torakka: 
kromi: 
litra: litra
kuitenkin: siitä-huolimatta, vielä, kuitenkin, joka-tapauksessa
hormoni: 
virheellinen: puute, puute, epätäydellinen, virheellinen, väärä, puuttuva
lävistää: puhkaista
animismista: 
monikulmio: kulma
feministi: 
konjugaatti: rinne, kytketty
euro: 
ginseng: 
algoritmi: 
laser: 
apteekki: 
millimetri: millimetri
flex: mutka, kaareva, joustava, suotuisa, kaapeli
anodi: 
vivahde: sävy
osa-aikainen: 
herkkyys: 
mielenosoittaja: 
helium: 
kaksikielinen: 
akronyymi: lyhyt, lyhyesti, kutistua
alkukirjainlyhenne: 
gerundi: 
plasma: 
kromosomi: 
järjestysluku: liittymä, rivi, säännöllinen, peräkkäinen
kilometri: kilometri
faksi: 
genetiikka: geneettinen, geneettisesti
pisama: 
ruuvimeisseli: jakoavain
parsakaali: 
preteriti: 
vitamiini: 
kadmium: 
pommikone: 
graafinen: 
titaani: 
törsätä: kerskailla
lambda: 
tyttöystävä: kumppani, poikaystävä, rakastaja, tyttö
paritella: 
tiimalasi: 
empatia: myötätunto, myötätunto, ymmärtäminen
boori: 
helikopteri: 
telluuria: skandium, lantaani
takaraja: termi
kohdista: 
senttimetri: 
molybdeeni: 
litium: 
multimedia: 
päivittää: nykyaikaistaa, virkeänä
kalori: 
robotti: 
kotitehtävät: 
logaritmi: 
rukoilijasirkka: 
asentaa: asentaa, asentaa, synteesi
amino: 
glyph: helpotus
aoristi: epämääräinen
ekologia: ekologinen
hieno-ihminen: pilata
marihuana: 
mikro: hienovarainen, pieni, pienen-pieni, pikkuriikkinen, mikrofoni
kilogramma: 
syödä-liikaa: 
ennustettavissa: ennustus, ennustaa, ennuste
pizza: 
kuunnella-salaa: 
kielitiede: kielellinen
hiustyyli: 
iridium: 
rasismi: rodullinen
optimaalinen: ylin, optimaalinen
teollistuminen: teollistaa, teollinen, valmistus
pääkonttori: päämaja, istuin
cerium: 
yhtenevä: ystävällinen, sopiva, suotuisa, yhteensopiva, samanlainen
partitiivi-tapaus: 
kasetti: nauha
tahdonvoima: tahto, tahtoa
ulotteinen: koko, muoto, ulottuvuus, tila
parametri: 
synkronoida: synkronoida
maksimoida: maksimi, parantaa, liioitella
seminaari: työpaja
disko: levy
neon: 
osmium: 
loppiainen: 
plagioida: varkaus
artefakti: 
reaktori: 
oregano: 
plutonium: 
yttrium: 
puhetta-tukevaa: 
käyttäjätunnus: 
jatko: 
oikeisto: 
argon: 
fobia: pelätä, awe, kummitella, inho
seurustella: ilmoittaa, olla-vuorovaikutuksessa
globalisaatio: 
aallonpituus: 
koodittaa: koodi
kierrättää: käytetty
uudelleenkäynnistää: reboot
maksatulehdus: 
torus: kyhmy
kemoterapiaa: uskonnollinen
modulo: muotti, moduuli
protoni: 
levyke: 
milligramma: 
pixel: 
tantaali: 
liuenneen-aineen: päättää
kansanmurha: 
petoeläin: raju
gallium: 
zirkonium: 
määritin: määrätä, määritellä, tutkija
epälineaarinen: 
torjunta-aine: 
beryllium: 
neuroni: 
predikatiivinen: itsevarma
alushousut: alusvaatteet
kertoma: tiedekunta
neutroni: 
niobia: 
germanium: 
metalloidi: ei-metalliset
laittaa-päälle: 
prolative-tapaus: 
biodiversiteetti: 
peliohjain: 
antibiootti: 
aktinium: 
astronautti: tila
avaruusolento: ulkomaalainen
hullu: tyhmä, vihainen, hullu, mielenvikainen, poikkeava
maraton-: 
ytterbium: 
autismi: 
ionisoi: 
radon: 
nerium: 
epidemiologia: 
vanhuus: vanhukset
telttailu: leiri
raidallinen: raita, järjestelmä, suunnittelija
indium: 
veridical: vilpitön, puhdas, netto
verkkosivusto: verkkosivusto, paikka, profiili
Koraani: 
flatware: 
nnen---root: 
lawrencium: 
siviili---oikeudet: 
kännykkä: kännykkä, kännykkä
halvaantunut: 
Protaktinium: 
säteily: hehku
riippua-päälle: 
torium-atomi: tulium-atomi, terbium-atomi, rodium-atomi, rubidium-atomi, vanadiinia-atomi, fluori-atomi, polonium-atomi, tallium-atomi, strontium-atomi, rutenium-atomi
blue---jean: 
huonekasvi: 
erikseen: henkilökohtaisesti, yksittäinen, henkilökohtainen, erikseen
flow---virta: 
triple---piste: 
ihmiskehon: 
fysiikka: fyysinen, fyysisesti
jälleenmyynti-kauppa: 
cesium: 
pitkä-sitten: 
taulukkolaskentaohjelma: 
yksikkö---of- massa: 
koota: 
binary---arvo: 
ihmisen-ollessa: 
mukaan-välineet-of: 
depan-dari: 
praseodyymi: 
pahvi: kortti-
rajallinen-verbi: 
oikeudenkäynti-määrä: 
ammattilainen-tuomita: ammattilainen-lauseke
kriitikko: kriittinen, kriittisesti
pakkaus: kääre, pakata
väliaikaisuuden: epävakaa
at-suurin-osa: 
avainsana: kuvaus
neodyymi: 
ystävyys: ystävällinen, liittolainen
lukea-vain: 
loisi: 
genomisen-mieliala: 
foneemi: 
järkevyys: tajunta, logiikka
fonologisten: 
ruokailu-huone: 
elävä-huone: 
centric-tapaus: 
pre-hodiernal: 
potilas-tapaus: 
vino-tapaus: 
maaseudun-alue: 
recurse: 
keskimmäinen-ääni: 
Meitnerium: 
postimies: 
välttelevä: litteä
kalusto-markkinoida: 
tunnistettavissa: henkilöllisyystodistus, tunnistaa
tavoite-laukaista: 
yksi-sekunti: 
dännön-tapaus: 
säännöstellä: osa
ei-ihmisen: 
elävä-asia: 
liian-vähän: 
elokuvateatteri: elokuva
hassium: 
vaimentavat: 
multal-määrä: 
maitomainen-tapa: 
neptunium: 
haamukirjoittaja: 
trans-numero: 
pelleillä: 
amerikium: 
aamu-kunnia: 
palomies: 
berkelium: 
galaxy-sukupuoli: 
nobelium: 
bye-Bye: bye, Hyvästi, asti
buddhalaisuus: 
fermium: 
syaani: purppura
soija: 
jakelija: 
rikkuri: 
suoritin: 
abessiivi-tapaus: 
adessiivi-tapaus: 
että-tapaus: at-tapaus, satunnaisesti
agentive-tapaus: 
rutherfordium: 
vasta-aine: 
kuten-paljon-kuten: 
agentti-laukaista: 
näyttelijä-rooli: 
eti-: 
yhteinen-sukupuoli: 
accompanier: 
saflori: 
frankium: 
erbium: 
passiivinen-ääni: 
astatiini: 
pureskelua-purukumi: 
tähti-sukupuoli: 
lainaus-muoto: 
curium: 
sarjakuva: 
värisokea: 
euler's---numero: 
Katso-at: 
suojatie: polku
taistelukenttä: 
autoilija: kuljettaja
oikosulku: 
sanallinen-substantiivi: 
itkeä-ulos: 
tilastollisesti: tilastollinen
jogurtti: 
xenon: 
hypnotisoida: 
ottaa-pois: 
lauseke-hännän: 
suoraan-esine: epäsuora-esine
ruokakauppa-kauppa: 
muodostuvat-of: 
ergative-tapaus: 
in--kielellä: 
ensi-käden: suoraan
locative-tapaus: 
uima-allas: pool, pesuallas
adverbiaali-tapaus: 
sightsee: matka, tarkastaa, verenkierto
televisio-sarja: 
lopullinen-hiukkanen: 
evitative-tapaus: 
kuntoutus: 
regressio: palata, vetäytyminen, vetäytyä, takaisku
lohko-of-asuntoja: 
herätä-ylös: 
valvoa-upseeri: 
vannon---in: 
haastattelija: haastatella
renium: 
aerosoli: 
omistushaluinen-tapaus: omistushaluinen-tapaus
nominalization: substantiivi
riivattu-tapaus: 
ylihinta: 
apu--verbi: 
ensisijainen-esine: 
tietokone---virus: 
Bisneshenkilö: liiketoiminta-henkilö, kauppias
ihmiset: ihmiset, kansa
antessive-tapaus: 
pääministeri: 
lutetium: 
europium: 
emote: 
kansanmusiikki: 
runoilija: 
postitoimisto: lähettää, posti
muka: olettamus, hypothesize, oletettavasti, ilmeisesti, todennäköisesti
elävöittää-sukupuoli: 
subessive-tapaus: 
kaasupedaali: 
vastakkaisuus: polaarinen
ajoneuvo-sukupuoli: 
mineraali-sukupuoli: 
verbi---pääte: 
intohimoinen: tunne, tunteellinen, aisti-
samarium: 
helpottajana: hidastin
kuvitteellinen---yksikkö: 
nopeus---of- light: 
ilmavoimat: 
empaattinen-ilo: 
Kriittinen-piste: 
täysaikainen: 
hafnium: 
esto: hillitä, hillitä, estää, kieltää
muuttaa-of-tapahtuma: 
holmium: 
eri-tapahtuma: 
maailmankaikkeus-sukupuoli: 
sijainti-sukupuoli: 
virtuaali--kone: 
tutkimus-sukupuoli: 
taiteellinen-sukupuoli: 
crastinal-jännittynyt: 
abstrakti-sukupuoli: 
exocentric-tapaus: 
transitiivinen-verbi: 
morfeemi: 
shovinisti: 
ohi-perfektiivinen: 
ammatillinen: erikoisuus, työperäinen, ammatti, alus, ammattilainen
epäsuora-puhe: 
toinen-kieli: 
että-olla: 
hautausmaa-siirtää: 
kollektiivinen-substantiivi: 
absolutive-tapaus: 
potilas-laukaista: 
itse-luottamus: 
ulosteet: jakkara, perä, lika
refleksiivinen-ääni: 
persoonaton-verbi: 
seaborgium: 
valkoinen-tila: 
modaalinen-tapaus: 
eloton-sukupuoli: 
syynä-oleva: 
propositive-mieliala: 
sähköinen-nykyinen: 
assosiatiivinen-tapaus: 
superlatiivi--tapaus: 
liian-paljon: 
planeettojen-sukupuoli: 
eloisa-sarjakuva: 
vastavuoroinen-ääni: 
säätää-lakeja: lainsäädäntö, lainsäädännöllinen, järjestää, järjestää
at-vähiten: 
kieliopin---tapaus: 
käyttäjä: 
ydin-benefactive: 
maalivahti: 
:-except-for: 
nimittäjä: 
muu---jos: 
sivuttain: syrjään
toisiaan: yksi-toinen, keskinäinen
peräkkäinen-lauseke: 
kulua: 
shortsit: 
dysprosium: 
pian-tulevaisuus-jännittynyt: 
si-yksiköt: 
krypton: 
mendelevium: 
applicative-ääni: 
antipassive-ääni: 
continuative-näkökohta: 
säteily---sairaus: 
necessitative-mieliala: 
yksittäinen-toiminta-verbi: 
junavaunujen: 
superlatiivi--aste: 
eksistentiaalinen-lauseke: 
kalifornium: 
esittää-partisiippi: 
valoisa-intensiteetti: 
singulative-määrä: 
kieliopin---esine: 
passiivinen-partisiippi: 
liiallinen-kesto: 
ylikriittinen---neste: 
määrä-of-aine: 
postpositional-tapaus: 
valinnainen-kvantisointi: 
gadolinium: 
epenthetic-morfeemi: 
negatory-kvantisointi: 
einsteinium: 
keinotekoinen-kieli: 
yhdistävä-hiukkanen: 
kauko--tulevaisuus-jännittynyt: 
frequentative-näkökohta: 
jakelu-pronomini: 
allocution-sopimus: 
kalju: paljas
lähiö: Hamlet, maaseutu
yleismaailmallinen-kvantisointi: 
tietokone-ohjelmointi: 
televisio-ohjelmoida: 
kelluva---point- numero: 
eksistentiaalinen-kvantisointi: 
päivä-jälkeen-huomenna: 
vaihtoehto-kvantisointi: 
pahantuulinen: karkea
ohi-passiivinen-partisiippi: 
päivä-ennen-eilen: 
locative-suunta--tapaus: 
vaihtoehtoisen-ehdollinen: 
