infinitif: infini, infini
nominatif-cas: 
accusatif-cas: 
sujet-cas: assujettir-cas
parent: parental, majeur, supérieur
papa: père
maman: maman, mère, maternel
Salut: adieu, salut, Hey
ancêtre: prédécesseur, grand-père
grand-parent: grand-père, grand-mère
affamé: faim, affamer
génitif-cas: possessif-cas
adjectif: 
et: somme, par
moi: moi-même, je, mon, nous
toi: eux, te, tu
nous: nous, notre, les-notres
ce: il, que, elle, ce, ces
destination-cas: objectif-cas
datif-cas: 
intérieur-le-contexte: 
personne-le-contexte: 
dépendant-clause: 
perfectif-aspect: 
passé-tendu: 
masculin-le-genre: neutre-le-genre
comitative-cas: 
présent-tendu: 
benefactive-cas: 
essive-cas: 
pas: non, non, à-peine, incapable, non-, pas
ses: leur, le-sien, elle, lui, ceux, la-sienne, de
surface-le-contexte: 
adpositional-cas: 
emplacement-cas: 
espace-le-contexte: 
façon-cas: 
instrumental-cas: 
laquelle: qui, comme, à-qui, quelconque, non-plus, que, qui, ce-qui--, que, chaque, quel
interrogatif-humeur: 
et-ou: 
OU-exclusif: 
la-source-cas: 
ablatif-cas: 
démonstratif: solide, substantiel, béton, convaincant, directif, dramatique
mais: encore, toutefois
tous: tout-le-monde, Tout-le-monde, le-total, tout, Globalement, entier, tout, quelconque, de-plus-en plus
féminin-le-genre: 
ils: eux, elle, ceux, leur, les-leurs, nom-de-famille, ces
pluriel-nombre: 
un: unique, une, dans, en-solo
avenir-tendu: 
social-le-contexte: 
lorsque: n'importe-quand
non-accompli-aspect: 
Là: 
conditionnel-humeur: subjonctif-humeur, hypothétique-humeur
plus: plus-de, la-plupart, plus-loin, au-delà, ascendant, vers-le-haut, multi, que, plutôt, aussi, de-plus, plus, encore, encore, autre, Plusieurs, plusieurs
dehors: dehors, extérieur, externe, de-plein-air, en-plein-air, de, en-dehors-de, au-delà, en-haut, sur, sur
relatif-cas: relatif-cas
illatif-cas: 
faire: faire, effectuer, entreprendre, rendre, activer, fait, commettre
directif-humeur: indicatif-humeur
déontique-humeur: 
question-mot: 
copule: connecteur, liaison, bouquet
la-personne: homme, personnes, individuel, quelqu'un, Quelqu'un, gars, Humain, visage, bouche, entité
mâle: masculin, mention, gentilhomme, homme
pourrait: peut, pourrait, peut-être, Peut-être
autre: autre, du-repos, deuxième, un-autre, différent, un-autre
nombre: montant, somme, figure, numérique, numéral, Quantité
très: considérablement, extrêmement, terriblement, beaucoup, aussi, terriblement, largement, très, vraiment, mal, énorme, considérablement, lot, multi, énormément, la-plupart, assez, équitablement, loin, assez, D'accord, OK, d'accord
temps: Pendant-que, moment, durant, opportun, durée, temporel, tendu, calendrier, point-final, Météo
temps-le-contexte: 
temporel-cas: 
environ: En-ce-qui concerne, concernant, presque, environ, de, par, que, autour, pour, utilisateur, plaindre, sur
épistémique-humeur: 
seulement: juste, simplement, simplement, point, simple, purement, confiné
petit: petit, minuscule, mince, légèrement, bit, mineur, petit, diminutif, portable, peu
puis: de-nouveau, ré-, Ya, depuis, depuis, plus-tard, après
il-revêt-humeur: 
rétrospective-aspect: 
formidable: grand, grand, noble, Sérieux, vaste, bruyant, énorme, géant, énorme, dominant, bien, amende, considérable, énorme, substantiel, formidable, excellent, optimum, grandiose, majeur, parfait, remarquable, brillant
volitive-humeur: 
avant: avant, pré, depuis, précéder, jusqu'à, avant, anciennement, contre
Dois: devrait, nécessairement, inutile, devoir, avoir-besoin, doit, devrait, vouloir, à
deux: double, les-deux
voir: Regarde, vue, vue, avis, apercevoir, regarde
connaître: vérifier, au-courant, enseigner, drapeau, visible
en-bas: vers-le-bas, vers-le-bas, en-dessous-de, au-dessous-de, en-dessous-de, sous, Moins, bas, inférieur, en-bas
après: arrière, sur, poster, dimension, plus-tard, après, après, en-suivant, passé, en-dessous-de, sous
premier: début, initiale, depuis, en-avant, poing
posséder: lui-même, toi-même, posséder, personnellement, le-sien, lui-même, soi
aliénable-possession: 
jamais: toujours
inaliénable-possession: 
Agé-de: utilisé, ancien, vieilli, personne-âgée, ancien, ex, ex-, âge
délibérant-humeur: 
jour: au-quotidien, aujourd'hui, ce-soir
où: partout-où, par-lequel, lieu
Venez: à, portée, arrivée, arriver, devenir, mode, se-produire
façon: la-méthode, méthodologie, veux-dire, chemin, route, tract, sentier, sentier, manière, route, rue, du-sucre, Piste, trajectoire, habitude
oeuvre: emploi, affectation, actif, tâche, la-main-d'oeuvre, la-main-d'oeuvre, carrière, fonction, fonctionner, fonctionnel, Entreprise, acte, faire-des-exercices, emploi, professionnel, travailler, oeuvre
une-voyelle: célèbre, la-vie, survie
aller: marche, aller, partir
perlative-cas: 
progressive-aspect: 
long: prolongé, durable, grand, le-long-de
dire: parlé, dire, parler
Comment: aimer, comme, que
pair: aussi, non-plus, jusqu'à, de-plus, aussi
arrière: derrière, arrière, en-arrière, en-arrière, retour, ré-, restaurer, annuler, de-nouveau, répéter, depuis, selon
ici: 
pense: en-pensant, pensée, considérer, imaginer, concevoir, méditer, voudrais, appelé, dérange
même: identique, similaire, égal, équivalent, avec-raison, D'accord, d'accord, lui-même, également, De-même
dernière: fin, dernier, final, ultime, un-autre, autre, dernier, récent, fin, passé, la-passé, supporter, résister, mettre, persister
un-moyen: loin, loin, de, à-l'écart, distant, gauche, abandonner, absent
en-dessous-de le contexte: 
prendre: recours, occuper, rapporter, adopter, saisir, Obtenez, recevoir, choisir, capture, capture, Acceptez, obtenir, charger
a-trouvé: trouve, découvrir, Découverte, détection, accessible
le-Main: bras, poignet
Jeune: jeunesse, junior, adolescent, adolescent, neuf
bien-que: bien-que, Néanmoins, fixé, raffermir, solide, fermement, en-dépit, toutefois, Quelqu'un
donner: prêter, fournir, offre, fournir, livrer, rendre, offrir, mettre, faire-un-don, laisser
Dieu: 
delative-cas: 
rien: quelque-chose, objet, personne, n'importe-quoi, aucun, personne
droit: paire, Corriger, avec-précision, Juste, Justice, justifiée, injuste, éligible, droit, loi, correctement, vrai, certain, bien-sur, habiliter, Hé-bien
une-seul-fois: immédiatement, rapidement, la-méthode, modèle, méthodologie, de-nouveau
semelfactive-aspect: 
partie: section, partiellement, partie, en-partie, parcelle, fraction, partager, bit, pièce, passage, sous-ensemble, chapitre, département, épisode, partiel, division, quartier, secteur, proportion, nom
vu: 
maison: domicile, locaux, temple, logement, Ménage
monde: domaine, mondial, univers
directeur: Titre, Principal, chef, chapitre, guide, Président, président, directeur, patron, supérieur, Stylo
Trois: troisième
néo: neuf, nouvellement
concentrer: prévu, avoir-pour-but, objectif, objectif, concentrer, attention, concentration, accent, converger
aimer: affection, charité, aimer
toujours: pour-toujours, constamment, toujours, habituel
nuit: soir, dîner, p.m.
chaque: par, chaque, quelconque
Roi: règne, Seigneur, monarque, magnat
compris-entre: parmi, parmi, de
cœur: acclamation, encourageant, renverser
paucal-nombre: 
en-raison: dû, depuis, cas, cause
causal-cas: 
chose: matière, affaire, phénomène, des-trucs, que
ensemble: groupe, mettre, garder, allonger, pâte, collection, combinaison, tableau, suite, forfait, portefeuille, la-synthèse, ensemble, série, faire-tourner, gamme, rangée, chaîne, trousse, corpus
prénom: nom-de-famille, nom
correct-nom: 
il-revêt: exhortative
Pays: nation, la-terre, Terre, Etat, sol, comté, sol, fête
a-demandé: 
visible-évident: 
mieux: supérieur, meilleur, excellent, idéal, exceptionnel
côté: latéral, faveur, faveur, nom, faire-tourner, page, aspect, demi, facette
cours: programme-d'études, cours, conférence, assurément, sûrement, certainement,-vraiment,-définitivement, taux
femelle: Dame, féminin, féminin, femmes, Fille, femme
assez: suffisant, suffisamment, adéquat, ample, équitablement, beaucoup, insuffisant, assez, assez
bientôt: d'ici-peu, rapide, rapide, rapidement, vite, immédiat, rapide, se-dépêcher, urgent, ainsi, immédiatement, facilement, juste-à-côté, de-bonne-heure, casser
complet: pleinement, suffisamment, absolu, complet, imparfait, entier, exactement, exact, prononcer, précisément, approfondi, tout, complet, Taille
chambre: chambre, Quatrième, chambre-à-coucher, paix
presque: presque, pratiquement, approximativement, environ, près, autour, Près, adjacent, pratiquement, juste-à-côté, d'ici-peu, proximale, grossièrement, à-peine
ne-peux-pas: incapable
eau: liquide, fluide, grand-tournant
désidératif-humeur: 
lumière: lueur, brillant, bougie, mince, style, légèrement, doux, plus-léger, pâle, clair
ni: non-plus, non-, encore, que, arriver, ou
mot: lexical
porte: porte, porte, entrée, chapitre, port
utilisation: utiliser, usage, consommation, dépense, consommateur, engager, application, utilitaire, appliquer, employer
matin: un-m., déjeuner
terminative-cas: 
du-pouvoir: force, énergie, pourrait, fort, obliger, puissant, dynamique, salade, dominance, autorité
se: nous-mêmes, toi-même, lui-même, moi-même, se, lui-même, soi, ego, chapitre
présent: actuel, la-présent, maintenant, actuellement,-en-ce moment, cadeau, exister, disponible
voix: du-son, à-haute-voix, scrutin, Audio, vote, article, rumeur, rumeur
blanc: blanc, plainte
de-l'argent: richesse, argent, financier, argent-comptant, devise, la-finance, monétaire
prochaine: à-côté-de, aux-côtés-de, à-côté-de, en-suivant, plus-tard, dimension, en-avant, ultérieur
pauvre: bras, la-pauvreté, mal, pire, pourri, faible
la-mort: mortalité, en-train-de mourir, mort
forme: forme, moule, format, contour, modèle
inessif-cas: 
aimable: classe, Trier, espèce, la-variété, type, amicale, article, bien, agréable, plaisant, agréable
souvent: fréquemment, constamment, de-façon-régulière, fréquent, communément, normalement, typiquement
an: annuel, annuellement, cinq
ami: allié, petit-ami, bonhomme, camarade
commande: système, arrangement, organiser, Contrat, tableau, commander, faire-tourner, rangée, queue
impératif-humeur: 
rond: arrondie, cercle, tour
croire: confiance, compter, présumer, foi, croyance, confiance, confiant, optimisme, optimiste
public: la-public, général, public
Etat-le-contexte: 
fils: essaim, garçon
cent: centième, visage, cent
enfants: enfant, progéniture, enfant, bébé
Ainsi: ainsi, ainsi, Par-conséquent, tel, Oui
espoir: souhait, perspective, anticiper, optimisme, optimiste
au-dessus-de: en-haut, plus-de, en-haut, haut, haut, Avancée, plus-haut, de-l'autre-côté, concernant, passant-par, sur, aérien, sur, devant, vers-le-haut
chère: amoureux, cher
lis: en-train-de lire, chanter, lis
ville: ville, municipal, comté
déjà: prêt, préparé, prêt, en-tous-cas
fait: vérité, réalité, véracité, vrai, réal, réel, en-effet, vraiment, actuellement, fait
factive-évident: 
entendre: écouter, audition, ressentir
moins: minimal, le-minimum, minimiser, moins, Moins
peut-être: Probablement, Peut-être, probablement, pourrait, peut-être, possible, probable, probable
Ouvert: clair, plaine, clairement, nu, évidemment, vacant, explicite, évident, de-plein-air, déficit, pâle, ouvertement, exposer
corps: la-chair, physique, physique, physiquement, corpus, organe, cadavre
air: Vent, brise, aviation, Météo, Compagnie-aérienne
la-nature: Naturel, originaire-de, naturellement, origine, descente, indigène, faune, personnage
Aidez-moi: aider, utile, aide, assistance, assistant, allonger
lettre: Courrier, en-train-d'écrire
quatre: Quatrième
optatif-humeur: subjonctif-humeur
du-feu: chaud, flamme, fièvre
donc: Par-conséquent
heure: horloge, heure, cloche
libre: liberté, liberté, exempter, gratuitement, vain, en-liberté, vacant, librement, Libération
guerre: bataille, lutte
qu'elle-soit: si, lui-même
raison: cause, compte, facteur, raisonnablement, excuse, terrains, propager, demandeur
uni: singulier, unité, compris, union, allié, allié, unique, unanime
appel: Challenge, oxyder, appel, sur, connexion, combinaison, mixte, la-fusion, invitation
Pourquoi: 
perdu: perte, disparu
mille: millième
Famille: Ménage, survivant
âme: esprit, fantôme, cerveau
question: problème, demande, en-train-de lire, matière
soins: concerné, préoccupation, attention, méditation, service, parrainage, garde, sécurité, la-protection, Sécurité, la-préservation, préservation, couverture, la-défense, prudence, guérir, traitement, garde
realis-humeur: 
signifier: impliquer, sens, sens, significatif, dénoter, milieu, agent, moyen, moyen, modérer
potentiel-humeur: 
envers: vers, contre, opposé, opposé, par, le-respect, pour
allative-cas: 
anthropique-le-genre: 
court: Moins, bas, bref, d'ici-peu, brièvement, carte, étroit, mince
capable: peut, qualifié, éligible, capable, capacité, capacité, incapable, compétent, potentiel, possibilité, probabilité, fort, puissant, habile, mai
habite: la-vie, survivre, se-comporter, vivant, nid, district, quartier, quartier, vivant, animé, brut, résider
assujettir: discipline, thème, sujet, cours, substance, problème, objet, sens, Matériel, sémantique, matière, affaire, Titre
même-assujettir-marqueur: 
différent-assujettir: 
réponse: le-nord, répondre, réponse, Solution, correspondre, répondre
mer: océan, Marin
la-crainte: crainte, peur, la-terreur, awe, effrayé, panique, anxiété, angst, horreur, effrayer
comprendre: compréhension, compréhension, apercevoir, saisir, concevoir, inintelligible, comprendre, prendre-conscience-de
difficile: difficile, rigide, compliqué, dur, bruyant, violemment, féroce, dure, strict, difficile, rusé, lourd, la-tombe, sévère, inquiet
les-termes: terme, terminologie, problème, basé, terrains, base, essentiellement, fondamentalement, fondamentalement
doute: soupçon, méfiance, suspect
dubitative-humeur: 
demander: prier, exiger, écouter, S'il-vous-plaît
bras: arme, désarmer, armé, bras
noir: 
apporter: rapporter, porter, voudrais, conduire
beau: bien, agréable, charmant, magnifiquement, bien, assez, chic, Bien, mignon
sombre: obscurité
tenir: garder, maintenir, capture, poignée, Contrat, conclure, nœud, décennie, mettre-en-fourrière, attendez, aimer, soutenir
Dix: décennie, dixième, Juste
montrer: afficher, effectuer, performance, manifestation, présentation, indiquer, dénoter, un-événement, projection
histoire: mythe, histoire, la-fiction, terrain
commun: général, habituel, routine, En-général, ordinaire, inhabituel, communément, modeste, Ordinaire, irrégulier, conventionnel, typique, normalement, typiquement, mixte, partenaire, associer, agrégat, Globalement, mutuel, d'entreprise
livre: rouleau, la-réserve, livre, cahier-de-texte
électronique: électronique, électron, foudre, électrique, électricité, Electrique
parler: conversation, bavarder, négocier, interaction, interagir, négociation, parler, discours, parlé, discours
Marc: marqueur, trace, sentier, But, mettre-en-évidence, cocher, signe, signal, indication, signal, marque, personnage, étiquette
intérêt: une-fleur, intéressé, préoccupation
écrit: composer, en-train-d'écrire, type, écrit
lit: 
nécessaire: essentiel, important, utile, critique, vital, important, sans-importance, intégral, crucial, important, avoir-besoin, nécessairement, intransitif, intransitif, intransitif
idée: pensée, considération, raisonnement, opinion, notion, remue-méninges
art: artisanat, artistique
vialis-cas: 
frère: enfant-de-mêmes parents, la-soeur
de-temps-en temps: rarement, de-temps-en temps, parfois
ligne: câbler, fil, rangée, voie, conduction, tiret, bande, Impôt, scénario
table: bureau, calendrier, catalogue
Fleuve: oreiller, coussin, flux
œil: nommer, autour
information: message, explication, la-description, bulletin, connaissance, données
soudainement: soudain
étrange: étrangement, surprenant, bizarrement, impair, merveille, formidable, remarquable, extraordinaire, incroyable, incroyable, bizarre, amusant, inconnu, exotique, gênant
profond: profondément, profondeur, extensif, peu-profond, approfondi, détaillé, complet, critique, profond, dans, à-l'intérieur, intérieur, ver
changement: modification, variation, transformation, transformer, mutation, décalage, modifier, modifier, transition, amendement, substitution
sentiment: ressentir, la-sensation, la-perception, impression, émotion, humeur, impressionné, émotif, sensoriel, sentiment, sens, la-passion, conscient, conscience
rencontrer: Obtenez, converger, rencontre, se-conformer, satisfaire, réunion
objectif: objet, avoir-pour-but, objectif, objectif, destination, intention, prévu, motif, cible
content: gai, amusé, plaisir, content-de, joie, bonheur, délice, Enchanté, amusant, Heureusement, chanceux, heureux
sembler: apparence, apparaître, Apparemment
du-sang: saigner, criminel
se-leva: rose
Sud: du-sud, le-midi, midi
du-froid: l'hiver, Bien, froidement
vers-l'avant: plus-loin, plus-loin, devant, vue, avant, Avancée, depuis, chauve-souris, sur, en-avant
position: emplacement, situation, statut, chance, occasion, espace, position,-attitude, posture, lieu, poster, article
en-retard: en-douceur, fin
se-mettre-debout: station, verticale, attitude, position,-attitude, Arrêtez, posture, pose, stalle
supposer: hypothèse, hypothèse, assumer, adopter, présumer, émettre-des-hypothèses, suggérer
fille: Fille, vierge
mien: mon
Couper: l'absence, manque, réduction, carence, diminution, pénurie, Mademoiselle, Coupe, couper-la-parole, côtelette, sabrer, surgir, réduire, brisé, violer
copie: reproduire, réplication, reproduire, transcription, photocopie, cloner, version, ordonnance
mari: homme, époux
six: sexe
rappel-toi: Note, rappel, rappeler, mémoriser
effet: influence, affecter, impression, impact, dominance, efficace, efficacement, efficacité, conséquence, résultat, exposition
tombe: l'automne, cas, situé, crash, chute, panne, effondrement, laissez-tomber, décliner, diminution
mis-à-part: sauf-si, dehors, en-dehors-de, excepté, à-l'écart, sauf, à-côté-de, de-côté, à-part
cheveux: 
passer: par, par, qui-passe, passant-par, près, à-côté-de, consister, diplômé, rouille, traverser, passage, procéder
droits-d'auteur: 
armée: troupes, troupe, hôte, soldat
courir: fuir, drain, fonctionnement, exécuter, fonctionner, conduire, qui-coule, équipement
cheval: fer-à-cheval, à
avenir: la-avenir, plus-tard, après, après
Ouest: occidental
Payer: les-salaires, salaire, le-salaire, poussée, Paiement, rémunérer, frais, Coût
rouge: 
or: 
désir: volition, désireux, appétit, souhait, aspirer, exhorter
joue: danser, pari, Jeu, joue, jouet
maîtriser: Seigneur, primaire, Principal, professeur, dominer, gouverner, M, gentilhomme, de-premier-plan, Monsieur
Bureau: agence, bureau
gouvernement: Etat, rangée
église: 
longueur: Hauteur, altitude, envergure, le-long-de, durée
compagnie: raffermir, corporation, société, Entreprise, d'entreprise, entité, institution, agence, institut, entreprise
papier: feuille, carte, charte
probabilité: possibilité, probabilité, probable, peut-être, improbable, perspective, chance
notamment: Spécial, spécialement, spécifiquement, particulièrement, particulier, exactement, principalement, principalement, principalement, spécifique
ours: porter, supporter, résister, abstention, tolérance, avoir, posséder, offrir
fenêtre: 
une-entente: protocole, règlement, compromis, consensus, traité, accepter, traiter, accord, soumissionner, accord, Contrat, convention, arrangement
beauté: magnifiquement, éclat, esthétique
devoir: responsabilité, la-responsabilité, obligation, responsable, douane, tâche, affectation, dette, devoir, devoir
envoyer: transmettre, soumission, poster, diffuser, email
distance: suppression, gamme, séparation
le-silence: immobilité
le-pied: jambe, arrêt, cuisse, doigt-de-pied, trimestre, marche, en-marchant
sauvage: sauvagement, illégal, féroce, faune
mourir: mort, en-train-de mourir
enregistrer: économie, la-préservation, récupérer, conserver, préservation, mémoriser, boutique, racheter, les-secours, enregistrement
vert: brut, brut
difficulté: embêter, problème, problème, épreuves, difficulté, pétrir, souffrance
sourire: sourire
faux: erreur, Erreur, erroné, mal, maltraiter, faux, faute, échec, défaut, à-tort, gaffe
divers: différent, varié, plusieurs, gamme, diverse, multi, contrairement-à, une-variante, différer, varier, la-variété
dormir: endormi, rêver
quotative-cas: 
début: commencer, démarrer, entreprendre, se-gratter, début, de-bonne-heure, initiale, initiation, début, principe
action: tâche, point, marche, étape, acte, procédure, actif, opération, opérationnel, activer, activiste, bouge-toi, entraine-toi, entraine-toi, fonctionner, stock, rassemblement, exécution, exécuter
visite: accès, entretien, accessible, Voyage, voyage, voyage, tour
suivre: conformité, adhérer, en-suivant, poursuivre, Piste, accompagner
Essai: tentative, tentative, effort, initiative, expérience, tester, échantillon
présence: existence, exister, entité, atout
sucré: bonbons, doux, fade, mignon
riches: beaucoup, abondant, riches
ennemi: 
navire: bateau, voile, flotte, voile, navire, croisière, traversier
condition: pari, pari, Etat, situation, circonstance, statut, fortune, étape, niveau, aptitude, exigence
y-compris: contenir, comprendre, impliquer, appartenir
compris-la-personne: 
secret: mystérieux, mystère, épingle, sous-la-terre, sécréter
precative-humeur: 
poli-registre: 
mal: nuire, méchant, vicieux, mal, mal
Mars: le-défilé, protestation, manifestation, Mars
peu-importe: n'importe-quoi, quel
rester: rester, siéger, régler, survivre, résider, attendez
au-lieu: à-la-place de, plutôt, remplacement, substitution
bleu: Fée
impossible: 
L'école: la-cité-universitaire, échelle
occasion: occasion, un-événement, occurrence, chance, rue, bonne-affaire
marié: mariage, marier, mariage
aliments: repas, régime, plat, nourrir, nutritif
vingt: 
silencieux: calme, tranquille, stabiliser, silencieux, paisible, lent, détendu, doucement
facilement: probable, facilement, assujetti, facile, commodité, mince, légèrement, légèrement, pratique, simple
éventuel-aspect: 
la-langue: linguistique, langue
expression: express, déclaration, phrase, articuler, révélation, exposition, énonciation
semaine: dimanche
salle: porche, le-théâtre, couloir, espace, chambre, salon, salon, rayon, coureur, hall
danger: dangereux, risque, le-respect, menace
propriété: atout, appartenir, la-possession, la-monarchie, possession, fonctionnalité, trait, biens, fortune, richesse
né: la-naissance
tribunal: judiciaire, plat, forum, essai
généralement: habituel, typiquement, général, Globalement, largement, En-général, communément, normalement, largement
gnomique-aspect: 
valeur: mériter, valeur, précieux, validité, mérite
facile: simplicité, simple, pratique, flexible, facile, juste, simplement, plaine, modeste, simplement, simple, tout-droit, ordinaire
arbre: plante, bois, arbre, bois
bataille: lutte, bataille, affrontement, querelle, brouiller
mur: 
cieux: ciel
inchoative-aspect: 
jussif-humeur: 
Ton: pas, mélodie, tonne, tonne, ombre
considérer: le-respect, assumer, présumer, attention, considération, considérer, relation, association, relation, concernant, En-ce-qui concerne, remarque, couverture
attendu: anticipation
mois: lune
de-l'expérience: empirique, expérimental, expérimenté, compétence, zeste, expérience
entièrement: totalement, à-la-perfection, pleinement, complètement, assez, tout-à-fait, absolument, absolu, tout, complètement, équitablement, purement, exactement
Frais: fraîchement, pur, nettoyer, rafraîchi, neuf, novice
Duc: règle, prince
couvert: couvrant, couverture, de, fermé, intérieur
lié: ampleur, limitation, limite, frontière, restriction, limité, connecté, dépendre, lier
l'est: est, depuis, précédent, avant, pré, Orient
pierre: marbre, Roche, gemme
quelque-peu: quelque-chose, n'importe-quoi, certains, assez, plutôt, légèrement, en-partie, en-quelque-sorte
direction: orientation, dimension, tendance, facette, instruction
chaise: siège, fauteuil, tabouret
aider: soutenir, approuver, assistance, aider, support, aide
rendez-vous-amoureux: histoire, rencontre
village: Hamlet, campagne
champ: sphère, domaine, région, territoire, région, zone, secteur, domaine, arène, Stade, espace, la-marge, campagne, camp
autorisation: permettre, oreille, permis, autorisation, abandonner, Licence, Licence, consentement, édition
permissif-humeur: 
Succès: couronné-de-succès, réussir, la-prospérité, exploit, la-victoire, gagner, frapper, gagnant, gagnant
correct: correctement, Corriger, raisonnable, approprier, exacte, précis, droit, exact, précisément, rapidement, fidèlement, avec-raison, correctement, variance, s'adapter, adapté, pratique, adapté, correspondre, éligible, pertinent, parfait, adéquat, de-façon-régulière
colline: Montagne, le-Mont
la-musique: musical
distale-démonstratif: 
après-midi: p.m., le-midi, midi, soir
cri: faire-le-deuil, cri, crier
honneur: honneur, le-respect, dignité, respectable, honorable, honorifique, courtoisie, gloire, taux, prix
Sept: 
privé: personnel, soi, personnellement, soi-, Spécial, confidentialité, spécifique, exclusif
des-nouvelles: message
scène: site, vue, le-contexte, afficher, visuel, étape, vue, perspective, tente
jardin: parc
course: racial, courses, fonctionnement, concours, le-tournoi, soumissionner, race, rencontre
distributif-cas: 
apprendre: faire-des-études, enseigner
politique: politique, politiquement, homme-politique, politique
mensonge: faux
jeter: lancer, jeter, jeter, lancer, format, moule, commencer, cabanon, cesser-de
manger: repas, nourrir, plat, dîner, consommation
plancher: couverture, sol, bas, sol, marche, haut, grand
mauvais: malade, patient, endolori, maladie, faux, mal
original: origine, initialement, préliminaire, initiale, la-synthèse, initialement, originaire-de, véritable, inné, indigène, Principal, primaire, prototype
l'été: chaleur
la-religion: religieux, dette
image: portrait, peinture, image, photographier, photographique, la-photographie, photo, photocopie, dessin, casser, film, illustration, représentation, figue, figure
échapper: fuir
auteur: écrivain, maitresse-d'école, éditeur
brun: gris, gris, bronzage, bronze
déterminé: détermination, décider, déterminer, précis, péremptoire, designer, spécifié, vérifier, stable, certain
douleur: blesser, angoisse, douloureux, douleur, endolori
le-printemps: la-plume, notre, les-notres
siècle: âge
doux: concessif, lisse, finement, soumissionner, avec-douceur, doucement, doux, fade, doux
coin: angle, coin, noyer
produire: production, Générer, productif, fabriquer, fabrication, fabrication
rire: plaisanter
oublier: négliger
Europe: 
huit: huitième
robe: costume, vêtement, robe, peignoir, habillé, uniforme, tenue
terrible: terrible, horrible, terriblement, effrayant, énorme, tragique, alarmant, effrayer, monstrueux, terriblement
souffle: respiratoire, respirer, respiration, exhaler, ego, haleter
sage: raisonnable, sensible, discret, réfléchi, astucieux, intelligent, intelligent
possessif-marqueur: 
Mémoire: mémoriser, référence, Mémorial
moderne: contemporain, sophistiqué, moderniser, à-la-mode, récent, discours
endroit: point, point, heure, emplacement, tache, défaut, pièce, lieu, nulle-part, locaux, lieu, site, locale, Localiser, signe, sol
monter: plante, escalade, truie, grimper, en-haut, Conseil, balade, soulèvement, survenir, augmenter, émergence, croître
briser: roder, frein, recours, salon, interruption, intervalle, écart, briser, briser, Arrêtez, pause, couper-la-parole
cinquante: 
île: 
touche: contact
promesse: commettre, engagement, gage, rendez-vous
commissive-humeur: 
degré: égal, ampleur, qualité, qualité
plan: schème, traiter, programme, programme, initiative, planificateur, proposition, projet, terrain, esquisser, projection, disposition, appartement, dessin, conception
conduite: tendance, comportement, comportement, comportementale
surprise: étonnant, inattendu, accidentel, surprenant
minute: 
coup: tirer, tournage, balle, munition, photographier, photo, coup, coup, coup, jeter, Cadre
pire: mal, pire, rugueux, négatif, mal, terriblement, inférieur, en-haut, en-haut
verre: miroir, cristal, pot, des-lunettes, lunettes
exemple: Exemple, illustration, modèle, modèle, métaphore, prototype, comme, représenter, spécimen, cas, précédent, échantillon, paradigme, par-example
sûr: garantir, sécurité, Sécurité, sans-encombre, confiant, Assurance
docteur: médecin, thérapeute, praticien, médical
complétif-aspect: 
répété: fréquemment, ordinaire, constante, constamment, de-temps-en temps, fréquent, de-façon-régulière, répéter
militaire: troupe, militant
chaleureux: chaud, confortable, chaleur, chaleur, température, chauffage, gramme, moite
boire: boisson
les-questions: 
colère: en-colère, rage, outrage, irriter, dépit
directement: tout-droit, direct, indirect, automatique, simple, immédiat
chapeau: bouchon, casque
chien: 
serviteur: intendant, serveur, Femme-de-ménage
fierté: arrogant, fier, fièrement
foule: se-ruer, bondé, foule, montant, Quantité, population, hôte, pile
entrainer: le-chariot, voiture, wagon, Chariot, chemin-de-fer, rail, éduquer
moral: moralité, moralement, éthique, éthique, moral, spirituel
associé: associer, la-pertinence, corrélatif, associée, concerné, préoccupation, pertinent, le-long-de, connecté, rapporter, allié
Entrer: bûche, entrée, Etat, indiquer, insérer, comprendre
Règle: administration, domination, régime, jugement, verdict, jugement, arbitre, arbitre, gouverner, loi, législation, norme
épée: lame
attaque: invasion, envahir, agression, infraction, agression, infraction, la-grève, début, offensive
la-santé: en-bonne-santé, saluer
paragraphe: verset, clause, gros-morceau, point, attitude, position,-attitude
social: société, socialement
remboursement: répondre, répondre, retour
Pardon: le-regret, pôle, Pardon, excuse, excuses
courage: cueillir, audacieux, confiant, nerf, courage, oser
la-grâce: faveur, faveur, la-miséricorde, la-gentillesse, bienveillance, nom, Pardon
officiel: formel, officiellement, officiellement, officier, employé-de-bureau
fourni: fournir, offre, fournir, introduction, disponible, la-fourniture, disposition, répondre, si
demande: prière, demande, revendication, exiger, exigence, enquête, enquête, rapide, offre, application
coup-d'œil: aperçu, vue, attitude, la-perception, perspective, vue, Regarde
mouvement: mouvement, campagne, sport, croisade, acte, bouge-toi, mobilité, Entreprise, en-déplacement
attendre: attente, anticipation, anticiper, attendez
contraire: avant, opposé, contraire, opposé, de-l'autre-côté, compteur
douze: 
engagé: engagement, occupé, impliqué, participer, occupé
du-vin: grain-de-raisin, alcool, alcoolique
goût: saveur, saveur, délicieux, appât, zeste
fer-à-repasser: acier, métal
distribuer: transmettre, déployer, publier, édition, la-diffusion, circuler, Distribution, allouer, partager, diviser, Divisé, séparer, classer
Commerce: commerce, Entreprise, Commerce, marchandises, Internet, bonne-affaire, transaction, marchande, courses, commercialisation
avantage: Gain, le-profit, avantage, viable, la-bonté, atout, préférence, dominance
vêtements: garde-robe, tissu, vêtement, tenue, vêtement, chute
juge: jugement, jugement, arbitre, arbitre
différence: différentiel, différencier, différent, séparé, distinct, différer, variation, séparément, variabilité, variance, diviser
anxieux: urgence, urgence, concerné, alarmé, inquiet, anxiété, préoccupation, inquiéter, réfléchi, inconfortable, inquiétant, peur, vif, inquiétant, alarmant, enthousiaste, désireux, agité, inquiet
capitaine: 
fini: terminer, fin, fini, prêt
cessation-aspect: 
curieuse: désireux, intéressant, passionnant
étranger: à-l'étranger, extraterrestre, étranger, exotique, inconnu, externe
intensificateur: intensifier
importance: nécessité, la-pertinence, sens, valeur
enfin: au-bout-du compte, finalement, fini, final, ultime, Terminal, finement
facture: acte, manuscrit, compte, calcul
prouver: preuve, confirmer, affirmer, démontrer, témoigner
empêcher: cesser, interdire, détenir, réprimer, restreindre, inhiber, bloque, retenir, dissuader, interdire, éviter, repousser, réprimer, suspendre
cou: gorge
juridique: judiciaire, loi, légitime, Cadre
sec: tige
servez: service, gagner, répondre, offre
perdre: Mademoiselle, égarer
preuve: évident, preuve, guider, indice, annuaire, afficher, témoin
évident-cas: 
progrès: foulée, progression, Développement, progressive, du-développement, avance, procéder, amélioration, soulèvement
bâtiment: construire, la-structure, construction, construction, locaux
chercher: trouve, découvrir, Découverte, quête, détection, recherche, chercher, recherche, enquête, poursuite, enquête, enquête, enquête
triste: déprimé, Malheureusement, misérable, bouleversant, dérangé, remords, déprimant
péché: culpabilité
30: 
honnête: sincère, fidèle, franchement, franc
fermer: Près, fermé, fermeture, de, installer, fermer, pack, empaqueter, parcelle, paquet, forfait, mettre-en-fourrière
banque: banc, étain
le-sort: fortune, la-chance, syntaxique, destination, lot
forêt: jungle
mesure: jauge, la-mesure, peser, mètre, mètre
autrement: sinon
courant: écoulement, clause, actuel, électricité, flux, jet
pain: cuire, truie, sandwich
supplémentaire: en-supplément, de-rechange, de-plus, excès, surplus, plus-loin, addition, supplémentaire, ajouter, annexe
choisir: choix, sélection, sélectionner, sélectif, choisir, élire, composer-un-numéro, vote, examen, préférence
animal: 
zoic-le-genre: 
eventive-humeur: 
même-un-événement marqueur: 
multiplicatif-cas: 
épais: obèse, épais, dense, graisse
créature: organisme, essence
pluie: humide, chute-de-pluie, douche
surface: visage, niveau, avion, région
saint: sacré, net, purement
juillet: 
rapport: détermination, déclaration, rapport, relation, relation, Juste, exposition, essai, exposition, But
côte: brin, plage
dossier: document, bobine, loge, profil, archiver
épaule: arbre, axe, représentation, peigne, bras
surpris: étonné, merveille
royal: impérial, la-monarchie, Royaume, empire, réal, réel
chanson: régler, Piste, en-chantant, poème
confort: facilité, détendu, relaxant, encouragement, commodité, du-repos, le-soulagement
n'importe-qui: n'importe-qui, quelqu'un, Quelqu'un, personne, Tout-le-monde
herbe: foins, cannabis, herbe, pelouse, gramme
dessiner: traînée, tirer, transporter, intéressant, appel, séduisant, se-désister, passionnant, attirer, intéressant, dessin, retirer, soustraire
ouverture: préliminaire, initiale, Découverte, écart, fente, ouvertement
juin: 
poisson: aquarium
capital: chapitre, fonds, atout
Sein: coffre,-poitrine
neige: de-la-glace
éducation: éduquer, cours, éducatif, alphabétisation, formation, entraînement, cultivé, académique
pointu: brillant, féroce, strict, nettement, épicé, pointu, aigu, vif, croustillant
pitié: la-miséricorde, la-compassion, la-sympathie, sympathique, compatissant, terrible, peine, la-plume, malheureux, déplorer, nuire, dommage, remords
frais: frais, dépense, Coût, édition, sortie, charger
la-tienne: votre
million: millionième
fatigué: fatigue, fatigant
tuer: meurtre, meurtre
ombre: ombre
poids: charge, lourd, fortement, peser, pression
Masse: qualité, collectif, Quantité, masse, pluriel, lot, bosse, grappe, foule, infraction, pâte, Pâtes
a-mis-en place: installer, solide, fermement, stable, création, mettre-en-place, titulaire
courageux: audacieux
mince: maigre, diluer, fuselé, étroit, maigre, amende, subtil, finement, mince, mince, raréfié, délicat, jauge
satisfait: heureux, la-satisfaction, contentement, content-de, satisfaire, satisfaisant
vérifier: vérifier, Regarde, regarde, choix, examiner, inspecter, examen, tester, audit, intermédiaire, enquête, enquêter, vérifier, réviser, contrôle
la-vertu: la-gentillesse, vertueux, la-bonté, bienveillance
nationale: nation, la-nationalité, ethnique, national
Divin: sacré
vallée: bassin
Devine: inférence, suspect, présumer, estimation, estimation, la-prévision, prédire, prévoir, spéculer
spéculatif-humeur: hypothétique-humeur
jaune: pâle, ambre, blond
restes: résidu, résiduel, restant, Restes, du-repos
courbé: courbé, courbe, sinueux, tendance, tordu, pente, inclinée, incliner, pliant
boîte: valise, tiroir, fonds, trousse, peut, poubelle
saison: saisonnier, chapitre, station, ère
la-science: scientifique
ennuyer: trou, percer, terne, ennuyeuse, percer, ennuyer, forum
oncle: 
liste: indice, catalogue, le-menu, Inscription
août: 
populaire: prévalence, célèbre, important, populaire
inconnu: inconnu
familier: connaissance, lignée, descendant
familier-registre: 
lecteur: chanteur
approche: portée, accès, technique, tactique, méthodologie, attitude, manière, la-méthode, mode, procédure, approximation, interface
deux-fois: double
intellectuel: dérange, intelligence, mental, intelligent, psychiatrique, penseur, sagesse, spirituel
vraiment: vraiment, en-effet, exactement, actuellement, pratiquement, pratiquement, vrai, sincère, réaliste, à-la-perfection, certainement,-vraiment,-définitivement, bien-sur, assurément, sûrement
prêtre: le-clergé
blessés: blessé, plaie, blesser
chagrin: douleur, tristesse, dépression, déprimé, le-deuil, angoisse
palais: 
battre: défaite, coup-de-poing, gifler, frappe, claquer, le-rythme, surmonter
hein?: 
fou: bête, ruse, tromper, Tricher, stupide, insensé, fou, fou, fou, tromper
bord: bord, la-frange, marginal, intense, frontière, la-marge, Conseil
neuf: neuvième, neuf
éclater: explosion, explosion, exploser, fissuré, boom, convulsion, coup
souffrir: supporter, soutenir
bruit: bruyant, cri, agitation, rugir
Littérature: littéraire
Conseil: conseil, recommander, recommandation, conseiller, consultation, Conseil, pointe
vide: blanc, vacant, tambour, loisir, nul, vide, vide, vain
rang: poster, qualité, exploit, Catégorie, valeur, classe
tempête: 
poche: sac, paquet
imagination: chic, imaginer, hypothèse, fantaisie, la-fiction, imaginaire
phrase: jugement, jugement, proposition, théorème, suggestion, proposition, Châtiment, conviction, phrase, condamner, dénoncer, peine
novembre: 
décembre: 
absence: absent, l'absence, pénurie
remercier: Reconnaissance, reconnaissant, remerciements, Je-vous-remercie
adresse: 
oiseau: vol, avion, jet, aéronef, avion, Compagnie-aérienne
propriétaire: patron, propriétaire
manteau: robe, gaine, couverture, veste, fourrure
préparer: prêt, préparé, organiser, préparation, formuler
rapports: relation, relation, rapport, la-pertinence, rapporter, affaire, Communication, communiquer
fumée: fumeur, le-tabac, brûler
janvier: 
machine: machinerie, moteur, avion, véhicule
contenu: Matériel, des-trucs, se-conformer, satisfaire, contenir, comprendre, consister, impliquer
dents: dent, équipement
honte: disgrâce, honteux, timide, embarrassé, embarrassant, embarras, nu, nu, insulter, outrage
baie: baie, vagin
cerveau: cerveau, moelle
bague: petit, composer-un-numéro, boucle, boucle, pneu, pneu, joint, timbre
phrase-marqueur: 
carré: 
fruit: 
thé: 
Explique: explication, illustrer, express, articuler, déclarer, clarifier, interpréter, commentaire
Bienvenue: salutation, réception, divertir, Hey, salut, saluer
poésie: poème, verset
Acheter: achat, acquérir, offrir, marché
fidèle: malhonnête, fidèle, fidèlement, dévoué, Corriger, fiable
excitation: stimulation, excité, agitation, tension, provoquer, joie, éveil, chasse-d'eau, anxiété
quarante: 
avril: 
gentiment: S'il-vous-plaît, amicale, avec-douceur
octobre: 
amer: épreuves, agonie, angoisse, amèrement, souffrance, douloureux, piquer
esclave: esclavage
en-vrac: indépendant, librement, résoudre, résoudre, mou, vacant, en-liberté
envoyer-des-textos: formulation
crédit: hypothéquer, carte-de-crédit, dette, prêter, emprunter, prêt, prestige, validité, la-crédibilité
quinze: 
cruel: féroce, dure
Joindre: participer, assister, impliqué, embarquer, adhérer, participant, participation, unir, brancher
processus: manipuler, procédure, traiter, opération, essai
la-criminalité: culpabilité, infraction, infraction
poussière: barrage, la-poudre
pratique: fonctionnel, pragmatique, pratiquement, pratique, pratiquement, pratique, appliqué
Couleur: Couleur, peindre, caprice, colorant, pâle, coloré, coloré, chasse-d'eau, terminer
détruire: épave, saper, sabotage, dégrader, démolir, écraser, briser, ruiné, confondre, effacer, nier, destruction
augmentation: procéder, améliorer, le-Mont, augmenter, ajouter, insérer, croissance, agrandir
nez: 
admettre: reconnaissance, concéder, Acceptez, reconnaître, accuser-réception, approuvant, approuver, subvention, prix
hier: demain
hesternal-tendu: 
échouer: échec, infructueux, défaite, revers, incapable, confondre, décevoir
Continue: procéder, continu, persistant, continuation, constamment, persister
porter: porter, porter
aveugle: 
douzaine: Plusieurs
Voler: en-volant, saut, vol, aviation
louange: admiration, admirer, réputation, mérite, féliciter, félicitation, gloire, célébrité
diable: 
au-fur-et à mesur: en-douceur, graduel
sacrifice: victime, proie, victime
exercice: athlétisme, faire-des-exercices, affectation, entraine-toi, entraine-toi, sport, aptitude, répétition
conscience: pronom, conscience
théorie: principe, théoricien, théorème
ministre: 
haine: méchant, dégoûtant, haine, aversion, préjudice, rancune, ressentiment, dégoûté, répugnance, dégoûter
Lac: 
centre: central, centre, station, quartier-général
perdre-connaissance: inconscient, désespoir, désespéré, faible, pâle
rationnel-le-genre: 
prudent: réfléchi, conscient, concentrer, prudent, exact, exacte, précis, détaillé
prendre-plaisir: jouissance, apprécier
culte: rituel
des-biens: produit, article, marchandises, marchandise, des-trucs
la-peau: cuir, absorption, écorce, coquille, peler, fourrure, zeste
toit: terrasse, plafond, couvrant, couverture, couvercle
couronne: 
Château: cage, tour, bloquer
trône: 
attaché: engager, conditionnel, joindre, connecté, dépendant, associer
mile: tendance, pente, maigre, pente, prêt
extrême: maximum, ultime, pôle, polaire, extrémiste, Sérieux, intense, intensif, membre, pointe
prison: prison
gobelet: agresser, bol
membre: organe, adhésion, membre, initié
civil: national, citoyen, civique, civil
partout: tout-au-long de, nulle-part
évident: évident, évidemment, évident, direct, apparent, certainement,-vraiment,-définitivement, précis, clair, clairement, transparent, pas-clair, perceptible
couple: paire, par, double, double, peu, Plusieurs, vapeur
le-volume: bobine, beaucoup, ampleur, montant, relativement, quantitatif, bloque, lot, module, masse, capacité, couverture
coutume: client, optionnel, costume, douane, entraine-toi, habitude, habitué
arc: cambre, oignon, courbe
costume: s'adapter, costume, approprier, accord, correspondre, correspondant-à, cas, poursuite, litige, robe, revendication
viande: la-chair, du-boeuf
lait: laitier, robinet, gelée
végétal-le-genre: 
la-vision: vue, transe, perspicacité, façade, vue, aperçu, perspective, paysage, perspective
peu-fréquent: rarement, à-peine
cousin: relatif
pont: qualité, pont
protéger: la-protection, préservation, garde, bouclier, défendre, préserver, maintenir, conserver, garantir
du-sel: exagéré, exagérer, salé
innocent: 
reine: 
compter: partition, compter, calculer, compter, déception, compte
curiosité: levier
danse: tambour, danser, saut, sauter
hôtel: hébergement, auberge
remplir: 
prisonnier: 
boutique: boutique, stalle, Entreprise, traiter, courses
escaliers: escalier, escalier, échelle, tiroir
mendier: recherche, assumer, plaider
le-sable: 
violent: la-violence, féroce, turbulent, formidable, sévère, fort, intense, vigoureux, sauvagement, intensif
septembre: 
Départ: abandonner, partir, sortie, sortie
se-ruiner: destruction, subversion, dommage, gâcher, catastrophe, débris
compétence: capacité, capable, capacité, efficacité, compétence, artisanat, compétence
bovins: vache
équipement: appareil, dispositif, trousse, équipement, tenue, tacle, Matériel, technique, la-technologie, établissement, fixation
cuisine: cuisine, cuisinière
vendre: vente, semi
la-rapidité: vitesse, rythme, élan, nettement
conclusion: inférence, le-retrait, sortie, implication, résolution, résultat, conséquence, collection, conclure, proposition
l'ordinateur: l'informatique
éternel: toujours, pour-toujours, infini
limité: fini, confiné, confiner, délimité, limité, contraindre
bibliothèque: bibliothèque
base: fondation, base, basé, fondamental, primaire, élémentaire, noyau, de-base, bas
confusion: désordre, le-chaos, agitation, déroutant
glorieux: brillant, charmant, noble
également: De-même, aussi, également
effrayé: peur, effrayé, crainte, effrayer
malheureux: malheureux, malchanceux, misérable
article: essai, article
cuire: cuisine, cuire, bouillir
bande: ceinture, ruban, bande, la-brigade, groupe, bande, bande, zone, brin, bouquet, grappe, voie
désert: désert, déserté
baiser: 
balle: caoutchouc, sphère, canon, balle
bâton: stock, canne, adhérer, bois, bois, chauve-souris, signal
argument: logique, bouge-toi, raisonnement, controverse, discussion, débat, différend, tract
observer: inspecter, examiner, Explorer, enquêter, observation
bénédiction-humeur: 
frappant: exceptionnel, étourdissant, la-grève, considérable, important, substantiel, perceptible, impressionnant, surprenant, étonnant, clair, brillant
coupable: culpabilité, devoir, offenser, délinquant, condamner
pistolet: fusil, arme, canon, tour
police: imposer, superviser
cacher: cacher, sécréter, déguisement
expédition: campagne, conduire, voyage, voyage, voyage, tour
ignorant: ignorance, ignorant, ignorant, insensé, bête, stupide, ridicule
généreux: libéral, hospitalité, bienveillance
nuage: 
déchets: inutile, inutile, refuser, refus, rejet, résidu, Restes, des-déchets
février: 
maladie: maladie, maladie, coronaire, satisfaisant, satisfaisant, syndrome
dépenser: une-fleur, utiliser, dépense, poursuivre, sauter, Mademoiselle
la-source: Ressource, brut, Fontaine
initiative-cas: 
tante: 
retard: remettre-à-plus tard
différé-impératif: 
signalé-évident: 
minuit: le-nord
héros: guerrier, champion
philosophie: philosophique
doigt: doigt-de-pied
confortable: Hé-bien, complètement, correctement, doucement, confortablement, pratique, relaxant, agréable, confortable, pratique
quelque-part: nulle-part
Appuyez: médias, magazine, journal, impression, type, formule
employés: équipage, personnel
récompense: prix, cadeau, prix, prime
faire-des-reproches: faute, défaut, défaut, dette, culpabilité, snober, poursuivre, responsabilité, la-responsabilité
la-misère: épreuves, souffrance, angoisse, misérable, ennui
front: 
un-d: publicité, La-publicité, de-la-publicité, annonce, annonce, publicité, avis, déclaration
l'ange: propriétaires, Fée
singulier-nombre: 
aube: crépuscule
commercial: professionnel, publicité, commerce, Entreprise
pardonner: excuse, Pardon, tolérer, exempter, soulager, rejeter
le-mouton: agneau
la-patience: courage, abstention
ferme: ranch, cultiver, plantation, agricole
référentielle: référence, référer
blé: blé, Corne
clé: liaison, bouton, clé, interrupteur, Principal, vital, important, sensible, majeur, niche, courant-dominant, indice
majorité: beaucoup, la-plupart
la-faiblesse: incapacité
atmosphère: Environnement, ciel, aviation, spatial
soupir: haleter
humanité: Humain
opposition: opposé, s'opposer, opposé, contraste, résister, protestation, contraire, la-résistance, compteur, adversaire, désapprobation, anti-, résistant, anti, objection
disque: disque, tranche, compteur, cylindre, assiette, enregistrement, plateau, conduire
solitaire: en-solo, solitude, séparément, unique, simplement
artiste: interprète, peintre, artiste
Chevalier: cavalier
charme: charismatique, attraction, la-magie, épeler
décision: décider, jugement, verdict, jugement, détermination, résolution, Solution
gouverneur: conservateur, règle
branche: 
disposition: arrangement, configuration, tendance, tendance, disposition, disposition, humeur, calendrier, calendrier
enthousiasme: zèle, chaleur, enthousiaste, zeste, euphorie, la-passion, extase, acclamation
inductif-humeur: inférentielle-humeur, déductif-humeur
Communauté: société, Catégorie, personnes
huile: graisse, carburant, fossile, moelle, thermique, beurre
tuyau: tube, robinet, robinet, caca, canal
impression: édition, pression, impression, axe, moule, impression
Oh: Ya
discours-le-contexte: 
vocatif-cas: 
cabine: chalet, tente, loge
alarme: cloche, alerte, effrayer, terrifier
nerveux: tendu, confus, déranger, dérangé, embarrassé, inquiétant, harceler, bouleversant, neural, inquiet, nerf
permanent: durée, fréquemment, de-façon-régulière, persistant, constante, fixé, stable
couteau: cri, lame
soie: 
mépris: mépriser, haine, aversion, dégoûter, répugnance, snober, insulter, outrage, négligence
enfer: 
séparé: séparé, de-côté, à-l'écart, distinct, différer, séparément, distant, discret, isolement, ostracisés, délimité, séparation
sérieusement: Sérieux, sincèrement, lourd, fortement, nettement, activement
mixte: mélange, combinaison, composite, mélanger, mixte
en-bois: bois, bois
préfère: préférence
avertissement: prudence, prévenir, alerte, Mémorial, avis
admonition-humeur: 
impulsion: inspiration, impulsion, lot, exhorter, élan, poussée
ambition: Déçu, déception, luxure, avide, décourager, ambitieux
nier: refus, rejeter, le-déni, rejet, négation, refuser, nier, décliner, désapprouver, rejeter, interdire, interdire, interdire, contredire
constitution: charte, constitutionnel
instrument: outil, navire, entité, organe, récipient, utilitaire
continu-aspect: 
marée: vague, casser
Université: la-faculté, académie, la-cité-universitaire, université
queue: queue
génération: descendant
chat: 
direct-évident: 
abandonné: la-négligence, abandonner, déserté, cesser-de, abandonner
onze: 
instinct: spontané
caractéristiques: trait, spécialité, personnage, habitude, tendance, comportement, comportement, fonctionnalité, caractérisation, qualitatif, typique
tribu: tronc, tige, charge
inquiet-humeur: 
abri: recours, résidence, règlement, habitat, Résidentiel, la-protection, dortoir, asile
grossier: grossièrement, rugueux, méchant
équitation: balade, cavalier
secouer: remue-méninges
industrie: secteur, fabrication, industriel, industrialiser
métier: professionnel, carrière, occupation, professionnel
lampe: bulbe
café: café
obéit: soumission, se-conformer, écouter
nord: le-nord
infirmière: 
assurer: assurance, mandat, gage, une-garantie, assurer, assurer, vérifier, confirmer, fournir, répondre, bien-sur, convaincre, affirmer, garantir
chaîne: séquence, série, chaîne, prison
enseignement: instruction, éduquer, entraînement
chaussures: chaussure, sandale
cour: code, page, cour
vague: ambiguïté, obscur, ambigu, pas-clair, mystérieux, incertain, indéfini, vague, vacant
ailleurs: autre
appartement: appartement, cercle, compartiment, suite
activité: transaction, fonction
samedi: sabbat
ensoleillement: solaire
veuve: 
élément: aspect, fonctionnalité, article, ingrédient, organe
réflexion: contemplation
organisation: tissu, organisation, organiser, tenue, corporation, utilitaire, agence, entité, système, la-structure, texture, disposition, institution, institut
la-vedette: 
incident: un-événement, occurrence, phénomène, incidence, accident, cas
client: inconnu, visiteur, extraterrestre, étranger, nouveau-venu, client, client, hôte
bar: nu, pub, charge, fret, café, baryum
bouteille: pot
bénir: bénédiction
mélanger: manipuler, mélanger, évoquer, émeute
interne: dans, à-l'intérieur, intérieur, interne, locale, national, intérieur, mental, initié
réparer: fixé, ajuster, réviser, Solution, résoudre, résoudre, remédier, améliorer, redresser, D'accord, OK, constante, stable, regard, Corriger, déterminer, mettre-en-place, identifier, vérifier
dériver: obtenir, acquérir, dérivé, Obtenez, recevoir
creux: plaine, nu, blanc, câble
Province: provincial
civilisation: 
Accrocher: 
choc: coup, revers, traumatisme, choquant, choc
exception: partiel, discrimination, stéréotype, exemption
fatigue: stress, tension, charge, fatigue, effort, intensité
Standard: critère, les-critères, taux, niveau, défaut, norme, fixé, constante, stable, stable, statique, durable, standardiser, modèle
au-volant: conduire, chauffeur, guider, la-gestion, balade
débarrasser: retirer, se-désister, éliminer, élimination, exempter, soulager, acquitter
jurer: assermentation
trésor: bijou
graine: sperme, noix, particule
la-tour: tour
préféré: préféré
récemment: récent, fraîchement, nouvellement
récent-passé-tendu: 
éveillé: conscient, moral, réveiller, alerte
meubles: 
corde: corde, chaîne, sangle
aventure: entreprise, pari
royauté: règne
le-banquet: fête, fête, banquet, jour-férié
décrire: la-description, caractérisation, représenter, représenter, définir
soixante: 
échelle: Cadre, jauge, rapport, échelle, escalier, escalier
cérémonie: rituel, fonction
chasse: chasse, victime, proie, chasse, tournage
chuchotement: murmurer
en-grande-partie: substantiellement, significativement, la-plupart, principalement, principalement, considérablement, largement, principalement
christianisme: 
avocat: mandataire, avocat
détail: propager, se-déployer, extension, expansion, développer, profondément, détaillé
Princesse: 
autel: sanctuaire
toile: réseau, net, la-grille, tissu, Toile, affiche
mauve: magenta
recueillir: collecte, accumuler, rétrécir, composer-un-numéro
élection: choix, élire, sentier, sondage, baleine, sélection, scrutin
conception: notion, concept, concevoir, la-perception, apercevoir, conceptuel, conception, capture, arrêter, capture
ivre: alcoolique
verser: renverser, cabanon, répandre, renverser
ascenseur: ascenseur, élever, soulèvement, augmenter, une-randonnée
geste: signe, signal, symbole, symbolique, attitude, posture
gérer: la-gestion, superviser, manipuler, administration, gouverner, diriger, contrôle
échange: échanger, réciproque, échange, remplacement
précis-article: 
empereur: monarque
éloigné: loin, loin, distant
laid: méchant, dégoûtant
inoffensif: 
rouleau: rouleau, bobine
pouce: douane, pouce
journal: journal, informer, journal
barbe: pointe, menton
larme: arracher
commission: Comité, Conseil
alors-que: Pendant-que, durant
Traversée: traverser, jonction, passage, qui-passe, transition, rayon
indépendance: indépendant, liberté, en-liberté, liberté, autonomie
odeur: puanteur, du-parfum
dix-huit: 
historique: historiquement, histoire, historien
brut: le-total, agrégat, sale, brut, brut
racine: tige, fraîchement
boue: sol, vase, argile, saleté, une-fleur
la-mariée: grand-mère
voile: rideau, voile, voile
le-théâtre: le-théâtre
comparaison: comparer, comparatif, corrélation, rapport, affrontement
rival: adversaire, dissident, compétition, compétitif, rivaliser
équilibre: équilibre, également, égalité, horizontal, proportionnel, par, budget
entraîneur: entraîneur, praticien, tuteur, mentor
humour: humour, humoristique, humeur, comédie
roman: la-fiction, neuf, nouvellement
vengeance: rancune
jaloux: jalousie, envie
la-roue: bicyclette, cercle
brûlé: brûler, évasée
flash: foudre, lueur, briller
Créer: création, construire, construction, constructif, faire, fabriquer, composer, forger, Générer
conflit: choc, lutte, affrontement, contraste, crash, impact
malédiction: 
imprecatory-humeur: 
sans-défense: misérable
positif: positivement
club: chauve-souris, bûche
inonder: 
grain: céréale, blé
indifférence: apathie, négligent, négligence
horizon: 
présumé-humeur: hypothétique-humeur
raide: élévation, inclinée
harmonie: compromis, régler
tonnerre: 
enfance: 
le-genou: tour
logiciel: application, répertoire
blessure: blesser, nuire, dommage, blesser, plaie, traumatisme, blessé, violation
le-reçu: recevoir, entrée, réception, admission, acceptation, bon, adoption
activer: capable, compétent, activer, permettre, habiliter, porter, imposer, laisser, autoriser
protase: 
glisser: glissant, diapositive, vol-plané
révolution: révolutionnaire, coup, rotation, révolte, la-rébellion
fermier: paysan
accident-vasculaire-cérébral: coup, coup, se-ruer, brouiller
Plate-forme: étape, forum, fondation
Messager: déléguer, ambassadeur, diplomate
privilège: privilégié, préférence, quota, franchise, offre, Concession
organisé: institution, organiser, institut, arrangement, organiser
élève: élève, savant, étudiant
la-grotte: 
tradition: traditionnel, traditionnellement, douane, abandoner
la-tragédie: épidémie, tristesse
adieu: Au-Revoir, adieu
la-critique: critiquer, la-critique, la-revue
coton: la-laine
hôpital: asile
location: aller, louer, Impôt, hommage, bail, employer, engager, loué, charte
gaz: 
inévitable: inévitablement
mortel: 
feuille: feuille, lame
publication: publier, édition, impression, proclamer, diffuser, Libération, sortie, la-diffusion, édition, annoncer
hostile: hostile, hostilité
Traduction: Traduire, Traduire, interprétation, épidémie, transfert
funérailles: enterrement, le-cimetière
farine: la-poudre, pâte, exact, exacte, précis, repas
correspondance: correspondre, contact, Communication, communicatif
romantique: 
cabane: chalet, loge
proposer: pose, offre, mouvement, proposition, proposition, suggérer, recommander, suggestion, offre, désigner
mimétique: 
dollar: 
la-lumière-du jour: 
seize: 
Assemblée: réunion, conférence, congrès, configuration
colonie: 
aile: quartier, suite
Lion: 
Culture: culturel
colonne: tableau, couche, pôle, passage
ruse: rusé, ruse, habile
comédie-dramatique: faire-semblant, dramatique
blague: plaisanter, sarcasme
brouillard: brouillard
médicament: drogue, remédier, pulvérisation, ordonnance
quatorze: 
acide: acide, acide
à-savoir: quelconque, c'est-à-dire., particulier
Revenu: dentelle
évêque: 
Orange: 
bain: salle-de-bain, douche, baignoire
primitif: de-bonne-heure, initiale
panier: poubelle, sac
un-secrétaire: 
paille: foins
Je-suis-patient: désireux
salut: sécurité, libération, salut
hodiernal-tendu: 
avoir-l'intention: prévu, intention, intéressé, vif, motif, réticent, consacrer, consacrer
vapeur: vapeur
poison: toxique, toxique, herbicide
Talent: éclat, talentueux, qualification, capacité, répertoire
climat: Météo
efficace: valide, efficacement, efficace, efficacité, influent, utile, viable
distinguer: différencier, établir-une-discrimination, discrimination, différenciation, allouer, séparer, rejeter, exclure, sécréter
lavage: la-lessive
confession: accuser-réception, credo, reconnaissance
absurdité: ordures, déraisonnable, incongru
charbon: carbone
canoë: 
temporaire: intervalle, durée, temporel, accidentel, Pendant-que
delimitative-aspect: 
OS: jambe
Lundi: 
Mardi: troisième
Mercredi: Quatrième
fédéral: fédération, central
souhaitable: séduisant, favorable
représentant: représenter, nom, déléguer, mandataire, adjoint, porte-parole
lin: lin, sous-vêtements
lavabo: noyer, bassin, zinc
neveu: la-nièce, petit-fils, petit-enfant
sanglant: effusion-de-sang, saigner
siège: entourer, siège
estomac: ventre, abdomen, abdominal, matrice
laiton: bronze, cuivre, riz
sommet: pic, haut, pointe
cinquième: cinq
bon-marché: à-bon-marché, bas
exclusif-la-personne: 
s'emparer-de: tacle, confiner, détenir, réservation, arracher, occupé, occuper, mettre-en-fourrière, saisir, saisir
clôture: haie
statue: sculpture
artillerie: canon
embrasse: absorber, se-pelotonner
environnant: autour, quartier, voisin, voisin, quartier, périphérique, alentours, adjacent, juste-à-côté
strictement: strict, cohérent, avec-précision, serré, sévère, assurément, absolument, certainement,-vraiment,-définitivement, fermement, dur
cerf: 
buisson: 
chemin-de-fer: chemin-de-fer, rail
décharge: libération, décharger, Libération, renoncer, expulser
héritier: hériter
chêne: 
désagréable: délice, plaisant, inquiet, agacé, bouleversant, méchant, inconfortable
invention: inventer, Découverte, innovation
piano: 
persuader: convaincre, célébrer, commémorer
invisible: mystérieux
bien-connu: célèbre, célèbre, important
cruauté: 
tentation: 
télique-aspect: 
économique: économie, économiquement, économiste, financier
international: mondial, multinational
interférer: ingérence, intervention, intervenir, déranger, embêter, inquiétant, couper-la-parole, ennuyer, irriter, harceler, choc
philosophe: philosophique
élégant: à-la-mode, délicat
aide-sociale: bienveillance, la-prospérité, disposition
faire-de-la pêche: 
voler: vol, voler, vol, swipe
lèvre: bec, oral, bord
se-retirer: la-retraite, retraité, retraité, battre-en-retraite, du-repos, loisir, se-désister, démissionner
étendue: redresser, se-déployer, tract, trait, pièce, passage, fragment, gros-morceau
Galerie: collection
parallèle: aux-côtés-de, compatible, associer, affixe
atélique-aspect: 
continent: continental
prohibitif-humeur: prohibitif-humeur
cravate: cravate, aigle
cellule: essence, noyau, cage, version, mobile, portable, téléphone-portable
œuf: testicule
artificiel: synthétique
pendant-ce-temps: simultanément
crise: marasme, jugement, jugement, urgence
poli: courtoisie, cultivé
déjeuner: déjeuner, dîner
pin: mâchoire
pousser: écraser, conduire, encourager, promouvoir, poussée, pression
alliance: union, ligue, coalition, combiner, Partenariat
taille: hanche, la-vie, vivant, milieu, milieu, milieu-
miracle: merveille
marin: 
pureté: chasteté
république: la-démocratie
téléphone: téléphone, mobile
fouet: 
chemise: T-shirt
présenter: introduction, présentation, mettre-en-place, lancer, rendre, disposition, recommander, renvoi, injecter, livrer, livraison, représenter, représenter
canapé: fauteuil
balayage: essuyer, râteau, balayage
voleur: patron
conserver: préserver, la-réserve, réservation, restaurer, garder, retenir, détenir, résister, engager, la-préservation, soutenir, conserver, maintenir, adhérer
canal: canal
personnalité: personnage
réforme: amélioration, correction, évolution, modifier
menaçant: menace, menacer, dangereux, effrayant
paume: érable
des-enceintes: porte-parole
au-seuil: barrière
induire: hall, exhorter, cause, prévenir, exciter, pose, conduire, tenter, évoquer
lance: de-rechange
soigné: bien-rangé, nettoyer, tendu
session: réunion, conférence
torture: souffrance
humide: saleté, humide, qui-coule, moite
crête: haut, tresser, empiler, peigne
voyageur: visiteur, voyageur, touristique, passager
moulin: usine, fabrication, plante
carte: carte, diagramme, graphique, aller, billet
collier: entourer
remplacer: remplacement, déplacer, de-rechange, alternative, remplacer, substitution, déplacement, modifier, varier, modifier, sous
délibérément: intentionnel, délibérer, au-courant, conscient, téléologique
bière: pinte
en-velours: 
la-gravité: attraction, écraser
sermon: prêcher
abuser-de: erroné, à-tort
troupeau: groupe, troupeau, lot, essaim
treize: 
justifier: mandat, plaider, avocat, justification, justifiée
Vendredi: argent, Vénus
brosse: peigne
Télécharger: 
crème: crème-glacée
falaise: Roche, bord
jury: 
monstre: géant, monstrueux
congelé: gel
pot: la-poêle, pot, récipient
penny: cent
insister: bruyant, poussée, affirmer, souligner, mettre-en-relief, persister, insistance, exiger, Soutenir
pomme: 
discuter: discussion, négocier, Soutenir
arrière-plan: 
transcrire: adapter, récrire
périodique: ordinaire, cyclique
Divertissement: récréation, artiste, loisir, divertissant, divertir, amusant, Loisir
virus: 
puéril: soprano
réfléchir: contemplation, méditation, méditer, illustrer, représenter
convertir: modifier, transformer, interrupteur, mutation
contour: profil, contour, résumé, esquisser, exposer, aperçu, Brouillon
opéra: 
approbation: approuvant, désapprobateur, consentement, acceptation, affirmation, approuver, approuver, adoption, applaudissements
trahir: faire-apparaître, tromper, décevoir
punir: condamner
coude: support
attachement: annexe, connexion, pièce, lien, connecteur
réparation: restauration, amélioration, reconstruire, correction
méfiant: soupçon, suspect
soixante-dix: 
écriture: Bible, scénario
fosse: trou, les-fouilles, piscine
trouble: le-chaos, anarchie, troubles, perturbation, désordre, bouleversant, ingérence, embarras
binaire: dyadique
une-abbaye: monastère
flèche: 
avoir-tendance: assujetti, En-général, normalement, typiquement
élaborer: détaillé, définir, clarifier, développer, compliqué, rusé, faire-des-exercices
fidélité: dévoué, fidèle, confiance, fidèlement, franchement, méfiance, la-crédibilité, foi, croyance
pièce-de-monnaie: devise
trembler: frisson
exilé: tirer, à-l'étranger
mécanique: machinerie, mécanicien, ingénieur
piège: poignée, condamner
gâteau: tarte, biscuit, pâte
Monsieur: M, Monsieur, Seigneur, gentilhomme
hésiter: frappe, hanter, la-fréquence, flotter
dix-sept: 
miel: 
enjeu: pari, proportion, coin, pile, partager, fraction, contribution
bande-de-roulement: bouge-toi, ruse, marche, en-marchant, pédale, marche, foulée, échelon
brique: tuile
quatre-vingts: 
malheureusement: malheureux, malchanceux, Malheureusement
consulter: consultation, référer
légende: mythe
récolte: surgir
promotion: élever, promouvoir, introduction, présentation, publicité
poêle: cuisinière, dalle, four
rebelle: révolte, la-rébellion
démodé: ancien
se-gonfler: gonfler, gonflé, inflation, gonflement, agrandir
marécage: le-marais
pansement: la-sauce, bandage
ascétique: ermite
gérante: intendant, chef, patron, administrateur, directeur, modérateur, guide, exécutif
Chorus: conduire, équipe
rationnel: justifiée, logique, logique, déraisonnable, sensible, raisonnablement, raisonnable
En-traitement: 
loup: 
tapis: couverture
antiquité: 
fertile: 
sifflet: flûte
du-fromage: 
mordre: côtelette, tailler, piquer
Invitez: invitation
Cathédrale: temple
port: port
errer: promenade, émigrer, une-randonnée
cultures: surgir
marine: Marin, flotte
masque: façade, ver
crayon: Stylo
légume: végétarien
exposition: exposition, offre, afficher, présentation, symptôme, exposition
pantalon: pantalon, un-pantalon
la-corruption: scandale, la-pollution
cabinet: placard, placard, garde-robe, toilette
le-potage: 
chirurgien: chirurgie, chirurgical, opération
allocation: remplacement, remplacer, compensation, apposition, allocation, annexe
espion: 
téméraire: négligent, désordonné
potins: rumeur, rumeur
jeton: 
abstrait: résumé, programme
Jeudi: 
circulation: circulation, transport, le-transport
architecture: 
fissure: fente, fissuré, partir, cesser-de, fracture
ornement: décoration, décoratif, décorer, bijoux, réduire
inverser: contraire, inverse, interrupteur, inverser, négatif, à-l'envers, arrière
amuser: divertir, divertissant, amusé
la-récupération: restauration, les-secours, amélioration, la-relance, récupérer, restaurer, reconstruire
chaussée: freiner, pas, le-goudron, vase, couverture
décisif: crucial, vital, déterminer, décider, péremptoire
négatif: négatif
Festival: concert
réduire: réduction, diminution, facilité, soulager, minimiser, dégrader, sabrer, réduire, soustraire, confiner, restreindre
trahison: 
chasseur: 
serpent: reptile
la-batterie: 
la-cire: bougie
détective: enquêteur
une-analyse: analyser, recherche, faire-des-études, examiner, inspecter, exploration, résolution, panne, panne
Accentuation: catégorique, pression, souligner, mettre-en-relief, souligné, accent, affirmation, attention
baignade: la-natation
enveloppe: circonstance, adverbe, gaine
quiconque: qui, quelqu'un, qui, n'importe-qui
cigarette: fumeur, le-tabac
moteur: automobile, moteur, motif, moto
bénévole: consacrer, volontaire
réaction: réactif, réponse, répondre, réagir, retour-d'information
bagages: bagage, fret, tronc, valise
sourd: 
jus: extrait
humilité: simplicité, modeste
ministère: 
sexuel: sexe, sexualité
diamètre: 
hache: 
diamant: 
alterner: de-rechange, alternative, remplacer, option, adjoint, remplacement, transplantation
faire-écho: 
retenue: retenir, freiner, limitation, restriction, contrainte
identité: identifier, identification, symbolique
écran: afficher, rideau
paresseux: pourri
momentane-aspect: 
compact: accord, solide, dense
dérive: opération, déviation, tendance, tendance
disparaître: disparu
rayon: faisceau, rayon, rayon
encre: 
massif: grand, grandiose, énorme, énorme, énorme, grand, énormément
cave: 
mémorable: important
éblouissement: lueur, briller, éclat
sénat: parlement
cercueil: 
le-pardon: 
avaler: siroter
gâter: poursuivre, satisfaire
balançoire: 
pré: pâturage, pré, pelouse
complexe: compliqué, compliquer, sophistiqué, composé, rusé
démission: démissionner, la-retraite
humble-registre: 
conspiration: terrain
poivre: 
poney: 
candidat: demandeur
Renard: 
la-cheminée: cheminée, empiler
juridiction: autorité, jugement, jugement, compétence
agriculture: agriculture, agricole
précision: précision, chasteté, avec-précision, correctement, véracité
ancien-décédé: 
démocratique: 
bourgeon: bouton, germer
couverture: plafond, couverture, couverture, couverture
saluer: occupé, saluer
cochon: truie
en-forme-de: figure, forme, figue, facette
ivoire: 
classique: classique, traditionnel
observateur: superviseur, visiteur
l'éléphant: 
ongles: clouer
abeille: 
enterrer: enterrement, Intégrer
acteur: actrice, interprète, demandeur
transpiration: 
polonais: dialecte
illusion: fraude
incertitude: incertain, ambiguïté
secondaire: mineur, moyen, moyen, modérer, courant-dominant, milieu-
plier: pliant
rural: provincial, campagne, villageois
gémissement: 
ressembler: similaire, similarité, rappeler
citation: extrait, devis, fin-de-citation, prêter, emprunter, prêt
sac: rejeter, congédiement, sac
ennui: perturbation, ingérence, interruption, épreuves, ennui, embêter
aiguille: injection, seringue, style, épingle
contrôlée: contrôle
poulet: poule
cohérent: persistant, compatible, béton, implicite, approprier, niche, pertinent, cohérent, séquentiel, équilibré, stable
baril: seau
habituel-aspect: 
expert: spécialiste, expérimenté, Spécial, spécifique
impressionner: affecter, impression, attirer
olive: 
van: soupape
obstacle: couper-la-parole, contrainte, handicap, barrière, revers
hocher-la-tête: 
favoriser: cultiver, épinards, promouvoir, faciliter, nourrir, faveur, faveur
définition: commentaire, identification, la-description, détermination
anniversaire: anniversaire
marteau: 
parfumé: 
répétition: lourd, destination, répéter, reproduire, répétition
banal: petit, sans-importance
coup-de-pied: frapper, bosse, au-football, calcium, football, coup
creuser: creuser, percer, les-fouilles
animal-de-compagnie: 
crâne: 
corps-législatif: parlement, législatif, législation
talon: saut
froncer-les-sourcils: 
brevet: 
milliard: 
chimique: chimie, produits-chimiques, chimiste
pilote: expérience, expérimental
imiter: simuler, simulation, reproduire, reproduire
jupe: Roche
exceptionnellement: inhabituel, anormal, impair, remarquable, extraordinaire, incroyable, irrégulier, phénoménal, incroyablement, extrêmement, bizarrement
hebdomadaire: 
technique: technique, la-technologie, techniquement, technologie
végétation: 
corbeau: tour
lever-du-soleil: 
durée-de-vie: la-vie, survie, mode-de-vie, vivant
contribuer: contribution, faire-un-don, Partenariat, promouvoir, faciliter
crochet: rapporter, brancher, corrélatif, support
tigre: 
pénétrer: percer, par, influent
manche: bras
Autoroute: route
milice: 
fossé: tranchée, arbre
intégrité: 
dix-neuf: 
organique: 
théologie: 
flotte: bateau, flotter, flotte
sorcière: 
ennuyé: ennuyeuse, ennui
diplomatique: diplomate
studio: étiquette, atelier, faire-des-études
dépasser: agression, râpé, surmonter, traverser
Champagne: 
inspirer: encourager, inspiration, encourageant, inhaler
bannière: drapeau, affiche, billet
divorce: divorcé
boulon: foudre, clouer, torsion, vis
veine: nerf
passif: public, désactivée
mousse: bulle
gravier: 
tablier: tour
planète: 
étagère: grille, placard
ventilateur: 
tropical: 
phase: photographique, étape, point-final, construction, marche
arbitraire: spontané
prononcer: prononciation, accent, énonciation, prononcer
le-mercure: 
se-glisser: crawl, escalade, agneau
suicide: 
journaliste: journaliste
priver: privation, révoquer, exclure, soustraire
qualifié: habile, efficace, capable, talentueux, expérimenté, qualifié, astucieux
balcon: terrasse, porche
fourchette: 
employé: ouvrier, ouvrier, travailler, facteur, dépendant, employé-de-bureau
employeur: patron
largeur: largement, la-fourniture, large, semi
irrité: agacé, excité, irriter, provoquer, stimulation
accuser: dénoncer
Pension: la-retraite, syntaxe
verbe: acte, réagir
singe: 
acceptable: Acceptez, acceptation, plausible
Signature: 
orthodoxe: conservateur
ironie: plaisanter, torsion
garderie: plantation
réluctance: aversion
importer: introduction
torche: 
grammaire: grammatical
dépôt: accumuler
colonial: 
yacht: traversier, bateau
consécutif: conséquence, épisode, important, considérable, de-premier-plan, important, considérablement, important, substantiel, significatif
dôme: 
épaisseur: 
tête-de-mule: péremptoire
muscle: 
ordre-de-grandeur: Taille, masse, amplitude, jauge, Quantité
frotter: 
lâche: 
harnais: unir, fusionner, unifier, utiliser, ceinture
pain-grillé: Goûter
une-souris: rat
syllabe: 
tapoter: taper, frappe
dialogue: communiquer, conversation
neutre: neutre
diligence: zèle, garde
contradiction: contradictoire, controverse, ambigu, déroutant, controversé, ambiguïté, paradoxe, contredire, variance, objection
accomplir: prendre-conscience-de, portée, arriver
chèvre: 
fleurir: la-prospérité, prospérer, boom, bijou, gemme
imposer: obliger, imposer, déterminer
anonyme: 
formel-registre: 
veau: se-dépêcher
Manuel: guider, ligne-directrice, marque, leadership, cahier-de-texte, instruction, guide, superviseur
faire-fondre: évaporer, dégel, la-fusion
effacer: effacer, dissoudre, annuler, retirer, exclure, abolir, éliminer, élimination
parapluie: parachute
botte: chaussure, tronc
minéral: iode, nutritif, métal
trêve: -feu
canard: 
Planification: 
du-savon: 
poupée: bébé, jouet
squelette: 
villa: Fée
couture: point, Coudre
réconcilier: médiat, unir, unifier
bouilloire: 
mature: adulte
lapin: 
conducteur: échelle, surveillant-général, chauffeur, guide
dépendance: dépendre, dépendance, dépendant, intoxiqué, affinité, attitude
joueur: interprète
insecte: ravageurs
restaurant: 
chouette: 
radical: militant, extrémiste, progressive
résident: habitant, originaire-de, national, indigène
dragon: cerf-volant
auditif-évident: 
assoiffé: 
traîner: prolongé
calcul: calculer, calcul, l'informatique, calcul, compter, compte, recensement
règlement: censure, contrôle, contrainte, restriction, règlement
maire: 
minorité: 
acquisition: obtenir, Gain, acquérir, accès, disponibilité
ancien-combattant: supérieur
orchestre: 
Bacon: 
désavantage: perte, privation, négatif, défaut, handicap
en-tissu: tissu, vêtement, serviette, Toile, tissu
musicien: compositeur, musical
mentalement: spirituel, mental, moral, mana, subjectif
conjonction: coopérer, connexion, composé, association, associer, combiner, cohérent, aux-côtés-de, continuité, linker
inadéquat: manque, insuffisant, carence, misérable, inférieur, gênant, ample, malheureux, incongru, inapproprié
architecte: 
citron: 
la-toux: tousser
mal-de-tête: 
locataire: planificateur
la-fertilité: reproduction
guérir: guérir, améliorer, améliorer, amélioration, traiter
quatre-vingt-dix: 
aléatoire: au-hasard, randomiser, accidentel
cuillère: seau
ballon: 
craie: plâtre
inférence-évident: 
éditeur: éditeur
le-vinaigre: 
cendre: gris, gris
explétif: assermentation
relancer: la-relance
sensible: vulnérable, sensible, sensible, émotif, assujetti
tunnel: métro
casse-tête: embrouiller, déroutant
mécanisme: procédure, routine, systématique, machinerie
mathématiques: les-maths, mathématique
fondu: 
foie: 
sublative-cas: 
tremper: se-plonger, Intégrer, laissez-tomber, chute, incidence, pente, inclinaison, inclinée, pente, tremper
unité: unité, entité, module, bec, singulier
monopole: exclusif
jeux-d'argent: pari, Jeu, rencontre, autorisation, jouet
sous-marin: sous-l'eau
séisme: convulsion
laboratoire: laboratoire
liège: champignon, fongus, bouchon
soi-contrôle: 
Bouddha: 
tricoter: tricot, tisser, poussée, tricoté, nœud, nœud, tresser
ambassade: 
le-plus-éloigné: 
déclaratif-humeur: 
stimulus: encouragement, motivation, recette, motivation, motif
le-chocolat: bonbons
coïncidence: chance, combinaison, malheureux, au-hasard, accidentel, rencontre
gant: 
s'agenouiller: 
géographie: 
investissement: investir, entreprise
verbal: parlé, oral, insultant
analogie: égalité, similarité, affinité, parenté, rapport
laïque: allonger
faucon: aigle
psychologie: 
fixer: rapporter, lier, brancher, bandage, arrêter, joindre
ferraille: annuler, ordures, des-déchets, fragment
rôle: poulie, partager, stock, participant
dose: Quantité
saumon: 
pudding: 
magnétique: séduisant
pompe: bombe
oxygène: 
certificat: 
médaille: 
rhétorique: 
gratter: se-gratter, pâturer
rame: pelle, ailette
lunette-astronomique: microscope
Collier: défaite, pâte
orthographe: épeler
whisky: 
saule: pâturage
chameau: 
amateur: 
Sortie: exporter, sortie, émergence, sortie
biographie: 
âne: 
mensuel: 
ignorer: la-négligence, négliger, rejeter, ignorance
vacances: abandonner, jour-férié, récréation, du-repos
clic: clique, casser
ovale: 
élastique: caoutchouc, flexible
dictionnaire: lexical, vocabulaire
jambon: cuisse, fesse
arc-en-ciel: 
consommer: consommation, utiliser, déployer
cracher: camarade, langue
réservoir: réservoir, récipient, T.V.A
collègue: coopérative, bonhomme, camarade, associer
papillon: 
graphique: diagramme, graphique, graphique, graphique, calendrier, schème
jumelle: double, double
de-façon-autonome: indépendant, en-liberté, à-l'écart
bambou: 
revendeur: détaillant, le-vendeur, vendeur, marchande
accumulation: accumuler, collection, concentration
inspecteur: auditeur, surveillant-général
morceau: fragment, tranche, bit
cauchemar: rêver
confiture: gelée
musée: 
alphabet: alphabétique
dispersion: déployer, propager
raid: occupation, invasion, agression, offensive, début, dominant, bannir
divulguer: annoncer, faire-apparaître, détection, exposer, annuler, publier, découvrir
pourrir: se-désintégrer, détériorer
agressif: déranger, désordre, occupation, agression, offensive, péremptoire
friction: 
jetée: 
Araign?-e: 
pomme-de-terre: 
révision: ajuster, amendement, réviser, correction, modifier, la-revue, audit
avidité: avide
prématuré: de-bonne-heure, bosse
multiplier: frapper, race, bosse
tourner: faire-tourner, rotation, spirale, fil, torsion
statistiques: statistique, figure, bavarder
calendrier: calendrier, calendrier, journal, vue
nomination: désigner, rendez-vous, sélection, engagement
billion: 
grenier: Vent
affirmative-humeur: 
applications: 
nominal: 
insatisfaction: 
infection: infecter, infecté, transition, transmission, infectieux
lanceur: pot
hausser-les-épaules: tic
pionnier: majeur, avant-garde
omission: défaut, gaffe, carence, négligence, la-négligence, élimination
chou: 
athlétique: athlétisme, mathématique, athlète
ivresse: du-sucre
idiophone: 
levier: levier
sénateur: 
iris: 
fourmi: 
punaise: 
Enceinte: maternel
précipité: précipitation, sédiment, vitesse, urgent, accélérer
cheville: 
classification: Trier, classer, classificateur
variable: varier
emballage: pack, parcelle, paquet, forfait, bobine, emballage, couverture, couvrant
bouclé: boucle, lancer, bobine, rouleau, hélix
soufre: soufre, brisé
dicter: 
émerger: apparaître, apparence, survenir, émergence, cesser-de
grenouille: 
excessif-cas: 
éponge: fongus, champignon
agaçant: bouleversant, déranger, embêter, agitation, ennuyer, ennuyeuse, délicat, inquiétant
écureuil: 
moudre: demi, semi
irréel-humeur: 
volcan: 
à-l'intérieur: intérieur, à-l'intérieur, dans, locaux
exploit: utiliser, absorber, exploit, Explorer
géologique: 
le-passeport: 
immoral: vicieux, pourri
biscuit: biscuit
collaboration: coopérer, Partenariat, l'intégration, aider
tablette: balle, pilule, dalle
relaxation: mou, détendu, loisir, relaxer, relaxant, récréation
atome: atomique, particule, individuel
le-sida: aide, le-soulagement, auxiliaire
pyramide: 
cycle: cercle, circulation, la-fréquence, rotation, faire-tourner, vélo, bicyclette
sieste: 
illicite: illégal
patte: griffe, doigt-de-pied
la-timidité: timide, contraction
éclipse: obscur
luth: incliner
balai: 
panneau: assiette, dalle, peinture, Conseil, groupe, Comité
astronomie: 
labyrinthe: 
Bourse-d'études: parrainage
tortue: 
conseiller: mentor, conseiller
fibre: fibre, empaqueter
cricket: 
Pigeon: 
adaptation: adapter, fixation, conformité, modification, ajuster
triangle: 
trésorier: 
hydrogène: 
fragile: délicat, croustillant
imprimante: 
étranglement: 
chronique: résistant
chape: rencontre, adapter, affronter, offset, surmonter, tacle, contrastive, manipuler
dilemme: 
ingénierie: technique, techniquement
Camera: chambre
s'excuser: excuses, Pardon
lécher: 
danseur: 
migration: émigrer, immigration
tennis: 
colonne-vertébrale: 
frire: 
métier-à-tisser: fermé, fermeture
coup-de-couteau: piquer, percer, saisir, tentative, tentative
mot-de-passe: signal, signal, slogan
hémisphère: pointu, pointe
stratégie: stratégique
quartz: 
les-ciseaux: tirer, traînée
patrouille: 
glacier: 
à-mi-chemin: demi, en-partie, semi, milieu, milieu
mémorandum: traité, Contrat, convention, accord, mandat
cône: fuselé
symétrie: 
fabricant: productif, producteur, constructif
défendeur: avocat
mosquée: 
échecs: 
péage: charger, frais, victime, figure, complication
cerise: 
répandu: extensif, largement, propager, large, large
trébucher: chute
un-camion: camion, fret, cargo
moutarde: 
pour-cent: pour-cent, cent
enchères: vente
tamis: 
instable: instable, instabilité, incertain, inquiet
aimant: 
sucer: absorber, tremper
Islam: 
la-pointe-des pieds: doigt-de-pied, prêt, prêt
membrane: 
se-raser: 
guitare: 
brillant: brillant, un-m., brillant
orme: 
monter-en-flèche: une-randonnée, flotter, gorge, vol
pronom-marqueur: 
agrafe: agrafe, support, essentiel, fondamental, de-base, Principal, majeur, ultime, primaire
pimenter: zeste
caution: liaison, assurance, gage, une-garantie
transporteur: vecteur, demandeur, porter
vibration: résonance
taquiner: tenter, ennuyer, irriter, fasciner
charrue: résoudre, houe, détourner
physiologique: physique
gouttière: drain
comète: délinquant
médiéval: milieu
moineau: 
compenser: rémunérer, compensation, offset, racheter, maquillage, maquillage
Plastique: 
note-de-bas de page: 
orbite: classe, la-salle-de classe, trajectoire
frugal: modeste
golf: 
zéro: nul
puce: pièce, fragment, tranche, gros-morceau
opprimer: réprimer, réprimer, déprimer, submerger
bâillement: évaporer
inégalité: 
môle: sésame, argile
poterie: 
femme-au-foyer: 
seigle: 
désobéir: violer
tolérant: tolérance
embryon: pneu, pneu, fœtal, fœtus, noyau
mineur: mineur
applaudir: apprécier, applaudissements, taper
levure: enzyme, pâte
prime: prime, prix, prix
prune: 
faillite: échec
irrigation: 
menthe: bonbons
capitaliste: capitalisme
élasticité: la-flexibilité
requin: 
recruter: ruse, novice
espace-de-rangement: préserver, conserver, boutique, économie
le-réalisme: 
gingembre: 
ambulance: 
comparable: proportionnel, similaire
portefeuille: portefeuille
grimace: agresser, sourire, frétiller
scientifique: scientifique, savant, chercheur, enquêteur
intestin: intestins, intestin
équanimité: 
radio: radium
hors-de-propos: contradictoire, inapproprié, incongru, sans-importance
haricot: noix, pois, cacahuète, céréale
informel: 
petite-fille: petit-fils, petit-enfant, la-nièce, descendant
désaccord: objection, débat, différend, être-en-désaccord
bifteck: côtelette
azote: 
le-rasoir: 
contrastant: contraste, contrastive, contradictoire, opposé, contraire
la-propagande: proclamer, publicité, publicité, La-publicité, de-la-publicité
des-feux-d'artifice: 
pop: casser, coup
déshabiller: 
sillon: 
nocif: nuire, dangereux, négatif
judaïsme: 
complément: supplémentaire, équiper, addition
lentille: lentille, lampe-de-poche
pegative-cas: 
cancer: 
pion: hypothéquer, soldat, gage
Maître-de-conférences: 
fuite: répandre, perte, laissez-tomber
qualifier: éligible, mérite, mériter, qualifié, qualification
densité: bondé, intensité
induction: 
mâcher: 
bavard: communicatif
homard: 
remise: exemption, vente, Concession
Taxi: 
hiérarchie: leadership, système
jade: 
gronder: 
lézard: 
cascade: 
décevant: déprimant, déception, décevoir, Déçu, méchant
veto: refuser, trace, rejeter, rejeter, désapprobation, pari, traction
présidence: présidentiel
acheteur: client
gallon: 
moustique: 
déviation: déviation, Distorsion, offset
lutter: rivaliser
mosaïque: 
prise-de-courant: connecteur, bon
s'accroupir: accroupissement
épicerie: 
communiste: 
étonner: surprenant, incroyable, étourdissant, tromper, embrouiller, étourdir, confondre
prosecutive-cas: 
constellation: galaxie
dictateur: 
la-préoccupation: emploi, anxiété, inquiéter, préoccupation
Satellite: 
pantoufle: sandale
consonne: 
approximatif: approximation, approximativement, approximative
sans-emploi: emploi
supporter: assistant, auxiliaire, supporter, support
lotus: 
salade: salade, épinards
chlorure: 
bactéries: fongus, bactérien
gluant: visqueux
composant: 
noyau: 
feindre: faire-semblant, simuler
octet: 
sécrétion: sécréter
explicitement: clairement, ouvertement, Apparemment, évidemment, certainement,-vraiment,-définitivement
coïncider: rencontre, adapté, adapté, accord, correspondant-à
ballet: ailette
urine: pisse
ail: 
passé: passé, qui-passe
économie: économie, récession, économie
classe-moyenne: 
agile: vite, rapide, rapide, rapide
pinces: pelle, agrafe
blanchisserie: la-lessive
fraise: 
Urbain: civique
embarrasser: décourager, handicap, embarrassant, confondre, embrouiller
cahier: 
album: 
base-ball: 
renifler: 
buffet: 
participe: participant, participant
garage: 
diagnostic: diagnostique, diagnostiquer, cognitif, reconnaître
béquille: 
extorquer: chantage, cueillir, contraindre
enregistrement: enregistrement, Inscription, enregistrement, bûche
soluble: dissoudre
phosphore: 
de-construction: la-structure, configuration, config
colle: 
thèse: thèse
artisan: mécanicien
banane: 
axiome: théorème, franc, apparent, évident, explicite, principe
nervure: équipement
nickel: aucun
pi: adieu, tarte, silicium
autobus: laisser
censurer: censure
missile: fusée
saucisse: l'Hot-dog
manipulation: fonctionner, manipuler, opérationnel, ruse, Tricher, manipuler
tomate: 
renforcer: consolider, intensifier, confirmer
douille: le-retrait, sortie, connecteur, nid
potassium: 
récupérer: rapporter, récupérer, restaurer, restauration
virtuel: réal, réel, véritable
algèbre: 
dentiste: dent
optique: visuel
bouger: Concession, concessif, bouge-toi, en-déplacement, déplacer
la-biologie: 
chômage: 
chenille: 
solo: séparé, phénoménal, discret, sol, en-solo
navigateur: 
éloigné-passé-tendu: 
historique-tendu: 
le-nucléaire: noyau, atomique
spectre: 
sodium: 
hystérie: 
curateur: administrateur
otage: hypothéquer, gage
gourde: citrouille, moelle
ride: défaut
transparence: transparent, explicite, simple
pointe: coin, dentelle, pointe, clouer
priorité: attention
piéton: en-marchant
athéisme: 
moniteur: Piste, superviser, regarde, poursuivre
circonscription-électorale: électeur, électorat
incontrôlé: 
sonde: examen, enquête, enquête, enquêter, enquête, exploration, essai
platine: 
double-nombre: 
poumon: 
super: phénoménal, énormément, incroyablement
chariot: le-chariot, Chariot, wagon
localement: locale
inciter: exciter, ennuyer
de-l'essence: essence
le-rein: 
butin: vol, pillage, proie, gâcher, voler, transporter
évaluation: estimation, estimation, évaluer, qualité
arsenic: 
escargot: hélix
sauterelle: 
équation: formule, égalité
socialiste: parenté
filtre: 
sensoriel-évident-humeur: 
élargir: développer, large, ajouter, augmenter, améliorer, se-déployer, largement, résolution, extension, expansion
émettre: commencer, jeter, exhaler, tirer, laisser
laisse: bail, sangle
mandarin: 
jockey: 
pneumonie: 
la-solidarité: unir, rassemblement, affinité, unité, similarité
charnière: détaillé, boucle
longitudinal: verticale
dividende: allocation
patin: ski
exposant: indice, exponentiel
invalidité: handicap, incapacité, défaut, imparfait, désactivée, défaut, défaut
obsession: harceler
attribution: allocation, allouer, disposition, quota, affectation
photographe: photographique
delta: participer
numérique: figure, numéral, numérique
chienne: 
paupière: 
diagonale: 
subconscient: 
sourcil: 
éternuement: 
hilarant: gai, amusant, content-de, amusant, divertissant, amusant, amusé, humoristique, ridicule
hindouisme: 
réfugié: immigrant
la-navette: vaisseau-spatial, le-chariot, transport, le-transport
protéine: blanc-d'oeuf
déverser: pile, empiler, bannir, ordures, des-déchets
affiner: 
vomir: 
gène: génétiquement, génétique
étudiant-de-première année: 
sociologie: 
squash: citrouille, écraser
pêcheur: 
régional: comté, région, zone, quartier, sphère, secteur, périphérique
mouvement-montée: 
rétrospective: passé, introspection
tornade: 
inversion: inverser, contraire, réciproque, inverse
la-télé: télévision, film
cube: 
productivité: performance, sortie
carotte: 
moléculaire: molécule, substrat
conglomérat: clique, groupe, grappe
comptable: auditeur
concombre: option, gorge
orgie: 
solvant: dissoudre
phosphate: 
apprêt: appât, connaissance, introduction
alcalin: 
gymnastique: aptitude
virgule: coma, fête
mouvement-une-descente: 
fausse-couche: Avortement, bas, échec
cosse: coquille, gaine, peler
donneur: 
manganèse: 
psychologue: 
chlore: 
clavier: 
élite: 
parenthèse: 
le-rugby: 
ulcère: endolori, plaie, traumatisme, bouillir
fléchie: 
grignoter: 
quantum: montant, Quantité, quota, proportion
chandail: veste
évolutionniste: du-développement, évolution
notation: signe, symbole, Note
rebondir: boom, saut
dissection: allouer, section
cachette: 
linéaire: simple
antimoine: 
superessive-cas: 
tumeur: tumeur, masse, bosse
érosion: 
alpha: 
nombril: ventre, pôle
immunitaire: respiration, résistant
grippe: grippe, qui-coule, fièvre, influence
Brasserie: 
simplifier: 
abréger: limite, confiner, restreindre
bosse: bosse, bosse, dent
captiver: capture, fasciner
contraindre: contraindre, obliger, imposer, mise-en-vigueur
chaussette: 
film: film, cinéma, ruban, bande, bande
cosmos: univers
polluer: la-pollution, infecter
grégaire: 
pénis: sexe
sylviculture: 
aluminium: aluminium
oscillation: fluctuation
horoscope: 
éjecter: jet, expulser, évincer, expulser, sécréter, déplacer, soustraire
inclusion: enregistrement, l'intégration, Intégrer, couverture, comprendre, couvrant, implication, impliquer, participation
bénéficiaire: titulaire, utilisateur
dauphin: 
tueur: 
mammifère: 
indicateur: posture, indice, les-critères, l'index, jauge
dioxyde: 
côlon: 
bureaucratie: bureaucratique
fausser: tromper, brouiller, Distorsion
réfrigérateur: frigo
archéologique: archéologie, archéologie, fossile
inacceptable: désapprobateur
spécification: norme, standardiser
brochure: bulletin, polycopié, feuille
anthropologie: 
délicieux: délicieux
transitif: excuse, transition
se-recroqueviller: crawl
tournesol: 
pou: cocher, bit
ion: 
le-tourisme: touristique, Voyage
modem: 
accélération: promouvoir, faciliter, stimulation
falsifier: confondre, forger
émission: sale, problème
kidnapper: détourner, conduction, arracher
chevauchement: interaction, interactif
coiffeur: 
folklore: blé
capillaire: 
nationalisme: la-nationalité
fesses: hanche, fesse
motif: thème, sujet, motif, terrains
sublimé: 
frustration: revers, désespoir, déception, confus, annuler
cobalt: 
avoine: 
mouvement-en-amont: 
anus: 
bovine: 
bascule: Traduire, Traduire
redondance: beaucoup, résiduel, excès, rejeter, congédiement, exemption
vidéo: 
boycotter: comté, ostracisés, la-négligence
quiz: tentative, examen, questionnaire
le-hockey: 
guérilla: 
magnésium: 
radar: 
chimpanzé: 
fiabilité: la-crédibilité
rectangle: 
varech: 
généraliser: généralisation
couvre-feu: 
homosexuel: 
scénario: scénario, paysage
formulation: construire, construction, constructif, formulation, création, formation, formuler
réincarnation: 
enflammer: 
uranium: 
catcher: récepteur
coordonner: coordination
contribuable: 
intégré: intégral
opiné: vue, opinion, remarque
gamma: 
safari: balade, voyage, voyage, voyage
mouvement-en-aval: 
coefficient: qualité, facteur
gros-titre: Titre, sujet
analyste: analyser
échec-et-mat: 
centre-commercial: supermarché
bismuth: 
carte-postale: salutation
convergence: approximation, converger
faire-une-digression: battre-en-retraite, partir
actionnaire: partenaire
microbe: 
génital: 
morphologique: génétique, morphologie
bêta: 
jeans: 
base-de-données: 
calculatrice: l'informatique
radiographie: 
analyser: 
écologique: paysage, alentours, Environnement, le-contexte, écologique, quartier, quartier, contour
sigma: 
disjonction: isolement, séparation, panne, panne
ordre-du-jour: programme, programme, programme-d'études
visa: 
Infrastructure: 
luciole: 
détecteur: 
adaptatif: 
biologiste: 
épissure: affixe, modifier, joindre, brancher
brome: 
palladium: 
hoquet: 
pastel: pâle
zoo: 
clinique: 
connotation: implication, sens, sémantique, notion, concept, sens, le-contexte
yoga: somme
librairie: bibliothèque
thérapie: traitement, traiter, guérir, remédier, thérapeute
nationaliste: ethnique
décapiter: 
Oui: Oui
problématique: problème, problème, complication
jazz: 
tungstène: 
terroriste: militant, la-terreur
dribble: vase
métabolisme: 
pension: 
fin-de-semaine: 
chrysanthème: 
vaccin: commentaire, couverture
moto: moto
mantra: 
semestre: terme
héroïne: 
dossier: 
cathode: 
idéologie: pensée
parking: 
thêta: 
déception: déception
sélénium: 
Faire-du-vélo: circulation, boucle, cyclique, vélo, bicyclette
cortex: écorce, coquille, peler
équivalence: égalité
courant-pertinence-marqueur: 
aéroport: 
amputer: couper-la-parole
basket: 
imposteur: 
cafard: 
chrome: 
litre: litre
toutefois: Néanmoins, encore, toutefois, en-tous-cas
hormone: 
imparfait: l'absence, carence, imparfait, erroné, faux, manque
perforer: percer
animisme: 
polygone: angle
féministe: 
conjuguer: inclinaison, connecté
euro: 
ginseng: 
algorithme: 
laser: 
pharmacie: 
millimètre: millimètre
fléchir: courbe, courbé, flexible, favorable, câble
anode: 
nuancer: ombre
à-temps-partiel: 
sensibilité: 
démonstrateur: 
hélium: 
bilingue: 
acronyme: bref, brièvement, rétrécir
initialism: 
gérondif: 
plasma: 
chromosome: 
ordinal: jonction, rangée, ordinaire, séquentiel
kilomètre: kilomètre
fax: 
la-génétique: génétique, génétiquement
rousseur: 
tournevis: clé
brocoli: 
prétérit: 
vitamine: 
cadmium: 
bombardier: 
graphique: 
titane: 
folie: se-vanter
lambda: 
copine: partenaire, petit-ami, amoureux, Fille
copuler: 
Sablier: 
empathie: la-sympathie, la-compassion, compréhension
bore: 
hélicoptère: 
tellure: scandium, lanthane
date-limite: terme
aligner: 
centimètre: 
molybdène: 
lithium: 
multimédia: 
mettre-à-jour: moderniser, rafraîchi
calorie: 
robot: 
devoirs: 
logarithme: 
mante: 
installer: le-Mont, installer, la-synthèse
amino: 
glyphe: le-soulagement
aoriste: indéfini
écologie: écologique
distordre: gâcher
marijuana: 
micro: subtil, petit, minuscule, diminutif, micro
kilogramme: 
trop-manger: 
prévisible: la-prévision, prédire, prévoir
Pizza: 
espionner: 
linguistique: linguistique
la-Coupe-de cheveux: 
iridium: 
racisme: racial
optimal: haut, optimum
industrialisation: industrialiser, industriel, fabrication
siège-social: quartier-général, siège
cérium: 
conforme: amicale, adapté, favorable, compatible, similaire
partitif-cas: 
cassette: bande
volonté: volition, sera
dimensionnelle: Taille, forme, dimension, spatial
paramètre: 
synchroniser: synchroniser
maximiser: maximum, améliorer, exagérer
séminaire: atelier
disco: assiette
néon: 
osmium: 
Épiphanie: 
plagier: vol
artefact: 
réacteur: 
origan: 
plutonium: 
yttrium: 
augmentatif: 
Nom-d'utilisateur: 
de-troisième-cycle: 
Aile-droite: 
argon: 
phobie: crainte, awe, hanter, dégoûter
socialiser: communiquer, interagir
mondialisation: 
longueur-d'ondes: 
encoder: code
recycler: utilisé
redémarrer: réinitialiser
hépatite: 
torus: bosse
chimiothérapie: religieux
modulo: moule, module
proton: 
disquette: 
milligramme: 
pixel: 
tantale: 
soluté: décider
génocide: 
prédateur: féroce
gallium: 
zirconium: 
déterminant: déterminer, définir, enquêteur
non-linéaire: 
pesticide: 
béryllium: 
neurone: 
prédicatif: péremptoire
slip: sous-vêtements
factorielle: la-faculté
neutron: 
niobium: 
germanium: 
métalloïde: non-métallique
mettre-sur: 
prolative-cas: 
biodiversité: 
manette: 
antibiotique: 
actinium: 
astronaute: espace
extra-terrestre: extraterrestre
cinglé: stupide, fou, fou, fou, anormal
marathon: 
ytterbium: 
autisme: 
ioniser: 
radon: 
nerium: 
épidémiologie: 
vieillesse: personne-âgée
camping: camp
rayé: bande, schème, planificateur
indium: 
véridique: sincère, pur, net
site-Internet: site-Internet, site, profil
Coran: 
couverts: 
nième-racine: 
lawrencium: 
droits-civils: 
téléphone-portable: portable, téléphone-portable
paralysé: 
protactinium: 
radiation: lueur
dépendre-sur: 
thorium-atome: thulium-atome, terbium-atome, rhodium-atome, rubidium-atome, vanadium-atome, fluor-atome, polonium-atome, thallium-atome, strontium-atome, ruthénium-atome
blue--jean: 
plante-d'appartement: 
individuellement: personnellement, individuel, personnel, séparément
flux-de-courant: 
point-triple: 
corps-humain: 
la-physique: physique, physiquement
vente-au-détail boutique: 
césium: 
longue-depuis: 
tableur: 
unité-de-masse: 
compiler: 
binaire-valeur: 
Humain-étant: 
par-veux-dire de: 
depan-dari: 
praséodyme: 
carton: carte
fini-verbe: 
procès-nombre: 
Pro-phrase: Pro-phrase
critique: critique, critique
conditionnement: emballage, pack
impermanence: instable
à-les-plus: 
descripteur: la-description
néodyme: 
relation-amicale: amicale, allié
lire-seulement: 
fonde: 
gnomique-humeur: 
phonème: 
rationalité: conscience, logique
phonologique: 
à-manger-chambre: 
vivant-chambre: 
central-cas: 
hodiernal-pré: 
patient-cas: 
oblique-cas: 
rural-région: 
recurse: 
milieu-voix: 
meitnerium: 
postier: 
évasif: appartement
stock-marché: 
identifiable: identification, identifier
objectif-gâchette: 
une-seconde: 
latif-cas: 
ration: partie
non-Humain: 
vivant-chose: 
aussi-peu: 
cinéma: cinéma
hassium: 
atténuant: 
multal-nombre: 
laiteux-façon: 
neptunium: 
Fantôme-écrivain: 
trans-numéral: 
duper-autour: 
américium: 
matin-gloire: 
pompier: 
berkelium: 
galaxie-le-genre: 
nobelium: 
au-revoir: adieu, Au-Revoir, jusqu'à
bouddhisme: 
fermium: 
cyan: magenta
soya: 
distributeur: 
briseur-de-grève: 
processeur: 
abessive-cas: 
adessive-cas: 
à-cas: à-cas, au-hasard
agentive-cas: 
rutherfordium: 
anticorps: 
comme-beaucoup-comme: 
agent-gâchette: 
acteur-rôle: 
éthidium: 
commun-le-genre: 
accompagnateur: 
carthame: 
francium: 
erbium: 
passif-voix: 
astate: 
mastication-gomme: 
étoile-le-genre: 
citation-forme: 
curium: 
Bande-dessinée: 
daltonien: 
euler's-numéro: 
Regarde-à: 
passage-clouté: sentier
champ-de-bataille: 
automobiliste: chauffeur
court-circuit: 
verbal-nom: 
cri-en-dehors: 
statistiquement: statistique
yaourt: 
xénon: 
hypnotiser: 
prendre-de: 
clause---queue: 
direct-objet: indirect-objet
épicerie-boutique: 
consister-de: 
ergative-cas: 
en-langue: 
première-main: direct
locatif-cas: 
piscine: piscine, bassin
adverbial-cas: 
sightsee: voyage, inspecter, circulation
télévision-ensemble: 
final-particule: 
evitative-cas: 
réhabilitation: 
régression: retour, le-retrait, battre-en-retraite, revers
Bloc-de-appartements: 
réveiller-en-haut: 
police-officier: 
jurer-de: 
intervieweur: entretien
rhénium: 
aérosol: 
possessif-cas: possessif-cas
nominalisation: nom
possédé-cas: 
surcharge: 
auxiliaire-verbe: 
primaire-objet: 
virus-informatique: 
homme-d'affaires: Entreprise-la-personne, marchande
une-gens: personnes, populaire
antessive-cas: 
premier-ministre: 
lutétium: 
europium: 
emote: 
musique-folklorique: 
poète: 
bureau-de-poste: poster, Courrier
soi-disant: hypothèse, émettre-des-hypothèses, probablement, Apparemment, probable
animer-le-genre: 
subessive-cas: 
gaz---pédale: 
polarité: polaire
véhicule-le-genre: 
minéral-le-genre: 
verbe---suffixe: 
passionné: émotion, émotif, sensoriel
samarium: 
animateur: modérateur
unité-imaginaire--: 
vitesse-de-la lumière: 
armée-de-l'air: 
empathique-joie: 
point-critique: 
à-plein-temps: 
hafnium: 
inhibition: retenir, freiner, inhiber, interdire
changement-de-un événement: 
holmium: 
différent-un-événement: 
univers-le-genre: 
localité-le-genre: 
virtuel-machine: 
recherche-le-genre: 
artistique-le-genre: 
crastinal-tendu: 
abstrait-le-genre: 
exocentrique-cas: 
transitif-verbe: 
morphème: 
chauvin: 
passé-perfectif: 
professionnel: spécialité, professionnel, occupation, artisanat, professionnel
indirect-parole: 
seconde-la-langue: 
à-être: 
cimetière-décalage: 
collectif-nom: 
absolutive-cas: 
patient-gâchette: 
soi-confiance: 
excréments: tabouret, caca, saleté
réfléchi-voix: 
impersonnel-verbe: 
seaborgium: 
espace-blanc: 
modal-cas: 
inanimé-le-genre: 
causal: 
propositive-humeur: 
électrique-courant: 
associatif-cas: 
superlatif-cas: 
aussi-beaucoup: 
planétaire-le-genre: 
animé-dessin-animé: 
réciproque-voix: 
légiférer: législation, législatif, organiser, organiser
à-moins: 
grammaticale-cas: 
utilisateur: 
noyau-benefactive: 
gardien-de-but: 
:-except-for: 
dénominateur: 
else-if: 
de-côté: de-côté
l'un-et-l'autre: un-autre, mutuel
successif-clause: 
épuisé: 
short: 
dysprosium: 
bientôt-avenir-tendu: 
si-unités: 
krypton: 
mendelevium: 
applicative-voix: 
antipassif-voix: 
continuative-aspect: 
le-mal-de rayonnement: 
necessitative-humeur: 
unique-action-verbe: 
autorail: 
superlatif-degré: 
existentiel-clause: 
californium: 
présent-participe: 
lumineux-intensité: 
singulative-nombre: 
grammaticale---objet: 
passif-participe: 
excessif-durée: 
fluide-supercritique: 
montant-de-substance: 
postpositionnel-cas: 
électif-quantificateur: 
gadolinium: 
épenthétique-morphème: 
négatoire-quantificateur: 
einsteinium: 
artificiel-la-langue: 
conjonctif-particule: 
éloigné-avenir-tendu: 
fréquentatif-aspect: 
distributif-pronom: 
allocution-une-entente: 
chauve: nu
banlieue: Hamlet, campagne
universel-quantificateur: 
ordinateur-la-programmation: 
télévision-programme: 
virgule-flottante-nombre: 
existentiel-quantificateur: 
la-journée-après demain: 
alternative-quantificateur: 
de-mauvaise-humeur: rugueux
passé-passif-participe: 
la-journée-avant hier: 
locatif-directionnel-cas: 
contrefactuelle-conditionnel: 
