adieu: au-revoir, Salut, pi, adieu
la: 
de: compris-entre, environ, ses
à: Venez, Dois
dans: 
:-first-person: 
je: moi
:-third-person: 
que: ce, laquelle
le-sien: ses, posséder
il: ce
avec: 
pour: environ, envers
comme: laquelle, exemple, Comment
:second-person: 
être: 
elle: ses
sur: appel, environ
à: cheval
par: passer, et, environ
avoir: ours
ou: ni
de: 
ce: ce
lui: ses
elle: ils, ce
mon: mien, moi
leur: ses, ils
ainsi: Ainsi, bientôt
un: 
eux: ils, toi
nous: nous, moi
qui: quiconque, laquelle
voudrais: pense, apporter
sera: volonté
non: pas
si: qu'elle-soit, fourni
en-haut: au-dessus-de, monter, dehors, pire
dans: un
quelconque: à-savoir, laquelle, tous, chaque
votre: la-tienne
que: ni, laquelle, chose
indicatif-humeur: directif-humeur
homme: la-personne, mari, mâle
que: plus, environ, Comment
notre: le-printemps, nous
certains: quelque-peu
sur: après, au-dessus-de, dehors
mai: capable
maintenant: présent
aimer: Comment, aimer, tenir
peut: capable, pourrait, boîte
devrait: Dois
fait: faire, fait
tel: Ainsi
une: un
ces: ils, ce
plus-de: au-dessus-de, plus
beaucoup: très, le-volume
M: Monsieur, maîtriser
bien: beau, formidable, aimable
la-plupart: plus, en-grande-partie, majorité, très
doit: Dois
ceux: ils, ses
lui-même: posséder, même, se
la-vie: habite, durée-de-vie, une-voyelle, taille
sans-pour-autant: 
faire: faire, Créer
Hé-bien: confortable, droit
discours-marqueur: 
par: passer, pénétrer
pourrait: du-pouvoir, peut-être, pourrait
aussi: très, pair
de-nouveau: puis, arrière, une-seul-fois
beaucoup: majorité
chaque: chaque, laquelle
personnes: la-personne, Communauté, une-gens
pensée: idéologie, idée, pense
en-dessous-de: en-bas
encore: plus
lieu: endroit, position, où
Pendant-que: alors-que, temps, temporaire
juste: seulement, facile
aussi: pair, également, plus
encore: mais, ni, toutefois, plus
contre: envers, avant
Obtenez: rencontrer, prendre, dériver
toujours: éternel, jamais, toujours
de: fermer, un-moyen, dehors, couvert
visage: surface, cent, la-personne
un-autre: dernière, autre
gauche: un-moyen
neuf: néo, roman, Frais, neuf, Jeune
Madame: 
mettre: ensemble, dernière, donner
dire: dire
dérange: intellectuel, pense
peu: couple, petit
qui: laquelle, quiconque
loin: un-moyen, éloigné, très
appelé: pense
entier: complet, tous
les-deux: deux
trouve: a-trouvé, chercher
Regarde: voir, vérifier, coup-d'œil
laisser: autobus, émettre, donner, activer
Seigneur: maîtriser, Monsieur, Roi
domicile: maison
quelque-chose: rien, quelque-peu
moment: temps
père: papa
parmi: compris-entre
femmes: femelle
mère: maman
fin: fini, dernière, en-retard
petit: petit, micro
tu: toi
vouloir: Dois
toutefois: mais, toutefois, bien-que
assez: entièrement, quelque-peu, très, assez
à-qui: laquelle
meilleur: mieux
moi-même: moi, se
jusqu'à: pair, avant, au-revoir
depuis: puis, premier, en-raison
utilisé: Agé-de, recycler
plutôt: au-lieu, quelque-peu, plus
Moins: court, en-bas, moins
dans: interne, profond, à-l'intérieur
ensemble: ensemble
grand: formidable, massif
matière: chose, assujettir, question
certain: déterminé, droit
se: se
demi: à-mi-chemin, moudre, côté
vrai: vraiment, fait, droit
n'importe-quoi: peu-importe, quelque-peu, rien
garder: tenir, ensemble, conserver
femme: femelle
veux-dire: façon
près: passer, presque
Etat: condition, Entrer, Pays, gouvernement
en-solo: solitaire, solo, un
cas: tombe, exemple, costume, incident, en-raison
te: toi
haut: au-dessus-de, plancher
Fille: fille, femelle, copine
bien-sur: assurer, droit, vraiment
en-effet: vraiment, fait
lui-même: se, posséder, qu'elle-soit
le-long-de: associé, long, longueur
la-terre: Pays
retour: régression, arrière, remboursement
abandonner: Départ, vacances, abandonné, un-moyen, autorisation
non-plus: pair
loi: droit, juridique, Règle
allonger: ensemble, laïque, Aidez-moi
point: endroit, action, seulement, paragraphe
enfant: enfants
souhait: espoir, désir
parler: dire, parler
durant: temps, alors-que
Plusieurs: douzaine, couple, plus
Entreprise: Commerce, boutique, compagnie, oeuvre, commercial, mouvement
manière: façon, approche
deuxième: autre
général: commun, généralement, public
derrière: arrière
devenir: Venez
mort: mourir, la-mort
Terre: Pays
garçon: fils
ressentir: sentiment, entendre
esprit: âme
vérité: fait
sol: plancher, Pays, endroit
vraiment: vraiment, très, fait
du-repos: autre, confort, se-retirer, restes, vacances
différent: divers, différence, autre
possible: peut-être
Humain: la-personne, humanité
ville: ville
en-suivant: prochaine, suivre, après
avoir-besoin: nécessaire, Dois
cause: raison, induire, en-raison
soir: nuit, après-midi
cinq: cinquième, an
fort: du-pouvoir, capable, violent
Dame: femelle
autour: environnant, presque, environ, œil
faire-tourner: côté, ensemble, commande
sens: signifier, sentiment, connotation
Près: fermer, presque
personnage: caractéristiques, personnalité, Marc, la-nature
Trier: classification, aimable
vue: la-vision, vers-l'avant, scène, voir, coup-d'œil
fête: le-banquet, virgule, Pays
amende: formidable, mince
prêt: préparer, déjà, la-pointe-des pieds, fini
compte: raison, facture, calcul, compter
écrit: écrit
âge: Agé-de, siècle
autre: autre, dernière, ailleurs, plus
obliger: du-pouvoir, contraindre, imposer
de-l'autre-côté: au-dessus-de, contraire
de-bonne-heure: prématuré, début, primitif, bientôt
Soleil: 
plus-tard: avenir, puis, après, prochaine
tout: tous
passé: passé, rétrospective, dernière, après
acte: facture, verbe, action, oeuvre, mouvement
plus-loin: vers-l'avant, plus, supplémentaire
au-delà: plus, dehors
non-plus: ni, laquelle
vue: opiné, coup-d'œil, voir, la-vision, scène, calendrier
du-son: voix
aucun: rien, nickel
clair: Ouvert, évident, frappant, lumière
route: Autoroute, façon
réal: virtuel, fait, royal
presque: presque, environ
connaissance: information
vers: envers
mal: pire, mal, pauvre
vivant: habite, taille, durée-de-vie
paix: chambre
bas: court, bon-marché, fausse-couche
le-nord: réponse, nord, minuit
Naturel: la-nature
assez: beau, très, assez
Juste: droit, rapport, Dix
service: servez, soins
au-dessous-de: en-bas
plaisir: content
histoire: histoire, rendez-vous-amoureux, historique
Note: rappel-toi, notation
bien-que: bien-que
avant: contraire, vers-l'avant, avant
grand: formidable, massif
assurément: strictement, cours, vraiment
Vent: air, grenier
recevoir: le-reçu, prendre, dériver
attention: soins, priorité, concentrer, considérer, Accentuation
force: du-pouvoir
Probablement: peut-être
content-de: content, hilarant, satisfait
important: nécessaire, consécutif
toi-même: posséder, se
bonhomme: collègue, ami
opinion: opiné, idée
foi: croire, fidélité
depuis: l'est, puis, avant, vers-l'avant, arrière
charger: péage, frais, prendre
bras: le-Main, pauvre, manche, bras, épaule
dernier: dernière
objet: objectif, rien, assujettir
gentilhomme: mâle, Monsieur, maîtriser
particulier: notamment, à-savoir
à-peine: pas, presque, peu-fréquent
chef: gérante, directeur
chance: coïncidence, position, occasion, probabilité
traiter: plan, boutique, une-entente
en-pensant: pense
lourd: répétition, poids, sérieusement, difficile
plaine: Ouvert, facile, creux
immédiatement: une-seul-fois, bientôt
bouche: la-personne
peur: effrayé, la-crainte, anxieux
unique: un, solitaire
joie: content, excitation
brisé: soufre, Couper
sauf-si: mis-à-part
porter: ours, porter, apporter, activer
influence: effet, grippe
apparaître: émerger, sembler
dehors: dehors, mis-à-part
S'il-vous-plaît: gentiment, demander
apparence: émerger, sembler
en-douceur: au-fur-et à mesur, en-retard
point-final: phase, temps
la-soeur: frère
bataille: bataille, guerre
ancien: Agé-de
jeunesse: Jeune
simplement: seulement, facile, solitaire
portée: approche, accomplir, Venez
système: commande, hiérarchie, organisation
dîner: nuit, déjeuner
après: avenir, après
marche: bande-de-roulement, aller, plancher, le-pied
merveille: miracle, étrange, surpris
habituel: généralement, commun, toujours
figure: numérique, statistiques, en-forme-de, nombre, péage, image
ancien: Agé-de, démodé
le-respect: considérer, honneur, danger, envers
troisième: Trois, Mardi
rester: rester
société: social, Communauté, compagnie
résultat: conclusion, effet
commander: commande
simple: seulement, facile
à-côté-de: passer, prochaine, mis-à-part
silencieux: silencieux
parfait: correct, formidable
rue: façon
en-train-d'écrire: écrit, lettre
bois: en-bois, arbre, bâton
rapidement: bientôt
avis: voir, un-d, avertissement
brillant: pointu, lumière, brillant, frappant
bateau: navire, flotte, yacht
noble: formidable, glorieux
soudain: soudainement
valeur: valeur, rang, importance
dû: en-raison
en-train-de lire: lis, question
accepter: une-entente
attendez: attendre, tenir, rester
pièce: puce, partie, étendue
ex: Agé-de
conversation: parler, dialogue
occasion: occasion, position
Coût: frais, Payer
considérable: formidable, consécutif, frappant
siéger: rester
haut: optimal, crête, au-dessus-de, sommet
mariage: marié
marche: action, bande-de-roulement, phase
commencer: début
par: chaque, envers
individuel: la-personne, individuellement, atome
difficile: difficile
bit: partie, petit, pou, morceau
discours: parler
autorité: juridiction, du-pouvoir
bonheur: content
fournir: fourni, donner, assurer
faire-des-études: apprendre, une-analyse, studio
personnel: privé, individuellement, employés
regarde: vérifier, moniteur, voir
heureux: satisfait, content
chaud: chaleureux, du-feu
effort: Essai, fatigue
préparé: préparer, déjà
tentative: Essai, quiz, coup-de-couteau
vite: bientôt, agile
en-dessous-de: en-bas, après
prévu: avoir-l'intention, concentrer, objectif
tout-droit: directement, facile
probable: facilement, probabilité, peut-être, soi-disant
Justice: droit
simplement: seulement, facile
confiance: croire, fidélité
passage: partie, Traversée, colonne, passer, étendue
fermé: fermer, métier-à-tisser, couvert
nous-mêmes: se
qui-passe: passer, passé, Traversée
moyen: secondaire, signifier
possession: propriété
agréable: confortable, aimable
à-la-perfection: entièrement, vraiment
En-général: commun, généralement, avoir-tendance
la-tombe: difficile
fixé: réparer, bien-que, Standard, permanent
troupes: armée
réunion: session, Assemblée, rencontrer
camp: camping, champ
nation: Pays, nationale
existence: présence
répondre: réponse, remboursement
ciel: atmosphère, cieux
égal: même, degré
fortune: le-sort, condition, propriété
domaine: champ
situation: position, condition
milieu: signifier, à-mi-chemin, taille
l'hiver: du-froid
permettre: autorisation, activer
pâle: jaune, Couleur, perdre-connaissance, pastel, Ouvert, lumière
fonctionnement: course, courir
religieux: la-religion, chimiothérapie
conduire: induire, apporter
bouge-toi: bande-de-roulement, argument, bouger, mouvement, action
Arrêtez: briser, se-mettre-debout
parlé: dire, verbal, parler
Conseil: monter, panneau, Conseil, bord, commission
vain: libre, vide
perte: désavantage, perdu, fuite
offre: fourni, proposer, donner, exposition, servez, privilège
classe: aimable, orbite, rang
complet: complet
accès: visite, approche, acquisition
la-passion: enthousiasme, sentiment
physique: la-physique, corps
Exemple: exemple
démarrer: début
dépit: colère
Sérieux: formidable, sérieusement, extrême
argent: de-l'argent, Vendredi
suffisant: assez
Principal: directeur, maîtriser, clé, original, agrafe
formidable: étrange, violent, formidable
chemin: façon
sens: connotation, signifier, importance, assujettir
s'adapter: costume, correct
lot: Masse, très, le-sort
siège: chaise, siège, siège-social
Jeu: jeux-d'argent, joue
déclaration: expression, rapport
rêver: cauchemar, dormir
Roche: falaise, jupe, pierre
Spécial: notamment, privé, expert
frais: frais, péage, Payer
partager: partie, enjeu, rôle, distribuer
propager: détail, répandu, dispersion, raison
gloire: honneur, louange
espace: position, salle, champ, astronaute
ordinaire: commun, facile
considérer: pense, considérer
considérablement: très, en-grande-partie
officier: officiel
taux: Standard, honneur, cours
signe: notation, geste, Marc, endroit
originaire-de: la-nature, original, résident
travailler: employé, oeuvre
marier: marié
ampleur: lié, le-volume, degré
la-méthode: façon, une-seul-fois, approche
excellent: mieux, formidable
confiance: croire
exactement: vraiment, notamment, complet, entièrement
vaste: formidable
chic: imagination, beau
rapide: bientôt, agile
Oui: Oui, Ainsi
liberté: libre, indépendance
intéressant: dessiner, curieuse
de-côté: séparé, de-côté, mis-à-part
pur: Frais, véridique
concernant: au-dessus-de, environ, considérer
évident: preuve, évident
loin: un-moyen, éloigné
similaire: ressembler, même, conforme, comparable
étroit: mince, court
tout-à-fait: entièrement
page: côté, cour
particulièrement: notamment
Montagne: colline
fier: fierté
clairement: explicitement, Ouvert, évident
prix: honneur
malade: mauvais
jugement: décision, phrase, Règle, juge, juridiction, crise
Acceptez: acceptable, admettre, prendre
espèce: aimable
chercher: chercher
honneur: honneur
oreille: autorisation
bas: en-bas, plancher, base
aide: le-sida, Aidez-moi, aider
pleinement: complet, entièrement
délice: content, désagréable
montant: quantum, le-volume, foule, nombre
obtenir: acquisition, dériver, prendre
Impôt: location, ligne
traverser: Traversée, passer, dépasser
inconnu: client, étrange, étranger, inconnu
oser: courage
croître: monter
faux: mensonge, faux, mauvais, imparfait
grand: long, plancher
porte: porte
en-liberté: indépendance, libre, de-façon-autonome, en-vrac
coup: choc, accident-vasculaire-cérébral, coup, coup-de-pied
mode: approche, Venez
au-quotidien: jour
Distribution: distribuer
richesse: de-l'argent, propriété
liberté: libre, indépendance
avance: progrès
doux: doux, sucré
sûrement: cours, vraiment
garantir: sûr, protéger, assurer
occupé: s'emparer-de, saluer, engagé
étape: Plate-forme, action, phase, condition, scène
partie: partie, ration
langue: la-langue, cracher
en-colère: colère
le-chariot: entrainer, chariot, la-navette
Météo: climat, air, temps
nécessité: importance
entraine-toi: exercice, action, coutume
revendication: demande, costume
prince: Duc
groupe: ensemble, conglomérat, troupeau, bande, panneau
tout-au-long de: partout
ajouter: élargir, supplémentaire, augmentation
prier: demander
de-premier-plan: consécutif, maîtriser
gris: brun, cendre
fréquemment: souvent, répété, permanent
célèbre: populaire, bien-connu, une-voyelle
puissant: du-pouvoir, capable
vivant: habite
faible: perdre-connaissance, pauvre
Matériel: contenu, assujettir
franc: honnête, axiome
chaleur: l'été, chaleureux
garde: protéger, soins
également: équilibre, même, également
naturellement: la-nature
remarquable: étrange, exceptionnellement, formidable
lune: mois
mince: petit, facilement, lumière, mince, court
style: lumière
pointu: hémisphère, pointu
principe: théorie, axiome, début
immédiat: bientôt, directement
prêt: déjà, la-pointe-des pieds, mile
conséquence: consécutif, effet, conclusion
soumissionner: doux, une-entente, course
intéressé: avoir-l'intention, intérêt
trimestre: le-pied
Avancée: au-dessus-de, vers-l'avant
Apparemment: explicitement, soi-disant, sembler
actif: oeuvre, action
au-courant: délibérément, connaître
dangereux: danger, nocif, menaçant
calme: silencieux
sacré: Divin, saint
Royaume: royal
tout: entièrement, tous, complet
agréable: beau
habitude: caractéristiques, façon, coutume
direct: évident, directement, première-main
actuellement: vraiment, fait
audition: entendre
en-marchant: bande-de-roulement, le-pied, piéton
jeter: émettre, jeter, coup
sagesse: intellectuel
conduire: au-volant, Chorus, expédition, pousser, courir, disque
faute: faire-des-reproches, faux
affaire: chose, assujettir, rapports
contact: correspondance, touche
station: se-mettre-debout, centre, saison
écouter: entendre, demander, obéit
blesser: blessure, douleur, blessés
express: expression, Explique
faveur: côté, la-grâce, favoriser
Hauteur: longueur
Taille: dimensionnelle, ordre-de-grandeur, complet
tâche: action, oeuvre, devoir
la-sympathie: empathie, pitié
habillé: robe
plus-loin: vers-l'avant
navire: instrument, navire
affection: aimer
souffrance: torture, la-misère, amer, difficulté
la-chair: viande, corps
grandiose: massif, formidable
poster: rang, bureau-de-poste, après, envoyer, position
collection: accumulation, ensemble, Galerie, conclusion
imaginer: imagination, pense
arrivée: Venez
bruyant: insister, formidable, difficile
charmant: beau, glorieux
extraordinaire: étrange, exceptionnellement
arriver: ni
déjeuner: matin, déjeuner
population: foule
série: chaîne, ensemble
le-soulagement: le-sida, confort, glyphe
impression: effet, sentiment, impressionner, impression
la-satisfaction: satisfait
forme: dimensionnelle, forme, en-forme-de
la-naissance: né
considération: idée, considérer
ordinaire: périodique, répété, ordinal
en-déplacement: bouger, mouvement
occupé: engagé
qualité: Masse, degré
découvrir: a-trouvé, chercher, divulguer
à-l'intérieur: interne, profond, à-l'intérieur
sol: boue, plancher, solo, Pays
complètement: entièrement
message: information, des-nouvelles
phrase: expression, phrase
mention: mâle
paire: droit, couple
Titre: gros-titre, directeur, assujettir
compréhension: comprendre, empathie
dimanche: semaine
fou: cinglé, fou
absolument: entièrement, strictement
lent: silencieux
la-miséricorde: pitié, la-grâce
contenir: y-compris, contenu
douleur: chagrin, douleur
soldat: armée, pion
précédent: l'est
explication: Explique, information
prière: demande
croyance: croire, fidélité
constante: répété, Standard, réparer, permanent
final: dernière, enfin
balade: équitation, safari, monter, au-volant
politique: politique
dessin: image, dessiner, plan
en-train-de mourir: la-mort, mourir
demande: demande, question
plus-haut: au-dessus-de
somme: et, yoga, nombre
mouvement: mouvement, proposer
assistance: aider, Aidez-moi
dignité: honneur
capture: tenir, prendre, conception
parmi: compris-entre
actuel: présent, courant
peut-être: probabilité, peut-être, pourrait
séparé: séparé, différence, solo
pire: pire, pauvre
la-terreur: la-crainte, terroriste
contrôle: règlement, contrôlée, vérifier, gérer
capable: activer, capable, qualifié, compétence
raffermir: compagnie, bien-que
supérieur: mieux
spirituel: mentalement, moral, intellectuel
preuve: prouver, preuve
relation: rapports, rapport, considérer
concerné: soins, anxieux, associé
profondément: profond, détail
chanter: lis
amicale: conforme, gentiment, relation-amicale, aimable
entrée: porte, le-reçu
la-fourniture: largeur, fourni
nettoyer: Frais, soigné
utile: nécessaire, efficace
délicat: fragile, mince, élégant
retirer: débarrasser, effacer, dessiner
choix: choisir, élection, vérifier
énorme: massif, formidable
incapable: ne-peux-pas, pas, échouer
couverture: manteau, inclusion, couverture, emballage, chaussée
double: jumelle, deux-fois, couple
la-victoire: Succès
constamment: souvent, répété, toujours, Continue
niveau: Standard, condition, surface
Libération: décharge, publication, libre
rugueux: pire, de-mauvaise-humeur, grossier
devant: vers-l'avant, au-dessus-de
connecté: lié, attaché, associé, conjuguer
Gain: acquisition, avantage
addition: supplémentaire, complément
chambre: chambre, salle, Camera
connaissance: familier, apprêt
erreur: faux
basé: base, les-termes
voiture: entrainer
personne: n'importe-qui, rien
énergie: du-pouvoir
nu: Ouvert, bar, honte, creux, chauve
en-partie: à-mi-chemin, partie, quelque-peu
Couleur: Couleur
sécurité: sûr, salut, soins
la-description: décrire, information, descripteur, définition
endormi: dormir
laissez-tomber: tremper, tombe, fuite
brillant: glorieux, brillant, formidable
bref: acronyme, court
gris: brun, cendre
très: très
excité: excitation, irrité
désespoir: frustration, perdre-connaissance
facilité: confort, réduire
le-total: brut, tous
la-gentillesse: la-vertu, la-grâce
cercle: cycle, appartement, rond, la-roue
terne: ennuyer
intention: avoir-l'intention, objectif
terme: les-termes, semestre, date-limite
complètement: confortable, entièrement
appliquer: utilisation
la-main-d'oeuvre: oeuvre
intelligence: intellectuel
la-grève: attaque, frappant
équitablement: entièrement, assez, très
se-conformer: rencontrer, obéit, contenu
un-événement: incident, occasion, montrer
avec-douceur: doux, gentiment
connexion: conjonction, attachement, appel
la-protection: protéger, abri, soins
conscient: éveillé, délibérément, sentiment
édition: frais, impression, publication, autorisation
vol: oiseau, Voler, monter-en-flèche
la-variété: aimable, divers
à-l'écart: séparé, un-moyen, mis-à-part, de-façon-autonome
terrible: terrible, pitié
Tout-le-monde: tous, n'importe-qui
la-main-d'oeuvre: oeuvre
amoureux: chère, copine
en-chantant: chanson
désireux: désir, Je-suis-patient, curieuse, anxieux
exiger: demander, demande, insister
n'importe-quand: lorsque
couronné-de-succès: Succès
augmenter: élargir, ascenseur, augmentation, monter
Développement: progrès
Bien: du-froid, beau
essai: sonde, processus, tribunal
à-l'étranger: étranger, exilé
dévoué: fidélité, fidèle
littéraire: Littérature
écrivain: auteur
stock: bâton, rôle, action
type: aimable, écrit, Appuyez
beaucoup: riches, redondance, assez
éviter: empêcher
faveur: côté, la-grâce, favoriser
mental: intellectuel, mentalement, interne
attitude: coup-d'œil, se-mettre-debout, geste, approche, dépendance, paragraphe
admiration: louange
anxiété: anxieux, la-crainte, la-préoccupation, excitation
enseigner: connaître, apprendre
visible: connaître
guider: Manuel, preuve, au-volant
réel: virtuel, fait, royal
misérable: inadéquat, triste, malheureux, la-misère, sans-défense
nuire: mal, nocif, blessure, pitié
Pardon: pardonner, Pardon, s'excuser, la-grâce
rarement: de-temps-en temps
enregistrement: enregistrement, disque, enregistrer
graisse: huile, épais
appartement: appartement, évasif, plan
cadeau: récompense, présent
temple: maison, Cathédrale
Licence: autorisation
consentement: approbation, autorisation
suffisamment: complet, assez
plaie: blessure, blessés, ulcère
audacieux: courage, courageux
nulle-part: quelque-part, partout
témoin: preuve
insensé: ignorant, fou
n'importe-qui: n'importe-qui, quiconque
soi: privé, se, posséder
extrêmement: très, exceptionnellement
traitement: thérapie, soins
gorge: cou, monter-en-flèche, concombre
patient: mauvais
croissance: augmentation
Quantité: quantum, Masse, foule, dose, nombre, ordre-de-grandeur
sévère: strictement, violent, difficile
excuse: pardonner, raison, transitif, Pardon
origine: original, la-nature
public: passif, public
restant: restes
gagner: Succès
Femme-de-ménage: serviteur
doucement: doux, silencieux
réalité: fait
site: scène, site-Internet, endroit
voile: navire, voile
boutique: boutique, espace-de-rangement, enregistrer
remarque: opiné, considérer
pause: briser
précieux: valeur
Par-conséquent: Ainsi, donc
plante: monter, arbre, moulin
de-la-glace: neige
absolu: complet, entièrement
facilement: facilement, bientôt
féroce: pointu, violent, difficile, cruel, prédateur, sauvage
rage: colère
Découverte: a-trouvé, chercher, invention, ouverture
associée: associé
Châtiment: phrase
légèrement: petit, facilement, quelque-peu
mystérieux: secret, vague, invisible
ombre: ombre, Ton, nuancer
meurtre: tuer
émotion: sentiment, passionné
destruction: se-ruiner, détruire
horreur: la-crainte
locale: localement, interne, endroit
gamme: divers, distance, ensemble
hôte: armée, client, foule
humide: pluie, humide
mystère: secret
posséder: posséder, ours
conscience: rationalité, sentiment, conscience
anciennement: avant
production: produire
pont: pont
biens: propriété
règne: Roi, royauté
conformité: suivre, adaptation
la-sienne: ses
malheureux: malheureusement, coïncidence, malheureux, pitié, inadéquat
une-fleur: dépenser, intérêt, boue
remerciements: remercier
appartenir: propriété, y-compris
marché: Acheter
bouchon: chapeau, liège
Enchanté: content
Ménage: Famille, maison
flotte: navire, marine, flotte
bébé: enfants, poupée
région: champ
exact: farine, correct, complet, prudent
image: image
soupçon: doute, méfiant
refuser: nier, veto, déchets
responsabilité: devoir, faire-des-reproches
honteux: honte
repas: aliments, manger, farine
statut: position, condition
indiquer: Entrer, montrer
poème: poésie, chanson
survenir: émerger, monter
voyage: safari, expédition
assister: Joindre
offrir: Acheter, donner, ours
faire-un-don: contribuer, donner
emploi: oeuvre
procéder: Continue, augmentation, progrès, passer
le-regret: Pardon
risque: danger
rapide: bientôt, agile
distinct: séparé, différence
correctement: correct, confortable
célébrité: louange
singulier: uni, unité
Erreur: faux
réputation: louange
appel: dessiner, appel
l'absence: Couper, imparfait, absence
la-violence: violent
rendre: faire, présenter, donner
carrière: métier, oeuvre
conception: conception, plan
suggestion: phrase, proposer
prononcer: prononcer, complet
résolution: décision, conclusion, une-analyse, élargir
de-rechange: alterner, supplémentaire, remplacer, lance
national: civil, interne, résident, nationale
référence: référentielle, Mémoire
exister: présence, présent
problème: problématique, les-termes, difficulté, assujettir, question, émission
fournir: fourni, donner
flamme: du-feu
ignorance: ignorant, ignorer
de-temps-en temps: de-temps-en temps, répété
en-volant: Voler
tissu: en-tissu, vêtements
le-profit: avantage
Quatrième: quatre, Mercredi, chambre
cloche: alarme, heure
avantage: avantage
chapitre: porte, partie, directeur, saison, capital, se
trou: ennuyer, fosse
raisonnable: correct, sage, rationnel
du-sucre: ivresse, façon
remplacement: remplacer, au-lieu, allocation, alterner, échange
poussée: insister, tricoter, Payer, pousser, impulsion
Cadre: échelle, juridique, coup
substance: assujettir
email: envoyer
division: partie
esclavage: esclave
verset: poésie, paragraphe
probable: peut-être
douloureux: amer, douleur
pour-toujours: toujours, éternel
océan: mer
arrière: après, arrière, inverser
guide: directeur, gérante, conducteur, Manuel
vif: avoir-l'intention, anxieux, pointu
la-chance: le-sort
apparent: évident, axiome
se-dépêcher: bientôt, veau
schème: plan, rayé, graphique
inutile: déchets
Néanmoins: bien-que, toutefois
lisse: doux
solide: démonstratif, a-mis-en place, bien-que, compact
nécessairement: Dois, nécessaire
construire: Créer, bâtiment, formulation
tentative: Essai, coup-de-couteau
équivalent: même
récent: récemment, moderne, dernière
Voyage: visite, le-tourisme
le-midi: après-midi, Sud
situé: tombe
annonce: un-d
cesser: empêcher
circonstance: condition, enveloppe
tente: cabine, scène
fréquent: répété, souvent
à-haute-voix: voix
indépendant: indépendance, en-vrac, de-façon-autonome
essentiel: nécessaire, agrafe
observation: observer
Reconnaissance: remercier
préserver: conserver, espace-de-rangement, protéger
aspect: élément, côté
crainte: la-crainte, phobie, effrayé
astucieux: qualifié, sage
district: habite
échec: échouer, faux, faillite, fausse-couche
cent: penny, pour-cent, cent
sentiment: sentiment
agent: signifier
désespéré: perdre-connaissance
union: alliance, uni
subvention: admettre
frapper: multiplier, coup-de-pied, Succès
énorme: formidable, massif
conviction: phrase
fièvre: du-feu, grippe
traiter: thérapie, processus, guérir
les-notres: le-printemps, nous
erroné: faux, abuser-de, imparfait
idéal: mieux
se-ruer: foule, accident-vasculaire-cérébral
Corriger: correct, droit, fidèle, réparer
effectuer: montrer, faire
en-quelque-sorte: quelque-peu
notion: conception, connotation, idée
discussion: discuter, argument
fermement: a-mis-en place, bien-que
stable: Standard, réparer, cohérent, permanent
empire: royal
Stylo: crayon, directeur
permis: autorisation
maintenir: tenir, protéger, conserver
bondé: foule, densité
limitation: lié, retenue
horrible: terrible
port: port, porte
expérimenté: de-l'expérience, qualifié, expert
opposé: opposition, contraire, envers, contrastant
traité: mémorandum, une-entente
se-produire: Venez
recherche: mendier, chercher
pratiquement: presque, vraiment, pratique
trace: Marc, veto
gai: content, hilarant
arrangement: commande, disposition, organisé, une-entente
occidental: Ouest
pression: Accentuation, impression, pousser, poids
politique: politique
scientifique: la-science, scientifique
mérite: louange, qualifier, valeur
entretien: visite, intervieweur
territoire: champ
sexe: pénis, sexuel, six
création: Créer, formulation, a-mis-en place
sentier: Marc, élection, façon
perspective: espoir, probabilité, la-vision, scène
opération: dérive, processus, action, chirurgien
profond: profond
rencontre: jeux-d'argent, coïncider, coïncidence, course
uniforme: robe
dette: faire-des-reproches, la-religion, devoir, crédit
entreprise: aventure, investissement, compagnie
exécution: action
humeur: sentiment, humour, disposition
équipage: employés
apercevoir: comprendre, conception, voir
déclarer: Explique
version: copie, cellule
impair: étrange, exceptionnellement
reconnaissant: remercier
infini: éternel, infinitif
Sécurité: sûr, soins
sensible: sage, rationnel, sensible
chalet: cabane, cabine
capacité: capable, compétence, le-volume
régler: rester
impliqué: engagé, Joindre
conseil: Conseil
examen: sonde, vérifier, choisir
acier: fer-à-repasser
tester: vérifier, Essai
charité: aimer
cabanon: verser, jeter
Communication: correspondance, rapports
quelqu'un: quiconque, la-personne, n'importe-qui
rangée: ligne, ordinal, ensemble, gouvernement, commande
la-pauvreté: pauvre
intense: bord, extrême, violent
querelle: bataille
disponible: fourni, présent
la-résistance: opposition
inhabituel: exceptionnellement, commun
déserté: abandonné, désert
vote: choisir, voix
supporter: ours, supporter, dernière, souffrir
réussir: Succès
jambe: le-pied, OS
offre: proposer, demande
intérieur: interne
légèrement: facilement, lumière
afficher: montrer, exposition, écran, scène, preuve
confiné: limité, seulement
avoir-pour-but: objectif, concentrer
critique: nécessaire, critique
sac: poche, sac, panier
répéter: répétition, arrière, répété
Piste: moniteur, chanson, façon, suivre
résidence: abri
amusant: content, hilarant, Divertissement
défendre: protéger
fortement: poids, sérieusement
des-trucs: contenu, des-biens, chose
section: partie, dissection
règlement: une-entente, abri, règlement
assiette: panneau, disque, disco
surmonter: chape, dépasser, battre
terrains: raison, les-termes, motif
marbre: pierre
capacité: capable, compétence, Talent
vague: marée, vague
populaire: une-gens, populaire
possibilité: probabilité, capable
beurre: huile
haine: mépris, haine
poursuite: chercher
tirer: dessiner, les-ciseaux
signal: geste, Marc, mot-de-passe
sans-encombre: sûr
brûler: brûlé, fumée
cours: éducation, assujettir, cours
annuel: an
carte: carton, carte, court, papier
application: utilisation, logiciel, demande
intelligent: intellectuel, sage
comté: boycotter, régional, ville, Pays
format: forme, jeter
écoulement: courant
dommage: se-ruiner, blessure, pitié
de-plus: supplémentaire, pair, plus
Commerce: Commerce
du-sud: Sud
extérieur: dehors
moyen: secondaire, signifier
nu: honte
évident: évident, Ouvert, axiome
fondation: base, Plate-forme
préoccupation: soins, anxieux, associé, intérêt, la-préoccupation
la-magie: charme
campagne: mouvement, expédition
libéral: généreux
communément: commun, souvent, généralement
chasse: chasse
maitresse-d'école: auteur
d'ici-peu: bientôt, court, presque
bénédiction: bénir
minuscule: petit, micro
nettement: la-rapidité, pointu, sérieusement
coffre,-poitrine: Sein
profondeur: profond
performance: montrer, productivité
la-prospérité: fleurir, Succès, aide-sociale
employé-de-bureau: employé, officiel
décider: décision, déterminé, décisif, soluté
victime: chasse, sacrifice, péage
motif: avoir-l'intention, motif, moteur, objectif, stimulus
précis: déterminé, évident
tendance: caractéristiques, mile, disposition, dérive
terminer: fini, Couleur
drapeau: bannière, connaître
administration: Règle, gérer
rarement: peu-fréquent
véritable: virtuel, original
entraînement: éducation, enseignement
mal: faux, très, pire, mal, mauvais
nourrir: manger, favoriser, aliments
central: centre, fédéral
contraste: contrastant, opposition, conflit
la-structure: bâtiment, de-construction, organisation
Paiement: Payer
rythme: la-rapidité
enquête: sonde, demande, chercher
partout-où: où
devoir: coupable, devoir
manipuler: processus, gérer, chape, manipulation
voyage: visite, safari, sightsee, expédition
tirer: coup, exilé, émettre
emploi: sans-emploi, la-préoccupation, oeuvre
Coupe: Couper
résister: opposition
déterminer: déterminant, déterminé, décisif, imposer, réparer
marchande: revendeur, homme-d'affaires, Commerce
animé: habite
brise: air
relatif: cousin
ainsi: Ainsi
disposition: présenter, fourni, aide-sociale, attribution, disposition
En-ce-qui concerne: environ, considérer
choisir: choisir, prendre
ruiné: détruire
livrer: donner, présenter
inattendu: surprise
bureau: table, Bureau
voie: ligne, bande
représenter: représentant, exemple
respectable: honneur
la-responsabilité: devoir, faire-des-reproches
Déçu: ambition, décevant
adapté: coïncider, correct
dépendre: dépendance, lié
géant: formidable, monstre
saisir: comprendre, s'emparer-de
arriver: Venez, accomplir
simplicité: facile, humilité
l'automne: tombe
absent: absence, un-moyen
obscurité: sombre
suspect: Devine, doute, méfiant
détermination: déterminé, décision, rapport, définition
base: base, les-termes
examiner: observer, vérifier, une-analyse
prix: récompense, prime
achat: Acheter
Quelqu'un: la-personne, n'importe-qui, bien-que
prendre-conscience-de: accomplir, comprendre
défaite: battre, Collier, échouer
criminel: du-sang
bête: fou, ignorant
rappel: rappel-toi
occupation: raid, métier, professionnel, agressif
discours: moderne, parler
aider: Aidez-moi, aider, collaboration
vente: enchères, vendre, remise
invitation: Invitez, appel
inférieur: inadéquat, en-bas, pire
reconnaître: admettre, diagnostic
portrait: image
suggérer: proposer, supposer
déception: frustration, ambition, déception, décevant, compter
construction: bâtiment
zèle: enthousiasme, diligence
responsable: devoir
guérir: thérapie, guérir, soins
comprendre: y-compris, Entrer, inclusion, comprendre, contenu
satisfaire: rencontrer, satisfait, contenu, gâter
agonie: amer
stupide: cinglé, ignorant, fou
jouissance: prendre-plaisir
cacher: cacher
précisément: correct, complet
assumer: mendier, supposer, considérer
estimation: évaluation, Devine
route: façon
visiteur: voyageur, client, observateur
non: pas
câbler: ligne
principalement: notamment, en-grande-partie
inconscient: perdre-connaissance
mutuel: l'un-et-l'autre, commun
externe: dehors, étranger
univers: cosmos, monde
horloge: heure
instruction: enseignement, direction, Manuel
endolori: ulcère, mauvais, douleur
discipline: assujettir
introduction: présenter, fourni, promotion, apprêt, importer
désert: désert
confus: nerveux, frustration
mariage: marié
nom: représentant, côté, la-grâce, partie
compter: croire, calcul, compter
incertain: incertitude, instable, vague
engagement: engagé, nomination
sale: émission, brut
médecin: docteur
couvrant: couvert, inclusion, toit, emballage
sincère: honnête, vraiment, véridique
la-sensation: sentiment
spécifique: notamment, privé, expert
auberge: hôtel
rigide: difficile
accompagner: suivre
But: Marc, rapport
vierge: fille
faim: affamé
préféré: préféré
douane: tradition, pouce, devoir, coutume
impressionné: sentiment
proie: chasse, butin, sacrifice
musical: la-musique, musicien
satisfaisant: maladie
ridicule: ignorant, hilarant
feuille: papier, feuille, brochure
disgrâce: honte
initialement: original
les-salaires: Payer
extensif: répandu, profond
loisir: Divertissement, vide, se-retirer, relaxation
menton: barbe
lueur: éblouissement, lumière, radiation, flash
jalousie: jaloux
chemin-de-fer: chemin-de-fer, entrainer
livre: livre
est: l'est
citoyen: civil
plage: côte
fonctionnalité: élément, caractéristiques, propriété
la-réserve: conserver, livre
rugir: bruit
étrangement: étrange
écorce: cortex, la-peau
réception: Bienvenue, le-reçu
plaisant: désagréable, aimable
réveiller: éveillé
recherche: une-analyse, chercher
monarque: empereur, Roi
vêtement: en-tissu, robe, vêtements
maladie: maladie, mauvais
plaisanter: blague, ironie, rire
commentaire: Explique
métal: fer-à-repasser, minéral
Solution: réparer, décision, réponse
le-tabac: cigarette, fumée
entité: instrument, unité, présence, organisation, compagnie, la-personne
partir: Départ, faire-une-digression, fissure, aller
amèrement: amer
paisible: silencieux
alarmé: anxieux
ruse: recruter, bande-de-roulement, fou, manipulation, ruse
financier: de-l'argent, économique
préparation: préparer
coquille: cosse, cortex, la-peau
nid: habite, douille
concevoir: conception, comprendre, pense
rendez-vous: nomination, promesse
rapporter: apporter, récupérer, prendre
bougie: lumière, la-cire
infraction: attaque, la-criminalité, Masse
mélange: mixte
modèle: exemple
défaut: faire-des-reproches, ride, invalidité
objection: désaccord, opposition, contradiction
artisanat: art, professionnel, compétence
la-négligence: ignorer, abandonné, omission, boycotter
données: information
arme: bras, pistolet
rose: se-leva
utilisateur: environ, bénéficiaire
grand-père: ancêtre, grand-parent
nul: zéro, vide
vigoureux: violent
foudre: électronique, boulon, flash
sport: mouvement, exercice
la-poudre: farine, poussière
peinture: image, panneau
cri: bruit, couteau, cri
négligent: téméraire, indifférence
dérivé: dériver
porte: porte
pratique: facile, pratique, confortable, facilement, correct
Courrier: bureau-de-poste, lettre
peindre: Couleur
abandoner: tradition
mettre-en-place: présenter, a-mis-en place, réparer
doux: doux, lumière
rapidement: une-seul-fois, correct
département: partie
mériter: valeur, qualifier
cesser-de: abandonné, émerger, fissure, jeter
assurance: assurer, caution
miroir: verre
terrain: conspiration, plan, histoire
ascendant: plus
Malheureusement: triste, malheureusement
modeste: commun, facile, humilité, frugal
plat: tribunal, aliments, manger
net: toile, véridique, saint
chaleur: enthousiasme, chaleureux
agité: anxieux
expérience: pilote, de-l'expérience, Essai
aujourd'hui: jour
énorme: terrible, formidable, massif, très
amélioration: réforme, réparation, progrès, la-récupération, guérir
différend: désaccord, argument
proposition: proposer, phrase
Peut-être: peut-être, pourrait
fusil: pistolet
bouclier: protéger
employer: location, utilisation
contrairement-à: divers
récupérer: enregistrer, récupérer, la-récupération
camarade: cracher, collègue, ami
organiser: commande, légiférer, organisé
Comité: panneau, commission
vieilli: Agé-de
fantôme: âme
révélation: expression
reconnaissance: admettre, confession
argile: boue, môle
tronc: tribu, bagages, botte
la-gestion: gérer, au-volant
restaurer: conserver, arrière, la-récupération, récupérer
protestation: opposition, Mars
pile: déverser, enjeu, foule
modérer: secondaire, signifier
épeler: charme, orthographe
région: champ, régional, surface
formel: officiel
éditeur: auteur, éditeur
accuser-réception: confession, admettre
remédier: médicament, thérapie, réparer
poursuivre: gâter, moniteur, dépenser, suivre
pôle: Pardon, colonne, extrême, nombril
vital: nécessaire, décisif, clé
Président: directeur
quartier: aile, régional, partie
Mme: 
acclamation: cœur, enthousiasme
justifiée: rationnel, droit, justifier
admirer: louange
ouvertement: explicitement, Ouvert, ouverture
modification: changement, adaptation
dramatique: comédie-dramatique, démonstratif
en-haut: au-dessus-de, pire
varié: divers
descente: la-nature
envie: jaloux
charge: poids, fatigue, bar, tribu
faire-semblant: feindre, comédie-dramatique
interne: interne
rideau: voile, écran
en-bonne-santé: la-santé
obscur: vague, éclipse
centre: centre
concours: course
modifier: convertir, changement, remplacer
aperçu: coup-d'œil, la-vision
Contrat: mémorandum, commande, tenir, une-entente
économie: enregistrer, espace-de-rangement, économie
chaîne: corde, chaîne, ensemble
combinaison: coïncidence, mixte, ensemble, appel
arrêter: fixer, conception
température: chaleureux
strict: strictement, pointu, difficile
professionnel: métier, professionnel
blessé: blessés, blessure
quartier: environnant, habite, écologique
fumeur: fumée, cigarette
médical: docteur
informer: journal
important: populaire, mémorable, consécutif, clé, bien-connu
institution: organisé, compagnie, organisation
pack: emballage, fermer, conditionnement
angoisse: amer, la-misère, douleur, chagrin
évidemment: évident, Ouvert, explicitement
capture: captiver, prendre, conception
ample: assez, inadéquat
chambre-à-coucher: chambre
purement: seulement, entièrement, saint
mixte: commun, mixte, appel
référer: référentielle, consulter
identifier: identité, identifiable, réparer
banc: banque
les-secours: la-récupération, enregistrer
limite: lié, abréger
attente: attendre
programme: plan, ordre-du-jour
électrique: électronique
intervalle: temporaire, briser
chasse: chasse
occuper: prendre, s'emparer-de
robe: manteau, robe, costume
bloquer: Château
proposition: proposer, phrase, plan, conclusion
Heureusement: content
ultérieur: prochaine
inquiet: instable, désagréable, anxieux, difficile
briller: éblouissement, flash
machinerie: mécanique, machine, mécanisme
séduisant: magnétique, dessiner, souhaitable
produit: des-biens
maladie: maladie
moteur: moteur, machine
les-leurs: ils
cuir: la-peau
subtil: micro, mince
pente: mile, tremper, courbé
inquiéter: anxieux, la-préoccupation
violemment: difficile
spécifié: déterminé
bois: en-bois, bâton, arbre
calculer: calcul, compter
meurtre: tuer
amusant: étrange, hilarant
insulter: mépris, honte
incapable: capable
dîner: manger
sensible: sensible, clé
appétit: désir
courtoisie: poli, honneur
sphère: champ, balle, régional
honorifique: honneur
culpabilité: coupable, la-criminalité, faire-des-reproches, péché
délicieux: délicieux, goût
blé: folklore, grain, blé
humour: humour
rencontre: chape, rencontrer, rendez-vous-amoureux
crépuscule: aube
parc: jardin
économie: économique, économie
gouverner: gérer, Règle, maîtriser
formation: éducation, formulation
maigre: mile, mince
frappe: hésiter, tapoter, battre
unité: uni, unité, la-solidarité
majeur: pionnier, clé, parent, formidable, agrafe
préliminaire: ouverture, original
frontière: lié, bord
respirer: souffle
exempter: libre, débarrasser, pardonner
riches: riches
inspiration: impulsion, inspirer
tout-le-monde: tous
abondant: riches
peintre: artiste
des-lunettes: verre
tournage: coup, chasse
wagon: entrainer, chariot
prêter: donner, crédit, citation
entreprendre: début, faire
joint: bague
le-clergé: prêtre
le-Mont: installer, augmentation, colline
tableau: colonne, ensemble, commande
magazine: Appuyez
dur: difficile, strictement
en-dépit: bien-que
serré: strictement
paysage: scénario, écologique, la-vision
abandonner: abandonné
artistique: art
principalement: notamment, en-grande-partie
fidèle: fidélité, honnête, fidèle
adapté: conforme, coïncider, correct
conseiller: Conseil, conseiller
stable: a-mis-en place, déterminé, Standard
maximum: maximiser, extrême
commettre: promesse, faire
affecter: effet, impressionner
paysan: fermier
considérablement: très, consécutif
se-déployer: détail, élargir, étendue
personnellement: individuellement, privé, posséder
moralité: moral
la-rébellion: rebelle, révolution
fil: ligne, tourner
cuivre: laiton
réponse: réaction, réponse
impérial: royal
blanc: vide, creux, blanc
mineur: secondaire, petit, mineur
bonne-affaire: Commerce, occasion
fatigue: fatigué, fatigue
aversion: mépris, haine, réluctance
Ordinaire: commun
esquisser: contour, plan
vertueux: la-vertu
en-tous-cas: toutefois, déjà
chauffeur: automobiliste, au-volant, conducteur
déclaration: un-d
excès: supplémentaire, redondance
séparation: disjonction, distance, séparé
dégoûter: mépris, phobie, haine
avec-raison: même, correct
foule: foule, Masse
inutile: déchets, Dois
fourrure: la-peau, manteau
encourager: inspirer, pousser
hommage: location
soulager: réduire, débarrasser, pardonner
législation: légiférer, Règle, corps-législatif
projet: plan
Fée: l'ange, bleu, villa
conclure: tenir, conclusion
chanceux: content
tour: le-genou, tablier, rond
gâcher: butin, se-ruiner, distordre
assujetti: facilement, avoir-tendance, sensible
réfléchi: prudent, anxieux, sage
favorable: conforme, fléchir, souhaitable
étain: banque
dépendant: dépendance, attaché, employé
mandat: assurer, justifier, mémorandum
plainte: blanc
convention: mémorandum, une-entente
angle: coin, polygone
largement: répandu, très, généralement, en-grande-partie
vache: bovins
préjudice: haine
porche: salle, balcon
surprenant: étrange, étonner, surprise, frappant
Fontaine: la-source
approprier: correct, costume, cohérent
confiant: courage, sûr, croire
organe: instrument, membre, élément, corps
sélection: choisir, nomination, élection
awe: phobie, la-crainte
comparer: comparaison
rapporter: fixer, crochet, rapports, associé
présumer: croire, Devine, supposer, considérer
disparu: perdu
à-la-mode: moderne, élégant
positivement: positif
raisonnement: idée, argument
déranger: nerveux, agressif, interférer, agaçant
partenaire: copine, commun, actionnaire
association: conjonction, considérer
la-nièce: neveu, petite-fille
physique: physiologique, corps
la-faculté: Université, factorielle
canon: balle, artillerie, pistolet
voile: navire, voile
intelligent: sage
petit: bague, banal, petit
prudence: avertissement, soins
manuscrit: facture
guerrier: héros
liquide: eau
concept: conception, connotation
spécialement: notamment
saut: Voler, danse, talon, rebondir
réticent: avoir-l'intention
en-supplément: supplémentaire
pas: chaussée, Ton, pas
gênant: inadéquat, étrange
apprécier: applaudir, prendre-plaisir
survivre: habite, rester
brièvement: acronyme, court
riz: laiton
gars: la-personne
comportement: caractéristiques, conduite
adopter: supposer, prendre
de-façon-régulière: souvent, répété, permanent, correct
enquête: sonde, chercher
constitutionnel: constitution
dernier: dernière
élève: élève
totalement: entièrement
tordu: courbé
différer: séparé, différence, divers
catastrophe: se-ruiner
pari: enjeu, condition, veto
brut: habite, la-source, brut, vert
bûche: Entrer, enregistrement, club
hospitalité: généreux
Chariot: entrainer, chariot
peignoir: robe
engager: attaché, utilisation, location, conserver
troupeau: troupeau
collecte: recueillir
la-poêle: pot
agression: attaque, raid
tromper: fou, trahir
le-deuil: chagrin
se-désister: débarrasser, dessiner, se-retirer
régler: chanson, harmonie
la-compassion: empathie, pitié
déguisement: cacher
transcription: copie
document: dossier
voisin: environnant
bloque: empêcher, le-volume
obligation: devoir
décliner: nier, tombe
ambitieux: ambition
jour-férié: vacances, le-banquet
poing: premier
aigle: faucon, cravate
honorable: honneur
important: nécessaire, consécutif, frappant
dense: compact, épais
la-fiction: roman, imagination, histoire
recommander: proposer, présenter, Conseil
éducatif: éducation
vers-le-haut: plus, au-dessus-de
Corne: blé
fonds: boîte, capital
loge: cabane, dossier, cabine
costume: robe, costume, coutume
aller: location, aller, carte
applaudissements: applaudir, approbation
rappeler: rappel-toi, ressembler
oreiller: Fleuve
nulle-part: endroit
cadavre: corps
essence: cellule, créature
élévation: raide
domaine: champ, monde
escalier: escaliers, échelle
accord: mémorandum, compact, costume, coïncider, une-entente
dentelle: pointe, Revenu
savant: élève, scientifique
règle: Duc, gouverneur
fou: cinglé, fou
divertir: Bienvenue, amuser, Divertissement
salutation: Bienvenue, carte-postale
féminin: femelle
monstrueux: monstre, terrible
établissement: équipement
voler: voler, butin
échelle: escaliers, conducteur, échelle, L'école
fin: dernière
diviser: différence, distribuer
incroyable: étrange, exceptionnellement
cambre: arc
élire: élection, choisir
timide: la-timidité, honte
brouillard: brouillard
coloré: Couleur
prévenir: avertissement, induire
peu-profond: profond
encouragement: stimulus, confort
irrégulier: commun, exceptionnellement
fidèlement: fidélité, fidèle, correct
transfert: Traduction
fondamental: base, agrafe
empaqueter: fermer, fibre
tragique: terrible
la-revue: révision, la-critique
terriblement: terrible, très, pire
cuisine: cuire, cuisine
révolte: rebelle, révolution
améliorer: réparer, guérir
épave: détruire
convaincre: persuader, assurer
bol: gobelet
illustration: exemple, image
nerf: veine, courage, nerveux
regard: réparer
vérifier: connaître, assurer, déterminé, vérifier, réparer
gage: assurer, promesse, otage, caution, pion
gagner: servez
sélectionner: choisir
industriel: industrialisation, industrie
interprétation: Traduction
Challenge: appel
interdire: empêcher, nier
thème: motif, assujettir
admission: le-reçu
piscine: piscine, fosse
conférence: session, Assemblée
égalité: analogie, équilibre, équivalence, équation
nouvellement: néo, récemment, roman
alentours: écologique, environnant
invasion: attaque, raid
modèle: exemple, une-seul-fois, Standard, forme
faire-apparaître: divulguer, trahir
résoudre: en-vrac, réparer
prêcher: sermon
grand-mère: la-mariée, grand-parent
la-laine: coton
communiquer: dialogue, socialiser, rapports
essentiellement: les-termes
s'opposer: opposition
spécimen: exemple
traînée: dessiner, les-ciseaux
surgir: cultures, récolte, Couper
exacte: correct, farine, prudent
recours: prendre, abri, briser
refus: nier, déchets
liaison: clé, caution, copule
sympathique: pitié
le-salaire: Payer
continu: Continue
exciter: induire, inciter
sauvagement: sauvage, violent
tristesse: chagrin, la-tragédie
allié: uni, associé
plafond: couverture, toit
objectif: concentrer, objectif
argent-comptant: de-l'argent
vacant: Ouvert, libre, vide, en-vrac, vague
mépriser: mépris
pelouse: herbe, pré
Dinde: 
voisin: environnant
ultime: dernière, extrême, enfin, agrafe
soumission: obéit, envoyer
entrée: Entrer
approfondi: profond, complet
passionnant: dessiner, curieuse
gagnant: Succès
conservateur: orthodoxe, gouverneur
enthousiaste: enthousiasme, anxieux
en-bas: en-bas
bouillir: cuire, ulcère
magnifiquement: beauté, beau
demain: hier
inconfortable: anxieux, désagréable
appareil: équipement
affirmer: insister
énonciation: prononcer, expression
rail: chemin-de-fer, entrainer
imparfait: complet, invalidité, imparfait
acquérir: acquisition, dériver, Acheter
offensive: raid, attaque, agressif
froidement: du-froid
conférence: cours
par-lequel: où
la-perception: sentiment, coup-d'œil, conception
développer: élaborer
fonction: cérémonie, oeuvre, activité
balle: tablette, coup, balle
lier: fixer, lié
identique: même
substantiel: démonstratif, formidable, consécutif, frappant
masse: Masse, ordre-de-grandeur, le-volume, tumeur
prolongé: long, traîner
agacé: irrité, désagréable
dérangé: nerveux, triste
bouquet: copule, bande
foins: herbe, paille
débat: désaccord, argument
immobilité: le-silence
partiel: exception, partie
du-boeuf: viande
unir: la-solidarité, harnais, réconcilier, Joindre
lame: feuille, épée, couteau
usine: moulin
nul: zéro, vide
journal: journal, Appuyez
franchement: fidélité, honnête
légitime: juridique
accent: prononcer, Accentuation, concentrer
sincèrement: sérieusement
ligue: alliance
approuver: approbation
membre: membre, extrême
intendant: gérante, serviteur
évolution: réforme, évolutionniste
enquête: vérifier, chercher
contemporain: moderne
scandale: la-corruption
délibérer: délibérément
symbole: notation, geste
la-lessive: lavage, blanchisserie
précis: correct, farine, prudent
occurrence: incident, occasion
arbre: fossé, épaule, arbre
tige: sec, tribu, racine
corporation: compagnie, organisation
préférence: privilège, préfère, avantage, choisir
exhorter: induire, impulsion, désir
suppression: distance
affirmation: approbation, Accentuation
accessible: visite, a-trouvé
comédie: humour
chasse-d'eau: Couleur, excitation
code: cour, encoder
adéquat: assez, correct
Divisé: distribuer
historien: historique
intensité: densité, fatigue
la-démocratie: république
credo: confession
attraction: charme, la-gravité
concert: Festival
vers-le-bas: en-bas
canal: canal, tuyau
rapide: bientôt, demande, agile
bronze: laiton, brun
vêtement: vêtements
remords: triste, pitié
exclusif: monopole, privé
porter: porter, transporteur
tiret: ligne
bande: bande
au-bout-du compte: enfin
équipe: Chorus
cher: chère
quartier-général: siège-social, centre
aigu: pointu
embarrassé: nerveux, honte
progéniture: enfants
réseau: toile
avion: oiseau, surface, machine
partiellement: partie
fièrement: fierté
terrasse: balcon, toit
poignée: tenir, piège
explosion: éclater
troupe: armée, militaire
fermement: strictement
peine: pitié, phrase
saleté: humide, excréments, boue
ère: saison
ambassadeur: Messager
race: multiplier, course
ingérence: interférer, ennui, trouble
consister: passer, contenu
acceptation: acceptable, approbation, le-reçu
ingénieur: mécanique
arrêt: le-pied
alternative: alterner, remplacer
timbre: bague
compteur: disque, opposition, contraire
Vénus: Vendredi
imaginaire: imagination
escalade: monter, se-glisser
attirer: dessiner, impressionner
étonnant: surprise, frappant
compétition: rival
cristal: verre
douche: bain, pluie
philosophique: philosophe, philosophie
bruyant: bruit
dispositif: équipement
transport: circulation, la-navette
finalement: enfin
terriblement: très, terrible
contemplation: réfléchir, réflexion
fabrication: industrie, produire
confortablement: confortable
exposition: exposition, rapport
agricole: agriculture, ferme
quête: chercher
extension: détail, élargir
controverse: contradiction, argument
grossièrement: presque
aérien: au-dessus-de
retenir: inhibition, empêcher, retenue, conserver
la-préservation: enregistrer, soins, conserver
pub: bar
bassin: vallée, piscine, lavabo
mélodie: Ton
louer: location
inquiet: anxieux, nerveux
personne-âgée: vieillesse, Agé-de
université: Université
prudent: prudent
avant: l'est, avant
compliqué: complexe, difficile, élaborer
excuses: s'excuser, Pardon
effrayé: effrayé, la-crainte
remplacer: alterner, allocation, remplacer
usage: utilisation
restauration: réparation, la-récupération, récupérer
haie: clôture
primaire: maîtriser, base, original, agrafe
faisceau: rayon
tour: visite, expédition
exagéré: du-sel
compétent: activer, capable
urgent: bientôt, précipité
alerte: avertissement, alarme, éveillé
four: poêle
arrondie: rond
conventionnel: commun
plaider: mendier, justifier
corde: corde
aux-côtés-de: parallèle, prochaine, conjonction
extrait: citation, jus
plus-léger: lumière
pinte: bière
tube: tuyau
rue: occasion
efficace: qualifié, efficace, effet
mélanger: mixte, mélanger
perturbation: trouble, ennui
exécutif: gérante
dixième: Dix
comparatif: comparaison
un-m.: matin, brillant
cage: Château, cellule
prison: prison, chaîne
habile: qualifié, ruse, capable
crier: cri
compromis: une-entente, harmonie
munition: coup
assistant: supporter, Aidez-moi
canne: bâton
Soutenir: discuter, insister
logique: argument, rationnel, rationalité
panique: la-crainte
circulation: Faire-du-vélo, cycle, circulation, sightsee
stress: fatigue
consommation: utilisation, consommer, manger
soutenir: aider, conserver, tenir, souffrir
crash: tombe, conflit
manque: inadéquat, Couper, imparfait
graduel: au-fur-et à mesur
écraser: détruire, la-gravité, squash
phénomène: incident, chose
exécuter: courir, action
saluer: la-santé, Bienvenue, saluer
la-monarchie: royal, propriété
se-comporter: habite
barrière: obstacle, au-seuil
courbe: arc
compter: compter
commodité: facilement, confort
agneau: le-mouton, se-glisser
logique: rationnel
régime: aliments
judiciaire: tribunal, juridique
méfiance: doute, fidélité
la-plume: le-printemps, pitié
volontaire: bénévole
veste: manteau, chandail
la-natation: baignade
impressionnant: frappant
sous: en-bas, après
provincial: rural, Province
compensation: compenser, allocation
serveur: serviteur
promouvoir: accélération, promotion, favoriser, pousser, contribuer
consacrer: avoir-l'intention
hostilité: hostile
plantation: ferme, garderie
exposer: contour, divulguer, Ouvert
pièce: endroit, attachement
interruption: briser, ennui
pouce: pouce
révolutionnaire: révolution
incroyable: étrange, étonner
pointe: hémisphère, pointe, extrême, barbe, sommet, Conseil
menace: menaçant, danger
jungle: forêt
typique: commun, caractéristiques
carburant: huile
tranquille: silencieux
destination: répétition, objectif, le-sort
épingle: secret, aiguille
Mars: Mars
associer: associé, collègue, conjonction, commun, parallèle, attaché
vicieux: immoral, mal
banquet: le-banquet
détaillé: élaborer, profond, charnière, détail, prudent
placard: cabinet
législatif: légiférer, corps-législatif
la-marge: bord, champ
champion: héros
impulsion: impulsion
fuir: courir, échapper
clause: courant, paragraphe
composé: conjonction, complexe
nœud: tenir, tricoter
relation: rapports, rapport, considérer
agence: organisation, compagnie, Bureau
sourire: sourire, grimace
manifestation: montrer, Mars
dépression: chagrin
véhicule: machine
emprunter: crédit, citation
gonflement: se-gonfler
sujet: motif, assujettir, gros-titre
verdict: décision, Règle
sabbat: samedi
identification: identifiable, identité, définition
photographier: image, coup
allié: ami, relation-amicale, uni
tract: façon, étendue, argument
ruban: bande, film
plus: plus
transparent: transparence, évident
du-parfum: odeur
embêter: difficulté, interférer, agaçant, ennui
qualifié: capable, qualifier, qualifié
essai: article, rapport
cavalier: Chevalier, équitation
solitude: solitaire
poignet: le-Main
finement: doux, mince, enfin
nul: zéro, vide
condamner: phrase
mâchoire: pin
unique: uni
inévitablement: inévitable
tambour: danse, vide
poubelle: boîte, panier
durée: temporaire, permanent, temps, longueur
peser: mesure, poids
monastère: une-abbaye
publier: publication, distribuer, divulguer
perspicacité: la-vision
certainement,-vraiment,-définitivement: évident, strictement, cours, vraiment, explicitement
décalage: changement
ce-soir: jour
facteur: raison, employé, coefficient
désordre: agressif, trouble, confusion
entraine-toi: exercice, action
sanctuaire: autel
rétrécir: acronyme, recueillir
dépense: frais, utilisation, dépenser
encourageant: cœur, inspirer
exposition: expression, exposition, rapport, effet
brut: brut, vert
billet: bannière, carte
en-arrière: arrière
chaussure: chaussures, botte
fraude: illusion
explosion: éclater
cheminée: la-cheminée
pot: verre, bouteille, lanceur, pot
la-sauce: pansement
pourri: paresseux, immoral, pauvre
comportement: caractéristiques, conduite
prêt: crédit, citation
déraisonnable: rationnel, absurdité
luxure: ambition
annuellement: an
fluide: eau
enfant: enfants
fou: cinglé, fou
renverser: verser
exploit: Succès, rang, exploit
hypothèse: supposer, imagination, soi-disant
humoristique: humour, hilarant
extase: enthousiasme
la-retraite: se-retirer, démission, Pension
parlement: corps-législatif, sénat
urgence: anxieux, crise
parcelle: emballage, partie, fermer
tiroir: boîte, escaliers
contribution: contribuer, enjeu
lien: attachement
cueillir: courage, extorquer
impression: publication, impression, Appuyez
avocat: avocat, justifier, défendeur
Environnement: atmosphère, écologique
confirmer: prouver, assurer, renforcer
annoncer: divulguer, publication
démissionner: démission, se-retirer
rejeter: nier, veto
dure: difficile, cruel
fragment: puce, morceau, ferraille, étendue
méditation: soins, réfléchir
tache: endroit
enterrement: funérailles, enterrer
hypothèse: supposer
hypothétique-humeur: spéculatif-humeur, présumé-humeur, conditionnel-humeur
transaction: activité, Commerce
outrage: colère, mépris, honte
varier: variable, divers, remplacer
mandataire: avocat, représentant
offenser: coupable
paquet: emballage, poche, fermer
classique: classique
ranch: ferme
tarte: gâteau, pi
avec-précision: droit, précision, strictement
jeter: jeter
Marin: marine, mer
chanteur: lecteur
électricité: électronique, courant
extraterrestre: étranger, client, extra-terrestre
fissuré: éclater, fissure
déprimé: triste, chagrin
épais: épais
raisonnablement: raison, rationnel
câble: creux, fléchir
illustrer: Explique, réfléchir
adoption: approbation, le-reçu
célèbre: bien-connu
blesser: blessure
correctement: précision, correct, droit
pâturage: saule, pré
ver: masque, profond
estimation: évaluation, Devine
tenue: organisation, vêtements, équipement, robe
malchanceux: malheureux, malheureusement
huitième: huit
détendu: confort, relaxation, silencieux
adjacent: presque, environnant
supérieur: ancien-combattant, parent, directeur
effrayer: alarme
tuteur: entraîneur
vol: butin, voler
commerce: Commerce, commercial
disparu: disparaître
bosse: Masse, torus, bosse
accidentel: aléatoire, temporaire, coïncidence, surprise
locaux: maison, endroit, bâtiment, à-l'intérieur
livraison: présenter
courbé: courbé, fléchir
productif: fabricant, produire
gonflé: se-gonfler
cultiver: favoriser, ferme
variation: changement, différence
adversaire: rival, opposition
petit-fils: petite-fille, neveu
clouer: ongles, pointe, boulon
bienveillance: généreux, aide-sociale, la-vertu, la-grâce
précision: précision
indication: Marc
réduction: réduire, Couper
ventre: estomac, nombril
dégoûté: haine
composer: écrit, Créer
passager: voyageur
piquer: coup-de-couteau, amer, mordre
simultanément: pendant-ce-temps
épisode: consécutif, partie
persistant: cohérent, Continue, permanent
affamer: affamé
consultation: consulter, Conseil
acide: acide
souligner: insister, Accentuation
le-défilé: Mars
casque: chapeau
proclamer: la-propagande, publication
hébergement: hôtel
pulvérisation: médicament
officiellement: officiel
inquiétant: nerveux, interférer, anxieux, agaçant
anticipation: attendu, attendre
qualité: pont, coefficient, rang, évaluation, degré
tabouret: excréments, chaise
justification: justifier
étranger: étranger, client
le-transport: circulation, la-navette
compréhension: comprendre
directeur: gérante, directeur
temporel: temporaire, temps
bien: beau
imposer: imposer, contraindre, activer, police
complet: profond, complet
menacer: menaçant
progressive: progrès, radical
Ressource: la-source
confiner: limité, s'emparer-de, abréger, réduire
féliciter: louange
Assurance: sûr
nommer: œil
couper-la-parole: obstacle, Couper, interférer, amputer, briser
réprimer: opprimer, empêcher
couche: colonne
indice: preuve, clé
dent: dents, dentiste, bosse
une-garantie: assurer, caution
procédure: processus, mécanisme, action, approche
recommandation: Conseil
écart: briser, ouverture
impliquer: signifier
joindre: attaché, épissure, fixer
posture: geste, indicateur, position, se-mettre-debout
suite: aile, ensemble, appartement
bijou: trésor, fleurir
émotif: sentiment, passionné, sensible
béton: démonstratif, cohérent
combiner: alliance, conjonction
pic: sommet
devise: de-l'argent, pièce-de-monnaie
objectif: objectif, concentrer
Mémorial: Mémoire, avertissement
séparément: séparé, différence, individuellement, solitaire
plateau: disque
horizontal: équilibre
charte: constitution, papier, location
article: des-biens, article, élément, voix, aimable, position
expansion: détail, élargir
torsion: boulon, tourner, ironie
traditionnel: tradition, classique
impliquer: y-compris, inclusion, contenu
routine: commun, mécanisme
résoudre: charrue, en-vrac, réparer
tenter: taquiner, induire
infructueux: échouer
homme-politique: politique
couvercle: toit
violation: blessure
jonction: ordinal, Traversée
patron: propriétaire, gérante, employeur, directeur, voleur
Matériel: équipement
brin: côte, bande
bord: bord, falaise, lèvre
marchandises: Commerce, des-biens
distant: séparé, un-moyen, éloigné
asile: hôpital, abri
affirmer: prouver, assurer
calendrier: table, calendrier, graphique, disposition
tranchée: fossé
municipal: ville
émeute: mélanger
témoigner: prouver
maternel: Enceinte, maman
sculpture: statue
saveur: goût
marque: Manuel, Marc
bagage: bagages
ordures: absurdité, ferraille, déverser
outil: instrument
le-chaos: trouble, confusion
poursuite: costume
tendu: nerveux, temps
poule: poulet
réduire: ornement, réduire, Couper
discret: sage
faire-le-deuil: cri
dialecte: polonais
élémentaire: base
fret: bagages, bar, un-camion
essuyer: balayage
le-déni: nier
sous-la-terre: secret
intermédiaire: vérifier
formule: équation, Appuyez
Tricher: fou, manipulation
hanter: hésiter, phobie
Inscription: liste, enregistrement
indéfini: vague, aoriste
surplus: supplémentaire
frisson: trembler
tissu: organisation, toile, en-tissu
Brouillon: contour
jouet: poupée, joue, jeux-d'argent
escalier: escaliers, échelle
transition: infection, changement, transitif, Traversée
bouton: clé
méchant: grossier
programme: plan, ordre-du-jour
fabrication: industrialisation, moulin, produire
zone: champ, régional, bande
neuvième: neuf
alcool: du-vin
avide: ambition, avidité
diriger: gérer
influent: efficace, pénétrer
entourer: collier, siège
noyer: lavabo, coin
diapositive: glisser
truie: monter, pain, cochon
dominant: formidable, raid
leadership: hiérarchie, Manuel
journal: journal, calendrier
célébrer: persuader
agitation: excitation, bruit, agaçant, confusion
adjoint: représentant, alterner
automobile: moteur
amendement: révision, changement
verticale: se-mettre-debout, longitudinal
insuffisant: inadéquat, assez
mince: mince
inférence: Devine, conclusion
inférentielle-humeur: inductif-humeur
publicité: un-d, commercial, la-propagande
vol: voler, plagier
spontané: instinct, arbitraire
utilitaire: organisation, utilisation, instrument
brancher: fixer, crochet, épissure, Joindre
vers-le-bas: en-bas
intervention: interférer
la-relance: relancer, la-récupération
Internet: Commerce
physiquement: la-physique, corps
point: endroit
choquant: choc
grossièrement: grossier
équilibré: cohérent
indice: exposant, liste, indicateur
transmettre: envoyer, distribuer
sur: au-dessus-de, dehors, vers-l'avant
bavarder: parler, statistiques
ambre: jaune
tonne: Ton
doucement: confortable
tension: fatigue, excitation
baleine: élection
toxique: poison
Concession: bouger, privilège, remise
ouvrier: employé
inclinaison: tremper, conjuguer
toilette: cabinet
infraction: attaque, la-criminalité
rancune: haine, vengeance
courage: la-patience, courage
anticiper: espoir, attendre
le-rythme: battre
rat: une-souris
correspondre: correspondance, costume, correct, réponse
détenir: empêcher, s'emparer-de, conserver
interpréter: Explique
salon: salle
fonctionner: manipulation, oeuvre, courir, action
drain: gouttière, courir
salaire: Payer
méchant: haine, mal, désagréable, décevant, laid
le-cimetière: funérailles
plâtre: craie
robinet: tuyau, lait
rejeter: sac, ignorer, nier, veto, distinguer, redondance, pardonner
provoquer: excitation, irrité
résider: rester, habite
décoration: ornement
doigt-de-pied: la-pointe-des pieds, le-pied, doigt, patte
incapacité: invalidité, la-faiblesse
inventer: invention
définir: déterminant, élaborer, décrire
limité: limité, lié
placard: cabinet, étagère
grille: étagère
surveillant-général: conducteur, inspecteur
présentation: présenter, montrer, exposition, promotion
caoutchouc: balle, élastique
exclure: priver, effacer, distinguer
privilégié: privilège
ermite: ascétique
se-gratter: gratter, début
vis: boulon
Explorer: observer, exploit
assurer: assurer
cylindre: disque
résumé: contour, abstrait
improbable: probabilité
essaim: troupeau, fils
systématique: mécanisme
pratiquement: vraiment, presque, pratique
client: coutume, client
catalogue: liste, table
chimie: chimique
cuire: pain, cuire
percer: coup-de-couteau, pénétrer, ennuyer, perforer
arracher: larme, s'emparer-de, kidnapper
commencer: émettre, jeter
agriculture: agriculture
actrice: acteur
le-théâtre: le-théâtre, salle
drogue: médicament
négatif: pire, désavantage, inverser, négatif, nocif
bonbons: menthe, le-chocolat, sucré
pâte: ensemble, Collier
condamner: piège, punir, coupable
enquêter: sonde, observer, vérifier
forfait: emballage, ensemble, fermer
crawl: se-glisser, se-recroqueviller
casser: pop, clic, image, marée, bientôt
pneu: embryon, bague
perceptible: frappant, évident
noyau: base
prédécesseur: ancêtre
De-même: également, même
barrage: poussière
glissant: glisser
transformation: changement
la-frange: bord
emplacement: position, endroit
grappe: conglomérat, Masse, bande
devis: citation
garde: diligence, soins
plausible: acceptable
lancer: jeter
échelon: bande-de-roulement
concentration: accumulation, concentrer
pratique: pratique, confortable
appât: goût, apprêt
diverse: divers
tranche: puce, disque, morceau
percer: ennuyer, creuser
répondre: réaction, remboursement, réponse
mortalité: la-mort
cannabis: herbe
relativement: le-volume
mathématique: mathématiques, athlétique
moralement: moral
haleter: soupir, souffle
courses: course
isolement: disjonction, séparé
parfois: de-temps-en temps
adulte: mature
épreuves: amer, la-misère, difficulté, ennui
rumeur: potins, voix
résister: conserver, ours, dernière
junior: Jeune
tricot: tricoter
indirect: directement
précédent: exemple
rayon: rayon, salle, Traversée
contredire: contradiction, nier
racheter: enregistrer, compenser
sentier: façon, passage-clouté
équipement: équipement, dents, nervure, courir
fête: le-banquet
confortable: chaleureux, confortable
édition: publication, distribuer
client: client, acheteur
couverture: tapis, plancher, couverture
partition: compter
perspective: coup-d'œil, la-vision
esthétique: beauté
ressentiment: haine
pose: proposer, induire, se-mettre-debout
contentement: satisfait
organisme: créature
inintelligible: comprendre
catégorique: Accentuation
midi: après-midi, Sud
lis: lis
nom: nominalisation, prénom
pliant: plier, courbé
utile: Aidez-moi
persister: insister, Continue, dernière
sortie: Sortie, douille, Départ
hériter: héritier
vitesse: la-rapidité, précipité
insultant: verbal
carence: inadéquat, Couper, omission, imparfait
assurer: assurer
injuste: droit
sous: remplacer
seau: baril, cuillère
organisation: organisation
principalement: notamment
rituel: cérémonie, culte
cuisse: jambon, le-pied
garde-robe: vêtements, cabinet
texture: organisation
turbulent: violent
le-marais: marécage
ignorant: ignorant
initiale: ouverture, original, début, premier, primitif
le-minimum: moins
correction: réforme, révision, réparation
négliger: ignorer, oublier
unanime: uni
carbone: charbon
bobine: dossier, rouleau, bouclé
croustillant: fragile, pointu
vocabulaire: dictionnaire
promenade: errer
aptitude: exercice, gymnastique, condition
la-nationalité: nationalisme, nationale
saveur: goût
sans-importance: nécessaire, banal, hors-de-propos
coup-de-poing: battre
foulée: progrès, bande-de-roulement
axe: épaule, impression
satisfaisant: maladie, satisfait
fiable: fidèle
dégoûtant: haine, laid
éthique: moral
effondrement: tombe
coussin: Fleuve
confondre: falsifier, détruire, étonner, échouer, embarrasser
mythe: histoire, légende
la-possession: propriété
effrayer: effrayé, terrible, la-crainte
frein: briser
noix: haricot, graine
agrandir: se-gonfler, augmentation
solaire: ensoleillement
bec: lèvre, unité
bail: laisse, location
rapport: rapports, comparaison, échelle, rapport, analogie
peigne: brosse, épaule, crête
Traduire: Traduction, bascule
récréation: Divertissement, vacances, relaxation
caprice: Couleur
échantillon: exemple, Essai
pluriel: Masse
initiative: plan, Essai
gelée: confiture, lait
anarchie: trouble
profil: contour, dossier, site-Internet
la-finance: de-l'argent
de-base: base, agrafe
bannir: déverser, raid
Electrique: électronique
herbe: herbe
prospérer: fleurir
similarité: analogie, ressembler, la-solidarité
confidentialité: privé
arène: champ
voyageur: voyageur
particule: atome, graine
inné: original
habitant: résident
flûte: sifflet
reproduction: la-fertilité
envergure: longueur
salade: salade, du-pouvoir
colorant: Couleur
démontrer: prouver
éthique: moral
officiellement: officiel
ennuyer: interférer, agaçant, taquiner, inciter, ennuyer
vol-plané: glisser
trait: caractéristiques, propriété, étendue
compositeur: musicien
au-football: coup-de-pied
Partenariat: collaboration, alliance, contribuer
continuation: Continue
anormal: exceptionnellement, cinglé
séquence: chaîne
écraser: pousser
tacle: s'emparer-de, chape, équipement
freiner: inhibition, chaussée, retenue
La-publicité: un-d, la-propagande
le-retrait: régression, douille, conclusion
hypothéquer: otage, crédit, pion
abstention: la-patience, ours
réprimer: empêcher, opprimer
époux: mari
valide: efficace
soupape: van
construction: Créer, bâtiment, formulation, phase
vapeur: vapeur, couple
chauve-souris: bâton, club, vers-l'avant
contradictoire: contradiction, hors-de-propos, contrastant
automatique: directement
explicite: Ouvert, transparence, axiome
efficacement: efficace, effet
dépendance: dépendance
inspecter: observer, vérifier, sightsee, une-analyse
bizarrement: étrange, exceptionnellement
transporter: dessiner, butin
embarrassant: honte, embarrasser
désactivée: invalidité, passif
arrogant: fierté
boucle: bouclé, bague
gemme: pierre, fleurir
anniversaire: anniversaire
prestige: crédit
négligence: omission, mépris, indifférence
soi-: privé
discrimination: exception, distinguer
continental: continent
cible: objectif
stalle: boutique, se-mettre-debout
investir: investissement
croisière: navire
rassemblement: la-solidarité, action
rumeur: potins, voix
activement: sérieusement
vérifier: vérifier
compartiment: appartement
spécifiquement: notamment
coup: pop, éclater, coup
agrégat: brut, commun
fraction: partie, enjeu
illégal: illicite, sauvage
dissoudre: effacer, soluble, solvant
équilibre: équilibre
exploration: sonde, une-analyse
oignon: arc
affinité: analogie, la-solidarité, dépendance
malhonnête: fidèle
choc: conflit, choc, interférer
fauteuil: chaise, canapé
pâte: farine, Masse, levure, gâteau
embarquer: Joindre
transe: la-vision
rejet: nier, déchets
variance: différence, correct, contradiction
absorption: la-peau
collectif: Masse
opportun: temps
envahir: attaque
congédiement: sac, redondance
significativement: en-grande-partie
expérimental: pilote
film: film, la-télé, image
publicité: la-propagande, promotion, un-d
développer: élargir, détail
chute: trébucher, tombe, tremper, vêtements
forger: Créer, falsifier
fossile: huile, archéologique
contrainte: obstacle, règlement, retenue
zeste: enthousiasme, pimenter, de-l'expérience, goût, la-peau
délicat: agaçant
Hamlet: banlieue, village
boom: fleurir, rebondir, éclater
reproduire: copie, imiter
congrès: Assemblée
grain-de-raisin: du-vin
atelier: studio, séminaire
diminution: réduire, Couper, tombe
prononciation: prononcer
jugement: décision, phrase, Règle, juge, juridiction, crise
concentrer: prudent, concentrer
annuler: divulguer, arrière
traversier: yacht, navire
simple: facile, directement, facilement, transparence, linéaire
altitude: longueur
dénoter: montrer, signifier
exporter: Sortie
délinquant: comète, coupable
désapprobation: opposition, veto
par: couple, équilibre
abolir: effacer
ajuster: révision, réparer, adaptation
adhésion: membre
jauge: mesure, échelle, ordre-de-grandeur, mince, indicateur
tolérer: pardonner
hanche: fesses, taille
adhérer: suivre, Joindre, bâton, conserver
repousser: empêcher
troubles: trouble
chasteté: précision, pureté
mou: relaxation, en-vrac
contraction: la-timidité
journaliste: journaliste
symptôme: exposition
vélo: Faire-du-vélo, cycle
le-goudron: chaussée
spirale: tourner
commentaire: vaccin, définition
transmission: infection
scrutin: voix, élection
potentiel: capable
éligible: capable, droit, qualifier, correct
boucle: Faire-du-vélo, charnière, bague
ouvrier: employé
poursuivre: faire-des-reproches
Licence: autorisation
renoncer: décharge
ego: se, souffle
jet: éjecter, oiseau, courant
violer: désobéir, Couper
intoxiqué: dépendance
survie: durée-de-vie, une-voyelle
gel: congelé
tisser: tricoter
titulaire: a-mis-en place, bénéficiaire
apathie: indifférence
organiser: organisation, préparer, légiférer, organisé
probablement: peut-être, soi-disant
accord: une-entente
saigner: du-sang, sanglant
détection: a-trouvé, chercher, divulguer
briser: détruire, briser
faciliter: accélération, favoriser, contribuer
la-fréquence: cycle, hésiter
point: couture
annuaire: preuve
côtelette: mordre, Couper, bifteck
chauffage: chaleureux
déprimant: décevant, triste
coup: révolution, coup, accident-vasculaire-cérébral
compatissant: pitié
penseur: intellectuel
budget: équilibre
civique: civil, Urbain
insérer: Entrer, augmentation
méditer: réfléchir, pense
flexible: facile, fléchir, élastique
dalle: panneau, tablette, poêle
qualification: Talent, qualifier
interrupteur: inverser, convertir, clé
serviette: en-tissu
décennie: Dix, tenir
plusieurs: divers, plus
bandage: pansement, fixer
bien-rangé: soigné
taper: tapoter, applaudir
érable: paume
râteau: balayage
vide: vide
moelle: huile, cerveau, gourde
gaine: manteau, enveloppe, cosse
absorber: exploit, sucer, embrasse
la-prévision: prévisible, Devine
éduquer: éducation, entrainer, enseignement
enquête: sonde, demande, chercher
domination: Règle
parental: parent
participer: delta, Joindre, engagé
ascenseur: ascenseur
latéral: côté
remettre-à-plus tard: retard
répugnance: mépris, haine
noyau: le-nucléaire, cellule, embryon
métaphore: exemple
diminutif: petit, micro
bombe: pompe
critique: profond, critique
rouille: passer
réservation: conserver, s'emparer-de
Coudre: couture
chimiste: chimique
salon: briser, salle
début: début, raid, attaque
se-plonger: tremper
hostile: hostile
recensement: calcul
dénoncer: accuser, phrase
lin: lin
suspendre: empêcher
gifler: battre
relaxer: relaxation
cour: cour
marchandise: des-biens
continuité: conjonction
réciproque: échange, inversion
ordonnance: médicament, copie
bulle: mousse
pelle: pinces, rame
utiliser: exploit, utilisation, dépenser, harnais, consommer
durable: long
lignée: familier
zinc: lavabo
quel: peu-importe, laquelle
fini: limité, enfin, fini
auxiliaire: supporter, le-sida
brouiller: fausser, bataille, accident-vasculaire-cérébral
académique: éducation
pneu: embryon, bague
consommateur: utilisation
validité: valeur, crédit
approximativement: presque, approximatif
tricoté: tricoter
microscope: lunette-astronomique
civil: civil
sangle: laisse, corde
symbolique: geste, identité
adapter: adaptation, chape, transcrire
probabilité: probabilité, capable
subjectif: mentalement
pronom: conscience
à-tort: faux, abuser-de
décourager: embarrasser, ambition
nouveau-venu: client
infini: infinitif
graphique: graphique
figue: en-forme-de, image
niche: cohérent, clé
décevoir: décevant, trahir, échouer
projection: plan, montrer
libération: décharge, salut
recette: stimulus
franchise: privilège
incongru: absurdité, hors-de-propos, inadéquat
rotation: cycle, révolution, tourner
bouton: bourgeon
mètre: mesure
restriction: lié, retenue, règlement
Catégorie: Communauté, rang
racial: course, racisme
substitution: au-lieu, remplacer, changement
innovation: invention
affronter: chape
interdire: nier
décoratif: ornement
hall: induire, salle
lancer: jeter, bouclé
rouleau: livre, rouleau, bouclé
mécanicien: mécanique, artisan
agression: attaque, agressif, dépasser
Hey: Salut, Bienvenue
la-mesure: mesure
rivaliser: lutter, rival
académie: Université
novice: recruter, Frais
divorcé: divorce
laitier: lait
réservoir: réservoir
courses: boutique, Commerce
implicite: cohérent
stratégique: stratégie
moule: modulo, forme, impression, jeter
répétition: exercice, répétition
insistance: insister
précéder: avant
milieu: médiéval, à-mi-chemin, taille
touristique: voyageur, le-tourisme
boisson: boire
conscient: prudent
articuler: Explique, expression
ré-: puis, arrière
modifier: révision, changement, remplacer, épissure, réforme
diagramme: graphique, carte
déductif-humeur: inductif-humeur
submerger: opprimer
mobile: téléphone, cellule
élever: promotion, ascenseur
paradoxe: contradiction
exagérer: du-sel, maximiser
blond: jaune
signal: Marc, mot-de-passe, bâton
coureur: salle
négocier: parler, discuter
régime: Règle
tolérance: tolérant, ours
option: alterner, concombre
croisade: mouvement
épidémie: la-tragédie, Traduction
technique: technique, approche, ingénierie, équipement
Terminal: enfin
diplômé: passer
sortie: frais, conclusion, publication, Départ, productivité, Sortie
Localiser: endroit
défaut: omission, Standard
le-contexte: écologique, scène, connotation
coalition: alliance
défaut: faire-des-reproches, faux, invalidité, désavantage
concéder: admettre
diffuser: publication, envoyer
composer-un-numéro: choisir, bague, recueillir
prévalence: populaire
de-plus-en plus: tous
transformer: changement, convertir
cerf-volant: dragon
ambigu: vague, contradiction
café: café, bar
prix: récompense, prime, admettre
étiquette: studio, Marc
approuvant: approbation, admettre
parenté: analogie, socialiste
réaliste: vraiment
reptile: serpent
de-plein-air: dehors, Ouvert
politiquement: politique
résidu: restes, déchets
bande: cassette, bande, film
fade: doux, sucré
oral: verbal, lèvre
spéculer: Devine
expulser: éjecter, décharge
défaut: endroit, invalidité
sauter: danse, dépenser
agresser: gobelet, grimace
coin: pointe, enjeu, coin
exemption: remise, exception, redondance
portable: petit
emballage: conditionnement, emballage
éclat: Talent, beauté, éblouissement
ailette: rame, ballet
murmurer: chuchotement
baie: baie
immigration: migration
houe: charrue
chirurgie: chirurgien
accumuler: accumulation, dépôt, recueillir
caca: excréments, tuyau
abdomen: estomac
implication: connotation, inclusion, conclusion
motivation: stimulus
clé: tournevis, clé
campagne: rural, banlieue, champ, village
dégrader: détruire, réduire
indigène: la-nature, original, résident
empiler: déverser, crête, la-cheminée
disque: disque
tendance: conduite, direction, courbé, disposition, dérive
d'entreprise: compagnie, commun
acquitter: débarrasser
instable: instable, impermanence
compatible: cohérent, parallèle, conforme
téléphone: téléphone
vide: vide
saisir: coup-de-couteau, prendre, s'emparer-de
convulsion: séisme, éclater
ennuyeuse: ennuyé, ennuyer, agaçant
portefeuille: ensemble, portefeuille
fente: fissure
complication: problématique, péage
intervenir: interférer
polaire: polarité, extrême
déléguer: représentant, Messager
volition: volonté, désir
prédire: prévisible, Devine
optimisme: espoir, croire
peler: la-peau, cosse, cortex
tailler: mordre
flotter: flotte, monter-en-flèche, hésiter
secteur: champ, industrie, régional, partie
nom-de-famille: prénom, ils
institut: organisé, compagnie, organisation
urgence: anxieux
agréable: aimable
dissuader: empêcher
négation: nier
gagnant: Succès
composite: mixte
impact: effet, conflit
fibre: fibre
siroter: avaler
visuel: optique, scène
griffe: patte
demandeur: acteur, transporteur, raison
déplorer: pitié
tromper: fausser, étonner, fou
interdire: inhibition, empêcher, nier
interprète: acteur, artiste, joueur
le-tournoi: course
exigence: demande, condition
moins: moins
désordonné: téméraire
infectieux: infection
mettre-en-relief: insister, Accentuation
un-pantalon: pantalon
embrouiller: casse-tête, étonner, embarrasser
consacrer: bénévole, avoir-l'intention
chirurgical: chirurgien
véracité: fait, précision
centième: cent
inclinée: raide, tremper, courbé
juste-à-côté: presque, bientôt, environnant
normalement: commun, souvent, généralement, avoir-tendance
déroutant: contradiction, casse-tête, confusion
proportionnel: comparable, équilibre
être-en-désaccord: désaccord
irriter: colère, interférer, taquiner, irrité
exceptionnel: mieux, frappant
initiation: début
précipitation: précipité
terrifier: alarme
Loisir: Divertissement
grammatical: grammaire
numérique: nombre, numérique
critère: Standard
prévoir: prévisible, Devine
désapprouver: nier
exotique: étranger, étrange
bulbe: lampe
améliorer: élargir, augmentation, maximiser, guérir
la-fusion: faire-fondre, appel
sondage: élection
talentueux: Talent, qualifié
dégel: faire-fondre
redresser: étendue, réparer
décorer: ornement
présidentiel: présidence
bosse: prématuré, multiplier, coup-de-pied, bosse, tumeur
félicitation: louange
balayage: balayage
habiliter: activer, droit
pari: condition
techniquement: technique, ingénierie
empirique: de-l'expérience
dominer: maîtriser
de-la-publicité: un-d, la-propagande
la-diffusion: distribuer, publication
pâturer: gratter
trousse: équipement, boîte, ensemble
praticien: docteur, entraîneur
tremper: sucer, tremper
préservation: protéger, enregistrer, soins
vase: boue, chaussée, dribble
difficile: difficile
la-pollution: polluer, la-corruption
produits-chimiques: chimique
lot: troupeau, impulsion, le-volume
maman: maman
effrayant: terrible, menaçant
spécialiste: expert
aspirer: désir
salle-de-bain: bain
pari: jeux-d'argent, joue, aventure
intégral: nécessaire, intégré
éliminer: débarrasser, effacer
pois: haricot
annexe: attachement, supplémentaire, allocation
circuler: distribuer
compris: uni
le-vendeur: revendeur
harceler: nerveux, interférer, obsession
exploser: éclater
levier: curiosité, levier
répandre: fuite, verser
gratuitement: libre
ingrédient: élément
déficit: Ouvert
bouleversant: nerveux, agaçant, désagréable, triste, trouble
logement: maison
photographique: phase, image, photographe
ravageurs: insecte
pilule: tablette
actuellement,-en-ce moment: présent
médias: Appuyez
débris: se-ruiner
corpus: corps, ensemble
le-menu: liste
fracture: fissure
forum: Plate-forme, ennuyer, tribunal
élan: la-rapidité, impulsion
incliner: luth, courbé
tuile: brique
bibliothèque: bibliothèque, librairie
calcul: calcul
producteur: fabricant
monétaire: de-l'argent
représenter: décrire, réfléchir, présenter
inflation: se-gonfler
marginal: bord
fantaisie: imagination
saper: détruire
cohérent: strictement, conjonction, cohérent
fondamentalement: les-termes
intentionnel: délibérément
survivant: Famille
flux: Fleuve, courant
compétitif: rival
bijoux: ornement
alcoolique: ivre, du-vin
établir-une-discrimination: distinguer
militant: radical, terroriste, militaire
désarmer: bras
crucial: nécessaire, décisif
affectation: oeuvre, exercice, devoir, attribution
quota: privilège, attribution, quantum
les-fouilles: fosse, creuser
calcium: coup-de-pied
commémorer: persuader
historiquement: historique
salut: Salut, Bienvenue, salut
élimination: débarrasser, omission, effacer
tendu: soigné
relaxant: confort, confortable, relaxation
efficacité: efficace, effet, compétence
vulnérable: sensible
athlète: athlétique
bande: rayé, ligne, bande, film
façade: masque, la-vision
agrafe: agrafe, pinces
prototype: exemple, original
offset: chape, compenser, déviation
nul: zéro, vide
restreindre: empêcher, abréger, réduire
cocher: Marc, pou
T.V.A: réservoir
râpé: dépasser
nul: zéro, vide
conditionnel: attaché
culturel: Culture
la-technologie: technique, équipement
commercialisation: Commerce
cravate: cravate
économiquement: économique
administrateur: gérante, curateur
représenter: décrire, présenter
petit-enfant: petite-fille, neveu
double: deux, couple, jumelle
la-synthèse: original, installer, ensemble
spécialité: professionnel, caractéristiques
bizarre: étrange
demandeur: candidat
linguistique: la-langue, linguistique
champignon: liège, éponge
citrouille: squash, gourde
soulèvement: ascenseur, monter, progrès
phénoménal: exceptionnellement, solo, super
dynamique: du-pouvoir
réviser: révision, réparer, vérifier
panne: disjonction, tombe, une-analyse
fatigant: fatigué
la-cité-universitaire: Université, L'école
thèse: thèse
statistique: statistiques, statistiquement
formuler: préparer, formulation
sandwich: pain
nul: zéro, vide
stimulation: accélération, excitation, irrité
censure: censurer, règlement
équiper: complément
désigner: nomination, proposer
annuler: effacer, ferraille, frustration
mètre: mesure
déprimer: opprimer
Monsieur: Monsieur, maîtriser
reconstruire: réparation, la-récupération
arbitre: Règle, juge
atomique: atome, le-nucléaire
controversé: contradiction
sophistiqué: complexe, moderne
tic: hausser-les-épaules
inapproprié: hors-de-propos, inadéquat
sédiment: précipité
snober: mépris, faire-des-reproches
une-variante: divers
critiquer: la-critique
ennui: ennuyé, ennui, la-misère
coopérer: collaboration, conjonction
analyser: une-analyse, analyste
chute-de-pluie: pluie
germer: bourgeon
aéronef: oiseau
épicé: pointu
la-flexibilité: élasticité
fusée: missile
adverbe: enveloppe
instabilité: instable
privation: priver, désavantage
accroupissement: s'accroupir
Générer: produire, Créer
approximation: approximatif, approche, convergence
moral: éveillé, moral, mentalement
optimiste: espoir, croire
classer: classification, distribuer
programme-d'études: cours, ordre-du-jour
en-plein-air: dehors
réagir: réaction, verbe
scénario: scénario, ligne, écriture
chantage: extorquer
prime: récompense, prime
atout: propriété, présence, avantage, capital
variabilité: différence
ambiguïté: vague, contradiction, incertitude
nul: zéro, vide
neutre: neutre
handicap: embarrasser, obstacle, invalidité, désavantage
la-photographie: image
pénurie: Couper, absence
déplacement: remplacer
fongus: bactéries, éponge, liège
formulation: formulation, envoyer-des-textos
diplomate: diplomatique, Messager
lancer: présenter
fusionner: harnais
briser: briser
inhaler: inspirer
poulie: rôle
maigre: mince
électeur: circonscription-électorale
fédération: fédéral
mobilité: mouvement
décharger: décharge
habitat: abri
évoquer: mélanger, induire
diluer: mince
Au-Revoir: au-revoir, adieu
démolir: détruire
syntaxe: Pension
fer-à-cheval: cheval
Distorsion: déviation, fausser
claquer: battre
pertinent: cohérent, correct, associé
fonctionnel: pratique, oeuvre
déplacer: remplacer, éjecter, bouger
autonomie: indépendance
puanteur: odeur
différenciation: distinguer
disponibilité: acquisition
étudiant: élève
graphique: graphique, carte
fasciner: captiver, taquiner
mignon: beau, sucré
abdominal: estomac
alphabétisation: éducation
synthétique: artificiel
entraîneur: entraîneur
conserver: espace-de-rangement, enregistrer, protéger, conserver
des-déchets: ferraille, déverser, déchets
photo: image, coup
cahier-de-texte: Manuel, livre
consolider: renforcer
contraindre: contraindre, limité, extorquer
économiste: économique
athlétisme: athlétique, exercice
frétiller: grimace
iode: minéral
infecter: infection, polluer
designer: déterminé
sécréter: sécrétion, cacher, éjecter, secret, distinguer
épinards: favoriser, salade
intensif: extrême, violent
convaincant: démonstratif
début: premier, début
millième: mille
intérieur: interne, profond, à-l'intérieur, couvert
révoquer: priver
amplitude: ordre-de-grandeur
dimension: direction, après, dimensionnelle, prochaine
Bible: écriture
affiche: bannière, toile
accélérer: précipité
intensifier: renforcer, intensificateur
Avortement: fausse-couche
typiquement: généralement, commun, souvent, avoir-tendance
engagement: promesse
queue: queue, commande
support: agrafe, coude, crochet, supporter, aider
ex-: Agé-de
inverse: inverser, inversion
évaporer: faire-fondre, bâillement
aviation: atmosphère, air, Voler
corrélation: comparaison
ethnique: nationaliste, nationale
sabrer: Couper, réduire
rusé: ruse, élaborer, complexe, difficile
caractérisation: décrire, caractéristiques
affixe: épissure, parallèle
molécule: moléculaire
configuration: disposition, de-construction, Assemblée
interaction: parler, chevauchement
quantitatif: le-volume
introspection: rétrospective
Orient: l'est
sperme: graine
approuver: aider, admettre, approbation
non-: ni, pas
la-crédibilité: fidélité, fiabilité, crédit
subversion: se-ruiner
déviation: dérive, déviation
injection: aiguille
sandale: pantoufle, chaussures
gros-morceau: puce, paragraphe, étendue
télévision: la-télé
céréale: grain, haricot
récipient: instrument, réservoir, pot
émigrer: migration, errer
terminologie: les-termes
électorat: circonscription-électorale
effacer: effacer, détruire
médiat: réconcilier
capitalisme: capitaliste
ski: patin
autorisation: jeux-d'argent, autorisation
sélectif: choisir
statique: Standard
converger: rencontrer, convergence, concentrer
alphabétique: alphabet
mondial: international, monde
victime: sacrifice
D'accord: même, réparer, très
pragmatique: pratique
arbitre: Règle, juge
différentiel: différence
exhaler: émettre, souffle
grand-tournant: eau
fixation: adaptation, équipement
installer: installer, a-mis-en place, fermer
résonance: vibration
traditionnellement: tradition
la-salle-de classe: orbite
protocole: une-entente
calcul: calcul, facture
gramme: chaleureux, herbe
essence: de-l'essence
galaxie: constellation
adolescent: Jeune
pétrir: difficulté
radium: radio
raréfié: mince
avion: oiseau
pédale: bande-de-roulement
environ: presque, environ
lampe-de-poche: lentille
valise: boîte, bagages
échanger: échange
optionnel: coutume
matrice: estomac
représentation: épaule, image
pré: l'est, avant, pré
annonce: un-d
étourdir: étonner
incidence: incident, tremper
renverser: verser, cœur
sensoriel: sentiment, passionné
consensus: une-entente
superviser: gérer, moniteur, police
transplantation: alterner
aluminium: aluminium
fluctuation: oscillation
simuler: imiter, feindre
compliquer: complexe
mentor: conseiller, entraîneur
fente: ouverture
tour: corbeau, la-tour, Château, pistolet
manipuler: manipulation, mélanger
végétarien: légume
norme: spécification, Standard, Règle
métro: tunnel
respiratoire: souffle
simulation: imiter
seringue: aiguille
mutation: changement, convertir
sous-vêtements: slip, lin
vagin: baie
différencier: distinguer, différence
saisonnier: saison
villageois: rural
sésame: môle
coma: virgule
inverser: inversion, inverser
superviseur: observateur, Manuel
évincer: éjecter
audit: vérifier, révision
une-randonnée: monter-en-flèche, errer, ascenseur
lieu: endroit
récession: économie
pillage: butin
slogan: mot-de-passe
fœtus: embryon
l'intégration: collaboration, inclusion
magenta: mauve, cyan
minimiser: moins, réduire
Résidentiel: abri
numéral: numérique, nombre
salé: du-sel
nul: zéro, vide
théoricien: théorie
aquarium: poisson
traction: veto
parachute: parapluie
important: nécessaire
Globalement: généralement, tous, commun
détériorer: pourrir
nul: zéro, vide
sexualité: sexuel
bobine: le-volume, emballage
principalement: en-grande-partie
visqueux: gluant
intestin: intestin
archéologie: archéologique
cacahuète: haricot
apposition: allocation
cuisinière: poêle, cuisine
pantalon: pantalon
les-critères: Standard, indicateur
aperçu: contour
qualitatif: caractéristiques
lunettes: verre
génétique: morphologique, la-génétique, gène
participant: Joindre, rôle, participe
répertoire: Talent, logiciel
faire-tourner: cycle, tourner
disposition: organisation, plan, disposition
bon: prise-de-courant, le-reçu
théorème: phrase, théorie, axiome
cognitif: diagnostic
clarifier: élaborer, Explique
toxique: poison
souligné: Accentuation
style: aiguille
marasme: crise
répondre: servez, fourni, assurer
anti-: opposition
résistant: chronique, opposition, immunitaire
Goûter: pain-grillé
cinéma: film, cinéma
robinet: tuyau
marqueur: Marc
périphérique: environnant, régional
péremptoire: déterminé, prédicatif, agressif, décisif, tête-de-mule
nœud: tricoter
obèse: épais
soustraire: éjecter, réduire, dessiner, priver
intransitif: nécessaire
hélix: escargot, bouclé
biscuit: biscuit, gâteau
gonfler: se-gonfler
électronique: électronique
récrire: transcrire
laboratoire: laboratoire
professionnel: métier, commercial, professionnel, oeuvre
pente: mile, tremper
coloré: Couleur
couverture: couvert, vaccin, soins, couverture, toit, considérer, le-volume
participation: Joindre, inclusion
orientation: direction
fabriquer: Créer, produire
thermique: huile
stéréotype: exception
technologie: technique
résiduel: restes, redondance
camion: un-camion
Stade: champ
coordination: coordonner
bactérien: bactéries
interface: approche
silicium: pi
mémoriser: Mémoire, enregistrer, rappel-toi
diagnostique: diagnostic
programme: abstrait
conduction: ligne, kidnapper
millionième: million
détaillant: revendeur
baryum: bar
courant-dominant: clé, secondaire
significatif: signifier, consécutif
Audio: voix
conceptuel: conception
la-grille: toile
spatial: atmosphère, dimensionnelle
examen: quiz
milieu-: secondaire, taille
maquillage: compenser
discret: séparé, solo
inhiber: inhibition, empêcher
multi: divers, plus, très
moite: humide, chaleureux
morphologie: morphologique
diagnostiquer: diagnostic
grippe: grippe
graphique: graphique
coronaire: maladie
fesse: fesses, jambon
archiver: dossier
affrontement: bataille, conflit, comparaison
cargo: un-camion
optimum: optimal, formidable
fondamentalement: les-termes
motivation: stimulus
testicule: œuf
soufre: soufre
opérationnel: manipulation, action
trajectoire: orbite, façon
la-pertinence: associé, importance, rapports
bicyclette: Faire-du-vélo, cycle, la-roue
directif: démonstratif
Compagnie-aérienne: oiseau, air
litre: litre
revers: frustration, choc, régression, échouer, obstacle
unifier: harnais, réconcilier
position,-attitude: se-mettre-debout, position, paragraphe
minimal: moins
cyclique: Faire-du-vélo, périodique
substrat: moléculaire
sous-l'eau: sous-marin
compétence: de-l'expérience, compétence
nul: zéro, vide
électron: électronique
interactif: chevauchement
initialement: original
sabotage: détruire
interagir: parler, socialiser
les-maths: mathématiques
fœtal: embryon
moderniser: moderne, mettre-à-jour
extrémiste: radical, extrême
pisse: urine
se-pelotonner: embrasse
OK: réparer, très
swipe: voler
téléologique: délibérément
semi: à-mi-chemin, vendre, moudre, largeur
neural: nerveux
anti: opposition
lentille: lentille
proximale: presque
nutritif: minéral, aliments
pas-clair: vague, évident
traumatisme: choc, blessure, ulcère
échange: échange
vecteur: transporteur
tactique: approche
évaluer: évaluation
nul: zéro, vide
cloner: copie
viable: avantage, efficace
réplication: copie
réactif: réaction
calendrier: calendrier, temps, disposition
syntaxique: le-sort
stabiliser: silencieux
dissident: rival
retour-d'information: réaction
questionnaire: quiz
oxyder: appel
millimètre: millimètre
psychiatrique: intellectuel
syndrome: maladie
paradigme: exemple
activer: activer, faire, action
au-hasard: aléatoire, coïncidence, à-cas
ostracisés: séparé, boycotter
sous-ensemble: partie
méthodologie: façon, approche, une-seul-fois
oeuvre: oeuvre
séquentiel: cohérent, ordinal
mettre-en-fourrière: tenir, s'emparer-de, fermer
kilomètre: kilomètre
multinational: international
planificateur: locataire, rayé, plan
exponentiel: exposant
égarer: perdre
chercheur: scientifique
supermarché: centre-commercial
allouer: attribution, distinguer, distribuer, dissection
nul: zéro, vide
football: coup-de-pied
droit: droit, correct
Restes: restes, déchets
durable: Standard
vaisseau-spatial: la-navette
expérimental: de-l'expérience
sémantique: connotation, assujettir
initié: interne, membre
tonne: Ton
module: modulo, unité, le-volume
enzyme: levure
mode-de-vie: durée-de-vie
Pâtes: Masse
dortoir: abri
adolescent: Jeune
mettre-en-évidence: Marc
nier: nier, détruire
petit-ami: copine, ami
comportementale: conduite
Je-vous-remercie: remercier
cerveau: cerveau, âme
écologique: écologie, écologique
immigrant: réfugié
Intégrer: inclusion, tremper, enterrer
photocopie: copie, image
activiste: action
T-shirt: chemise
thérapeute: docteur, thérapie
magnat: Roi
éveil: excitation
synchroniser: synchroniser
acide: acide
lexical: dictionnaire, mot
roder: briser
classificateur: classification
avant-garde: pionnier
président: directeur
polycopié: brochure
charismatique: charme
scandium: tellure
ligne-directrice: Manuel
émettre-des-hypothèses: supposer, soi-disant
frigo: réfrigérateur
réinitialiser: redémarrer
remue-méninges: secouer, idée
reproduire: copie, imiter, répétition
angst: la-crainte
-feu: trêve
gaffe: omission, faux
industrialiser: industrialisation, industrie
enfant-de-mêmes parents: frère
porte-parole: des-enceintes, représentant
détourner: kidnapper, charrue
non-métallique: métalloïde
qui-coule: grippe, humide, courir
facette: direction, en-forme-de, côté
de-cas: 
la-bonté: la-vertu, avantage
librement: en-vrac, libre
après: avenir, puis, après
difficulté: difficulté
la-brigade: bande
largement: largeur, élargir, généralement
corrélatif: associé, crochet
selon: arrière
nul: zéro, vide
bulletin: brochure, information
désapprobateur: approbation, inacceptable
baignoire: bain
divertissant: Divertissement, amuser, hilarant
à-part: mis-à-part
émergence: émerger, Sortie, monter
nul: zéro, vide
joue: joue
devoir: Dois, devoir
pour-cent: pour-cent
litige: costume
nul: zéro, vide
passant-par: passer, au-dessus-de
soprano: puéril
amusant: hilarant
p.m.: après-midi, nuit
blanc-d'oeuf: protéine
effusion-de-sang: sanglant
thulium-atome: thorium-atome
courbe: courbé, fléchir
linker: conjonction
exhortative: il-revêt
terbium-atome: thorium-atome
loué: location
maquillage: compenser
sarcasme: blague
config: de-construction
la-passé: dernière
séparer: distinguer, distribuer
professeur: maîtriser
rhodium-atome: thorium-atome
Etat-marqueur: 
espace-marqueur: 
bureaucratique: bureaucratie
ceinture: bande, harnais
nul: zéro, vide
vendeur: revendeur
nul: zéro, vide
lanthane: tellure
assujettir-cas: sujet-cas
constructif: Créer, formulation, fabricant
nul: zéro, vide
féminin: femelle
auditeur: inspecteur, comptable
micro: micro
en-dehors-de: dehors, mis-à-part
enregistrement: inclusion, enregistrement
l'index: indicateur
parrainage: Bourse-d'études, soins
ignorant: ignorant
nul: zéro, vide
standardiser: spécification, Standard
heure: endroit, heure
propriétaire: propriétaire
enquêteur: déterminant, scientifique, détective
évasée: brûlé
nul: zéro, vide
autoriser: activer
la-défense: soins
couloir: salle
négociation: parler
rafraîchi: Frais, mettre-à-jour
sinueux: courbé
en-avant: premier, prochaine, vers-l'avant
respiration: immunitaire, souffle
nul: zéro, vide
progression: progrès
intransitif: nécessaire
euphorie: enthousiasme
large: élargir, largeur, répandu
intransitif: nécessaire
contrastive: contrastant, chape
étonné: surpris
renvoi: présenter
descendant: familier, petite-fille, génération
crème-glacée: crème
rayon: rayon
sinon: autrement
quartier: environnant, habite, écologique
habitué: coutume
embarras: honte, trouble
substantiellement: en-grande-partie
fraîchement: Frais, récemment, racine
danser: joue, danse
nul: zéro, vide
montant-marqueur: 
social-marqueur: 
la-critique: la-critique
rubidium-atome: thorium-atome
lutte: bataille, conflit, guerre
plaindre: environ
nul: zéro, vide
vanadium-atome: thorium-atome
neutre-le-genre: masculin-le-genre
fluor-atome: thorium-atome
voyage: visite, safari, expédition
masculin: mâle
nul: zéro, vide
du-développement: évolutionniste, progrès
appliqué: pratique
fermer: fermer
se-vanter: folie
en-arrière: arrière
la-présent: présent
nul: zéro, vide
randomiser: aléatoire
coopérative: collègue
retraité: se-retirer
nul: zéro, vide
amusé: content, hilarant, amuser
approximative: approximatif
dyadique: binaire
supplémentaire: complément, supplémentaire
communicatif: correspondance, bavard
nul: zéro, vide
à-cas: à-cas
polonium-atome: thorium-atome
panne: disjonction, une-analyse
bronzage: brun
problème: problématique, difficulté
Traduire: Traduction, bascule
nul: zéro, vide
thallium-atome: thorium-atome
clique: conglomérat, clic
facile: facilement, facile
modérateur: animateur, gérante
socialement: social
correspondant-à: costume, coïncider
accident: incident
ce-qui--: laquelle
intéressant: dessiner
à-l'envers: inverser
herbicide: poison
nul: zéro, vide
participant: participe
par-example: exemple
tumeur: tumeur
se-désintégrer: pourrir
nul: zéro, vide
site-Internet: site-Internet
énormément: massif, très, super
sera: 
relatif-cas: relatif-cas
objectif-cas: destination-cas
rémunérer: compenser, Payer
maltraiter: faux
tresser: crête, tricoter
à-la-place de: au-lieu
archéologie: archéologique
connecteur: copule, prise-de-courant, attachement, douille
nul: zéro, vide
généralisation: généraliser
strontium-atome: thorium-atome
ruthénium-atome: thorium-atome
sauf: mis-à-part
nul: zéro, vide
battre-en-retraite: faire-une-digression, régression, se-retirer
retraité: se-retirer
un-autre: l'un-et-l'autre, autre
large: répandu
l'informatique: calcul, l'ordinateur, calculatrice
Entreprise-la-personne: homme-d'affaires
l'Hot-dog: saucisse
dominance: effet, du-pouvoir, avantage
fin-de-citation: citation
possessif-cas: génitif-cas, possessif-cas
génétiquement: gène, la-génétique
concessif: bouger, doux
indirect-objet: direct-objet
prohibitif-humeur: prohibitif-humeur
faire-des-exercices: exercice, oeuvre, élaborer
délimité: limité, séparé
contraire: inverser, opposition, contraire, inversion, contrastant
grimper: monter
incroyablement: exceptionnellement, super
nul: zéro, vide
fermeture: fermer, métier-à-tisser
à-bon-marché: bon-marché
Toile: en-tissu, toile
cultivé: éducation, poli
faune: la-nature, sauvage
opposé: opposition, contraire, envers
nul: zéro, vide
creuser: creuser
infecté: infection
nul: zéro, vide
armé: bras
c'est-à-dire.: à-savoir
personne: rien
assermentation: jurer, explétif
fuselé: mince, cône
artiste: Divertissement, artiste
etc.: 
excepté: mis-à-part
contour: contour, écologique, forme
portable: téléphone-portable, cellule
Mademoiselle: Couper, perdre, dépenser
alarmant: terrible, anxieux
la-avenir: avenir
subjonctif-humeur: conditionnel-humeur, optatif-humeur
devrait: Dois
moto: moto, moteur
carte-de-crédit: crédit
nul: zéro, vide
la-public: public
téléphone-portable: téléphone-portable, cellule
nul: zéro, vide
intestins: intestin
déployer: distribuer, dispersion, consommer
expulser: éjecter
proportion: enjeu, partie, quantum
compétence: compétence, juridiction
propriétaires: l'ange
prépositionnel-cas: 
allocation: attribution, dividende, allocation
inquiétant: anxieux
d'accord: même, très
mise-en-vigueur: contraindre
Pro-phrase: Pro-phrase
récepteur: catcher
injecter: présenter
étourdissant: étonner, frappant
tousser: la-toux
à-côté-de: prochaine
