infinitif: hnit
nominatif-cas: hnak
accusatif-cas: hkak
sujet-cas: htak
parent: hmat
papa: hpap
maman: hmam
Salut: hnat
ancêtre: htat
grand-parent: hyat
affamé: hcac
génitif-cas: hnik
adjectif: hcit
et: hwan
moi: hmic
toi: hnan
nous: hnam
ce: hyic
destination-cas: htas
datif-cas: htik
intérieur-le-contexte: htis
personne-le-contexte: hpak
dépendant-clause: htan
perfectif-aspect: htap
passé-tendu: hkat
masculin-le-genre: hsan
comitative-cas: hmik
présent-tendu: hyan
benefactive-cas: hpik
essive-cas: swik
pas: hnic
ses: hsis
surface-le-contexte: hsak
adpositional-cas: hpan
emplacement-cas: hwak
espace-le-contexte: hnos
façon-cas: hrak
instrumental-cas: hsik
laquelle: hkan
interrogatif-humeur: hnim
et-ou: htam
OU-exclusif: hkit
la-source-cas: hsok
ablatif-cas: hlak
démonstratif: hdit
mais: hlan
tous: hsut
féminin-le-genre: hnin
ils: hwin
pluriel-nombre: hlun
un: hyik
avenir-tendu: hwet
social-le-contexte: hson
lorsque: hkap
non-accompli-aspect: hmap
Là: hkac
conditionnel-humeur: hcan
plus: hdoc
dehors: htac
relatif-cas: hrik
illatif-cas: hlik
faire: hkas
directif-humeur: hden
déontique-humeur: hdim
question-mot: hwac
copule: hkok
la-personne: hpon
mâle: hman
pourrait: kwat
autre: hcon
nombre: hnoc
très: tcac
temps: htim
temps-le-contexte: htos
temporel-cas: hmak
environ: hkam
épistémique-humeur: hsim
seulement: htun
petit: hcak
puis: pcan
il-revêt-humeur: hton
rétrospective-aspect: hrip
formidable: hcat
volitive-humeur: hlim
avant: hsec
Dois: pcic
deux: htut
voir: tcan
connaître: hsat
en-bas: hcin
après: hcas
premier: hpas
posséder: hpun
aliénable-possession: hlic
jamais: hnac
inaliénable-possession: hkic
Agé-de: hwat
délibérant-humeur: hcim
jour: htin
où: hnap
Venez: hlat
façon: hyas
oeuvre: hkaf
une-voyelle: hwaf
aller: hkun
perlative-cas: pwik
progressive-aspect: hpip
long: hlac
dire: hsac
Comment: hkin
pair: hpit
arrière: hwap
ici: hcic
pense: hcik
même: hsam
dernière: kcac
un-moyen: twan
en-dessous-de le contexte: hnas
prendre: htit
a-trouvé: hfan
le-Main: cyat
Jeune: hyac
bien-que: hyap
donner: hkik
Dieu: hmac
delative-cas: lwak
rien: hmin
droit: hyit
une-seul-fois: hyam
semelfactive-aspect: fwip
partie: hpat
vu: htic
maison: hfas
monde: tcat
directeur: hcaf
Trois: tyin
néo: hnon
concentrer: hcok
aimer: hpac
toujours: hsit
nuit: hwit
chaque: hmit
Roi: hyak
compris-entre: hsin
cœur: cyin
paucal-nombre: plom
en-raison: hyok
causal-cas: ksak
chose: hkis
ensemble: swat
prénom: hnem
correct-nom: hran
il-revêt: hrat
Pays: hlit
a-demandé: hput
visible-évident: crit
mieux: pcac
côté: psac
cours: hkus
femelle: hfin
assez: kyat
bientôt: hpuc
complet: hcun
chambre: hfac
presque: hlap
ne-peux-pas: nyat
eau: hwik
désidératif-humeur: hdin
lumière: lyak
ni: hnun
mot: slat
porte: tyan
utilisation: hpus
matin: hsap
terminative-cas: twik
du-pouvoir: hkuk
se: hmis
présent: hyin
voix: hwas
blanc: hpis
de-l'argent: tlan
prochaine: kyak
pauvre: hyis
la-mort: hmut
forme: hfam
inessif-cas: nwik
aimable: tyac
souvent: tsan
an: nwan
ami: myat
commande: hyut
impératif-humeur: hpim
rond: hcut
croire: hban
public: hpin
Etat-le-contexte: hsas
fils: psat
cent: hmas
enfants: hcis
Ainsi: tyak
espoir: hcap
au-dessus-de: hyip
chère: pyin
lis: pyac
ville: hsic
déjà: hpic
fait: hfat
factive-évident: hfit
entendre: hsun
moins: hmim
peut-être: pyat
Ouvert: kcat
corps: tcic
air: cwac
la-nature: nyit
Aidez-moi: mlat
lettre: lyat
quatre: ksat
optatif-humeur: hpam
du-feu: hfak
donc: hyif
heure: hcam
libre: tyit
guerre: syat
qu'elle-soit: hsaf
raison: kyan
uni: hnut
appel: hkuc
Pourquoi: hwam
perdu: hkut
mille: tsas
Famille: hfic
âme: twam
question: swac
soins: kcan
realis-humeur: hlin
signifier: mwit
potentiel-humeur: hten
envers: cyan
allative-cas: lwik
anthropique-le-genre: hrin
court: kyut
capable: hyuk
habite: hkip
assujettir: hsek
même-assujettir-marqueur: hcek
différent-assujettir: hfek
réponse: tsat
mer: mwat
la-crainte: hcoc
comprendre: pcat
difficile: kyin
les-termes: tyut
doute: hdac
dubitative-humeur: twin
demander: psan
bras: tcas
noir: clis
apporter: tyat
beau: ksis
sombre: tcak
tenir: psak
Dix: htaf
montrer: pyan
histoire: hkif
commun: kwan
livre: hkup
électronique: lyin
parler: plak
Marc: myac
intérêt: nyis
écrit: kcit
lit: pwat
nécessaire: syis
idée: hwis
art: klat
vialis-cas: hlas
frère: pyak
de-temps-en temps: ksas
ligne: lyan
table: tlas
Fleuve: nwit
œil: kyac
information: fyin
soudainement: tfan
étrange: hgan
profond: ksan
changement: hrit
sentiment: nwac
rencontrer: mlit
objectif: htuc
content: hcuc
sembler: syit
du-sang: cyac
se-leva: kwas
Sud: swan
du-froid: tlat
vers-l'avant: myik
position: psis
en-retard: tyam
se-mettre-debout: syan
supposer: nlas
fille: pyit
mien: myan
Couper: hkim
copie: hfap
mari: hgat
six: hlis
rappel-toi: twat
effet: hyaf
tombe: htuk
mis-à-part: hsip
cheveux: hpaf
passer: pyas
droits-d'auteur: pcit
armée: cyit
courir: kcak
cheval: kcas
avenir: hwic
Ouest: pcak
Payer: plit
rouge: hyun
or: tcun
désir: hdan
joue: plin
maîtriser: mwas
Bureau: hfus
gouvernement: syak
église: kyas
longueur: hlen
compagnie: ksin
papier: kyis
probabilité: hbin
notamment: cyas
ours: pcas
fenêtre: cyak
une-entente: hgac
beauté: syac
devoir: tfac
envoyer: fyan
distance: htif
le-silence: slan
le-pied: fyat
sauvage: kyik
mourir: myam
enregistrer: pfan
vert: kcin
difficulté: mlan
sourire: myak
faux: clat
divers: pcin
dormir: slit
quotative-cas: kwik
début: cwan
action: kfan
visite: fwat
suivre: nlan
Essai: tcis
présence: psit
sucré: tlit
riches: tcin
ennemi: tcam
navire: hcip
condition: kyit
y-compris: hkum
compris-la-personne: hlon
secret: kwit
precative-humeur: pwim
poli-registre: hbit
mal: pwac
Mars: myas
peu-importe: kwac
rester: hlam
au-lieu: plat
bleu: plan
impossible: psap
L'école: hsuk
occasion: ksac
marié: nwat
aliments: hcuk
vingt: tsis
silencieux: tcit
facilement: hnis
éventuel-aspect: hrap
la-langue: lyac
expression: syas
semaine: hsus
salle: hcum
danger: kcic
propriété: myit
né: nyan
tribunal: kcut
généralement: tyap
gnomique-aspect: hmip
valeur: tyas
facile: syap
arbre: pyic
bataille: pyap
mur: twit
cieux: cwak
inchoative-aspect: htip
jussif-humeur: hjin
Ton: twun
considérer: klan
attendu: pcik
mois: hmaf
de-l'expérience: nyap
entièrement: nyac
Frais: tsac
Duc: hnuk
couvert: kwak
lié: hyim
l'est: tyuk
pierre: pwan
quelque-peu: kfat
direction: tlac
chaise: kwis
aider: syut
rendez-vous-amoureux: tyic
village: klac
champ: clit
autorisation: nwin
permissif-humeur: hmom
Succès: slak
correct: hric
colline: clin
la-musique: ksik
distale-démonstratif: hdat
après-midi: htup
cri: hyuc
honneur: hnaf
Sept: swit
privé: pfat
des-nouvelles: nwas
scène: slac
jardin: cyam
course: htus
distributif-cas: twak
apprendre: clan
politique: syik
mensonge: kcun
jeter: tsak
manger: kcam
plancher: hlaf
mauvais: pwin
original: mlin
l'été: kyam
la-religion: tlam
image: ksit
échapper: plap
auteur: hlut
brun: pyun
déterminé: htem
douleur: hdon
le-printemps: psin
siècle: syic
doux: mwan
coin: kyun
produire: psas
rire: cyaf
oublier: flat
Europe: hyup
huit: lwat
robe: lwac
terrible: cyap
souffle: syaf
sage: hbas
possessif-marqueur: srak
Mémoire: myin
moderne: fwan
endroit: tcap
monter: hyus
briser: pyik
cinquante: hfis
île: tlap
touche: hsuc
promesse: pcam
commissive-humeur: mwin
degré: tfat
plan: plac
conduite: nyak
surprise: cran
minute: hmun
coup: hwut
pire: pcap
verre: klak
exemple: tlin
sûr: hsif
docteur: tsit
complétif-aspect: hmep
répété: tyun
militaire: slin
chaleureux: nyam
boire: pfin
les-questions: pcaf
colère: nran
directement: tyik
chapeau: hcup
chien: kwap
serviteur: hnuc
fierté: hram
foule: tcuc
entrainer: nyin
moral: myut
associé: kyim
Entrer: fyak
Règle: nyas
épée: cwat
attaque: kfak
la-santé: clac
paragraphe: pyaf
social: hsum
remboursement: tfit
Pardon: hpec
courage: krac
la-grâce: hnen
officiel: hfaf
fourni: tsik
demande: pwit
coup-d'œil: klas
mouvement: hyon
attendre: cwit
contraire: psam
douze: tyaf
engagé: nyut
du-vin: hwun
goût: swut
fer-à-repasser: fyac
distribuer: syin
Commerce: myap
avantage: twac
vêtements: kfip
juge: fwak
différence: tfaf
anxieux: kcis
capitaine: kwin
fini: nlat
cessation-aspect: hsep
curieuse: kyic
étranger: kwic
intensificateur: hnif
importance: myun
enfin: hfim
facture: fwin
prouver: hpuk
empêcher: flan
cou: cyun
juridique: hfik
sec: swak
servez: syam
perdre: pcut
preuve: pyut
évident-cas: hdak
progrès: pyis
bâtiment: klit
chercher: syuc
triste: hrac
péché: psip
30: tfis
honnête: tsin
fermer: kyap
banque: pcun
le-sort: cyik
forêt: hfun
mesure: mlac
autrement: htoc
courant: lyam
pain: hpup
supplémentaire: tfak
choisir: twas
animal: nwam
zoic-le-genre: hzin
eventive-humeur: hwim
même-un-événement marqueur: hcom
multiplicatif-cas: tlak
épais: hmus
créature: hyum
pluie: myic
surface: pfas
saint: swis
juillet: clim
rapport: hfut
côte: pwas
dossier: hfif
épaule: cwut
surpris: kran
royal: klik
chanson: hkuf
confort: kfaf
n'importe-qui: nyic
herbe: kcap
dessiner: cwik
ouverture: cyic
juin: cwun
poisson: mlic
capital: klin
Sein: cyut
neige: hcif
éducation: tlik
pointu: tcaf
pitié: hdam
frais: fyas
la-tienne: hmuc
million: mlun
fatigué: tcik
tuer: ksam
ombre: cwap
poids: plas
Masse: mlas
a-mis-en place: tlip
courageux: pyam
mince: plic
satisfait: srat
vérifier: kcik
la-vertu: hdet
nationale: nyaf
Divin: swin
vallée: clak
Devine: kwam
spéculatif-humeur: hken
jaune: clas
restes: mwac
courbé: nlac
boîte: pwak
saison: tsim
la-science: slas
ennuyer: kcuc
oncle: hmuk
liste: lyit
août: ksut
populaire: hlup
inconnu: fyit
familier: flak
familier-registre: krit
lecteur: tsut
approche: pcuc
deux-fois: tsap
intellectuel: tfik
vraiment: tsam
prêtre: pcis
blessés: fran
chagrin: hpom
palais: kfas
battre: clap
hein?: hnec
fou: myuk
bord: pfac
neuf: nwun
éclater: psut
souffrir: tfas
bruit: hcus
Littérature: lyic
Conseil: swas
vide: kcuk
rang: psik
tempête: tcut
poche: kyip
imagination: nlin
phrase: cwas
novembre: nwap
décembre: tsip
absence: psic
remercier: ryak
adresse: tyis
oiseau: pyuc
propriétaire: mlik
manteau: kwut
préparer: tyip
rapports: lwan
fumée: htum
janvier: nwak
machine: clic
contenu: nyik
dents: tlis
honte: hcet
baie: kcaf
cerveau: pyuk
bague: klic
phrase-marqueur: frak
carré: ksap
fruit: fyut
thé: tsic
Explique: slam
Bienvenue: cwam
poésie: pwis
Acheter: klam
fidèle: hdic
excitation: hcen
quarante: klis
avril: pyip
gentiment: kfit
octobre: kfap
amer: kyuc
esclave: tlaf
en-vrac: hluk
envoyer-des-textos: tsus
crédit: cyip
quinze: pfit
cruel: kcim
Joindre: cluc
processus: hpif
la-criminalité: kyaf
poussière: tsuc
pratique: plik
Couleur: nlak
détruire: nyuc
augmentation: lyas
nez: hnus
admettre: tyim
hier: kfac
hesternal-tendu: tlen
échouer: slap
Continue: tcim
porter: pwam
aveugle: nlit
douzaine: tsun
Voler: fyap
louange: cwin
diable: cwaf
au-fur-et à mesur: twic
sacrifice: kyif
exercice: cyis
conscience: tfin
théorie: tlic
ministre: myis
haine: hnet
Lac: cwic
centre: syun
perdre-connaissance: pfic
rationnel-le-genre: hron
prudent: fwac
prendre-plaisir: nlam
culte: pwap
des-biens: twap
la-peau: twaf
toit: tlut
couronne: gyan
Château: klap
trône: tcus
attaché: nlaf
mile: mlim
extrême: krim
prison: fyis
gobelet: kcip
membre: mlam
civil: syim
partout: tsaf
évident: tfic
couple: pwaf
le-volume: clam
coutume: ksaf
arc: ksun
costume: slut
viande: mwak
lait: hluc
végétal-le-genre: hwen
la-vision: slic
peu-fréquent: nlap
cousin: ksic
pont: pwut
protéger: pfak
du-sel: swam
innocent: hwus
reine: kwim
compter: kcus
curiosité: hras
danse: tyus
hôtel: clut
remplir: flin
prisonnier: psun
boutique: hjan
escaliers: sric
mendier: hmen
le-sable: sran
violent: hgit
septembre: hsem
Départ: prac
se-ruiner: crin
compétence: krin
bovins: hwec
équipement: hwip
cuisine: hkon
vendre: hbak
la-rapidité: hsot
conclusion: clon
l'ordinateur: hkot
éternel: hsen
limité: mrit
bibliothèque: hbek
base: hbac
confusion: hrun
glorieux: cris
également: hjic
effrayé: hbic
malheureux: prin
article: hrek
cuire: kfin
bande: hbat
désert: hget
baiser: hbun
balle: hbot
bâton: hpot
argument: hrut
observer: nrak
bénédiction-humeur: hbim
frappant: hrim
coupable: hdis
pistolet: hgin
police: plis
cacher: hzan
expédition: srin
ignorant: nrin
généreux: drac
nuage: blan
déchets: htek
février: frif
maladie: hren
dépenser: bwan
la-source: sron
initiative-cas: hnok
tante: hbam
retard: dlic
différé-impératif: hlip
signalé-évident: prat
minuit: dyit
héros: nrac
philosophie: hfof
doigt: hjit
confortable: hzat
quelque-part: hmoc
Appuyez: bran
employés: hraf
récompense: rwan
faire-des-reproches: dlac
la-misère: krat
front: htec
un-d: glan
l'ange: htet
singulier-nombre: hgam
aube: hbon
commercial: krak
pardonner: pran
le-mouton: hcec
la-patience: hpen
ferme: crac
référentielle: hrec
blé: mran
clé: kcif
majorité: hmot
la-faiblesse: hdut
atmosphère: traf
soupir: tcoc
humanité: mlis
opposition: pric
disque: hdik
solitaire: hket
artiste: nrat
Chevalier: cwis
charme: tran
décision: drin
gouverneur: gran
branche: rwac
disposition: hsoc
enthousiasme: tsum
inductif-humeur: hdum
Communauté: hmum
huile: hyen
tuyau: hbap
impression: trat
Oh: dyoc
discours-le-contexte: hros
vocatif-cas: hwok
cabine: ksen
alarme: plam
nerveux: hnes
permanent: hset
couteau: ksuk
soie: slik
mépris: grin
enfer: nrik
séparé: plen
sérieusement: mrat
mixte: mrik
en-bois: mrak
préfère: hpet
avertissement: trin
admonition-humeur: htom
impulsion: hmos
ambition: mrac
nier: hnek
constitution: swic
instrument: srit
continu-aspect: hnip
marée: hgas
Université: klen
queue: hkek
génération: nric
chat: blat
direct-évident: hret
abandonné: trac
onze: hyec
instinct: nlik
caractéristiques: trit
tribu: hgik
inquiet-humeur: pcim
abri: crat
grossier: hruc
équitation: hris
secouer: hmon
industrie: hdot
métier: hres
lampe: hdap
café: kfif
obéit: htot
nord: nrit
infirmière: nris
assurer: hjat
chaîne: ryin
enseignement: cric
chaussures: hgut
cour: mram
vague: hmec
ailleurs: hlet
appartement: pret
activité: twot
samedi: cram
ensoleillement: hduc
veuve: hwuc
élément: hlem
réflexion: hfen
organisation: hgis
la-vedette: tram
incident: hgon
client: hgip
bar: brap
bouteille: hbet
bénir: blak
mélanger: crak
interne: trik
réparer: krik
dériver: prit
creux: hcot
Province: hpos
civilisation: srac
Accrocher: hgak
choc: crok
exception: swap
fatigue: tren
Standard: ryan
au-volant: dran
débarrasser: hruk
jurer: kses
trésor: zran
graine: hbis
la-tour: tras
préféré: fwit
récemment: hcem
récent-passé-tendu: hrot
éveillé: srik
meubles: mrin
corde: hkos
aventure: hdas
royauté: ryit
le-banquet: dyat
décrire: dras
soixante: hses
échelle: hkem
cérémonie: srec
chasse: clik
chuchotement: psus
en-grande-partie: ryat
christianisme: ksim
avocat: hwif
détail: drit
Princesse: hrus
autel: dlat
toile: hwes
mauve: brin
recueillir: hkoc
élection: hben
conception: kren
ivre: crik
verser: brac
ascenseur: hlif
geste: hjis
gérer: rwin
échange: tcen
précis-article: hdek
empereur: mras
éloigné: hroc
laid: clup
inoffensif: cras
rouleau: hrof
pouce: nlic
journal: grat
barbe: dric
larme: srim
commission: kson
alors-que: grak
Traversée: kcoc
indépendance: htes
odeur: hwon
dix-huit: hdec
historique: tris
brut: krut
racine: hrok
boue: hbik
la-mariée: dlan
voile: pras
le-théâtre: tret
comparaison: kras
rival: rwis
équilibre: slen
entraîneur: kron
humour: hnum
roman: rwas
vengeance: hbaf
jaloux: ryut
la-roue: hlok
brûlé: glat
flash: flac
Créer: hkec
conflit: hnot
malédiction: hlos
imprecatory-humeur: pram
sans-défense: hces
positif: hzit
club: klup
inonder: nras
grain: gwan
indifférence: hdun
horizon: crim
présumé-humeur: hsom
raide: htop
harmonie: mron
tonnerre: hgot
enfance: htok
le-genou: hgun
logiciel: pwen
blessure: kram
le-reçu: ryis
activer: nlim
protase: hpoc
glisser: slok
révolution: hrif
fermier: hjim
accident-vasculaire-cérébral: trak
Plate-forme: hpof
Messager: hmes
privilège: hpek
organisé: hyot
élève: clen
la-grotte: hgec
tradition: rwat
la-tragédie: tses
adieu: hjap
la-critique: ryik
coton: krap
hôpital: slot
location: kris
gaz: hges
inévitable: pwic
mortel: hgim
feuille: glit
publication: plun
hostile: tsup
Traduction: dwan
funérailles: jran
farine: mrun
correspondance: ryon
romantique: hrom
cabane: clun
proposer: psot
mimétique: hmet
dollar: dlon
la-lumière-du jour: hjac
seize: hsos
Assemblée: hzac
colonie: klon
aile: gyin
Lion: hles
Culture: klut
colonne: hkom
ruse: glak
comédie-dramatique: dram
blague: hjuc
brouillard: hdus
médicament: dwas
quatorze: hkes
acide: sram
à-savoir: hyet
Revenu: hmok
évêque: hbip
Orange: tron
bain: byan
primitif: rwit
panier: ksek
un-secrétaire: sris
paille: prak
Je-suis-patient: pfif
salut: slon
hodiernal-tendu: dlin
avoir-l'intention: zrin
vapeur: tcip
poison: hwoc
Talent: tlon
climat: lwim
efficace: fric
distinguer: tcif
lavage: dwac
confession: kfis
absurdité: hjas
charbon: kyon
canoë: kwon
temporaire: tric
delimitative-aspect: hdip
OS: hcos
Lundi: nwic
Mardi: glac
Mercredi: bwac
fédéral: frin
souhaitable: hzic
représentant: ryic
lin: lwin
lavabo: swuk
neveu: bwin
sanglant: kric
siège: cren
estomac: hpem
laiton: pcon
sommet: hzik
cinquième: pfik
bon-marché: brat
exclusif-la-personne: kwen
s'emparer-de: zrat
clôture: hzas
statue: tfam
artillerie: tlep
embrasse: mrap
environnant: sren
strictement: srot
cerf: hluf
buisson: hbuc
chemin-de-fer: hrep
décharge: hduk
héritier: mris
chêne: blun
désagréable: pren
invention: hgic
piano: pyon
persuader: swen
invisible: gric
bien-connu: ryun
cruauté: kluk
tentation: hyoc
télique-aspect: hlep
économique: kfik
international: troc
interférer: tcek
philosophe: flif
élégant: gyit
aide-sociale: kyen
faire-de-la pêche: mlak
voler: truc
lèvre: hloc
se-retirer: ryac
étendue: sras
Galerie: glen
parallèle: zlan
atélique-aspect: htep
continent: trap
prohibitif-humeur: nrim
cravate: dwat
cellule: slep
œuf: dyan
artificiel: jrat
pendant-ce-temps: nwis
crise: ksot
poli: sloc
déjeuner: lyon
pin: pwon
pousser: hcef
alliance: lyen
taille: hkop
miracle: hmek
marin: slis
pureté: prut
république: hguk
téléphone: tfen
fouet: krip
chemise: cyim
présenter: ryas
canapé: hsof
balayage: hsup
voleur: ksif
conserver: nrec
canal: kcen
personnalité: klim
réforme: kfam
menaçant: hzim
paume: plim
des-enceintes: hzak
au-seuil: dwic
induire: pris
lance: bzak
soigné: syec
session: cwen
torture: crot
humide: tcum
crête: grit
voyageur: hyek
moulin: mwik
carte: jrac
collier: klok
remplacer: klif
délibérément: drat
bière: hbif
en-velours: hwem
la-gravité: gwit
sermon: hpum
abuser-de: glas
troupeau: hgen
treize: tres
justifier: jyit
Vendredi: crum
brosse: broc
Télécharger: dlas
crème: krem
falaise: klaf
jury: jrin
monstre: ksos
congelé: hgoc
pot: pfot
penny: psen
insister: srut
pomme: hpep
discuter: drak
arrière-plan: prun
transcrire: trim
périodique: prik
Divertissement: nren
virus: bris
puéril: blit
réfléchir: flit
convertir: kcet
contour: kluc
opéra: hpop
approbation: nron
trahir: rwak
punir: hzen
coude: kcon
attachement: tcet
réparation: hrop
méfiant: cyec
soixante-dix: swet
écriture: srip
fosse: grac
trouble: dlak
binaire: byin
une-abbaye: bjan
flèche: tcec
avoir-tendance: trec
élaborer: frat
fidélité: hlot
pièce-de-monnaie: syip
trembler: tcem
exilé: gwin
mécanique: myim
piège: crap
gâteau: kyek
Monsieur: cyes
hésiter: sret
dix-sept: syet
miel: myon
enjeu: dzat
bande-de-roulement: hjam
brique: brit
quatre-vingts: hpes
malheureusement: pcen
consulter: kcot
légende: lwen
récolte: hfos
promotion: pfon
poêle: hsop
rebelle: bric
démodé: hnom
se-gonfler: cron
marécage: swot
pansement: hdes
ascétique: pces
gérante: mren
Chorus: cros
rationnel: tson
En-traitement: pson
loup: blaf
tapis: hgap
antiquité: hjak
fertile: frut
sifflet: slif
du-fromage: twis
mordre: byat
Invitez: jwan
Cathédrale: kyet
port: brak
errer: djan
cultures: tsos
marine: nlen
masque: mrok
crayon: pses
légume: sroc
exposition: hzet
pantalon: tlun
la-corruption: hrup
cabinet: nram
le-potage: srup
chirurgien: syon
allocation: tcot
espion: gyas
téméraire: hlec
potins: gyic
jeton: hzon
abstrait: srok
Jeudi: cwim
circulation: ryaf
architecture: ryek
fissure: rwaf
ornement: rwon
inverser: lwas
amuser: mwun
la-récupération: ksus
chaussée: plut
décisif: dyin
négatif: nraf
Festival: hfec
réduire: hrum
trahison: zyan
chasseur: djin
serpent: syen
la-batterie: bret
la-cire: flam
détective: dlit
une-analyse: nlis
Accentuation: hzot
baignade: twen
enveloppe: lwaf
quiconque: hgek
cigarette: jrit
moteur: mrot
bénévole: hwot
réaction: ryif
bagages: blam
sourd: hboc
jus: hjus
humilité: jlit
ministère: mret
sexuel: hjon
diamètre: dyam
hache: blac
diamant: dlam
alterner: hlek
faire-écho: hgus
retenue: swon
identité: hdaf
écran: krun
paresseux: lwis
momentane-aspect: hmop
compact: kfot
dérive: hdif
disparaître: hgaf
rayon: ryen
encre: mwic
massif: mraf
cave: dyac
mémorable: nrun
éblouissement: klek
sénat: slet
cercueil: tfap
le-pardon: frac
avaler: nlun
gâter: nlot
balançoire: swun
pré: gram
complexe: klos
démission: hzis
humble-registre: nret
conspiration: swim
poivre: prip
poney: pron
candidat: hzam
Renard: flik
la-cheminée: tcon
juridiction: drik
agriculture: rwic
précision: tcuk
ancien-décédé: brim
démocratique: mrek
bourgeon: hbos
couverture: bwat
saluer: hgep
cochon: srus
en-forme-de: krek
ivoire: craf
classique: ksok
observateur: nwet
l'éléphant: lwit
ongles: nwus
abeille: hmif
enterrer: dzan
acteur: bzat
transpiration: zwan
polonais: ploc
illusion: hlus
incertitude: pcet
secondaire: syif
plier: tsot
rural: grun
gémissement: nyen
ressembler: slec
citation: hzun
sac: cyek
ennui: fren
aiguille: hjun
contrôlée: nroc
poulet: truk
cohérent: kwot
baril: bras
habituel-aspect: hcep
expert: ksec
impressionner: blin
olive: zlin
van: myen
obstacle: bwak
hocher-la-tête: kcec
favoriser: plaf
définition: fyic
anniversaire: gjin
marteau: hcof
parfumé: hfon
répétition: trun
banal: twut
coup-de-pied: hjik
creuser: kwaf
animal-de-compagnie: plot
crâne: hcop
corps-législatif: dlik
talon: cruk
froncer-les-sourcils: crun
brevet: plet
milliard: blim
chimique: fyik
pilote: pyot
imiter: mlot
jupe: kwet
exceptionnellement: srap
hebdomadaire: jwik
technique: tfip
végétation: tset
corbeau: kraf
lever-du-soleil: sruc
durée-de-vie: glin
contribuer: hyom
crochet: hdok
tigre: blic
pénétrer: crut
manche: slun
Autoroute: jras
milice: mlip
fossé: kroc
intégrité: kret
dix-neuf: dzin
organique: rwik
théologie: flic
flotte: flut
sorcière: byac
ennuyé: hwuk
diplomatique: dyik
studio: twos
dépasser: kcok
Champagne: cyen
inspirer: crif
bannière: hbes
divorce: lwon
boulon: hbut
veine: jyan
passif: psif
mousse: hgum
gravier: grik
tablier: tyen
planète: gren
étagère: claf
ventilateur: flon
tropical: hjip
phase: fwas
arbitraire: rwen
prononcer: kfun
le-mercure: krok
se-glisser: hrem
suicide: tcos
journaliste: prot
priver: hpok
qualifié: klun
balcon: blik
fourchette: fras
employé: mlek
employeur: myot
largeur: jrak
irrité: djit
accuser: klot
Pension: pyen
verbe: kres
singe: mwon
acceptable: hwek
Signature: tlim
orthodoxe: rwos
ironie: fron
garderie: nrap
réluctance: jlan
importer: tyot
torche: croc
grammaire: gjak
dépôt: gyat
colonial: plon
yacht: jyat
consécutif: kwec
dôme: kwun
épaisseur: hfot
tête-de-mule: cyon
muscle: hmup
ordre-de-grandeur: ryam
frotter: ryos
lâche: rwam
harnais: gwac
pain-grillé: tros
une-souris: myus
syllabe: slim
tapoter: prap
dialogue: dlaf
neutre: nrot
diligence: dwin
contradiction: trot
accomplir: kfic
chèvre: byak
fleurir: hfet
imposer: mlon
anonyme: nwim
formel-registre: frit
veau: hbof
Manuel: mwut
faire-fondre: hjec
effacer: flas
parapluie: gras
botte: bzut
minéral: mrim
trêve: crus
canard: hbok
Planification: pfam
du-savon: hsuf
poupée: gwak
squelette: klet
villa: blis
couture: jlin
réconcilier: dyak
bouilloire: kset
mature: mruc
lapin: kruc
conducteur: nwot
dépendance: djat
joueur: jlic
insecte: pset
restaurant: cret
chouette: lwun
radical: djik
résident: zwin
dragon: dron
auditif-évident: drot
assoiffé: kyos
traîner: dren
calcul: glun
règlement: ryim
maire: mlap
minorité: mric
acquisition: dwon
ancien-combattant: bren
orchestre: ryes
Bacon: bjin
désavantage: zwat
en-tissu: frap
musicien: gzik
mentalement: hnep
conjonction: nyon
inadéquat: nrip
architecte: tsek
citron: nyim
la-toux: kcos
mal-de-tête: crek
locataire: ryet
la-fertilité: srun
guérir: hfoc
quatre-vingt-dix: nwon
aléatoire: hbec
cuillère: kcek
ballon: blon
craie: hfip
inférence-évident: nlet
éditeur: pcot
le-vinaigre: sruk
cendre: fyec
explétif: slek
relancer: nrut
sensible: kfim
tunnel: tfun
casse-tête: hpef
mécanisme: mwim
mathématiques: gzit
fondu: frun
foie: jwin
sublative-cas: bwik
tremper: dris
unité: twim
monopole: hnop
jeux-d'argent: hgup
sous-marin: bzin
séisme: hbem
laboratoire: brot
liège: kruk
soi-contrôle: syot
Bouddha: hbus
tricoter: bjat
ambassade: blas
le-plus-éloigné: sres
déclaratif-humeur: drim
stimulus: tyuc
le-chocolat: clot
coïncidence: tyon
gant: gwat
s'agenouiller: hjek
géographie: hjif
investissement: nwes
verbal: mrec
analogie: nlip
laïque: srek
faucon: blap
psychologie: nloc
fixer: gjan
ferraille: krep
rôle: cyum
dose: hdos
saumon: slom
pudding: pwun
magnétique: gyik
pompe: pcom
oxygène: ksip
certificat: tfot
médaille: hmem
rhétorique: trok
gratter: rwap
rame: dyas
lunette-astronomique: trip
Collier: clek
orthographe: prif
whisky: hwos
saule: hwof
chameau: hlum
amateur: myet
Sortie: crec
biographie: brif
âne: gzac
mensuel: mwis
ignorer: nruk
vacances: byit
clic: lyik
ovale: twon
élastique: lyet
dictionnaire: kfon
jambon: gzam
arc-en-ciel: rwun
consommer: kcum
cracher: tcup
réservoir: trek
collègue: clok
papillon: trif
graphique: graf
jumelle: jwat
de-façon-autonome: trem
bambou: hbum
revendeur: jlat
accumulation: kles
inspecteur: nyet
morceau: hyos
cauchemar: hbom
confiture: gjam
musée: mrem
alphabet: lwam
dispersion: zras
raid: crip
divulguer: clus
pourrir: fraf
agressif: gris
friction: mroc
jetée: gyac
Araign?-e: brik
pomme-de-terre: trut
révision: cwon
avidité: jlac
prématuré: ryot
multiplier: gzan
tourner: pcip
statistiques: tsok
calendrier: klem
nomination: nwen
billion: tlos
grenier: tlok
affirmative-humeur: rwim
applications: pfen
nominal: nlon
insatisfaction: sraf
infection: hfok
lanceur: krot
hausser-les-épaules: cyok
pionnier: gzin
omission: nlif
chou: glic
athlétique: tlet
ivresse: mrut
idiophone: hdof
levier: lwek
sénateur: syem
iris: nrif
fourmi: mwam
punaise: hbop
Enceinte: grim
précipité: hjet
cheville: tcok
classification: glik
variable: prim
emballage: ryap
bouclé: krec
soufre: hsef
dicter: dwik
émerger: brun
grenouille: fram
excessif-cas: twek
éponge: hjen
agaçant: djon
écureuil: slip
moudre: zyin
irréel-humeur: flim
volcan: glam
à-l'intérieur: gron
exploit: kloc
géologique: jlik
le-passeport: psop
immoral: mlet
biscuit: hbuk
collaboration: kros
tablette: tlot
relaxation: kces
atome: trom
le-sida: hzip
pyramide: psim
cycle: swok
sieste: hnup
illicite: hjaf
patte: pfap
la-timidité: crom
éclipse: klip
luth: lwap
balai: srum
panneau: mwen
astronomie: tcom
labyrinthe: blen
Bourse-d'études: bwit
tortue: kfuc
conseiller: dwak
fibre: fwic
cricket: jrik
Pigeon: ksom
adaptation: dyon
triangle: tfon
trésorier: tsen
hydrogène: jron
fragile: hfuk
imprimante: pyet
étranglement: tcof
chronique: gzon
chape: slaf
dilemme: dlim
ingénierie: jyin
Camera: hkef
s'excuser: pluc
lécher: lwet
danseur: dret
migration: mres
tennis: tces
colonne-vertébrale: clip
frire: zrac
métier-à-tisser: tfuc
coup-de-couteau: twuc
mot-de-passe: psaf
hémisphère: praf
stratégie: zrit
quartz: krus
les-ciseaux: jris
patrouille: proc
glacier: lwic
à-mi-chemin: dwam
mémorandum: mwap
cône: kwuc
symétrie: hzut
fabricant: zrak
défendeur: fwik
mosquée: djis
échecs: cres
péage: htof
cerise: tref
répandu: kfen
trébucher: tfok
un-camion: ryok
moutarde: mros
pour-cent: pfet
enchères: jlam
tamis: srif
instable: swoc
aimant: gjat
sucer: syus
Islam: slum
la-pointe-des pieds: twip
membrane: mlen
se-raser: clet
guitare: gjit
brillant: bzan
orme: hyem
monter-en-flèche: kcom
pronom-marqueur: ryec
agrafe: pcus
pimenter: zlat
caution: jlas
transporteur: zyac
vibration: bron
taquiner: trus
charrue: hlom
physiologique: zlik
gouttière: hgok
comète: cyet
médiéval: dyic
moineau: grec
compenser: twet
Plastique: psuk
note-de-bas de page: cyot
orbite: rwot
frugal: twum
golf: hgof
zéro: zrun
puce: tcep
opprimer: prok
bâillement: gjac
inégalité: gwas
môle: tloc
poterie: frik
femme-au-foyer: hgif
seigle: rwem
désobéir: hyes
tolérant: glon
embryon: brec
mineur: jren
applaudir: zlac
levure: lyim
prime: pfim
prune: plem
faillite: byas
irrigation: rwif
menthe: nyun
capitaliste: glis
élasticité: hlef
requin: gyak
recruter: drut
espace-de-rangement: zren
le-réalisme: cles
gingembre: djic
ambulance: blus
comparable: kwip
portefeuille: bjap
grimace: glim
scientifique: gyis
intestin: grot
équanimité: hwum
radio: href
hors-de-propos: zlit
haricot: bwam
informel: frim
petite-fille: gyut
désaccord: dloc
bifteck: tfek
azote: zron
le-rasoir: hjut
contrastant: krom
la-propagande: pcoc
des-feux-d'artifice: fris
pop: pcop
déshabiller: crop
sillon: cruc
nocif: hzaf
judaïsme: hjum
complément: pluk
lentille: lyes
pegative-cas: pwek
cancer: kfes
pion: pyek
Maître-de-conférences: zyat
fuite: hzuk
qualifier: krif
densité: djot
induction: dyis
mâcher: htuf
bavard: bzit
homard: hgos
remise: dyut
Taxi: tsuk
hiérarchie: crem
jade: gyec
gronder: glaf
lézard: lyis
cascade: crof
décevant: djak
veto: frot
présidence: ryip
acheteur: mrif
gallon: jlen
moustique: mruk
déviation: dwen
lutter: lyut
mosaïque: myok
prise-de-courant: plok
s'accroupir: pcuk
épicerie: ksoc
communiste: myos
étonner: mwek
prosecutive-cas: rwuk
constellation: nlos
dictateur: dwit
la-préoccupation: tyet
Satellite: tlec
pantoufle: hlop
consonne: fyon
approximatif: tsif
sans-emploi: byet
supporter: sros
lotus: lwot
salade: sles
chlorure: lwok
bactéries: bwic
gluant: pcek
composant: bwon
noyau: klec
feindre: bjak
octet: bzet
sécrétion: sruf
explicitement: pres
coïncider: mloc
ballet: blet
urine: mrus
ail: lyun
passé: hguc
économie: kcem
classe-moyenne: hdom
agile: gjic
pinces: htef
blanchisserie: lyoc
fraise: srem
Urbain: pcos
embarrasser: mlaf
cahier: tfut
album: zlam
base-ball: hbep
renifler: sluc
buffet: hbuf
participe: rwip
garage: grek
diagnostic: djas
béquille: ksuc
extorquer: srom
enregistrement: psuc
soluble: jlun
phosphore: psof
de-construction: rwut
colle: glum
thèse: twes
artisan: clif
banane: bwas
axiome: kyom
nervure: psos
nickel: nyek
pi: pyim
autobus: bwos
censurer: swes
missile: mlus
saucisse: slos
manipulation: nlut
tomate: tfet
renforcer: kfut
douille: syok
potassium: tsom
récupérer: prup
virtuel: zwit
algèbre: gjas
dentiste: dzit
optique: pcok
bouger: bzen
la-biologie: bwim
chômage: byim
chenille: krum
solo: slof
navigateur: bjac
éloigné-passé-tendu: nyot
historique-tendu: crep
le-nucléaire: nluk
spectre: pyem
sodium: syom
hystérie: syes
curateur: tyos
otage: byik
gourde: gluk
ride: kwuk
transparence: tfif
pointe: swip
priorité: pcif
piéton: dyen
athéisme: tsem
moniteur: mwot
circonscription-électorale: nlec
incontrôlé: hkof
sonde: grok
platine: plip
double-nombre: dlun
poumon: pcep
super: syup
chariot: trop
localement: lyot
inciter: gzat
de-l'essence: plif
le-rein: grif
butin: bzac
évaluation: dlen
arsenic: syek
escargot: nrok
sauterelle: tsec
équation: fwen
socialiste: swos
filtre: flot
sensoriel-évident-humeur: hxin
élargir: kyot
émettre: mwet
laisse: pwet
mandarin: drun
jockey: hjok
pneumonie: hnof
la-solidarité: gret
charnière: cyif
longitudinal: nruc
dividende: dwun
patin: hkep
exposant: slop
invalidité: dlif
obsession: bwen
attribution: pfun
photographe: trof
delta: dlet
numérique: djim
chienne: brut
paupière: hyop
diagonale: dyun
subconscient: byon
sourcil: bruc
éternuement: pcec
hilarant: dlis
hindouisme: nwum
réfugié: nyif
la-navette: cwot
protéine: pwot
déverser: hdop
affiner: flen
vomir: hwom
gène: gyen
étudiant-de-première année: hdem
sociologie: syoc
squash: kwoc
pêcheur: hfuc
régional: jyen
mouvement-montée: hvok
rétrospective: hxik
tornade: gyon
inversion: nwos
la-télé: twif
cube: kfet
productivité: pwuk
carotte: krop
moléculaire: mwuk
conglomérat: glet
comptable: ksum
concombre: kyok
orgie: drok
solvant: jlet
phosphate: psef
apprêt: gwik
alcalin: flis
gymnastique: jyas
virgule: kwom
mouvement-une-descente: hvat
fausse-couche: jwac
cosse: tcop
donneur: dzon
manganèse: hzem
psychologue: syos
chlore: clos
clavier: kyoc
élite: zyit
parenthèse: pfaf
le-rugby: rwoc
ulcère: jlon
fléchie: hxit
grignoter: nres
quantum: fwam
chandail: swek
évolutionniste: fwis
notation: nyoc
rebondir: tcuf
dissection: drec
cachette: kcep
linéaire: lyec
antimoine: trum
superessive-cas: psek
tumeur: twom
érosion: cyos
alpha: flaf
nombril: nwip
immunitaire: myip
grippe: flun
Brasserie: bjit
simplifier: slef
abréger: bram
bosse: djen
captiver: dwim
contraindre: brok
chaussette: bzas
film: fyim
cosmos: klom
polluer: hpuf
grégaire: gjen
pénis: zyis
sylviculture: lyif
aluminium: lwum
oscillation: zlon
horoscope: ksop
éjecter: dlek
inclusion: nluc
bénéficiaire: byic
dauphin: dlip
tueur: cyus
mammifère: myaf
indicateur: swif
dioxyde: dwis
côlon: zlen
bureaucratie: brus
fausser: jric
réfrigérateur: frip
archéologique: cluk
inacceptable: kwok
spécification: pfis
brochure: pfut
anthropologie: nlom
délicieux: kyec
transitif: txit
se-recroqueviller: kwus
tournesol: hzuc
pou: glus
ion: lyos
le-tourisme: tyum
modem: myom
accélération: jrun
falsifier: tsoc
émission: hmef
kidnapper: drap
chevauchement: hwep
coiffeur: pfes
folklore: floc
capillaire: plek
nationalisme: nlum
fesses: nros
motif: hmuf
sublimé: slem
frustration: xras
cobalt: kwos
avoine: gwam
mouvement-en-amont: trup
anus: gyam
bovine: bwun
bascule: flip
redondance: dzun
vidéo: hwop
boycotter: bjik
quiz: cwif
le-hockey: cwok
guérilla: grip
magnésium: hgem
radar: drek
chimpanzé: hzif
fiabilité: kwif
rectangle: tyec
varech: klep
généraliser: jlak
couvre-feu: kfec
homosexuel: mlok
scénario: srop
formulation: flus
réincarnation: nrom
enflammer: zlak
uranium: ryum
catcher: kwes
coordonner: kyop
contribuable: nwaf
intégré: trep
opiné: hzap
gamma: hxam
safari: fwim
mouvement-en-aval: ht6n
coefficient: kfus
gros-titre: zlic
analyste: nles
échec-et-mat: hzes
centre-commercial: hmof
bismuth: bzim
carte-postale: psok
convergence: bros
faire-une-digression: djet
actionnaire: ksem
microbe: mrip
génital: jwit
morphologique: mluk
bêta: byot
jeans: gjis
base-de-données: tles
calculatrice: klus
radiographie: ksef
analyser: zram
écologique: zyen
sigma: zyim
disjonction: hxon
ordre-du-jour: gres
visa: bzis
Infrastructure: nyuk
luciole: gyun
détecteur: tyek
adaptatif: dyip
biologiste: byis
épissure: pyec
brome: brom
palladium: plum
hoquet: kfok
pastel: psec
zoo: zwac
clinique: lyok
connotation: nwoc
yoga: hjoc
librairie: byun
thérapie: grap
nationaliste: zlis
décapiter: zlet
Oui: swec
problématique: byam
jazz: dzas
tungstène: tsof
terroriste: gwis
dribble: droc
métabolisme: tlem
pension: lyaf
fin-de-semaine: hfom
chrysanthème: gzim
vaccin: byap
moto: tyok
mantra: dyot
semestre: myes
héroïne: gwon
dossier: flap
cathode: kfoc
idéologie: dlec
parking: prek
thêta: fret
déception: hxis
sélénium: clem
Faire-du-vélo: blek
cortex: pros
équivalence: swaf
courant-pertinence-marqueur: hxak
aéroport: cwoc
amputer: gyet
basket: bwet
imposteur: mwip
cafard: tlek
chrome: hgom
litre: hl6t
toutefois: nwec
hormone: cwom
imparfait: tluc
perforer: prec
animisme: nyom
polygone: cloc
féministe: hfes
conjuguer: kcop
euro: dros
ginseng: hjes
algorithme: hlof
laser: lwes
pharmacie: dlot
millimètre: mlem
fléchir: flek
anode: nlok
nuancer: hzus
à-temps-partiel: prem
sensibilité: nyec
démonstrateur: drom
hélium: clum
bilingue: dzic
acronyme: hqim
initialism: nl6m
gérondif: gros
plasma: psem
chromosome: rwom
ordinal: rwok
kilomètre: klum
fax: tfes
la-génétique: nwek
rousseur: frek
tournevis: dres
brocoli: blok
prétérit: xrit
vitamine: tyem
cadmium: kyem
bombardier: bwoc
graphique: gjik
titane: dyim
folie: clec
lambda: lwem
copine: pcem
copuler: kyuk
Sablier: tlus
empathie: mlif
bore: bres
hélicoptère: cwet
tellure: tlum
date-limite: jyic
aligner: gwic
centimètre: hfem
molybdène: mlom
lithium: tfim
multimédia: myum
mettre-à-jour: dyet
calorie: clom
robot: ryoc
devoirs: groc
logarithme: grom
mante: gzas
installer: nwut
amino: myoc
glyphe: glif
aoriste: pyos
écologie: plec
distordre: flok
marijuana: bjam
micro: mrom
kilogramme: lwom
trop-manger: jrot
prévisible: dzik
Pizza: zyas
espionner: zris
linguistique: bwis
la-Coupe-de cheveux: braf
iridium: ryom
racisme: gwim
optimal: gyim
industrialisation: drif
siège-social: krup
cérium: zrim
conforme: nrum
partitif-cas: pxik
cassette: ksep
volonté: blot
dimensionnelle: dzen
paramètre: rwet
synchroniser: nrop
maximiser: dzim
séminaire: mwec
disco: dyok
néon: nyok
osmium: hzom
Épiphanie: hp6n
plagier: lyap
artefact: rwek
réacteur: fyet
origan: ryop
plutonium: pwum
yttrium: tyom
augmentatif: hxat
Nom-d'utilisateur: mrum
de-troisième-cycle: zrot
Aile-droite: dwaf
argon: jros
phobie: hxot
socialiser: sluk
mondialisation: bluc
longueur-d'ondes: hnef
encoder: kfom
recycler: psoc
redémarrer: nrek
hépatite: pyes
torus: fros
chimiothérapie: myep
modulo: mwok
proton: zwot
disquette: dwet
milligramme: mlum
pixel: psep
tantale: twem
soluté: hjot
génocide: nyos
prédateur: rwes
gallium: glem
zirconium: hzum
déterminant: txin
non-linéaire: nlem
pesticide: pyif
béryllium: brem
neurone: nrus
prédicatif: pxit
slip: tlif
factorielle: kref
neutron: zrut
niobium: nwom
germanium: hjem
métalloïde: tlop
mettre-sur: dlap
prolative-cas: hl6k
biodiversité: jwic
manette: jyok
antibiotique: twok
actinium: gjim
astronaute: srof
extra-terrestre: tyes
cinglé: hwup
marathon: mrof
ytterbium: zwim
autisme: tyif
ioniser: nlof
radon: cwos
nerium: nrem
épidémiologie: pwip
vieillesse: lyuc
camping: kyep
rayé: drip
indium: nyum
véridique: hvik
site-Internet: bwes
Coran: kwek
couverts: fwet
nième-racine: tfec
lawrencium: lyem
droits-civils: glip
téléphone-portable: mlof
paralysé: twoc
protactinium: prum
radiation: hd6n
dépendre-sur: pxin
thorium-atome: hxim
blue--jean: bjun
plante-d'appartement: hxas
individuellement: dvit
flux-de-courant: lwuk
point-triple: ht6t
corps-humain: hn6n
la-physique: bzik
vente-au-détail boutique: hxan
césium: hs6m
longue-depuis: hqan
tableur: hxet
unité-de-masse: hn6m
compiler: ml6n
binaire-valeur: vrim
Humain-étant: nyus
par-veux-dire de: hvan
depan-dari: pxat
praséodyme: pyom
carton: kxat
fini-verbe: hqik
procès-nombre: hr6n
Pro-phrase: hr6t
critique: hk6k
conditionnement: pxas
impermanence: pxan
à-les-plus: txas
descripteur: drop
néodyme: nyem
relation-amicale: hvit
lire-seulement: xyak
fonde: xwan
gnomique-humeur: kxin
phonème: hxom
rationalité: xlit
phonologique: xlin
à-manger-chambre: hxac
vivant-chambre: hxic
central-cas: zrik
hodiernal-pré: hx6n
patient-cas: hqak
oblique-cas: bwok
rural-région: hqat
recurse: hr6s
milieu-voix: dyos
meitnerium: hm6m
postier: hvak
évasif: kxit
stock-marché: xrak
identifiable: hxap
objectif-gâchette: krof
une-seconde: hxen
latif-cas: dvak
ration: hr6c
non-Humain: hg6n
vivant-chose: hvic
aussi-peu: hxut
cinéma: hvin
hassium: xyim
atténuant: ty6t
multal-nombre: ml6m
laiteux-façon: txam
neptunium: nwem
Fantôme-écrivain: txik
trans-numéral: ts6s
duper-autour: hqun
américium: myem
matin-gloire: txan
pompier: xran
berkelium: blem
galaxie-le-genre: kxan
nobelium: blum
au-revoir: hvac
bouddhisme: hfum
fermium: frem
cyan: xyan
soya: syof
distributeur: qrit
briseur-de-grève: txak
processeur: ples
abessive-cas: bvak
adessive-cas: dvik
à-cas: kxak
agentive-cas: dvek
rutherfordium: hr6m
anticorps: txip
comme-beaucoup-comme: hjos
agent-gâchette: hg6t
acteur-rôle: xram
éthidium: txim
commun-le-genre: hk6n
accompagnateur: kl6n
carthame: kxam
francium: fyam
erbium: ry6m
passif-voix: xyis
astate: hqit
mastication-gomme: hqam
étoile-le-genre: hqin
citation-forme: ht6m
curium: jrim
Bande-dessinée: kxis
daltonien: hqon
euler's-numéro: hl6m
Regarde-à: kxas
passage-clouté: pwok
champ-de-bataille: txat
automobiliste: vrit
court-circuit: txok
verbal-nom: hvis
cri-en-dehors: hk6t
statistiquement: xyit
yaourt: txot
xénon: hs6n
hypnotiser: hxif
prendre-de: hxaf
clause---queue: hxok
direct-objet: dwot
épicerie-boutique: kxun
consister-de: hm6t
ergative-cas: gvik
en-langue: txic
première-main: pxam
locatif-cas: hqok
piscine: slup
adverbial-cas: vlak
sightsee: hqas
télévision-ensemble: ht6s
final-particule: xlik
evitative-cas: hvek
réhabilitation: xlat
régression: xris
Bloc-de-appartements: kxot
réveiller-en-haut: hxup
police-officier: ps6s
jurer-de: vran
intervieweur: qrat
rhénium: ryem
aérosol: xres
possessif-cas: kxik
nominalisation: mlec
possédé-cas: dzak
surcharge: pxak
auxiliaire-verbe: xyik
primaire-objet: mlut
virus-informatique: prus
homme-d'affaires: hqis
une-gens: hqen
antessive-cas: ts6k
premier-ministre: pxis
lutétium: lyum
europium: rwum
emote: xrot
musique-folklorique: zyik
poète: vwit
bureau-de-poste: pxot
soi-disant: hvas
animer-le-genre: hven
subessive-cas: bvik
gaz---pédale: glep
polarité: pr6t
véhicule-le-genre: vlin
minéral-le-genre: xrin
verbe---suffixe: hvif
passionné: pc6n
samarium: sr6m
animateur: hs6t
unité-imaginaire--: xyin
vitesse-de-la lumière: kxac
armée-de-l'air: hxes
empathique-joie: pfec
point-critique: qyit
à-plein-temps: hxem
hafnium: xyam
inhibition: hn6s
changement-de-un événement: qrin
holmium: xlim
différent-un-événement: hf6t
univers-le-genre: hvip
localité-le-genre: kxen
virtuel-machine: hvim
recherche-le-genre: txen
artistique-le-genre: ts6n
crastinal-tendu: sl6t
abstrait-le-genre: srep
exocentrique-cas: zrek
transitif-verbe: txif
morphème: tfom
chauvin: dvis
passé-perfectif: xrat
professionnel: hy6n
indirect-parole: tyoc
seconde-la-langue: draf
à-être: txis
cimetière-décalage: vrak
collectif-nom: hxos
absolutive-cas: bvuk
patient-gâchette: tr6t
soi-confiance: hs6s
excréments: hzos
réfléchi-voix: hf6s
impersonnel-verbe: hxek
seaborgium: br6m
espace-blanc: hxep
modal-cas: dlok
inanimé-le-genre: hj6n
causal: qran
propositive-humeur: psom
électrique-courant: tr6n
associatif-cas: nwok
superlatif-cas: tluk
aussi-beaucoup: xyut
planétaire-le-genre: pxen
animé-dessin-animé: nwuk
réciproque-voix: vrik
légiférer: hqaf
à-moins: vlas
grammaticale-cas: qrak
utilisateur: pxut
noyau-benefactive: kfef
gardien-de-but: hgop
:-except-for: kcef
dénominateur: dvan
else-if: lyek
de-côté: hx6s
l'un-et-l'autre: dles
successif-clause: lyuk
épuisé: hxun
short: ht6k
dysprosium: prom
bientôt-avenir-tendu: rwec
si-unités: vyin
krypton: kxon
mendelevium: dlem
applicative-voix: hp6s
antipassif-voix: tsef
continuative-aspect: ht6p
le-mal-de rayonnement: hr6k
necessitative-humeur: hn6t
unique-action-verbe: hqek
autorail: xlak
superlatif-degré: tlup
existentiel-clause: hs6k
californium: kf6n
présent-participe: vrat
lumineux-intensité: hc6t
singulative-nombre: slus
grammaticale---objet: hy6t
passif-participe: vris
excessif-durée: kxic
fluide-supercritique: sr6t
montant-de-substance: ks6t
postpositionnel-cas: pxok
électif-quantificateur: lwif
gadolinium: dl6n
épenthétique-morphème: hp6m
négatoire-quantificateur: nwif
einsteinium: ny6n
artificiel-la-langue: txac
conjonctif-particule: qrik
éloigné-avenir-tendu: twec
fréquentatif-aspect: hfep
distributif-pronom: bvin
allocution-une-entente: hk6m
chauve: blos
banlieue: syum
universel-quantificateur: vlit
ordinateur-la-programmation: mr6m
télévision-programme: tr6m
virgule-flottante-nombre: hvun
existentiel-quantificateur: tl6t
la-journée-après demain: dwek
alternative-quantificateur: lw6t
de-mauvaise-humeur: hdup
passé-passif-participe: hp6t
la-journée-avant hier: txet
locatif-directionnel-cas: tc6k
contrefactuelle-conditionnel: ht6c
