क्रियाकासाधारण रूप: ni
नियुक्तमामला: na
कर्मकारकमामला: ka
विषयमामला: ta
नमस्ते: ca
संबंधकारकमामला: sa
विशेषण: ci
और: wa
मुझे: mi
आप: ya
हमें: nlah
यह: yi
गंतव्यमामला: ti
संप्रदानकारकमामला: pa
आंतरिकप्रसंग: tu
व्यक्तिप्रसंग: pi
आश्रितधारा: yu
साधकपहलू: fa
अतीतकाल: ki
संज्ञालिंग: si
comitativeमामला: mwih
वर्तमानकाल: ma
benefactiveमामला: pwah
essiveमामला: swih
नहीं: nu
इसकी: tsih
सतहप्रसंग: su
adpositionalमामला: pu
स्थानमामला: te
अंतरिक्षप्रसंग: no
मार्गमामला: ra
सहायकमामला: se
प्रश्नवाचकमनोदशा: ri
तथाया: to
एकमात्र: ku
स्रोतमामला: so
पंचमीविभक्तिमामला: lwah
ठोस: di
लेकिन: la
स्त्रीलिंग: ne
बहुवचनसंख्या: lu
भविष्यकाल: we
सामाजिकप्रसंग: mo
अधूरापहलू: me
क्याआपवहां मौजूद हैं: klah
सशर्तमनोदशा: co
अधिक: kcoh
संबंधीमामला: nwih
नतीजेकामामला: lwih
आदेशमनोदशा: de
deonticमनोदशा: da
सवालशब्द: slah
योजक: ksah
व्यक्ति: psoh
अन्य: tcoh
संख्या: do
बहुत: tcah
T.I.M.E: trah
पहरप्रसंग: ro
लौकिकमामला: mrah
केबारेमें: ke
epistemicमनोदशा: pe
केवल: twuh
फिर: pcah
उपदेशदेनेवालामनोदशा: twah
पूर्वप्रभावीपहलू: rwih
volitiveमनोदशा: li
सेपहले: tceh
केबाद: ba
बदलनेकेयोग्य अधिकार: lyih
अविच्छेद्यअधिकार: nlih
अधिकारहीनमनोदशा: drih
perlativeमामला: pwih
प्रगतिशीलपहलू: psih
यहाँ: tcih
नीचेप्रसंग: ce
delativeमामला: dwih
semelfactiveपहलू: mweh
नियो: nyoh
फोकस: fo
प्यार: pyah
paucalसंख्या: ploh
क्योंकि: yo
करणीयमामला: ksih
नाम: gi
उचितसंज्ञा: tsah
उपदेशदेनेवाला: re
दिखाईप्रत्यक्ष: crih
desiderativeमनोदशा: dwah
terminativeमामला: twih
inessiveमामला: nweh
अनिवार्यमनोदशा: prih
मानना: kcah
राज्यप्रसंग: ga
आशा: cwah
factiveप्रत्यक्ष: fwih
आपटाइटिवमनोदशा: pcih
realisमनोदशा: le
क्षमतामनोदशा: tlah
allativeमामला: lweh
Anthropicलिंग: fi
विषय: wo
वहीविषयनिशान: cyah
अलगविषय: fe
डर: ko
संदेह: cu
dubitativeमनोदशा: tweh
ब्याज: nyih
vialisमामला: wi
अजीब: trih
परिवर्तन: ryih
खुश: clah
सिवाय: swah
इच्छा: kwah
लंबाई: lo
संभावना: bi
समझौता: grah
मुसीबत: mlah
quotativeमामला: kwih
सम्मिलितव्यक्ति: lwoh
precativeमनोदशा: rwah
सभ्यरजिस्टर: brih
भावीपहलू: tfah
सूक्तिकापहलू: go
इब्तिदाईपहलू: zi
jussiveमनोदशा: jwih
अनुमोदकमनोदशा: mwah
उचित: kcih
बाहरकाठोस: tseh
बांटनेवालामामला: nwah
चुनागया: treh
दर्द: droh
वार: ja
मालिकानानिशान: srah
commissiveमनोदशा: mu
अचरज: crah
शेषपहलू: kweh
क्रोध: nrah
अभिमान: brah
खेद: pceh
साहस: krah
अनुग्रह: nreh
आंदोलन: mroh
चिंतित: cwih
समाप्तिपहलू: za
intensifier: tfih
प्रत्यक्षमामला: ryah
उदास: syah
अन्यथा: tyah
Zoicलिंग: zo
eventiveमनोदशा: nwoh
वहीघटनानिशान: cwoh
गुणकमामला: plah
हैरान: prah
दया: lyah
सामूहिक: mlih
संतुष्ट: srih
सदाचार: be
काल्पनिकमनोदशा: po
परिचितरजिस्टर: krih
घायल: frah
गम: proh
ना?: nyah
धन्यवाद: kyah
शर्मकीबात है: ru
मुहावरानिशान: fyah
श्रद्धालु: cyih
उत्तेजना: tyeh
hesternalकाल: tleh
नफ़रत: tyih
तर्कसंगतलिंग: tlih
चरम: kreh
वनस्पतिकलिंग: slih
जिज्ञासा: kyih
भयभीत: kcuh
लेख: myah
आशीर्वादमनोदशा: bwih
दोषी: dlih
अनजान: nrih
उदार: drah
पहलमामला: twoh
विलंबितअनिवार्य: ji
कीसूचनादी प्रत्यक्ष: psah
दोष: dlah
कष्ट: kfah
विलक्षणसंख्या: gu
माफकरदो: pfah
धैर्य: je
referential: freh
अकेला: kyoh
आकर्षण: croh
उत्साह: tsuh
अधिष्ठापनकामनोदशा: tcuh
प्रवचनप्रसंग: ye
सम्बोधनमामला: bo
घृणा: grih
चेतावनीमनोदशा: tyuh
महत्वाकांक्षा: bwah
निरंतरपहलू: nyeh
प्रत्यक्षप्रत्यक्ष: troh
भयभीतमनोदशा: pcoh
झटका: cruh
हालकाअतीत काल: clih
निश्चितलेख: klih
ईर्ष्यालु: ryuh
फटकारकामनोदशा: mrih
उदासीनता: du
स्वीकृतमनोदशा: syih
चोट: kroh
नाटककापहला भाग: rwoh
शत्रुतापूर्ण: cyuh
अनुकरणकरनेवाला: mreh
यानी: gwih
अव्तनकाल: dloh
delimitativeपहलू: dweh
अनन्यव्यक्ति: kwuh
TELICपहलू: tfeh
atelicपहलू: tsoh
निषेधात्मकमनोदशा: jrih
यंत्रणा: nroh
निष्ठा: nloh
momentaneपहलू: myeh
माफी: jrah
नम्ररजिस्टर: myih
भूतपूर्वमृतक: frih
उद्धरण: wu
चिढ़: zrah
अभ्यस्तपहलू: bu
अहम: kseh
लगन: dyih
औपचारिकरजिस्टर: sreh
श्रवणप्रत्यक्ष: creh
संयोजन: ksoh
आनुमानिकप्रत्यक्ष: flih
दुर्वचन: sleh
Sublativeमामला: swoh
कथात्मकमनोदशा: ksuh
मौखिक: kceh
सकारात्मकमनोदशा: fwah
असंतोष: dyah
idiophone: dyoh
अत्यधिकमामला: zwah
irrealisमनोदशा: ze
शर्म: cyoh
अनुकूलन: pyih
सर्वनामनिशान: ryeh
अत्याचारकरना: zroh
समभाव: jyah
pegativeमामला: pweh
prosecutiveमामला: pwuh
अतिव्यस्तता: byah
कृदंत: pfih
दूरस्थअतीतकाल: dzah
ऐतिहासिककाल: sroh
हिस्टीरिया: syeh
दोहरीसंख्या: dluh
ग्रहणशीलप्रत्यक्षमनोदशा: xi
प्रस्तावऊपरकी ओर: ryoh
पूर्वप्रभावी: txih
प्रस्तावउतार: myoh
विभक्ति: blih
superessiveमामला: psuh
सकर्मक: t6
निराशा: xrah
प्रस्तावupriver: truh
प्रस्तावdownriver: txah
अलगाव: xo
अवनति: tloh
वर्तमानप्रासंगिकतानिशान: xa
संक्षिप्त: qi
initialism: nl6h
क्रियावाचकसंज्ञा: ge
भूत-काल: preh
AORIST: broh
ज़ातीमामला: pxih
इपिफ़नी: pf6h
वृद्धिकरनेवाला: xe
भय: xyoh
निर्धारक: txeh
विधेय: plih
prolativeमामला: pxah
सत्यप्रिय: vyih
द्विआधारीमूल्य: vrih
सीमितक्रिया: vi
परीक्षणसंख्या: pc6h
समर्थकवाक्य: r6
मित्रता: va
सूक्तिकामनोदशा: kxih
केंद्रीयमामला: dreh
पूर्वअव्तन: x6
मरीजमामला: qa
परोक्षमामला: bwoh
मध्यआवाज़: tyoh
पहचानयोग्य: xyah
लक्ष्यट्रिगर: groh
lativeमामला: dvah
गैरमानव: n6
attenuative: nyuh
multalसंख्या: mloh
ट्रांसअंक: ts6h
आकाशगंगालिंग: gjah
अलविदा: jwah
abessiveमामला: bvah
adessiveमामला: dvih
कोमामला: kxah
agentiveमामला: dveh
एजेंटट्रिगर: greh
अभिनेताभूमिका: nruh
सामान्यलिंग: k6
accompanier: kloh
निष्क्रियआवाज़: pyoh
तारालिंग: qrah
उद्धरणप्रपत्र: xu
मौखिकसंज्ञा: xlih
खंड-पूंछ: kluh
प्रत्यक्षवस्तु: rweh
ergativeमामला: gvih
इन-भाषा: byih
लोकैटिवमामला: kwoh
क्रिया-विशेषण-संबंधीमामला: vlah
अंतिमकण: nluh
evitativeमामला: ve
मालिकानामामला: kfih
nominalization: mleh
अधीनमामला: djah
सहायकक्रिया: fyih
मुख्यवस्तु: myuh
antessiveमामला: nleh
चेतनलिंग: xrih
subessiveमामला: bvih
वाहनलिंग: vlih
खनिजलिंग: xwih
क्रिया-प्रत्यय: kxeh
empatheticहर्ष: pfeh
परिवर्तनकाघटना: qrih
अलगघटना: txoh
ब्रम्हांडलिंग: bjih
इलाकेलिंग: lyeh
अनुसंधानलिंग: txuh
कलात्मकलिंग: s6
crastinalकाल: sl6h
सारलिंग: sruh
exocentricमामला: zrih
सकर्मकक्रिया: tfoh
अतीतसाधक: tr6h
अप्रत्यक्षभाषण: dyeh
दूसराभाषा: sr6h
सामूहिकसंज्ञा: kxoh
absolutiveमामला: bvuh
मरीजट्रिगर: pruh
स्वयंआत्मविश्वास: swuh
कर्मकर्त्ताआवाज़: flah
अवैयक्तिकक्रिया: pseh
मोडलमामला: dleh
अचेतनलिंग: djih
प्रेरणाका: kruh
propositiveमनोदशा: pxoh
बिजलीवर्तमान: breh
जोड़नेवालामामला: sloh
अतिशयोक्तिमामला: sluh
ग्रहोंलिंग: pxeh
पारस्परिकआवाज़: syoh
कोरbenefactive: kfeh
किसीऔरयदि: kyeh
क्रमिकधारा: lyoh
शीघ्रभविष्यकाल: rwuh
अनुप्रयोगीआवाज़: pyuh
antipassiveआवाज़: ps6h
सततपहलू: tfuh
necessitativeमनोदशा: nr6h
एककार्यक्रिया: qyah
अतिशयोक्तिउपाधि: tluh
अस्तित्वधारा: sy6h
वर्तमानकृदंत: vrah
प्रकाशयुक्ततीव्रता: kyuh
singulativeसंख्या: glih
निष्क्रियकृदंत: pfoh
अत्यधिकअवधि: kxuh
रकमकापदार्थ: m6
पूछेमामला: pwoh
निर्वाचितquantifier: vwih
epentheticशब्दका भाग: p6
निगेटिवquantifier: gwah
संयोजीकण: qyih
दूरस्थभविष्यकाल: tl6h
किसीकार्यकी पुनरावृत्ति दिखानेवाला पहलू: f6
बांटनेवालासर्वनाम: bzih
व्याख्यानसमझौता: ks6h
सार्वभौमिकquantifier: xlah
चलबिन्दुसंख्या: fu
अस्तित्वquantifier: sweh
विकल्पquantifier: l6
अतीतनिष्क्रियकृदंत: xyih
लोकैटिवदिशात्मकमामला: kfoh
प्रतितथ्यात्मकसशर्त: fyoh
