क्रियाकासाधारण रूप: hnit
नियुक्तमामला: hnak
कर्मकारकमामला: hkak
विषयमामला: htak
माता-पिता: hmat
पिता: hpap
माँ: hmam
नमस्ते: hnat
पूर्वज: htat
दादा-दादी: hyat
भूखा: hcac
संबंधकारकमामला: hnik
विशेषण: hcit
और: hwan
मुझे: hmic
आप: hnan
हमें: hnam
यह: hyic
गंतव्यमामला: htas
संप्रदानकारकमामला: htik
आंतरिकप्रसंग: htis
व्यक्तिप्रसंग: hpak
आश्रितधारा: htan
साधकपहलू: htap
अतीतकाल: hkat
संज्ञालिंग: hsan
comitativeमामला: hmik
वर्तमानकाल: hyan
benefactiveमामला: hpik
essiveमामला: swik
नहीं: hnic
इसकी: hsis
सतहप्रसंग: hsak
adpositionalमामला: hpan
स्थानमामला: hwak
अंतरिक्षप्रसंग: hnos
मार्गमामला: hrak
सहायकमामला: hsik
कौन: hkan
प्रश्नवाचकमनोदशा: hnim
तथाया: htam
एकमात्र: hkit
स्रोतमामला: hsok
पंचमीविभक्तिमामला: hlak
ठोस: hdit
लेकिन: hlan
सब: hsut
स्त्रीलिंग: hnin
वे: hwin
बहुवचनसंख्या: hlun
एक: hyik
भविष्यकाल: hwet
सामाजिकप्रसंग: hson
कब: hkap
अधूरापहलू: hmap
क्याआपवहां मौजूद हैं: hkac
सशर्तमनोदशा: hcan
अधिक: hdoc
बाहर: htac
संबंधीमामला: hrik
नतीजेकामामला: hlik
कर: hkas
आदेशमनोदशा: hden
deonticमनोदशा: hdim
सवालशब्द: hwac
योजक: hkok
व्यक्ति: hpon
नर: hman
सकताहै: kwat
अन्य: hcon
संख्या: hnoc
बहुत: tcac
T.I.M.E: htim
पहरप्रसंग: htos
लौकिकमामला: hmak
केबारेमें: hkam
epistemicमनोदशा: hsim
केवल: htun
थोड़ा: hcak
फिर: pcan
उपदेशदेनेवालामनोदशा: hton
पूर्वप्रभावीपहलू: hrip
महान: hcat
volitiveमनोदशा: hlim
सेपहले: hsec
चाहिए: pcic
दो: htut
देखना: tcan
जानना: hsat
नीचे: hcin
केबाद: hcas
पहले: hpas
अपना: hpun
बदलनेकेयोग्य अधिकार: hlic
कभीनहीं: hnac
अविच्छेद्यअधिकार: hkic
पुराना: hwat
अधिकारहीनमनोदशा: hcim
दिन: htin
जहाँ: hnap
आना: hlat
रास्ता: hyas
काम: hkaf
स्वर: hwaf
जाओन: hkun
perlativeमामला: pwik
प्रगतिशीलपहलू: hpip
लंबेसमयतक: hlac
कहना: hsac
कैसे: hkin
भी: hpit
वापस: hwap
यहाँ: hcic
सोच: hcik
समान: hsam
पिछलीबार: kcac
दूर: twan
नीचेप्रसंग: hnas
लेना: htit
पाया: hfan
हाथ: cyat
युवा: hyac
यद्यपि: hyap
देना: hkik
परमेश्वर: hmac
delativeमामला: lwak
कुछनहीं: hmin
सही: hyit
एकबार: hyam
semelfactiveपहलू: fwip
हिस्सा: hpat
देखा: htic
घर: hfas
दुनिया: tcat
सिर: hcaf
तीन: tyin
नियो: hnon
फोकस: hcok
प्यार: hpac
सदैव: hsit
रात: hwit
प्रत्येक: hmit
राजा: hyak
केबीच: hsin
दिल: cyin
paucalसंख्या: plom
क्योंकि: hyok
करणीयमामला: ksak
चीज़: hkis
सेट: swat
नाम: hnem
उचितसंज्ञा: hran
उपदेशदेनेवाला: hrat
देश: hlit
सेपूछा: hput
दिखाईप्रत्यक्ष: crit
बेहतर: pcac
पक्ष: psac
कोर्स: hkus
महिला: hfin
पर्याप्त: kyat
शीघ्र: hpuc
पूर्ण: hcun
कक्ष: hfac
लगभग: hlap
नहींकरसकते: nyat
पानी: hwik
desiderativeमनोदशा: hdin
प्रकाश: lyak
न: hnun
शब्द: slat
द्वार: tyan
उपयोग: hpus
सुबह: hsap
terminativeमामला: twik
शक्ति: hkuk
अपने: hmis
वर्तमान: hyin
आवाज़: hwas
सफेद: hpis
धन: tlan
अगला: kyak
दरिद्र: hyis
मौत: hmut
प्रपत्र: hfam
inessiveमामला: nwik
तरह: tyac
अक्सर: tsan
साल: nwan
मित्र: myat
व्यवस्था: hyut
अनिवार्यमनोदशा: hpim
दौर: hcut
मानना: hban
सार्वजनिक: hpin
राज्यप्रसंग: hsas
बेटा: psat
सौ: hmas
बच्चे: hcis
इसप्रकार: tyak
आशा: hcap
ऊपर: hyip
प्रिय: pyin
पढ़ना: pyac
शहर: hsic
पहलेही: hpic
तथ्य: hfat
factiveप्रत्यक्ष: hfit
सुनो: hsun
कमसेकम: hmim
शायद: pyat
खुला: kcat
शव: tcic
हवा: cwac
प्रकृति: nyit
मदद: mlat
पत्र: lyat
चार: ksat
आपटाइटिवमनोदशा: hpam
आग: hfak
इसलिये: hyif
समय: hcam
मुक्त: tyit
युद्ध: syat
किक्या: hsaf
कारण: kyan
यूनाइटेड: hnut
कॉल: hkuc
क्यों: hwam
खोया: hkut
हज़ार: tsas
परिवार: hfic
आत्मा: twam
सवाल: swac
ध्यान: kcan
realisमनोदशा: hlin
मतलब: mwit
क्षमतामनोदशा: hten
कीओर: cyan
allativeमामला: lwik
Anthropicलिंग: hrin
कम: kyut
योग्य: hyuk
जीना: hkip
विषय: hsek
वहीविषयनिशान: hcek
अलगविषय: hfek
उत्तर: tsat
समुद्र: mwat
डर: hcoc
समझना: pcat
कठिन: kyin
शर्तों: tyut
संदेह: hdac
dubitativeमनोदशा: twin
पूछना: psan
हथियार: tcas
काली: clis
लाना: tyat
खूबसूरत: ksis
अंधेरा: tcak
पकड़: psak
दस: htaf
प्रदर्शन: pyan
कहानी: hkif
सामान्य: kwan
किताब: hkup
इलेक्ट्रोनिक: lyin
बातचीत: plak
निशान: myac
ब्याज: nyis
लिखना: kcit
बिस्तर: pwat
ज़रूरी: syis
विचार: hwis
कला: klat
vialisमामला: hlas
भाई: pyak
कभीकभी: ksas
लाइन: lyan
तालिका: tlas
नदी: nwit
आंख: kyac
सूचना: fyin
अचानक: tfan
अजीब: hgan
गहरा: ksan
परिवर्तन: hrit
अनुभूति: nwac
मिलना: mlit
उद्देश्य: htuc
खुश: hcuc
प्रतीत: syit
खून: cyac
गुलाब: kwas
दक्षिण: swan
ठंड: tlat
आगे: myik
स्थिति: psis
देरसे: tyam
खड़ा: syan
मानलीजिए: nlas
बेटी: pyit
मेरा: myan
कमी: hkim
प्रतिलिपि: hfap
पति: hgat
छक्का: hlis
याद: twat
प्रभाव: hyaf
पड़ना: htuk
सिवाय: hsip
बाल: hpaf
पास: pyas
Copyright: pcit
सेना: cyit
रन: kcak
घोड़ा: kcas
भविष्य: hwic
पश्चिम: pcak
वेतन: plit
लाल: hyun
सोना: tcun
इच्छा: hdan
प्ले: plin
स्वामी: mwas
कार्यालय: hfus
सरकार: syak
चर्च: kyas
लंबाई: hlen
कंपनी: ksin
कागज़: kyis
संभावना: hbin
विशेषरूपसे: cyas
भालू: pcas
खिड़की: cyak
समझौता: hgac
सुंदरता: syac
कर्तव्य: tfac
भेजना: fyan
दूरी: htif
चुप्पी: slan
पैर: fyat
जंगली: kyik
मरना: myam
बचाना: pfan
ग्रीन: kcin
मुसीबत: mlan
मुस्कान: myak
गलत: clat
विभिन्न: pcin
नींद: slit
quotativeमामला: kwik
शुरू: cwan
कार्य: kfan
यात्रा: fwat
अनुसरण: nlan
कोशिश: tcis
उपस्थिति: psit
मीठा: tlit
धनी: tcin
दुश्मन: tcam
पोत: hcip
शर्त: kyit
शामिल: hkum
सम्मिलितव्यक्ति: hlon
गुप्त: kwit
precativeमनोदशा: pwim
सभ्यरजिस्टर: hbit
बुराई: pwac
मार्च: myas
जोकुछ: kwac
रहना: hlam
बजाय: plat
नीला: plan
असंभव: psap
स्कूल: hsuk
अवसर: ksac
विवाहित: nwat
भोजन: hcuk
बीस: tsis
शांत: tcit
आसानीसे: hnis
भावीपहलू: hrap
भाषा: lyac
अभिव्यक्ति: syas
सप्ताह: hsus
हॉल: hcum
खतरा: kcic
संपत्ति: myit
जन्म: nyan
कोर्ट: kcut
आमतौरपर: tyap
सूक्तिकापहलू: hmip
लायक: tyas
सरल: syap
पेड़: pyic
लड़ाई: pyap
दीवार: twit
स्वर्ग: cwak
इब्तिदाईपहलू: htip
jussiveमनोदशा: hjin
लहजा: twun
सम्मान: klan
अपेक्षित: pcik
माह: hmaf
अनुभव: nyap
पूरीतरहसे: nyac
ताज़ा: tsac
शासक: hnuk
कवर: kwak
सीमा: hyim
पूर्व: tyuk
पत्थर: pwan
कुछहदतक: kfat
दिशा: tlac
कुरसी: kwis
समर्थन: syut
तारीख: tyic
गाँव: klac
क्षेत्र: clit
अनुमति: nwin
अनुमोदकमनोदशा: hmom
सफलता: slak
उचित: hric
पहाड़ी: clin
संगीत: ksik
बाहरकाठोस: hdat
दोपहर: htup
रोना: hyuc
आदर: hnaf
सात: swit
प्राइवेट: pfat
समाचार: nwas
स्थल: slac
उद्यान: cyam
दौड़: htus
बांटनेवालामामला: twak
सीखना: clan
राजनीतिक: syik
झूठ: kcun
डालना: tsak
खाना: kcam
मंज़िल: hlaf
बीमार: pwin
मूल: mlin
गर्मी: kyam
धर्म: tlam
चित्र: ksit
पलायन: plap
लेखक: hlut
भूरा: pyun
चुनागया: htem
दर्द: hdon
वसंत: psin
सदी: syic
मुलायम: mwan
कोना: kyun
उत्पादितकरें: psas
हंसी: cyaf
भूलना: flat
यूरोप: hyup
आठ: lwat
पोशाक: lwac
भयानक: cyap
सांस: syaf
वार: hbas
मालिकानानिशान: srak
स्मृति: myin
आधुनिक: fwan
स्थान: tcap
वृद्धि: hyus
ब्रेक: pyik
पचास: hfis
द्वीप: tlap
स्पर्श: hsuc
वादा: pcam
commissiveमनोदशा: mwin
उपाधि: tfat
योजना: plac
आचरण: nyak
अचरज: cran
मिनट: hmun
शॉट: hwut
बदतर: pcap
कांच: klak
उदाहरण: tlin
सुरक्षित: hsif
चिकित्सक: tsit
शेषपहलू: hmep
दोहराया: tyun
सैन्य: slin
गरम: nyam
पेय: pfin
प्रशन: pcaf
क्रोध: nran
सीधे: tyik
टोपी: hcup
कुत्ता: kwap
नौकर: hnuc
अभिमान: hram
भीड़: tcuc
गाड़ी: nyin
नैतिक: myut
जुड़े: kyim
दर्ज: fyak
नियम: nyas
तलवार: cwat
आक्रमण: kfak
स्वास्थ्य: clac
अनुच्छेद: pyaf
सामाजिक: hsum
धनकीवापसी: tfit
खेद: hpec
साहस: krac
अनुग्रह: hnen
आधिकारिक: hfaf
प्रदानकी: tsik
प्रार्थना: pwit
झलक: klas
आंदोलन: hyon
उम्मीद: cwit
सामने: psam
बारह: tyaf
व्यस्त: nyut
वाइन: hwun
स्वाद: swut
लोहा: fyac
वितरितकरना: syin
व्यापार: myap
लाभ: twac
कपड़े: kfip
जज: fwak
अंतर: tfaf
चिंतित: kcis
कप्तान: kwin
समाप्त: nlat
समाप्तिपहलू: hsep
जिज्ञासु: kyic
विदेशी: kwic
intensifier: hnif
महत्त्व: myun
अंतमें: hfim
बिल: fwin
साबितकरना: hpuk
रोकना: flan
गरदन: cyun
कानूनी: hfik
सूखा: swak
कीसेवा: syam
खोना: pcut
सबूत: pyut
प्रत्यक्षमामला: hdak
प्रगति: pyis
इमारत: klit
खोज: syuc
उदास: hrac
पाप: psip
तीस: tfis
ईमानदार: tsin
बंद: kyap
बैंक: pcun
भाग्य: cyik
वन: hfun
माप: mlac
अन्यथा: htoc
धारा: lyam
रोटी: hpup
अतिरिक्त: tfak
चुनना: twas
जानवर: nwam
Zoicलिंग: hzin
eventiveमनोदशा: hwim
वहीघटनानिशान: hcom
गुणकमामला: tlak
मोटा: hmus
प्राणी: hyum
बारिश: myic
सतह: pfas
पवित्र: swis
जुलाई: clim
रिपोर्ट: hfut
तट: pwas
फ़ाइल: hfif
कंधा: cwut
हैरान: kran
राजकीय: klik
गीत: hkuf
आराम: kfaf
किसीकोभी: nyic
घास: kcap
खींचना: cwik
प्रारंभिक: cyic
जून: cwun
मछली: mlic
राजधानी: klin
स्तन: cyut
हिमपात: hcif
शिक्षा: tlik
तेज़: tcaf
दया: hdam
व्यय: fyas
तुम्हारा: hmuc
दसलाख: mlun
थका: tcik
हत्या: ksam
छाया: cwap
भार: plas
सामूहिक: mlas
स्थापित: tlip
बहादुर: pyam
पतला: plic
संतुष्ट: srat
चेक: kcik
सदाचार: hdet
राष्ट्रीय: nyaf
दिव्य: swin
घाटी: clak
अनुमान: kwam
काल्पनिकमनोदशा: hken
पीला: clas
अवशेष: mwac
तुलाहुआ: nlac
डिब्बा: pwak
ऋतु: tsim
विज्ञान: slas
छेद: kcuc
चाचा: hmuk
सूची: lyit
अगस्त: ksut
लोकप्रिय: hlup
अज्ञात: fyit
परिचित: flak
परिचितरजिस्टर: krit
पाठक: tsut
पहुंच: pcuc
दोबार: tsap
बौद्धिक: tfik
वास्तवमें: tsam
पुरोहित: pcis
घायल: fran
गम: hpom
महल: kfas
हराना: clap
ना?: hnec
मूर्ख: myuk
धार: pfac
नौ: nwun
विस्फोट: psut
भुगतना: tfas
शोर: hcus
साहित्य: lyic
सलाह: swas
खाली: kcuk
पद: psik
आंधी: tcut
जेब: kyip
कल्पना: nlin
वाक्य: cwas
नवंबर: nwap
दिसंबर: tsip
अनुपस्थिति: psic
धन्यवाद: ryak
पता: tyis
पक्षी: pyuc
मालिक: mlik
कोट: kwut
तैयारकरना: tyip
संबंधों: lwan
धुआं: htum
जनवरी: nwak
मशीन: clic
सामग्री: nyik
दांत: tlis
शर्मकीबात है: hcet
खाड़ी: kcaf
दिमाग: pyuk
अंगूठी: klic
मुहावरानिशान: frak
वर्ग: ksap
फल: fyut
चाय: tsic
समझाना: slam
स्वागत: cwam
कविता: pwis
खरीदनेकेलिए: klam
श्रद्धालु: hdic
उत्तेजना: hcen
चालीस: klis
अप्रैल: pyip
कृपया: kfit
अक्टूबर: kfap
कड़वा: kyuc
दास: tlaf
ढीला: hluk
टेक्स्ट: tsus
श्रेय: cyip
पंद्रह: pfit
निर्दयी: kcim
शामिलहो: cluc
प्रक्रिया: hpif
अपराध: kyaf
धूल: tsuc
व्यावहारिक: plik
रंग: nlak
नष्ट: nyuc
बढ़ना: lyas
नाक: hnus
स्वीकारकरना: tyim
कल: kfac
hesternalकाल: tlen
असफल: slap
जारीरखनेके लिए: tcim
पहनना: pwam
अंधा: nlit
दर्जन: tsun
उड़ना: fyap
प्रशंसा: cwin
शैतान: cwaf
धीरे-धीरे: twic
त्याग: kyif
व्यायाम: cyis
अंतरात्माकीआवाज: tfin
सिद्धांत: tlic
मंत्री: myis
नफ़रत: hnet
झील: cwic
केंद्र: syun
बेहोश: pfic
तर्कसंगतलिंग: hron
सावधान: fwac
आनंद: nlam
पूजा: pwap
माल: twap
त्वचा: twaf
छत: tlut
ताज: gyan
गढ़: klap
सिंहासन: tcus
संलग्न: nlaf
मील: mlim
चरम: krim
जेल: fyis
कप: kcip
सदस्य: mlam
नागरिक: syim
हरजगह: tsaf
प्रत्यक्ष: tfic
युगल: pwaf
आयतन: clam
रिवाज: ksaf
धनुष: ksun
सूट: slut
मांस: mwak
दूध: hluc
वनस्पतिकलिंग: hwen
दृष्टि: slic
दुर्लभ: nlap
चचेराभाई: ksic
पुल: pwut
रक्षाकरना: pfak
नमक: swam
मासूम: hwus
रानी: kwim
गिनती: kcus
जिज्ञासा: hras
नृत्य: tyus
होटल: clut
भरना: flin
बंदी: psun
दुकान: hjan
सीढ़ियों: sric
मानलेना: hmen
रेत: sran
हिंसात्मक: hgit
सितंबर: hsem
प्रस्थान: prac
विनाश: crin
कौशल: krin
मवेशी: hwec
उपकरण: hwip
रसोई: hkon
बेचना: hbak
गति: hsot
निष्कर्ष: clon
कंप्यूटर: hkot
सनातन: hsen
सीमित: mrit
पुस्तकालय: hbek
आधार: hbac
भ्रमकीस्थिति: hrun
यशस्वी: cris
इसीतरह: hjic
भयभीत: hbic
अप्रसन्न: prin
लेख: hrek
पकाना: kfin
बैंड: hbat
रेगिस्तान: hget
चुंबन: hbun
गेंद: hbot
छड़ी: hpot
तर्क: hrut
निरीक्षण: nrak
आशीर्वादमनोदशा: hbim
हड़ताली: hrim
दोषी: hdis
बंदूक: hgin
पुलिस: plis
छिपाना: hzan
अभियान: srin
अनजान: nrin
उदार: drac
बादल: blan
बेकार: htek
फरवरी: frif
रोग: hren
बिताना: bwan
स्रोत: sron
पहलमामला: hnok
चाची: hbam
विलंब: dlic
विलंबितअनिवार्य: hlip
कीसूचनादी प्रत्यक्ष: prat
आधीरात: dyit
नायक: nrac
दर्शन: hfof
उंगली: hjit
आरामदायक: hzat
कहींनकहीं: hmoc
दबाएँ: bran
स्टाफ़: hraf
इनाम: rwan
दोष: dlac
कष्ट: krat
माथा: htec
विज्ञापन: glan
देवदूत: htet
विलक्षणसंख्या: hgam
भोर: hbon
व्यावसायिक: krak
माफकरदो: pran
भेड़: hcec
धैर्य: hpen
खेत: crac
referential: hrec
मक्का: mran
कुंजी: kcif
बहुमत: hmot
दुर्बलता: hdut
वातावरण: traf
झोंका: tcoc
मानवता: mlis
विरोध: pric
डिस्क: hdik
अकेला: hket
कलाकार: nrat
शूरवीर: cwis
आकर्षण: tran
निर्णय: drin
राज्यपाल: gran
शाखा: rwac
स्वभाव: hsoc
उत्साह: tsum
अधिष्ठापनकामनोदशा: hdum
समुदाय: hmum
तेल: hyen
पाइप: hbap
छाप: trat
ओह: dyoc
प्रवचनप्रसंग: hros
सम्बोधनमामला: hwok
केबिन: ksen
अलार्म: plam
परेशान: hnes
स्थायी: hset
चाकू: ksuk
रेशम: slik
घृणा: grin
नरक: nrik
अलग: plen
गंभीरतासे: mrat
मिश्रित: mrik
लकड़ीका: mrak
पसंदकरतेहैं: hpet
चेतावनी: trin
चेतावनीमनोदशा: htom
आवेग: hmos
महत्वाकांक्षा: mrac
इनकार: hnek
संविधान: swic
साधन: srit
निरंतरपहलू: hnip
ज्वार: hgas
कॉलेज: klen
पूंछ: hkek
पीढ़ी: nric
बिल्ली: blat
प्रत्यक्षप्रत्यक्ष: hret
छोड़दिया: trac
ग्यारह: hyec
स्वाभाविक: nlik
विशेषता: trit
जनजाति: hgik
भयभीतमनोदशा: pcim
आश्रय: crat
अशिष्ट: hruc
सवारी: hris
मंथन: hmon
उद्योग: hdot
व्यवसाय: hres
दीपक: hdap
कॉफ़ी: kfif
आज्ञाकापालन: htot
उत्तरी: nrit
नर्स: nris
विश्वासदिलाताहूं: hjat
श्रृंखला: ryin
शिक्षण: cric
जूते: hgut
यार्ड: mram
अस्पष्ट: hmec
अन्यत्र: hlet
फ्लैट: pret
गतिविधि: twot
शनिवार: cram
धूप: hduc
विधवा: hwuc
तत्त्व: hlem
प्रतिबिंब: hfen
संगठन: hgis
तारा: tram
घटना: hgon
अतिथि: hgip
बार: brap
बोतल: hbet
भलाकरे: blak
हलचल: crak
आंतरिक: trik
कोठीक: krik
निकालेजातेहैं: prit
खोखला: hcot
प्रांत: hpos
सभ्यता: srac
लटकना: hgak
झटका: crok
अपवाद: swap
तनाव: tren
मानक: ryan
ड्राइव: dran
छुटकारा: hruk
कसमसे: kses
खजाना: zran
बीज: hbis
मीनार: tras
पसंदीदा: fwit
हालहीमें: hcem
हालकाअतीत काल: hrot
सचेत: srik
फर्नीचर: mrin
रस्सी: hkos
साहसिककार्य: hdas
रॉयल्टी: ryit
दावत: dyat
वर्णन: dras
साठ: hses
स्केल: hkem
समारोह: srec
शिकार: clik
फुसफुसाना: psus
काफीहदतक: ryat
ईसाईधर्म: ksim
वकील: hwif
विस्तार: drit
राजकुमारी: hrus
वेदी: dlat
वेब: hwes
बैंगनी: brin
इकट्ठा: hkoc
चुनाव: hben
धारणा: kren
शराबी: crik
बहना: brac
लिफ़्ट: hlif
इशारा: hjis
प्रबंधन: rwin
विनिमय: tcen
निश्चितलेख: hdek
सम्राट: mras
दूरस्थ: hroc
कुरूप: clup
हानिरहित: cras
रोल: hrof
इंच: nlic
समाचारपत्र: grat
दाढ़ी: dric
आंसू: srim
आयोग: kson
जबकि: grak
चौराहा: kcoc
स्वतंत्रता: htes
गंध: hwon
अठारह: hdec
ऐतिहासिक: tris
कुल: krut
जड़: hrok
कीचड़: hbik
दुल्हन: dlan
परदा: pras
थिएटर: tret
तुलना: kras
प्रतिद्वंद्वी: rwis
संतुलन: slen
कोच: kron
हास्य: hnum
उपन्यास: rwas
बदला: hbaf
ईर्ष्यालु: ryut
पहिया: hlok
जलादिया: glat
फ़्लैश: flac
बनाने: hkec
संघर्ष: hnot
अभिशाप: hlos
फटकारकामनोदशा: pram
असहाय: hces
सकारात्मक: hzit
क्लब: klup
बाढ़: nras
अनाज: gwan
उदासीनता: hdun
क्षितिज: crim
स्वीकृतमनोदशा: hsom
खड़ी: htop
सामंजस्य: mron
गड़गड़ाहट: hgot
बचपन: htok
घुटना: hgun
सॉफ्टवेयर: pwen
चोट: kram
रसीद: ryis
सक्षम: nlim
नाटककापहला भाग: hpoc
सरक: slok
क्रांति: hrif
किसान: hjim
स्ट्रोक: trak
मंच: hpof
मैसेंजर: hmes
विशेषाधिकार: hpek
संगठित: hyot
छात्र: clen
गुफा: hgec
परंपरा: rwat
त्रासदी: tses
बिदाई: hjap
आलोचना: ryik
कपास: krap
अस्पताल: slot
किराया: kris
गैस: hges
अपरिहार्य: pwic
घातक: hgim
पत्ती: glit
प्रकाशन: plun
शत्रुतापूर्ण: tsup
अनुवाद: dwan
अंतिमसंस्कार: jran
आटा: mrun
पत्र-व्यवहार: ryon
रोमानी: hrom
कुटिया: clun
प्रस्ताव: psot
अनुकरणकरनेवाला: hmet
डॉलर: dlon
दिनकाप्रकाश: hjac
सोलह: hsos
सभा: hzac
कालोनी: klon
विंग: gyin
शेर: hles
संस्कृति: klut
स्तंभ: hkom
चालाक: glak
नाटक: dram
परिहास: hjuc
धुंध: hdus
दवा: dwas
चौदह: hkes
अम्ल: sram
यानी: hyet
आमदनी: hmok
बिशप: hbip
नारंगी: tron
स्नान: byan
आदिम: rwit
टोकरी: ksek
सचिव: sris
पुआल: prak
अधीर: pfif
मोक्ष: slon
अव्तनकाल: dlin
इरादा: zrin
भाप: tcip
विष: hwoc
प्रतिभा: tlon
जलवायु: lwim
प्रभावी: fric
भेद: tcif
धुलाई: dwac
स्वीकारोक्ति: kfis
बकवास: hjas
कोयला: kyon
डोंगी: kwon
अस्थायी: tric
delimitativeपहलू: hdip
हड्डी: hcos
सोमवार: nwic
मंगलवार: glac
बुधवार: bwac
संघीय: frin
वांछनीय: hzic
प्रतिनिधि: ryic
लिनन: lwin
सिंक: swuk
भतीजा: bwin
रक्तरंजित: kric
घेराबंदी: cren
पेट: hpem
पीतल: pcon
शिखर: hzik
पांचवां: pfik
सस्ता: brat
अनन्यव्यक्ति: kwen
पकड़ना: zrat
बाड़: hzas
प्रतिमा: tfam
तोपें: tlep
आलिंगन: mrap
आसपासके: sren
सख्ती: srot
मृग: hluf
झाड़ी: hbuc
रेल: hrep
मुक्ति: hduk
वारिस: mris
बलूत: blun
अप्रिय: pren
आविष्कार: hgic
पियानो: pyon
मनाना: swen
अदृश्य: gric
श्रुत: ryun
क्रूरता: kluk
प्रलोभन: hyoc
TELICपहलू: hlep
आर्थिक: kfik
अंतरराष्ट्रीय: troc
हस्तक्षेप: tcek
दार्शनिक: flif
शिष्ट: gyit
कल्याण: kyen
मछलीपकड़ना: mlak
चुराना: truc
ओंठ: hloc
रिटायर: ryac
खिंचाव: sras
गेलरी: glen
समानांतर: zlan
atelicपहलू: htep
महाद्वीप: trap
निषेधात्मकमनोदशा: nrim
टाई: dwat
सेल: slep
अंडा: dyan
कृत्रिम: jrat
इसबीच: nwis
संकट: ksot
सभ्य: sloc
लंच: lyon
देवदार: pwon
धक्कादें: hcef
गठबंधन: lyen
कमर: hkop
चमत्कार: hmek
नाविक: slis
पवित्रता: prut
गणतंत्र: hguk
टेलीफोन: tfen
कोड़ा: krip
कमीज: cyim
परिचयकराना: ryas
सोफ़ा: hsof
घुमाव: hsup
चोर: ksif
बनाएरखनेके: nrec
चैनल: kcen
व्यक्तित्व: klim
सुधार: kfam
धमकी: hzim
हथेली: plim
वक्ता: hzak
डेवढ़ी: dwic
प्रेरितकरना: pris
भाला: bzak
स्वच्छ: syec
अधिवेशन: cwen
यंत्रणा: crot
नम: tcum
चोटी: grit
यात्री: hyek
चक्की: mwik
नक्शा: jrac
कॉलर: klok
कीजगह: klif
जान-बूझकर: drat
बीयर: hbif
मख़मली: hwem
गंभीरता: gwit
उपदेश: hpum
गाली: glas
झुण्ड: hgen
तेरह: tres
औचित्यसाबित: jyit
शुक्रवार: crum
ब्रश: broc
डाउनलोड: dlas
क्रीम: krem
चट्टान: klaf
जूरी: jrin
राक्षस: ksos
जमेहुए: hgoc
पॉट: pfot
पैसे: psen
जोर: srut
सेब: hpep
परचर्चा: drak
पृष्ठभूमि: prun
टाइपकरना: trim
सामयिक: prik
मनोरंजन: nren
वाइरस: bris
बचकाना: blit
प्रतिबिंबित: flit
बदलना: kcet
रूपरेखा: kluc
ओपेरा: hpop
अनुमोदन: nron
प्रकटकरना: rwak
सज़ादेना: hzen
कोहनी: kcon
आसक्ति: tcet
मरम्मत: hrop
संदेहजनक: cyec
सत्तर: swet
इंजील: srip
गड्ढा: grac
विकार: dlak
बाइनरी: byin
ऐबी: bjan
तीर: tcec
करतेहैं: trec
विस्तृत: frat
निष्ठा: hlot
सिक्का: syip
सिहरना: tcem
निर्वासन: gwin
मशीनी: myim
फंदा: crap
केक: kyek
महोदय: cyes
संकोच: sret
सत्रह: syet
मधु: myon
दाँव: dzat
चाल: hjam
ईंट: brit
अस्सी: hpes
दुर्भाग्यसे: pcen
परामर्शकरना: kcot
किंवदंती: lwen
फ़सल: hfos
पदोन्नति: pfon
स्टोव: hsop
विद्रोही: bric
पुरानेढंगका: hnom
महातरंग: cron
दलदल: swot
ड्रेसिंग: hdes
तपस्वी: pces
प्रबंधक: mren
सहगान: cros
तर्कसंगत: tson
प्रसंस्करण: pson
भेड़िया: blaf
गलीचा: hgap
प्राचीनकाल: hjak
उपजाऊ: frut
सीटी: slif
पनीर: twis
काटना: byat
आमंत्रण: jwan
कैथेड्रल: kyet
बन्दरगाह: brak
भटकना: djan
फसलों: tsos
नौसेना: nlen
मुखौटा: mrok
पेंसिल: pses
सब्ज़ी: sroc
एक्ज़िबिट: hzet
पतलून: tlun
दूषण: hrup
मंत्रिमंडल: nram
सूप: srup
सर्जन: syon
भत्ता: tcot
जासूस: gyas
लापरवाह: hlec
गपशप: gyic
टोकन: hzon
अमूर्त: srok
गुरूवार: cwim
यातायात: ryaf
आर्किटेक्चर: ryek
दरार: rwaf
आभूषण: rwon
उलटा: lwas
मनबहलाना: mwun
वसूली: ksus
फुटपाथ: plut
निर्णयात्मक: dyin
नकारात्मक: nraf
त्यौहार: hfec
कमहो: hrum
राज-द्रोह: zyan
शिकारी: djin
साँप: syen
बैटरी: bret
मोम: flam
जासूसी: dlit
विश्लेषण: nlis
ज़ोर: hzot
तैरना: twen
लिफ़ाफ़ा: lwaf
जोकोई: hgek
सिगरेट: jrit
मोटर: mrot
स्वयंसेवक: hwot
प्रतिक्रिया: ryif
सामान: blam
बहरा: hboc
रस: hjus
विनम्रता: jlit
मंत्रालय: mret
यौन: hjon
व्यास: dyam
कुल्हाड़ी: blac
हीरा: dlam
वैकल्पिक: hlek
गूंज: hgus
संयम: swon
पहचान: hdaf
स्क्रीन: krun
आलसी: lwis
momentaneपहलू: hmop
सघन: kfot
अभिप्राय: hdif
गायब: hgaf
रे: ryen
स्याही: mwic
बड़ा: mraf
तहख़ाना: dyac
अविस्मरणीय: nrun
चमक: klek
सिनेट: slet
ताबूत: tfap
माफी: frac
निगलना: nlun
तृप्त: nlot
झूला: swun
घासकामैदान: gram
जटिल: klos
इस्तीफा: hzis
नम्ररजिस्टर: nret
साजिश: swim
मिर्च: prip
टट्टू: pron
उम्मीदवार: hzam
लोमड़ी: flik
चिमनी: tcon
अधिकारक्षेत्र: drik
कृषि: rwic
शुद्धता: tcuk
भूतपूर्वमृतक: brim
डेमोक्रेटिक: mrek
कली: hbos
कंबल: bwat
जयहो: hgep
सूअर: srus
आकारका: krek
हाथीदांत: craf
क्लासिक: ksok
पर्यवेक्षक: nwet
हाथी: lwit
नाखून: nwus
मधुमक्खी: hmif
दफनाना: dzan
अभिनेता: bzat
पसीना: zwan
पोलिश: ploc
माया: hlus
अनिश्चितता: pcet
माध्यमिक: syif
तह: tsot
ग्रामीण: grun
कराह: nyen
जैसेलगतेहैं: slec
उद्धरण: hzun
थैला: cyek
चिढ़: fren
सुई: hjun
संगृहीत: nroc
मुर्गी: truk
संगत: kwot
बैरल: bras
अभ्यस्तपहलू: hcep
विशेषज्ञ: ksec
प्रभावितकरना: blin
जैतून: zlin
वैन: myen
बाधा: bwak
सिरकाइशारा: kcec
पालक: plaf
परिभाषा: fyic
जन्मदिन: gjin
हथौड़ा: hcof
सुगंधित: hfon
दुहराव: trun
तुच्छ: twut
लात: hjik
खुदाई: kwaf
पालतू: plot
खोपड़ी: hcop
विधायिका: dlik
एड़ी: cruk
भ्रूभंग: crun
पेटेंट: plet
एकअरब: blim
रासायनिक: fyik
पायलट: pyot
कीनकल: mlot
स्कर्ट: kwet
असामान्यरूपसे: srap
साप्ताहिक: jwik
तकनीकी: tfip
वनस्पतियां: tset
कौआ: kraf
सूर्योदय: sruc
जीवनकाल: glin
योगदान: hyom
अंकुड़ा: hdok
बाघ: blic
घुसना: crut
आस्तीन: slun
हाइवे: jras
मिलिशिया: mlip
खाई: kroc
अखंडता: kret
उन्नीस: dzin
कार्बनिक: rwik
धर्मशास्र: flic
नाव: flut
डायन: byac
ऊब: hwuk
राजनयिक: dyik
स्टूडियो: twos
सेअधिक: kcok
शैंपेन: cyen
कोप्रेरित: crif
बैनर: hbes
तलाक: lwon
पेंच: hbut
नस: jyan
निष्क्रिय: psif
झाग: hgum
कंकड़: grik
तहबंद: tyen
ग्रह: gren
शेल्फ: claf
प्रशंसक: flon
उष्णकटिबंधीय: hjip
अवस्था: fwas
मनमाना: rwen
उच्चारण: kfun
पारा: krok
रेंगना: hrem
आत्महत्या: tcos
रिपोर्टर: prot
वंचित: hpok
कुशल: klun
बालकनी: blik
कांटा: fras
कर्मचारी: mlek
नियोक्ता: myot
चौड़ाई: jrak
कुपित: djit
आरोपलगातेहैं: klot
पेंशन: pyen
क्रिया: kres
बंदर: mwon
स्वीकार्य: hwek
हस्ताक्षर: tlim
रूढ़िवादी: rwos
व्यंग्य: fron
नर्सरी: nrap
अनिच्छा: jlan
आयात: tyot
मशाल: croc
व्याकरण: gjak
जमा: gyat
औपनिवेशिक: plon
नौका: jyat
अहम: kwec
गुंबद: kwun
मोटाई: hfot
हठी: cyon
मांसपेशी: hmup
परिमाण: ryam
रगड़: ryos
राड़: rwam
साज़: gwac
टोस्ट: tros
माउस: myus
शब्दांश: slim
थपथपाना: prap
संवाद: dlaf
तटस्थ: nrot
लगन: dwin
अंतर्विरोध: trot
लक्ष्यकोहासिल: kfic
बकरा: byak
पनपने: hfet
थोपना: mlon
गुमनाम: nwim
औपचारिकरजिस्टर: frit
बछड़ा: hbof
गाइड: mwut
पिघल: hjec
मिटाना: flas
छाता: gras
बूट: bzut
खनिज: mrim
संघर्षविराम: crus
बत्तख: hbok
आयोजन: pfam
साबुन: hsuf
गुड़िया: gwak
कंकाल: klet
विला: blis
सिलाई: jlin
समाधानकरना: dyak
केतली: kset
प्रौढ़: mruc
खरगोश: kruc
कंडक्टर: nwot
निर्भरता: djat
खिलाड़ी: jlic
कीट: pset
भोजनालय: cret
उल्लू: lwun
उग्र: djik
निवासी: zwin
अजगर: dron
श्रवणप्रत्यक्ष: drot
प्यास: kyos
ठहराना: dren
गणना: glun
विनियमन: ryim
महापौर: mlap
अल्पसंख्यक: mric
अर्जन: dwon
दिग्गज: bren
ऑर्केस्ट्रा: ryes
बेकन: bjin
हानि: zwat
कपड़ा: frap
संगीतकार: gzik
मानसिकरूपसे: hnep
संयोजन: nyon
अपर्याप्त: nrip
वास्तुकार: tsek
नींबू: nyim
खांसी: kcos
सिरदर्द: crek
किरायेदार: ryet
उपजाऊपन: srun
चंगा: hfoc
नव्वे: nwon
बिनासोचेसमझे: hbec
चम्मच: kcek
गुब्बारा: blon
चाक: hfip
आनुमानिकप्रत्यक्ष: nlet
प्रकाशक: pcot
सिरका: sruk
एश: fyec
दुर्वचन: slek
पुनर्जीवित: nrut
कोमल: kfim
सुरंग: tfun
पहेली: hpef
तंत्र: mwim
गणित: gzit
मुरझाना: frun
जिगर: jwin
Sublativeमामला: bwik
डुबकी: dris
इकाई: twim
एकाधिकार: hnop
जुआ: hgup
पनडुब्बी: bzin
भूकंप: hbem
प्रयोगशाला: brot
काग: kruk
स्वयंनियंत्रण: syot
बुद्धा: hbus
बुनना: bjat
दूतावास: blas
सबसेअधिक दूर: sres
कथात्मकमनोदशा: drim
प्रोत्साहन: tyuc
चॉकलेट: clot
संयोग: tyon
दस्ताना: gwat
घुटनाटेकना: hjek
भूगोल: hjif
निवेश: nwes
मौखिक: mrec
समानता: nlip
धर्मनिरपेक्ष: srek
बाज़: blap
मनोविज्ञान: nloc
जकड़ना: gjan
स्क्रैप: krep
भूमिका: cyum
ख़ुराक: hdos
सैल्मन: slom
पुडिंग: pwun
चुंबकीय: gyik
पंप: pcom
ऑक्सीजन: ksip
प्रमाणपत्र: tfot
पदक: hmem
वक्रपटुता: trok
परिमार्जन: rwap
डांड़: dyas
दूरबीन: trip
हार: clek
वर्तनी: prif
व्हिस्की: hwos
विलो: hwof
ऊंट: hlum
शौकिया: myet
बाहरजाएं: crec
जीवनी: brif
गधा: gzac
मासिक: mwis
उपेक्षा: nruk
छुट्टी: byit
क्लिककरें: lyik
अंडाकार: twon
लोचदार: lyet
शब्दकोश: kfon
जांघ: gzam
इंद्रधनुष: rwun
उपभोगकरना: kcum
थूक: tcup
टैंक: trek
सहयोगी: clok
तितली: trif
चार्ट: graf
जुड़वां: jwat
स्वतंत्ररूपसे: trem
बांस: hbum
विक्रेता: jlat
संचय: kles
इंस्पेक्टर: nyet
निवाला: hyos
बुरासपना: hbom
जाम: gjam
संग्रहालय: mrem
वर्णमाला: lwam
बिखराव: zras
छापा: crip
खुलासा: clus
सड़ांध: fraf
आक्रामक: gris
टकराव: mroc
घाट: gyac
मकड़ी: brik
आलू: trut
संशोधन: cwon
लालच: jlac
असामयिक: ryot
गुणाकरना: gzan
स्पिन: pcip
सांख्यिकी: tsok
कैलेंडर: klem
नामांकन: nwen
ट्रिलियन: tlos
अटारी: tlok
सकारात्मकमनोदशा: rwim
आवेदन: pfen
नाममात्र: nlon
असंतोष: sraf
संक्रमण: hfok
मटकी: krot
कंधेउचकानेकी क्रिया: cyok
अगुआ: gzin
चूक: nlif
गोभी: glic
पुष्ट: tlet
मादकता: mrut
idiophone: hdof
उत्तोलक: lwek
सीनेटर: syem
आँखकीपुतली: nrif
चींटी: mwam
बग: hbop
गर्भवती: grim
वेग: hjet
टखने: tcok
वर्गीकरण: glik
परिवर्तनशील: prim
कपड़ेमेंलपेटकर: ryap
घुंघराले: krec
गंधक: hsef
हुक्म: dwik
उभरना: brun
मेढक: fram
अत्यधिकमामला: twek
स्पंज: hjen
कष्टप्रद: djon
गिलहरी: slip
पीसना: zyin
irrealisमनोदशा: flim
ज्वालामुखी: glam
घरकेअंदर: gron
शोषण: kloc
भूवैज्ञानिक: jlik
पासपोर्ट: psop
अनैतिक: mlet
बिस्कुट: hbuk
सहयोग: kros
गोली: tlot
विश्राम: kces
परमाणु: trom
एड्स: hzip
पिरामिड: psim
चक्र: swok
झपकी: hnup
ग़ैरक़ानूनी: hjaf
पंजा: pfap
शर्म: crom
ग्रहण: klip
वीणा: lwap
झाड़ू: srum
पैनल: mwen
खगोल: tcom
भूलभुलैया: blen
छात्रवृत्ति: bwit
कछुआ: kfuc
सलाहकार: dwak
रेशा: fwic
क्रिकेट: jrik
कबूतर: ksom
अनुकूलन: dyon
त्रिकोण: tfon
कोषाध्यक्ष: tsen
हाइड्रोजन: jron
नाज़ुक: hfuk
मुद्रक: pyet
गलाघोंटना: tcof
जीर्ण: gzon
सामना: slaf
दुविधा: dlim
इंजीनियरिंग: jyin
कैमरा: hkef
माफीमाँगताहूँ: pluc
चाटना: lwet
नर्तकी: dret
प्रवास: mres
टेनिस: tces
रीढ़कीहड्डी: clip
तलना: zrac
करघा: tfuc
आवेश: twuc
पासवर्ड: psaf
गोलार्द्ध: praf
रणनीति: zrit
क्वार्ट्ज: krus
कैंची: jris
पहरा: proc
हिमनद: lwic
आधेरास्ते: dwam
ज्ञापन: mwap
शंकु: kwuc
समरूपता: hzut
उत्पादक: zrak
प्रतिवादी: fwik
मस्जिद: djis
शतरंज: cres
टोल: htof
चेरी: tref
बड़ेपैमानेपर: kfen
ठोकर: tfok
ट्रक: ryok
सरसों: mros
प्रतिशत: pfet
नीलाम: jlam
चलनी: srif
अस्थिर: swoc
चुंबक: gjat
चूसना: syus
इसलाम: slum
छिपकरजाना: twip
झिल्ली: mlen
हजामत: clet
गिटार: gjit
चमकदार: bzan
एल्म: hyem
ऊंचीउड़ानभरना: kcom
सर्वनामनिशान: ryec
प्रधान: pcus
मसाला: zlat
जमानत: jlas
वाहक: zyac
कंपन: bron
चिढ़ाना: trus
हल: hlom
शारीरिक: zlik
नाली: hgok
धूमकेतु: cyet
मध्यकालीन: dyic
गौरैया: grec
क्षतिपूर्ति: twet
प्लास्टिक: psuk
फुटनोट: cyot
कक्षा: rwot
मितव्ययी: twum
गोल्फ़: hgof
शून्य: zrun
टुकड़ा: tcep
अत्याचारकरना: prok
जंभाई: gjac
असमानता: gwas
तिल: tloc
मिट्टीकेबर्तनों: frik
गृहिणी: hgif
राई: rwem
आज्ञाकाउल्लंघन करना: hyes
सहिष्णु: glon
भ्रूण: brec
खानमेंकाम करनेवाला: jren
सराहना: zlac
ख़मीर: lyim
प्रीमियम: pfim
बेर: plem
दिवालियापन: byas
सिंचाई: rwif
पुदीना: nyun
पूंजीवादी: glis
लोच: hlef
शार्क: gyak
रंगरूट: drut
भंडारण: zren
यथार्थवाद: cles
अदरक: djic
एम्बुलेंस: blus
तुलनीय: kwip
बटुआ: bjap
मुंहबनाना: glim
वैज्ञानिक: gyis
आंत: grot
समभाव: hwum
रेडियो: href
असंगत: zlit
सेम: bwam
अनौपचारिक: frim
पोती: gyut
बहस: dloc
स्टेक: tfek
नाइट्रोजन: zron
उस्तरा: hjut
विषम: krom
प्रचार: pcoc
आतिशबाजी: fris
पॉप: pcop
घरकाकपड़ा: crop
कुंड: cruc
हानिकारक: hzaf
जूदाईस्म: hjum
पूरकहैं: pluk
लेंस: lyes
pegativeमामला: pwek
कैंसर: kfes
प्यादा: pyek
व्याख्याता: zyat
रिसाव: hzuk
अर्हता: krif
घनत्व: djot
अधिष्ठापन: dyis
जुगल: htuf
बातूनी: bzit
झींगामछली: hgos
छूट: dyut
टैक्सी: tsuk
पदक्रम: crem
जेड: gyec
गिरह: glaf
छिपकली: lyis
झरना: crof
निराशाजनक: djak
वीटो: frot
राष्ट्रपतिपद: ryip
क्रेता: mrif
गैलन: jlen
मच्छर: mruk
विचलन: dwen
कुश्ती: lyut
मौज़ेक: myok
प्लग: plok
फूहड़: pcuk
किराना: ksoc
साम्यवादी: myos
विस्मितकरना: mwek
prosecutiveमामला: rwuk
नक्षत्र: nlos
तानाशाह: dwit
अतिव्यस्तता: tyet
उपग्रह: tlec
चप्पल: hlop
व्यंजन: fyon
अनुमानित: tsif
बेरोज़गार: byet
समर्थक: sros
कमल: lwot
सलाद: sles
क्लोराइड: lwok
जीवाणु: bwic
चिपचिपा: pcek
अंग: bwon
गुठली: klec
बहानाकरना: bjak
बाइट: bzet
स्राव: sruf
स्पष्टरूपसे: pres
मेलखाना: mloc
बैले: blet
मूत्र: mrus
लहसुन: lyun
गुजरचुके: hguc
अर्थशास्त्र: kcem
मध्यमवर्ग: hdom
चुस्त: gjic
चिमटा: htef
लॉन्ड्री: lyoc
स्ट्रॉबेरी: srem
शहरी: pcos
असमंजसमेंडालना: mlaf
नोटबुक: tfut
एल्बम: zlam
बेसबॉल: hbep
सूंघना: sluc
बुफ़े: hbuf
कृदंत: rwip
गेराज: grek
निदान: djas
बैसाखी: ksuc
धमकीदेकरमांगना: srom
पंजीकरण: psuc
घुलनशील: jlun
फास्फोरस: psof
संरचनात्मक: rwut
गोंद: glum
थीसिस: twes
शिल्पी: clif
केला: bwas
स्वयंसिद्ध: kyom
पसली: psos
निकल: nyek
गड़बड़ी: pyim
बस: bwos
सेंसर: swes
मिसाइल: mlus
सॉस: slos
जोड़-तोड़: nlut
टमाटर: tfet
कोमजबूत: kfut
सॉकेट: syok
पोटैशियम: tsom
पुनःप्राप्त: prup
वास्तविक: zwit
बीजगणित: gjas
दंतचिकित्सक: dzit
ऑप्टिकल: pcok
हिलना: bzen
जीवविज्ञान: bwim
बेरोजगारी: byim
कमला: krum
एकल: slof
ब्राउज़र: bjac
दूरस्थअतीतकाल: nyot
ऐतिहासिककाल: crep
नाभिकीय: nluk
स्पेक्ट्रम: pyem
सोडियम: syom
हिस्टीरिया: syes
ट्रस्टी: tyos
बंधक: byik
लौकी: gluk
शिकन: kwuk
पारदर्शिता: tfif
कील: swip
प्राथमिकता: pcif
पैदलयात्री: dyen
नास्तिकता: tsem
मॉनिटर: mwot
चुनावक्षेत्र: nlec
अनियंत्रित: hkof
जांच: grok
प्लैटिनम: plip
दोहरीसंख्या: dlun
फेफड़ा: pcep
सुपर: syup
ट्राली: trop
स्थानीयस्तरपर: lyot
उत्तेजितकरना: gzat
पेट्रोल: plif
गुर्दे: grif
लूटमार: bzac
मूल्यांकन: dlen
संखिया: syek
घोंघा: nrok
टिड्डी: tsec
समीकरण: fwen
समाजवादी: swos
फिल्टर: flot
ग्रहणशीलप्रत्यक्षमनोदशा: hxin
चौड़ा: kyot
फेंकना: mwet
पट्टा: pwet
अकर्मण्य: drun
जॉकी: hjok
निमोनिया: hnof
एकजुटता: gret
काज: cyif
अनुदैर्ध्य: nruc
लाभांश: dwun
स्केट: hkep
प्रतिपादक: slop
विकलांगता: dlif
जुनून: bwen
आवंटन: pfun
फोटोग्राफर: trof
डेल्टा: dlet
डिजिटल: djim
कुतिया: brut
पपोटा: hyop
विकर्ण: dyun
अचेतन: byon
भौं: bruc
छींक: pcec
उल्लसित: dlis
हिन्दूधर्म: nwum
शरणार्थी: nyif
शटल: cwot
प्रोटीन: pwot
ढेर: hdop
निखारने: flen
वमन: hwom
जीन: gyen
नए: hdem
समाजशास्त्र: syoc
स्क्वाश: kwoc
मछुआ: hfuc
क्षेत्रीय: jyen
प्रस्तावऊपरकी ओर: hvok
पूर्वप्रभावी: hxik
बवंडर: gyon
पलटना: nwos
टीवी: twif
घनक्षेत्र: kfet
उत्पादकता: pwuk
गाजर: krop
आणविक: mwuk
समूह: glet
मुनीम: ksum
खीरा: kyok
नंगानाच: drok
विलायक: jlet
फॉस्फेट: psef
भजनकीपुस्तक: gwik
क्षारीय: flis
कसरत: jyas
अल्पविराम: kwom
प्रस्तावउतार: hvat
गर्भपात: jwac
फली: tcop
दाता: dzon
मैंगनीज: hzem
मनोविज्ञानी: syos
क्लोरीन: clos
कीबोर्ड: kyoc
अभिजातवर्ग: zyit
कोष्टक: pfaf
रग्बी: rwoc
व्रण: jlon
विभक्ति: hxit
कुतरना: nres
मात्रा: fwam
स्वेटर: swek
विकासवादी: fwis
नोटेशन: nyoc
उछाल: tcuf
विच्छेदन: drec
कैश: kcep
रैखिक: lyec
सुरमा: trum
superessiveमामला: psek
फोडा: twom
कटाव: cyos
अल्फा: flaf
नाभि: nwip
प्रतिरक्षा: myip
इंफ्लुएंजा: flun
शराबकीभठ्ठी: bjit
आसानबनानेमें: slef
संक्षेपकरना: bram
काटनेकानिशान: djen
बंदीबनाना: dwim
मजबूरकरना: brok
मौज़ा: bzas
चलचित्र: fyim
कास्मोस\ब्रह्मांड: klom
नापाककियाहुआ: hpuf
झुण्डमेंरहनेवाला: gjen
लिंग: zyis
वानिकी: lyif
अल्युमीनियम: lwum
कंपन: zlon
कुंडली: ksop
बेदखलकरना: dlek
समावेश: nluc
लाभार्थी: byic
डॉल्फिन: dlip
हत्यारा: cyus
स्तनपायी: myaf
सूचक: swif
डाइऑक्साइड: dwis
पेटके: zlen
नौकरशाही: brus
बिगाड़ना: jric
फ्रिज: frip
पुरातात्विक: cluk
अस्वीकार्य: kwok
विनिर्देश: pfis
पत्रक: pfut
नृविज्ञान: nlom
स्वादिष्ट: kyec
सकर्मक: txit
cower: kwus
सूरजमुखी: hzuc
जूं: glus
आयन: lyos
पर्यटन: tyum
मोडम: myom
त्वरण: jrun
मिथ्यासिद्धकरना: tsoc
उत्सर्जन: hmef
अपहरणकरना: drap
ओवरलैप: hwep
नाई: pfes
लोक-साहित्य: floc
केशिका: plek
राष्ट्रवाद: nlum
नितंबों: nros
मूलभाव: hmuf
उदात्तीकरणकरना: slem
निराशा: xras
कोबाल्ट: kwos
जई: gwam
प्रस्तावupriver: trup
गुदा: gyam
मंद: bwun
फ्लिप: flip
फालतूपन: dzun
वीडियो: hwop
बहिष्कार: bjik
प्रश्नोत्तरी: cwif
हॉकी: cwok
गुरिल्ला: grip
मैग्नीशियम: hgem
राडार: drek
चिंपांज़ी: hzif
विश्वसनीयता: kwif
आयत: tyec
सिवार: klep
सामान्यीकरण: jlak
निषेधाज्ञा: kfec
समलैंगिक: mlok
परिदृश्य: srop
सूत्रीकरण: flus
पुनर्जन्म: nrom
आगलगना: zlak
यूरेनियम: ryum
पकड़नेवाला: kwes
समन्वयस्थापित: kyop
करदाता: nwaf
एकीकृत: trep
राय: hzap
गामा: hxam
सफारी: fwim
प्रस्तावdownriver: ht6n
गुणक: kfus
शीर्षक: zlic
विश्लेषक: nles
मात: hzes
मॉल: hmof
विस्मुट: bzim
पोस्टकार्ड: psok
अभिसरण: bros
पीछेहटना: djet
हिस्सेदार: ksem
सूक्ष्मजीव: mrip
जनन: jwit
रूपात्मक: mluk
बीटा: byot
जीन्स: gjis
डेटाबेस: tles
कैलकुलेटर: klus
एक्स-रे: ksef
पार्स: zram
पर्यावरण: zyen
सिग्मा: zyim
अलगाव: hxon
कार्यसूची: gres
वीसा: bzis
बुनियादीढांचे: nyuk
जुगनू: gyun
डिटेक्टर: tyek
अनुकूली: dyip
जीवविज्ञानी: byis
ब्याह: pyec
ब्रोमिन: brom
दुर्ग: plum
हिचकी: kfok
पस्टेल: psec
चिड़ियाघर: zwac
क्लिनिक: lyok
अर्थ: nwoc
योग: hjoc
किताबोंकीदुकान: byun
चिकित्सा: grap
राष्ट्रवादी: zlis
सिरकाटलेना: zlet
हाँ: swec
समस्यात्मक: byam
जाज: dzas
टंगस्टन: tsof
आतंकवादी: gwis
बूँदबूँदकर टपकना: droc
चयापचय: tlem
गुजाराभत्ता: lyaf
सप्ताहकेअंत में: hfom
गुलदाउदी: gzim
टीका: byap
मोटरसाइकिल: tyok
मंत्र: dyot
छमाही: myes
हेरोइन: gwon
फ़ोल्डर: flap
कैथोड: kfoc
विचारधारा: dlec
पार्किंग: prek
थीटा: fret
अवनति: hxis
सेलेनियम: clem
साइकिलचलाना: blek
कोर्टेक्स: pros
समानक: swaf
वर्तमानप्रासंगिकतानिशान: hxak
हवाईअड्डा: cwoc
अंग-विच्छेदकरना: gyet
बास्केटबाल: bwet
ढोंगी: mwip
तिलचट्टा: tlek
क्रोमियम: hgom
लीटर: hl6t
फिरभी: nwec
हार्मोन: cwom
त्रुटिपूर्ण: tluc
छेदना: prec
सर्वात्मवाद: nyom
बहुभुज: cloc
नारीवादी: hfes
एकत्रित: kcop
यूरो: dros
जिनसेंग: hjes
कलनविधि: hlof
लेज़र: lwes
दवाकीदुकान: dlot
मिलीमीटर: mlem
फ्लेक्स: flek
एनोड: nlok
अतिसूक्ष्मअंतर: hzus
पार्टटाईम: prem
संवेदनशीलता: nyec
प्रदर्शक: drom
हीलियम: clum
द्विभाषिक: dzic
संक्षिप्त: hqim
initialism: nl6m
क्रियावाचकसंज्ञा: gros
प्लाज्मा: psem
क्रोमोसाम: rwom
क्रमवाचक: rwok
किलोमीटर: klum
फैक्स: tfes
आनुवंशिकी: nwek
झाई: frek
पेंचकस: dres
ब्रोकली: blok
भूत-काल: xrit
विटामिन: tyem
कैडमियम: kyem
बमवर्षक: bwoc
चित्रात्मक: gjik
टाइटेनियम: dyim
शेख़ी: clec
लैम्ब्डा: lwem
प्रेमिका: pcem
मैथुनकरना: kyuk
hourglass: tlus
सहानुभूति: mlif
बोरान: bres
हेलीकाप्टर: cwet
टेल्यूरियम: tlum
समयसीमा: jyic
संरेखित: gwic
सेंटीमीटर: hfem
मोलिब्डेनम: mlom
लिथियम: tfim
मल्टीमीडिया: myum
अद्यतन: dyet
कैलोरी: clom
रोबोट: ryoc
घरकापाठ: groc
लोगारित्म: grom
एकप्रकारका कीड़ा: gzas
जमाना: nwut
अमीनो: myoc
ग्लिफ़: glif
AORIST: pyos
परिस्थितिकी: plec
मिलावटकरना: flok
मारिजुआना: bjam
सूक्ष्म: mrom
किलोग्राम: lwom
पेटभरखा जाना: jrot
उम्मीदकेमुताबिक: dzik
पिज़्ज़ा: zyas
छिपकरबातेंसुनना: zris
भाषाविज्ञान: bwis
बालकाटना: braf
इरीडियम: ryom
जातिवाद: gwim
इष्टतम: gyim
औद्योगीकरण: drif
मुख्यालय: krup
सैरियम: zrim
अनुकूल: nrum
ज़ातीमामला: pxik
कैसेट: ksep
इच्छाशक्ति: blot
आकार: dzen
पैरामीटर: rwet
सिंक्रनाइज़: nrop
अधिकतम: dzim
सेमिनार: mwec
डिस्को: dyok
नीयन: nyok
आज़मियम: hzom
इपिफ़नी: hp6n
plagiarize: lyap
विरूपणसाक्ष्य: rwek
रिएक्टर: fyet
अजवायनकीपत्ती: ryop
प्लूटोनियम: pwum
yttrium: tyom
वृद्धिकरनेवाला: hxat
उपयोगकर्तानाम: mrum
स्नातकोत्तर: zrot
दांयाविंग: dwaf
आर्गन: jros
भय: hxot
सामूहीकरणकरना: sluk
भूमंडलीकरण: bluc
तरंगदैर्ध्य: hnef
सांकेतिकशब्दोंमें बदलना: kfom
अपनीबातदोहराना: psoc
पुनःआरंभकरें: nrek
हैपेटाइटिस: pyes
टोरस्र्स: fros
कीमोथेरपी: myep
सापेक्ष: mwok
प्रोटॉन: zwot
डिस्केट: dwet
मिलीग्राम: mlum
पिक्सेल: psep
टैंटलम: twem
घुलाहुआपदार्थ: hjot
नरसंहार: nyos
दरिंदा: rwes
गैलियम: glem
zirconium: hzum
निर्धारक: txin
nonlinear: nlem
कीटनाशक: pyif
फीरोज़ा: brem
न्यूरॉन: nrus
विधेय: pxit
जांघिया: tlif
कारख़ानेका: kref
न्यूट्रॉन: zrut
नाइओबियम: nwom
जर्मेनियम: hjem
धातुकेरूप-रंग का एक अधातु पदार्थ: tlop
डालपर: dlap
prolativeमामला: hl6k
जैवविविधता: jwic
जोस्टिक: jyok
एंटीबायोटिकदवाओं: twok
जंगी: gjim
अंतरिक्षयात्री: srof
अलौकिक: tyes
बेवकूफ: hwup
मैराथन: mrof
ytterbium: zwim
आत्मकेंद्रित: tyif
योणबनाना: nlof
राडोण: cwos
Nerium: nrem
महामारीविज्ञान: pwip
बुढ़ापा: lyuc
कैंपिंग: kyep
धारीदार: drip
ईण्डीयुम: nyum
सत्यप्रिय: hvik
वेबसाइट: bwes
कुरान: kwek
flatware: fwet
वेंजड़: tfec
लॉरेंशियम: lyem
नागरिकअधिकार: glip
मोबाइलफोन: mlof
स्तंभित: twoc
एकप्रकारका रसायनिक मूलतत्त्व: prum
विकिरण: hd6n
निर्भरपर: pxin
थोरियमपरमाणु: hxim
ब्लूजीन: bjun
घरेलुपौध्ाा: hxas
व्यक्तिगतरूपसे: dvit
प्रवाहचालू: lwuk
तीनबिंदु: ht6t
मानवशरीर: hn6n
भौतिकविज्ञान: bzik
खुदरादुकान: hxan
सीज़ियम: hs6m
लंबापूर्व: hqan
स्प्रेडशीट: hxet
यूनिटकेद्रव्यमान: hn6m
संकलन: ml6n
द्विआधारीमूल्य: vrim
मानवकियाजा रहा है: nyus
द्वारामतलबका: hvan
depandari: pxat
प्रेसियोडीमियम: pyom
गत्ता: kxat
सीमितक्रिया: hqik
परीक्षणसंख्या: hr6n
समर्थकवाक्य: hr6t
आलोचक: hk6k
पैकेजिंग: pxas
अनस्थिरता: pxan
परअधिकांश: txas
वर्णनकर्ता: drop
Neodymium: nyem
मित्रता: hvit
पढ़नाकेवल: xyak
founds: xwan
सूक्तिकामनोदशा: kxin
स्वनिम: hxom
चेतना: xlit
ध्वनी: xlin
भोजनकक्ष: hxac
जीवितकक्ष: hxic
केंद्रीयमामला: zrik
पूर्वअव्तन: hx6n
मरीजमामला: hqak
परोक्षमामला: bwok
ग्रामीणक्षेत्र: hqat
recurse: hr6s
मध्यआवाज़: dyos
meitnerium: hm6m
डाकवाहक: hvak
noncommittal: kxit
स्टॉकबाजार: xrak
पहचानयोग्य: hxap
लक्ष्यट्रिगर: krof
एकक्षण: hxen
lativeमामला: dvak
राशन: hr6c
गैरमानव: hg6n
जीवितचीज़: hvic
बहुतथोड़ा: hxut
सिनेमाघर: hvin
हैशियम: xyim
attenuative: ty6t
multalसंख्या: ml6m
दूधकामार्ग: txam
नैप्टुनियम: nwem
असलीलेखक: txik
ट्रांसअंक: ts6s
सुस्तीमेंसमय गंवाना: hqun
रेडियोऐक्टिव: myem
सुबहमहिमा: txan
फायरफाइटर: xran
बर्कीलियम: blem
आकाशगंगालिंग: kxan
Nobelium: blum
अलविदा: hvac
बुद्धधर्म: hfum
Fermium: frem
सियान: xyan
सोया: syof
वितरक: qrit
हड़तालतोड़नेवाला: txak
प्रोसेसर: ples
abessiveमामला: bvak
adessiveमामला: dvik
कोमामला: kxak
agentiveमामला: dvek
रदरफोर्डियम: hr6m
एंटीबॉडी: txip
जैसाबहुतजैसा: hjos
एजेंटट्रिगर: hg6t
अभिनेताभूमिका: xram
ethidium: txim
सामान्यलिंग: hk6n
accompanier: kl6n
कुसुम: kxam
francium: fyam
अर्बियम: ry6m
निष्क्रियआवाज़: xyis
एस्टाटिन: hqit
चबानेगम: hqam
तारालिंग: hqin
उद्धरणप्रपत्र: ht6m
क्यूरियम: jrim
कॉमिकस्ट्रिप: kxis
रंगअंधा: hqon
euler'sसंख्या: hl6m
देखनापर: kxas
crosswalk: pwok
रणभूमि: txat
मोटरयात्री: vrit
शार्टसर्किट: txok
मौखिकसंज्ञा: hvis
रोनाबाहर: hk6t
सांख्यिकीयरूपसे: xyit
दही: txot
क्सीनन: hs6n
सम्मोहित: hxif
लेनाबंद: hxaf
खंड-पूंछ: hxok
प्रत्यक्षवस्तु: dwot
किरानादुकान: kxun
मिलकरका: hm6t
ergativeमामला: gvik
इन-भाषा: txic
पहलीहाथ: pxam
लोकैटिवमामला: hqok
स्विमिंगपूल: slup
क्रिया-विशेषण-संबंधीमामला: vlak
sightsee: hqas
टेलीविजनसेट: ht6s
अंतिमकण: xlik
evitativeमामला: hvek
पुनर्वास: xlat
वापसी: xris
खंडकाफ्लैटों: kxot
जागनाऊपर: hxup
पुलिसअफ़सर: ps6s
शपथलेना: vran
साक्षात्कारकर्ता: qrat
रेनीयाम: ryem
एयरोसोल: xres
मालिकानामामला: kxik
nominalization: mlec
अधीनमामला: dzak
पल्लाझुकना: pxak
सहायकक्रिया: xyik
मुख्यवस्तु: mlut
कंप्यूटरवायरस: prus
व्यापारी: hqis
एलोग: hqen
antessiveमामला: ts6k
प्रधानमंत्री: pxis
ल्यूटेशियम: lyum
युरोपियम: rwum
भावकाप्रकट करना: xrot
लोकसंगीत: zyik
कवि: vwit
डाकघर: pxot
मानाजाताहै कि: hvas
चेतनलिंग: hven
subessiveमामला: bvik
गैसपेडल: glep
polarity: pr6t
वाहनलिंग: vlin
खनिजलिंग: xrin
क्रिया-प्रत्यय: hvif
आवेशपूर्ण: pc6n
समैरियम: sr6m
फैसिलिटेटर: hs6t
काल्पनिकइकाई: xyin
प्रकाशकिगति: kxac
वायुसेना: hxes
empatheticहर्ष: pfec
क्रांतिकबिंदु: qyit
पूरासमय: hxem
हेफ़नियम: xyam
निषेध: hn6s
परिवर्तनकाघटना: qrin
holmium: xlim
अलगघटना: hf6t
ब्रम्हांडलिंग: hvip
इलाकेलिंग: kxen
वास्तविकमशीन: hvim
अनुसंधानलिंग: txen
कलात्मकलिंग: ts6n
crastinalकाल: sl6t
सारलिंग: srep
exocentricमामला: zrek
सकर्मकक्रिया: txif
शब्दकाभाग: tfom
अंधराष्ट्रीवादी: dvis
अतीतसाधक: xrat
व्यवसायिक: hy6n
अप्रत्यक्षभाषण: tyoc
दूसराभाषा: draf
कोहोना: txis
कब्रस्तानखिसकजाना: vrak
सामूहिकसंज्ञा: hxos
absolutiveमामला: bvuk
मरीजट्रिगर: tr6t
स्वयंआत्मविश्वास: hs6s
मल: hzos
कर्मकर्त्ताआवाज़: hf6s
अवैयक्तिकक्रिया: hxek
सीबोर्गियम: br6m
सफेदस्थान: hxep
मोडलमामला: dlok
अचेतनलिंग: hj6n
प्रेरणाका: qran
propositiveमनोदशा: psom
बिजलीवर्तमान: tr6n
जोड़नेवालामामला: nwok
अतिशयोक्तिमामला: tluk
बहुतबहुत: xyut
ग्रहोंलिंग: pxen
एनिमेटेडकार्टून: nwuk
पारस्परिकआवाज़: vrik
कानूनबनाना: hqaf
परकमसे कम: vlas
व्याकरण-मामला: qrak
उपयोगकर्ता: pxut
कोरbenefactive: kfef
गोलकीपर: hgop
:AksseptFor: kcef
भाजक: dvan
किसीऔरयदि: lyek
बग़लमें: hx6s
एकदूसरे: dles
क्रमिकधारा: lyuk
थकना: hxun
निकर: ht6k
डिस्प्रोसियम: prom
शीघ्रभविष्यकाल: rwec
siइकाइयों: vyin
क्रीप्टोण: kxon
मेण्डेलीवियम: dlem
अनुप्रयोगीआवाज़: hp6s
antipassiveआवाज़: tsef
सततपहलू: ht6p
विकिरणबीमारी: hr6k
necessitativeमनोदशा: hn6t
एककार्यक्रिया: hqek
railcar: xlak
अतिशयोक्तिउपाधि: tlup
अस्तित्वधारा: hs6k
कलिफ़ोरनियम: kf6n
वर्तमानकृदंत: vrat
प्रकाशयुक्ततीव्रता: hc6t
singulativeसंख्या: slus
व्याकरण-वस्तु: hy6t
निष्क्रियकृदंत: vris
अत्यधिकअवधि: kxic
सुपरतरल: sr6t
रकमकापदार्थ: ks6t
पूछेमामला: pxok
निर्वाचितquantifier: lwif
gadolinium: dl6n
epentheticशब्दका भाग: hp6m
निगेटिवquantifier: nwif
आइंस्टिनियम: ny6n
कृत्रिमभाषा: txac
संयोजीकण: qrik
दूरस्थभविष्यकाल: twec
किसीकार्यकी पुनरावृत्ति दिखानेवाला पहलू: hfep
बांटनेवालासर्वनाम: bvin
व्याख्यानसमझौता: hk6m
गंजा: blos
उपनगर: syum
सार्वभौमिकquantifier: vlit
कंप्यूटरप्रोग्रामिंग: mr6m
टेलीविजनकार्यक्रम: tr6m
चलबिन्दुसंख्या: hvun
अस्तित्वquantifier: tl6t
दिनबादआने वाला कल: dwek
विकल्पquantifier: lw6t
उतावला: hdup
अतीतनिष्क्रियकृदंत: hp6t
दिनसेपहले बिता कल: txet
लोकैटिवदिशात्मकमामला: tc6k
प्रतितथ्यात्मकसशर्त: ht6c
