क्रिया-का-साधारण रूप: अनंत, अनन्तता
नियुक्त-मामला: 
कर्म-कारक-मामला: 
विषय-मामला: विषय-मामला
माता-पिता: पैतृक, प्रमुख, वरिष्ठ
पिता: पिता
माँ: माँ, मां, माता-संबंधी
नमस्ते: नमस्ते, नमस्ते, अरे
पूर्वज: पूर्वज, दादा
दादा-दादी: दादा, दादी
भूखा: भूख, भूखा
संबंधकारक-मामला: मालिकाना-मामला
विशेषण: 
और: योग, द्वारा
मुझे: अपने-आप, मैं, मेरे, हम
आप: उन, तेरा, तुम
हमें: हम, हमारी, हमारा
यह: वह, कि, वह, इस, इन
गंतव्य-मामला: लक्ष्य-मामला
संप्रदान-कारक-मामला: 
आंतरिक-प्रसंग: 
व्यक्ति-प्रसंग: 
आश्रित-धारा: 
साधक-पहलू: 
अतीत-काल: 
संज्ञा-लिंग: नपुंसक-लिंग-लिंग
comitative-मामला: 
वर्तमान-काल: 
benefactive-मामला: 
essive-मामला: 
नहीं: नहीं, गैर, शायद-ही, असमर्थ, न, पिच
इसकी: उनकी, उनके, उसके, उसे, उन, उसकी, का
सतह-प्रसंग: 
adpositional-मामला: 
स्थान-मामला: 
अंतरिक्ष-प्रसंग: 
मार्ग-मामला: 
सहायक-मामला: 
कौन: कौन, जैसा, जिसका, कोई, न, कि, जिसे, जो-की, क्या, हर-एक, जो-भी
प्रश्नवाचक-मनोदशा: 
तथा-या: 
एकमात्र: 
स्रोत-मामला: 
पंचमी-विभक्ति-मामला: 
ठोस: ठोस, ठोस, ठोस, ठोस, आदेश, नाटकीय
लेकिन: अभी-तक, तथापि
सब: हर, हर, कुल, संपूर्ण, संपूर्ण, पूरे, सब-कुछ, कोई, तेजी-से
स्त्री-लिंग: 
वे: उन, वह, उन, उनकी, उनकी, उपनाम, इन
बहुवचन-संख्या: 
एक: एक, ए, में, अकेला
भविष्य-काल: 
सामाजिक-प्रसंग: 
कब: जब-भी
अधूरा-पहलू: 
क्या-आप-वहां मौजूद हैं: 
सशर्त-मनोदशा: अधीन-मनोदशा, काल्पनिक-मनोदशा
अधिक: ऊपर, सबसे, आगे, परे, ऊपर-की-ओर, ऊपर-की-ओर, बहु, से, बजाय, भी, अतिरिक्त, प्लस, अब-तक, अभी-तक, अन्य, कई, विभिन्न
बाहर: बाहर, बाहरी, बाहरी, घर-के-बाहर, सड़क-पर, बंद, के-बाहर, परे, ऊपर, पर, पर
संबंधी-मामला: संबंधी-मामला
नतीजे-का-मामला: 
कर: बनाना, प्रदर्शन, शुरू, प्रस्तुत-करना, सक्रिय, किया, प्रतिबद्ध
आदेश-मनोदशा: सूचक-मनोदशा
deontic-मनोदशा: 
सवाल-शब्द: 
योजक: योजक, बंधन, झुंड
व्यक्ति: आदमी, लोग, व्यक्ति, कोई-व्यक्ति, कोई, पुरुष, मानव, चेहरा, मुंह, सत्ता
नर: संज्ञा, उल्लेख, सज्जन, आदमी
सकता-है: कर-सकते-हैं, पराक्रम, संभवतः, शायद
अन्य: अन्य, शेष, दूसरा, एक-और, विभिन्न, एक-दूसरे
संख्या: मात्रा, योग, आकृति, संख्यात्मक, अंक, मात्रा
बहुत: बहुत, अत्यंत, भय-से, बहुत, बहुत, बहुत, व्यापक-रूप-से, अत्यधिक, वास्तव-में, बुरी-तरह, भयानक, काफी, बहुत-कुछ, बहु, अत्यंत, सबसे, काफी, काफी, दूर, सुंदर, ठीक, ठीक-है, ठीक-है
T.I.M.E: जबकि, पल, दौरान, समयोचित, अवधि, लौकिक, काल, समय-सारणी, अवधि, मौसम
पहर-प्रसंग: 
लौकिक-मामला: 
के-बारे-में: के-बारे-में, विषय-में, लगभग, लगभग, का, द्वारा, से, चारों-ओर, के-लिए, उपयोगकर्ता, शिकायत, पर
epistemic-मनोदशा: 
केवल: केवल, केवल, केवल, बिंदु, मात्र, विशुद्ध, सीमित
थोड़ा: छोटा, छोटे, थोड़ा, थोड़ा, बिट, नाबालिग, क्षुद्र, छोटा, पोर्टेबल, कुछ
फिर: फिर, फिर, फिर, के-बाद-से, पूर्व, बाद-में, बाद-में
उपदेश-देनेवाला-मनोदशा: 
पूर्वप्रभावी-पहलू: 
महान: बड़ा, बड़े, महान, गंभीर, व्यापक, जोर, विशाल, विशाल, भयानक, प्रमुख, अच्छा, जुर्माना, महत्वपूर्ण, विशाल, ठोस, आश्चर्यजनक, उत्कृष्ट, अनुकूलतम, बड़ा, प्रमुख, उत्तम, असाधारण, प्रतिभाशाली
volitive-मनोदशा: 
से-पहले: पूर्व, पूर्व, पूर्व, पूर्व-में-होना, जब-तक, सामने, पूर्व-में, के-खिलाफ
चाहिए: चाहिए, जरूरी, बेकार, यह-करना-है, ज़रूरत, करेगा, करना-चाहिए, चाहते, को
दो: दोहरी, दोनों
देखना: देखना, राय, दृष्टि, नोटिस, समझना, घड़ी
जानना: पता-लगाने-के, अवगत, सिखाना, झंडा, दिखाई
नीचे: नीचे, नीचे-की-ओर, नीचे, नीचे, नीचे, नीचे, कम, तल, अवर, सीढ़ी-के-नीचे
के-बाद: पीछे, पर, पद, आयाम, बाद-में, बाद-में, बाद-में, निम्नलिखित, अतीत, नीचे, नीचे
पहले: कैरियर-की-शुरुआत, प्रारंभिक, के-बाद-से, बाद, मुट्ठी
अपना: स्वयं, स्वयं, अधिकारी, व्यक्तिगत-रूप-से, उनके, खुद, स्वयं
बदलने-के-योग्य अधिकार: 
कभी-नहीं: कभी
अविच्छेद्य-अधिकार: 
पुराना: प्रयुक्त, प्राचीन, वृद्ध, वयोवृद्ध, भूतपूर्व, भूतपूर्व, भूतपूर्व, आयु
अधिकारहीन-मनोदशा: 
दिन: दैनिक, आज, आज-रात
जहाँ: जहाँ-भी, जिससे, जगह
आना: को, पहुंच, आगमन, पहुंचें, बनना, फैशन, घटित
रास्ता: विधि, कार्यप्रणाली, माध्यम, पथ, मार्ग, प्रणाली, मार्ग, निशान, ढंग, सड़क, सड़क, चीनी, ट्रैक, प्रक्षेपवक्र, आदत
काम: काम, काम, सक्रिय, कार्य, श्रम, श्रम, व्यवसाय, समारोह, संचालित, कार्यात्मक, व्यापार, अधिनियम, व्यायाम, रोज़गार, व्यावसायिक, काम-कर, कलाकृति
स्वर: प्रसिद्ध, जिंदगी, उत्तरजीविता
जाओ-न: चलना, किराया, रवाना
perlative-मामला: 
प्रगतिशील-पहलू: 
लंबे-समय-तक: लंबा, टिकाऊ, लंबा, साथ-में
कहना: मौखिक, कहना, बोलना
कैसे: जैसा, जैसा, से
भी: भी, भी, जब-तक, अतिरिक्त, बहुत
वापस: पीछे, पीछे, पीछे-की-ओर, पिछड़ा, वापसी, फिर, बहाल, पूर्ववत, फिर, दोहराना, पूर्व, इसके-अनुसार
यहाँ: 
सोच: सोच, विचार, विचार-करना, कल्पना, गर्भ-धारण, ध्यान-करें, होगा, कहा-जाता-है, मन
समान: समान, समान, बराबर, बराबर, ठीक, ठीक, ठीक-है, स्वयं, समान-रूप-से, उसी-प्रकार
पिछली-बार: समाप्त, बाद-वाला, अंतिम, परम, एक-और, अन्य, नवीनतम, हाल-का, अंत, अतीत, अतीत, सहना, झेलने, डाल, दृढ़-रहना
दूर: दूर, दूर, बंद, अलग, अलग, बाएं, छुट्टी, अनुपस्थित
नीचे-प्रसंग: 
लेना: आश्रय, पर-कब्जा, लाना, अपनाना, हथियाना, मिलना, प्राप्त, चुनना, पकड़, कब्जा, स्वीकार-करना, प्राप्त, चार्ज
पाया: खोज, खोज, खोज, खोज, सुलभ
हाथ: बांह, कलाई
युवा: जवानी, कनिष्ठ, किशोर, किशोर, नई
यद्यपि: हालांकि, फिर-भी, स्थिर, दृढ़, ठोस, दृढ़ता-से, के-बावजूद, तथापि, कोई
देना: देना, प्रदान, प्रस्ताव, प्रदान-कर, उद्धार, प्रस्तुत-करना, बर्दाश्त, डाल, दान-करना, चलो
परमेश्वर: 
delative-मामला: 
कुछ-नहीं: कुछ, वस्तु, कोई-नहीं, कुछ-भी, कोई-नहीं, कोई-भी-नहीं
सही: जोड़ा, सही, सही, मेला, न्याय, न्यायसंगत, अनुचित, योग्य, पात्रता, कानून, सही-ढंग-से, सच, कुछ, ज़रूर, समर्थ-बनाना, अच्छी-तरह-से
एक-बार: तुरंत, तुरंत, विधि, पैटर्न, कार्यप्रणाली, फिर
semelfactive-पहलू: 
हिस्सा: अनुभाग, आंशिक-रूप-से, भाग, आंशिक-रूप-में, पार्सल, अंश, शेयर, बिट, टुकड़ा, मार्ग, सबसेट, अध्याय, विभाग, प्रकरण, आंशिक, विभाजन, परवरिश, क्षेत्र, अनुपात, पक्ष
देखा: 
घर: घर, घर, मंदिर, आवास, गृहस्थी
दुनिया: क्षेत्र, वैश्विक, जगत
सिर: शीर्षक, मुख्य, प्रमुख, अध्याय, नेता, अध्यक्ष, अध्यक्ष, निदेशक, मालिक, वरिष्ठ, लेखनी
तीन: तिहाई
नियो: नई, नव
फोकस: इरादा, लक्ष्य, लक्ष्य, लक्ष्य, ध्यान-केंद्रित, ध्यान, एकाग्रता, उच्चारण, मिलना
प्यार: ममता, परोपकार, जैसा
सदैव: सदैव, निरंतर, कभी, सामान्य
रात: शाम, डिनर, दोपहर-बाद
प्रत्येक: प्रति, हर-एक, कोई
राजा: राज, भगवान, सम्राट, टाइकून
के-बीच: के-बीच-में, बीच-में, का
दिल: जयकार, उत्साहजनक, गिर-पड़ना
paucal-संख्या: 
क्योंकि: देय, के-बाद-से, मामला, कारण
करणीय-मामला: 
चीज़: मामला, मामला, घटना, सामग्री, क्या
सेट: समूह, डाल, रखना, रखना, पेस्ट, संग्रह, संयोग, सरणी, सुइट, पैकेज, पोर्टफोलियो, संश्लेषण, एक-साथ, शृंखला, मोड़, रेंज, पंक्ति, तार, किट, कोष
नाम: उपनाम, संज्ञा
उचित-संज्ञा: 
उपदेश-देनेवाला: उपदेशात्मक
देश: राष्ट्र, भूमि, पृथ्वी, राज्य, भूमि, काउंटी, धरती, पार्टी
से-पूछा: 
दिखाई-प्रत्यक्ष: 
बेहतर: बेहतर, सबसे-अच्छा, उत्कृष्ट, आदर्श, बकाया
पक्ष: पार्श्व, पक्ष, पक्ष, पक्ष, मोड़, पृष्ठ, पहलू, आधा, पहलू
कोर्स: पाठ्यक्रम, शिक्षा, व्याख्यान, निश्चित-रूप-से, निश्चित-रूप-से, निश्चित-रूप-से, दर
महिला: महिला, स्त्री, स्त्री, महिलाओं, लड़की, पत्नी
पर्याप्त: पर्याप्त, पर्याप्त, पर्याप्त, प्रचुर, काफी, बहुत-सारे, नाकाफी, काफी, सुंदर
शीघ्र: शीघ्र-ही, शीघ्र, शीघ्र, जल्दी-से, उपवास, तुरंत, तीव्र, जल्दी, अति-आवश्यक, ऐसा, तुरंत, आसानी-से, समीप, जल्दी, तस्वीर
पूर्ण: पूरी-तरह-से, पर्याप्त, पूर्ण, पूरा, अपूर्ण, पूरे, वास्तव-में, ठीक, निरा, ठीक, संपूर्ण, संपूर्ण, व्यापक, आकार
कक्ष: कक्ष, चौथा, शयनकक्ष, शांति
लगभग: लगभग, वास्तव-में, लगभग, लगभग, पास, चारों-ओर, बंद-करे, आसन्न, वास्तव-में, समीप, शीघ्र-ही, समीपस्थ, मोटे-तौर-पर, शायद-ही
नहीं-कर-सकते: असमर्थ
पानी: तरल, तरल-पदार्थ, जलविभाजन
desiderative-मनोदशा: 
प्रकाश: चमक, उज्ज्वल, मोमबत्ती, थोड़ा, अंदाज, धीरे-से, सौम्य, लाइटर, पीला, स्पष्ट
न: न, न, अभी-तक, क्या, होना, या
शब्द: शब्द-भांडार-का
द्वार: द्वार, द्वार, प्रवेश, अध्याय, बंदरगाह
उपयोग: उपयोग, प्रयोग, सेवन, व्यय, उपभोक्ता, संलग्न, आवेदन, उपयोगिता, लागू, रोजगार
सुबह: सुबह, नाश्ता
terminative-मामला: 
शक्ति: शक्ति, शक्ति, पराक्रम, दृढ़, बल, शक्तिशाली, गतिशील, सलाद, प्रभाव, अधिकार
अपने: हम, स्वयं, स्वयं, अपने-आप, स्वयं, खुद, स्वयं, अहंकार, अध्याय
वर्तमान: वर्तमान, वर्तमान, अब, वर्तमान-में, उपहार, मौजूद, उपलब्ध
आवाज़: ध्वनि, जोर-से, मतदान, ऑडियो, वोट, मद, अफवाह, अफवाह
सफेद: रिक्त, शिकायत
धन: धन, चांदी, वित्तीय, रोकड़, मुद्रा, वित्त, मौद्रिक
अगला: पास, साथ, के-पास, निम्नलिखित, बाद-में, आयाम, बाद, आगामी
दरिद्र: बांह, दरिद्रता, बुरा, सबसे-खराब, सड़ा-हुआ, निर्बल
मौत: मृत्यु-दर, मौत, मृत
प्रपत्र: आकार, ढालना, प्रारूप, समोच्च, पैटर्न
inessive-मामला: 
तरह: कक्षा, तरह, जाति, विविधता, टाइप, अनुकूल, मद, अच्छा, सुखद, मनभावन, सुखद
अक्सर: बहुधा, निरंतर, नियमित, बारंबार, सामान्यतः, सामान्य-रूप-से, आम-तौर-पर
साल: वार्षिक, प्रतिवर्ष, पंज
मित्र: मित्र, प्रेमी, साथी, दोस्त
व्यवस्था: व्यवस्था, व्यवस्था, व्यवस्था, अनुबंध, सरणी, आदेश, मोड़, पंक्ति, कतार
अनिवार्य-मनोदशा: 
दौर: गोल, वृत्त, गोद
मानना: भरोसा, मानना, मानना, श्रद्धा, आस्था, आत्मविश्वास, आश्वस्त, आशावाद, आशावादी
सार्वजनिक: जनता, सामान्य, दर्शक
राज्य-प्रसंग: 
बेटा: झुंड, लड़का
सौ: सौवां, चेहरा, प्रतिशत
बच्चे: बच्चा, संतति, बच्चा, बच्चा
इस-प्रकार: इस-प्रकार, ऐसा, अत, ऐसा, हाँ
आशा: चाहें, आशा, आशा, आशावाद, आशावादी
ऊपर: ऊपर, ऊपर, ऊपर, उच्च, चोटी, उन्नत, ऊपरी, पार, विषय-में, के-माध्यम-से, पर, भूमि-के-ऊपर, पर, आगे, ऊपर-की-ओर
प्रिय: प्रेमी, महंगा
पढ़ना: पढ़ना, गाना, लिली
शहर: शहर, म्युनिसिपल, काउंटी
पहले-ही: तैयार, तैयार, तैयार, वैसे-भी
तथ्य: सच, वास्तविकता, सत्यवादिता, सच, वास्तविक, वास्तविक, वास्तव-में, वास्तव-में, वास्तव-में, किया
factive-प्रत्यक्ष: 
सुनो: सुनना, श्रवण, महसूस
कम-से-कम: कम-से-कम, कम-से-कम, कम-से-कम, ऋणात्मक, कम
शायद: शायद, शायद, मुमकिन-है, पराक्रम, संभवतः, संभव, संभावना, संभावित
खुला: स्पष्ट, मैदान, स्पष्ट-रूप-से, नंगा, जाहिर-है, रिक्त, मुखर, ज़ाहिर, घर-के-बाहर, घाटा, पीला, खुले-तौर-पर, पर्दाफाश
शव: मांस, शारीरिक, भौतिक, शारीरिक-रूप-से, कोष, अंग, लाश
हवा: हवा, हवा, विमानन, मौसम, एयरलाइन
प्रकृति: प्राकृतिक, जन्म-का, स्वाभाविक-रूप-से, मूल, अवतरण, स्वदेशी, वन्य-जीवन, चरित्र
मदद: सहायता, सहायक, सहायता, सहायता, सहायक, रखना
पत्र: मेल, लेखन
चार: चौथा
आपटाइटिव-मनोदशा: अधीन-मनोदशा
आग: गरम, लौ, बुखार
इसलिये: अत
समय: घड़ी, बजे, घंटी
मुक्त: स्वतंत्रता, आजादी, मुक्त, मुक्त, व्यर्थ, आज़ादी-से, रिक्त, शिथिल, रिहाई
युद्ध: लड़ाई, संघर्ष
कि-क्या: यदि, खुद
कारण: कारण, कारण, फ़ैक्टर, यथोचित, बहाना, इस-आधार, विस्तार, वादी
यूनाइटेड: विलक्षण, एकता, सम्मिलित, संघ, सम्बद्ध, मित्र, अद्वितीय, एकमत
कॉल: चुनौती, oxidize, अपील, पर, संबंध, संयोग, संयुक्त, विलय, निमंत्रण
क्यों: 
खोया: हानि, लापता
हज़ार: हज़ारवां
परिवार: गृहस्थी, उत्तरजीवी
आत्मा: आत्मा, भूत, विख्यात-मन
सवाल: मुद्दा, मांग, पढ़ना, मामला
ध्यान: चिंतित, चिंता, ध्यान, ध्यान, सेवा, प्रायोजन, गार्ड, सुरक्षा, सुरक्षा, सुरक्षा, परिरक्षण, संरक्षण, कवरेज, रक्षा, सावधानी, इलाज, इलाज, हिरासत
realis-मनोदशा: 
मतलब: मतलब, समझ, अर्थ, सार्थक, सूचित-करना, बीच, एजेंट, मध्यम, औसत, मध्यम
क्षमता-मनोदशा: 
की-ओर: की-ओर, के-खिलाफ, विरोधी, का-विरोध, प्रति, सम्मान, के-लिए
allative-मामला: 
Anthropic-लिंग: 
कम: कम, कम, संक्षिप्त, शीघ्र-ही, संक्षिप्त, कार्ड, संकीर्ण, थोड़ा
योग्य: कर-सकते-हैं, योग्य, योग्य, सक्षम, क्षमता, योग्यता, अयोग्य, सक्षम, क्षमता, संभावना, संभावना, दृढ़, शक्तिशाली, कुशल, मई
जीना: जिंदगी, जीवित-रहने-के, व्यवहार-करते-हैं, जीवित, घोंसला, जिला, आस---पड़ोस, आस---पड़ोस, जिंदा, जीवंत, कच्चा, रहते-हैं
विषय: अनुशासन, विषय, विषय, शिक्षा, पदार्थ, मुद्दा, वस्तु, अर्थ, सामग्री, अर्थ, मामला, मामला, शीर्षक
वही-विषय-निशान: 
अलग-विषय: 
उत्तर: उत्तर, उत्तर, प्रतिक्रिया, समाधान, अनुरूप, प्रतिक्रिया
समुद्र: सागर, समुद्री
डर: भय, भयभीत, आतंक, भय, भयभीत, आतंक, चिंता, गुस्से, आतंक, डराना
समझना: समझ, समझ, समझना, समझ, गर्भ-धारण, दुर्बोध, शामिल, एहसास
कठिन: कठिन, कड़ा, जटिल, कठोर, जोर, बलपूर्वक, भयंकर, कड़ा, कठोर, चुनौतीपूर्ण, मुश्किल, भारी, गंभीर, कठोर, बेचैन
शर्तों: अवधि, शब्दावली, मुद्दा, आधारित, इस-आधार, आधार, अनिवार्य, मूलरूप-में, मूल-रूप-से
संदेह: संदेह, शक, संदिग्ध
dubitative-मनोदशा: 
पूछना: प्रार्थना-करना, आवश्यकता, सुनना, कृपया
हथियार: हथियार, वश-में-कर लेना, हथियारबंद, बांह
काली: 
लाना: लाना, ले-जाना, होगा, नेतृत्व
खूबसूरत: अच्छा, अच्छा, सुंदर, खूबसूरती, अच्छी-तरह-से, सुंदर, कल्पना, ठंडा, प्यारा
अंधेरा: उदासी
पकड़: रखना, रखना, पकड़, पकड़, अनुबंध, निष्कर्ष-निकालना, गांठ, दशक, ज़ब्त-करना, प्रतीक्षा, जैसा, बनाए-रखना
दस: दशक, दसवां, मेला
प्रदर्शन: प्रदर्शन, प्रदर्शन, प्रदर्शन, प्रदर्शन, प्रदर्शन, संकेत-मिलता-है, सूचित-करना, घटना, प्रक्षेपण
कहानी: कल्पित-कथा, इतिहास, उपन्यास, भूखंड
सामान्य: सामान्य, सामान्य, सामान्य, आमतौर-पर, साधारण, असामान्य, सामान्यतः, मामूली, साधारण, अनियमित, परम्परागत, ठेठ, सामान्य-रूप-से, आम-तौर-पर, संयुक्त, साथी, साथी, कुल, संपूर्ण, आपसी, कॉर्पोरेट
किताब: पुस्तक, रिज़र्व, पाउंड, पाठयपुस्तक
इलेक्ट्रोनिक: इलेक्ट्रानिक्स, इलेक्ट्रॉन, बिजली, बिजली, बिजली, विद्युतीय
बातचीत: बातचीत, बातचीत, बातचीत, बातचीत, बातचीत, बातचीत, बोलना, भाषण, मौखिक, प्रवचन
निशान: निशान, निशान, निशान, स्कोर, उजागर, टिकटिक, संकेत, संकेत, संकेत, संकेत, ब्रांड, चरित्र, लेबल
ब्याज: फूल, रुचि, चिंता
लिखना: लिखना, लेखन, टाइप, लिखा
बिस्तर: 
ज़रूरी: आवश्यक, जरूरी, उपयोगी, महत्वपूर्ण, महत्वपूर्ण, महत्वपूर्ण, महत्वहीन, अविभाज्य, महत्वपूर्ण, महत्वपूर्ण-बात, ज़रूरत, जरूरी, अकर्मक, अकर्मक, अकर्मक
विचार: विचार, विचार, विचार, राय, धारणा, मंथन
कला: शिल्प, कलात्मक
vialis-मामला: 
भाई: भाई, बहन
कभी-कभी: कभी-कभी, कभी-कभी, कुछ-समय
लाइन: तार, धागा, पंक्ति, लेन, प्रवाहकत्त्व, पानी-का-छींटा, पट्टी, टैक्स, लिपि
तालिका: डेस्क, अनुसूची, सूची
नदी: तकिया, तकिया, प्रवाह
आंख: नियुक्त-करना, चारों-ओर
सूचना: संदेश, व्याख्या, विवरण, बुलेटिन, ज्ञान, डेटा
अचानक: अचानक
अजीब: हैरत-की-बात, आश्चर्य-की-बात, विचित्र-रूप-से, अजीब, आश्चर्य-है, आश्चर्यजनक, असाधारण, असाधारण, अविश्वसनीय, अद्भुत, विचित्र, मजेदार, अजनबी, विदेशी, भद्दा
गहरा: गहरा, गहराई, व्यापक, उथला, संपूर्ण, विस्तृत, व्यापक, गंभीर-रूप-से, गहन, अंदर, अंदर, इनडोर, कीड़ा
परिवर्तन: परिवर्तन, परिवर्तन, परिवर्तन, परिवर्तन, परिवर्तन, पाली, बदलना, संशोधन-करना, संक्रमण, संशोधन, प्रतिस्थापन
अनुभूति: महसूस, सनसनी, अनुभूति, प्रभाव, भावना, मनोदशा, प्रभावित, भावुक, ग्रहणशील, भाव, समझ, जोश, सचेत, चेतना
मिलना: मिलना, मिलना, सामना, पालन-​​करना, मुआवज़ा-देना, बैठक
उद्देश्य: वस्तु, लक्ष्य, लक्ष्य, लक्ष्य, गंतव्य, इरादा, इरादा, प्रेरणा, लक्ष्य
खुश: हंसमुख, खुश, अभिराम, मगन, हर्ष, ख़ुशी, सुख, प्रसन्न, मज़ा, खुशी, भाग्यशाली, प्रसन्न
प्रतीत: दिखावट, दिखाई, जाहिरा
खून: खून-बहाना, अपराधिक
गुलाब: गुलाबी
दक्षिण: दक्षिण, दोपहर, दोपहर
ठंड: सर्दी, ठंडा, स्र्काई-से
आगे: आगे, आगे, आगे, दृष्टि, सामने, उन्नत, पूर्व, बल्ला, पर, बाद
स्थिति: स्थान, स्थिति, स्थिति, संयोग, अवसर, अंतरिक्ष, मुद्रा, आसन, जगह, पद, मद
देर-से: धीरे-धीरे, समाप्त
खड़ा: स्टेशन, खड़ा, रवैया, मुद्रा, रुकें, आसन, ढोंग, दुकान
मान-लीजिए: कल्पना, परिकल्पना, मान-लेना, अपनाना, मानना, परिकल्पना-बनाना, सुझाव-है
बेटी: लड़की, अछूता
मेरा: मेरे
कमी: कमी, कमी, कमी, कमी, कमी, कमी, कमी, काटने, बाधा, काटना, स्लेश, फ़सल, ट्रिम, टूटा, का-उल्लंघन
प्रतिलिपि: प्रतिलिपि-प्रस्तुत-करना, प्रतिकृति, दोहराने, प्रतिलिपि, फोटोकॉपी, क्लोन, संस्करण, पर्चे
पति: आदमी, जीवनसाथी
छक्का: लिंग
याद: ध्यान-दें, स्मरण-करो, याद-दिलाना, याद-करना
प्रभाव: प्रभाव, प्रभावित-कर, प्रभाव, प्रभाव, प्रभाव, कुशल, प्रभावी-ढंग-से, प्रभावशीलता, परिणाम, परिणाम, जोखिम
पड़ना: पतझड़, मामला, स्थित, दुर्घटना, गिरना, विभाजन, गिरावट, ड्रॉप, पतन, कमी
सिवाय: जब-तक, बाहर, के-बाहर, इसके-अलावा, अलग, के-सिवा, पास, अलग, अलग-से
बाल: 
पास: द्वारा, के-माध्यम-से, मृत्यु, के-माध्यम-से, पास, पास, मिलकर, स्नातक, जंग, पार, मार्ग, बढ़ना
Copyright: 
सेना: सैनिकों, सेना, मेज़बान, सैनिक
रन: भाग-जाना, नाली, चल-रहा, निष्पादित, संचालित, ड्राइव, बढनेवाला, गियर
घोड़ा: घोड़े-की-नाल, पर
भविष्य: भविष्य, बाद-में, बाद-में, बाद-में
पश्चिम: पश्चिमी
वेतन: वेतन, वेतन, वेतन, जोर, भुगतान, पुरस्कार-देना, शुल्क, लागत
लाल: 
सोना: 
इच्छा: इच्छा, उत्सुक, भूख, चाहें, हुड़कना, आग्रह-करता-हूं
प्ले: नाच, जुआ, खेल, गाल, खिलौना
स्वामी: भगवान, मुख्य, मुख्य, प्रोफ़ेसर, हावी, शासन, श्री, सज्जन, प्रमुख, श्रीमान
कार्यालय: एजेंसी, डेस्क
सरकार: राज्य, पंक्ति
चर्च: 
लंबाई: ऊंचाई, ऊंचाई, काल, साथ-में, अवधि
कंपनी: दृढ़, निगम, समाज, व्यापार, कॉर्पोरेट, सत्ता, संस्था, एजेंसी, संस्थान, उद्यम
कागज़: चादर, कार्ड, चार्टर
संभावना: संभावना, संभावना, संभावना, संभवतः, संभावना-नहीं, आशा, संयोग
विशेष-रूप-से: विशेष, विशेष-रूप-से, विशेष-रूप-से, विशेष-रूप-से, विशेष, वास्तव-में, मुख्य-रूप-से, अधिकतर, मुख्य-रूप-से, विशिष्ट
भालू: ले-जाना, सहना, झेलने, सहनशीलता, सहनशीलता, है, अधिकारी, बर्दाश्त
खिड़की: 
समझौता: मसविदा-बनाना, समझौता, समझौता, आम-सहमति, संधि, इस-बात-से सहमत, सौदा, समझौते, निविदा, ज्या, अनुबंध, सम्मेलन, व्यवस्था
सुंदरता: खूबसूरती, प्रतिभा, सौंदर्य
कर्तव्य: दायित्व, उत्तरदायित्व, कर्तव्य, उत्तरदायी, कस्टम, कार्य, काम, ऋण, कर्जदार, यह-करना-है
भेजना: संचारित, प्रस्तुत-करने, पद, प्रसारण, ईमेल
दूरी: निष्कासन, रेंज, पृथक्करण
चुप्पी: शांति
पैर: पैर, पड़ाव, जांघ, पैर-की-अंगुली, तिमाही, चलना, घूमना
जंगली: बेतहाशा, अवैध, भयंकर, वन्य-जीवन
मरना: मृत, मौत
बचाना: बचत, परिरक्षण, की-वसूली, संरक्षण, संरक्षण, याद-करना, दुकान, के-एवज-में, बचाव, अभिलेख
ग्रीन: कच्चा, अपरिष्कृत
मुसीबत: परेशानी, मुद्दा, समस्या, कष्ट, कठिनाई, सानना, पीड़ा
मुस्कान: मुसकान
गलत: ग़लती, त्रुटि, गलत, बुरी-तरह, बुरा-व्यवहार-करना, झूठा, दोष, असफलता, दोष, गलत-तरीके-से, चूक
विभिन्न: विभिन्न, विभिन्न, विभिन्न, रेंज, विविध, बहु, भिन्न, प्रकार, अलग, भिन्न-हो, विविधता
नींद: सो, ख्वाब
quotative-मामला: 
शुरू: शुरू, प्रारंभ, शुरू, खरोंच, शुरुआत, जल्दी, प्रारंभिक, दीक्षा, कैरियर-की-शुरुआत, सिद्धांत
कार्य: कार्य, बिंदु, कदम, मंच, अधिनियम, प्रक्रिया, सक्रिय, आपरेशन, परिचालन, सक्रिय, कार्यकर्ता, चाल, अभ्यास, अभ्यास, संचालित, स्टॉक, रैली, क्रियान्वयन, निष्पादित
यात्रा: पहुंच, साक्षात्कार, सुलभ, यात्रा, यात्रा, यात्रा, दौरा
अनुसरण: अनुपालन, पालन, निम्नलिखित, आगे-बढ़ाने, ट्रैक, के-साथ
कोशिश: प्रयास, का-प्रयास, प्रयास, पहल, प्रयोग, कसौटी, नमूना
उपस्थिति: अस्तित्व, मौजूद, सत्ता, संपत्ति
मीठा: कैंडी, सौम्य, नरम, प्यारा
धनी: बहुत-सारे, प्रचुर, धनी
दुश्मन: 
पोत: नाव, पाल, बेड़ा, नौकायन, पात्र, क्रूज, नौका
शर्त: शर्त, शर्त, राज्य, स्थिति, परिस्थिति, स्थिति, भाग्य, मंच, स्तर, फिटनेस, मांग
शामिल: शामिल, शामिल, शामिल, संबंधित-हैं
सम्मिलित-व्यक्ति: 
गुप्त: रहस्यमय, रहस्य, पिन, भूमिगत, छिपाना
precative-मनोदशा: 
सभ्य-रजिस्टर: 
बुराई: बुराई, बुरा, शातिर, बुरा, बुरी-तरह
मार्च: परेड, विरोध, प्रदर्शन, मंगल-ग्रह
जो-कुछ: कुछ-भी, जो-भी
रहना: रहना, बैठना, बसना, जीवित-रहने-के, रहते-हैं, प्रतीक्षा
बजाय: के-बजाय, बजाय, प्रतिस्थापन, प्रतिस्थापन
नीला: परी
असंभव: 
स्कूल: कैंपस, सीढ़ी
अवसर: अवसर, घटना, घटना, संयोग, मार्ग, सौदा
विवाहित: शादी, शादी-करना, शादी
भोजन: भोजन, भोजन, थाली, चारा, पुष्टिकर
बीस: 
शांत: शांत, शांत, स्थिर, मूक, शांतिपूर्ण, धीरे, आराम, धीरे
आसानी-से: संभावना, आसानी-से, उत्तरदायी, आसान, सुविधा, थोड़ा, थोड़ा, धीरे-से, सुविधाजनक, सरल
भावी-पहलू: 
भाषा: भाषाई, जीभ
अभिव्यक्ति: अभिव्यक्त, कथन, मुहावरा, स्पष्ट, रहस्योद्घाटन, जोखिम, उक्ति
सप्ताह: रविवार
हॉल: ओसारा, थिएटर, दालान, अंतरिक्ष, कक्ष, सैलून, लाउंज, गलियारा, हरकारा, लॉबी
खतरा: ख़तरनाक, जोखिम, सम्मान, धमकी
संपत्ति: संपत्ति, संबंधित-हैं, स्वामित्व, साम्राज्य, अधिकार, सुविधा, विशेषता, जायदाद, भाग्य, धन
जन्म: जन्म
कोर्ट: अदालती, थाली, मंच, परीक्षण
आम-तौर-पर: सामान्य, आम-तौर-पर, सामान्य, संपूर्ण, व्यापक-रूप-से, आमतौर-पर, सामान्यतः, सामान्य-रूप-से, मोटे-तौर-पर
सूक्ति-का-पहलू: 
लायक: लायक, मूल्य, मूल्यवान, वैधता, योग्यता
सरल: सादगी, सरल, सुविधाजनक, लचीला, आसान, केवल, केवल, मैदान, मामूली, केवल, मात्र, सीधे, साधारण
पेड़: पौधा, लकड़ी, दस्ता, लकड़ी
लड़ाई: संघर्ष, लड़ाई, आमना-सामना, झगड़ा, हाथापाई
दीवार: 
स्वर्ग: आकाश
इब्तिदाई-पहलू: 
jussive-मनोदशा: 
लहजा: पिच, राग, टन, टन, छाया
सम्मान: सम्मान, मान-लेना, मानना, ध्यान, विचार, विचार-करना, संबंध, संगति, संबंध, विषय-में, के-बारे-में, टिप्पणी, कवरेज
अपेक्षित: प्रत्याशा
माह: चंद्रमा
अनुभव: अनुभवसिद्ध, अनुभवात्मक, अनुभवी, विशेषज्ञता, दिलचस्पी, प्रयोग
पूरी-तरह-से: पूरी-तरह-से, पूरी-तरह-से, पूरी-तरह-से, पूरी-तरह-से, काफी, कुल-मिलाकर, बिल्कुल, पूर्ण, संपूर्ण, बिलकुल, काफी, विशुद्ध, वास्तव-में
ताज़ा: हौसले-से, विशुद्ध, साफ, ताजा, नई, नौसिखिया
शासक: शासक, राजकुमार
कवर: को-कवर, कवरेज, बंद, बंद, इनडोर
सीमा: सीमा, सीमा, सीमा, सीमा, सीमा, प्रतिबंधित, लॉग-इन, निर्भर, बाँध
पूर्व: पूर्वी, पूर्व, पूर्व, पूर्व, पूर्व, पूरबी
पत्थर: संगमरमर, चट्टान, मणि
कुछ-हद-तक: कुछ, कुछ-भी, कुछ, काफी, बजाय, थोड़ा, आंशिक-रूप-में, किसी-न-किसी तरह
दिशा: उन्मुखीकरण, आयाम, प्रवृत्ति, पहलू, अनुदेश
कुरसी: बैठिये, बंहदार-कुरसी, स्टूल
समर्थन: बनाए-रखना, समर्थन, सहायता, सहायता, ब्रैकेट, सहायता
तारीख: इतिहास, सामना
गाँव: पुरवा, ग्रामीण-इलाकों
क्षेत्र: क्षेत्र, क्षेत्र, क्षेत्र, क्षेत्र, क्षेत्र, क्षेत्र, क्षेत्र, डोमेन, अखाड़ा, स्टेडियम, अंतरिक्ष, हाशिया, ग्रामीण-इलाकों, शिविर
अनुमति: अनुमति-देते-हैं, कान, परमिट, निकासी, छुट्टी, लाइसेंस, लाइसेंस, सहमति, संस्करण
अनुमोदक-मनोदशा: 
सफलता: सफल, सफल-होने-के, समृद्धि, उपलब्धि, जीत, जीतना, मारा, जीत, विजेता
उचित: ठीक-से, सही, उचित, उपयुक्त, शुद्ध, ठीक, पात्रता, ठीक, ठीक, तुरंत, ईमानदारी, ठीक, सही-ढंग-से, झगड़ा, फिट, उपयुक्त, सुविधाजनक, अनुकूल, अनुरूप, योग्य, प्रासंगिक, उत्तम, पर्याप्त, नियमित
पहाड़ी: पहाड़, पर्वत
संगीत: संगीत
बाहर-का-ठोस: 
दोपहर: दोपहर-बाद, दोपहर, दोपहर, शाम
रोना: रोना, चिल्लाना, चिल्लाना
आदर: आदर, सम्मान, गौरव, सम्मानित, माननीय, माननीय, शिष्टाचार, महिमा, दर, कीमत
सात: 
प्राइवेट: व्यक्तिगत, स्वयं, व्यक्तिगत-रूप-से, आत्म-, विशेष, एकांत, विशिष्ट, अनन्य
समाचार: संदेश
स्थल: साइट, दृष्टि, प्रसंग, प्रदर्शन, दृश्य, मंच, राय, आशा, तंबू
उद्यान: पार्क
दौड़: जातीय, दौड़, चल-रहा, प्रतियोगिता, टूर्नामेंट, निविदा, नस्ल, मैच
बांटनेवाला-मामला: 
सीखना: अध्ययन, सिखाना
राजनीतिक: राजनीति, राजनीतिक-रूप-से, राजनीतिज्ञ, नीति
झूठ: झूठा
डालना: उछालना, फेंकना, हाथ-बढ़ाना, टॉस, प्रारूप, ढालना, लांच, बहाना, छोड़ना
खाना: भोजन, चारा, थाली, दोपहर-का-खाना खाना, सेवन
मंज़िल: गलीचा, भूमि, तल, धरती, चलना, उच्च, लंबा
बीमार: बीमार, रोगी, पीड़ादायक, रोग, झूठा, बुरी-तरह
मूल: मूल, मूल-रूप-से, प्रारंभिक, प्रारंभिक, संश्लेषण, शुरू-में, जन्म-का, वास्तविक, जन्मजात, स्वदेशी, मुख्य, मुख्य, प्रोटोटाइप
गर्मी: गर्मी
धर्म: धार्मिक, ऋण
चित्र: चित्र, चित्र, की-छवि, फोटो, फोटो, फोटोग्राफी, फ़ोटो, फोटोकॉपी, चि-त्र-का री, तस्वीर, फ़िल्म, उदाहरण, चित्रलेखन, अंजीर, आकृति
पलायन: भाग-जाना
लेखक: लेखक, अध्यापक, संपादक
भूरा: भूरा, भूरा, धूप-की-कालिमा, पीतल
चुना-गया: दृढ़-संकल्प, तय, निर्धारित, निश्चित, मुखर, डिजाइनर, निर्दिष्ट, पता-लगाने-के, स्थिर, कुछ
दर्द: चोट, पीड़ा, दर्दनाक, शोक, पीड़ादायक
वसंत: पंख, हमारी, हमारा
सदी: आयु
मुलायम: मुलायम, चिकना, पतले, निविदा, धीरे, धीरे, सौम्य, नरम, सौम्य
कोना: कोण, कील, डूबना
उत्पादित-करें: उत्पादन, उत्पन्न, उत्पादक, गढ़ना, उत्पादन, विनिर्माण
हंसी: मज़ाक
भूलना: अनदेखी
यूरोप: 
आठ: आठवाँ
पोशाक: पोशाक, कपड़ा, गाउन, जामा, कपड़े-पहने, वर्दी, संगठन
भयानक: भयंकर, भयंकर, बहुत, भयावह, भयानक, दुखद, खतरनाक, डराना, राक्षसी, भय-से
सांस: सांस, साँस-लेना, साँस-लेने-का, बाष्पीभवन, अहंकार, हांफी
वार: उचित, समझदार, विचारशील, सावधान, चतुर, स्मार्ट, बुद्धिमान
मालिकाना-निशान: 
स्मृति: याद-करना, संदर्भ, स्मारक
आधुनिक: समकालीन, जटिल, आधुनिकीकरण, फैशनेबल, हाल-का, प्रवचन
स्थान: बिंदु, डॉट, बजे, स्थान, धब्बा, धब्बा, पैच, जगह, कहीं-नहीं, घर, ठिकाना, साइट, स्थानीय, पता-लगाने, संकेत, भूमि
वृद्धि: पौधा, चढ़ना, बुआई-करना, चढ़ाई, ऊपर, बोर्ड, सवारी, उत्थान, उठता, उठाना, उद्भव, बढ़ने
ब्रेक: ताला-तोड़-कर घुसना, ब्रेक, आश्रय, लाउंज, व्यवधान, अंतराल, अन्तर, गरज, टूट, रुकें, ठहराव, बाधा
पचास: 
द्वीप: 
स्पर्श: संपर्क
वादा: प्रतिबद्ध, प्रतिबद्धता, प्रतिज्ञा, नियुक्ति
commissive-मनोदशा: 
उपाधि: बराबर, सीमा, ग्रेड, गुणवत्ता
योजना: योजना, सौदा, कार्यक्रम, कार्यक्रम, पहल, योजनाकर्ता, प्रस्ताव, परियोजना, भूखंड, स्केच, प्रक्षेपण, ख़ाका, समतल, चि-त्र-का री, डिज़ाइन
आचरण: प्रवृत्ति, व्यवहार, व्यवहार, व्यवहार
अचरज: आश्चर्यजनक, अप्रत्याशित, आकस्मिक, आश्चर्य-की-बात
मिनट: 
शॉट: गोली-मार, शूटिंग, गोली, गोलाबारूद, फोटो, फ़ोटो, झटका, धमाके, तख्तापलट, फेंकना, ढांचा
बदतर: बुरा, सबसे-खराब, असभ्य, विपरीत, बुरी-तरह, बहुत, अवर, ऊपर, ऊपर
कांच: आईना, क्रिस्टल, जार, चश्मा, चश्मा
उदाहरण: उदाहरण, उदाहरण, आदर्श, पैटर्न, रूपक, प्रोटोटाइप, जैसा, प्रतिनिधित्व, नमूना, मामला, मिसाल, नमूना, मिसाल, उदाहरण-के-लिए
सुरक्षित: सुरक्षित, सुरक्षा, सुरक्षा, सुरक्षित-रूप-से, आश्वस्त, बीमा
चिकित्सक: चिकित्सक, चिकित्सक, व्यवसायी, मेडिकल
शेष-पहलू: 
दोहराया: बहुधा, नियमित, स्थिर, निरंतर, कभी-कभी, बारंबार, नियमित, दोहराना
सैन्य: सेना, आतंकवादी
गरम: गरम, गरम, गर्मी, गर्मजोशी, तापमान, हीटिंग, ग्राम, उमसदार
पेय: पेय
प्रशन: 
क्रोध: गुस्सा, क्रोध, बलात्कार, जलन, बावजूद
सीधे: सीधे, प्रत्यक्ष, अप्रत्यक्ष, स्वचालित, सरल, तुरंत
टोपी: टोपी, हेलमेट
कुत्ता: 
नौकर: प्रबंधक, वेटर, नौकरानी
अभिमान: अभिमानी, अभिमानी, गर्व-से
भीड़: भीड़, भीड़, भीड़, मात्रा, मात्रा, आबादी, मेज़बान, ढेर
गाड़ी: गाड़ी, गाड़ी, गाड़ी, गाड़ी, रेलवे, रेल, शिक्षित
नैतिक: नैतिकता, नैतिक-रूप-से, नैतिक, नीति, हौसला, आध्यात्मिक
जुड़े: साथी, प्रासंगिकता, सहसंबंधी-बनाना, संबद्ध, चिंतित, चिंता, प्रासंगिक, साथ-में, लॉग-इन, संबंधित-हैं, सम्बद्ध
दर्ज: लॉग-इन-करें, प्रविष्टि, राज्य, संकेत-मिलता-है, डालें, शामिल
नियम: प्रशासन, प्रभुत्व, शासन, निर्णय, निर्णय, निर्णय, अंपायर, पंच, शासन, कानून, विधान, आदर्श
तलवार: ब्लेड
आक्रमण: आक्रमण, आक्रमण, आक्रमण, अपमान, हमला, अपमान, हड़ताल, शुरुआत, अपमानजनक
स्वास्थ्य: स्वस्थ, नमस्कार
अनुच्छेद: कविता, धारा, टुकड़ा, बिंदु, रवैया, मुद्रा
सामाजिक: समाज, सामाजिक-रूप-से
धन-की-वापसी: उत्तर, प्रतिक्रिया, वापसी
खेद: खेद, खंभा, क्षमा, बहाना, क्षमायाचना
साहस: साहस, बोल्ड, आश्वस्त, नस, धैर्य, हिम्मत
अनुग्रह: पक्ष, पक्ष, दया, दयालुता, कृपा, पक्ष, क्षमा
आधिकारिक: औपचारिक, औपचारिक-रूप-से, आधिकारिक-तौर-पर, अफ़सर, क्लर्क
प्रदान-की: प्रदान, प्रस्ताव, प्रदान-कर, परिचय, उपलब्ध, सप्लाई, प्रावधान, पूरा, यदि
प्रार्थना: प्रार्थना, मांग, दावा, आवश्यकता, मांग, जांच, जांच, शीघ्र, बोली, आवेदन
झलक: झलक, राय, रवैया, अनुभूति, आउटलुक, दृष्टि, देखना
आंदोलन: प्रस्ताव, अभियान, खेल, धर्मयुद्ध, अधिनियम, चाल, गतिशीलता, व्यापार, चलती
उम्मीद: उम्मीद, प्रत्याशा, आशा, प्रतीक्षा
सामने: सामने, विरोधी, विरोध, का-विरोध, पार, काउंटर
बारह: 
व्यस्त: सगाई, व्यस्त, लिप्त, भाग-लेना, अधिकृत
वाइन: अंगूर, शराब, शराबी
स्वाद: स्वाद, स्वाद, स्वादिष्ट, चारा, दिलचस्पी
लोहा: स्टील, धातु
वितरित-करना: संचारित, तैनात, प्रकाशित-करना, प्रकाशन, प्रसार, परिचालित, वितरण, आवंटित, शेयर, डिवाइड, विभाजित-करें, विभाजित-करने-के लिए, वर्गीकृत
व्यापार: व्यापार, व्यापार, व्यापार, व्यापार, इंटरनेट, सौदा, सौदा, सौदागर, खरीदारी, विपणन
लाभ: लाभ, लाभ, लाभ, व्यवहार्य, भलाई, संपत्ति, पसंद, प्रभाव
कपड़े: कपड़े, कपड़ा, कपड़ा, संगठन, परिधान, गिरना
जज: निर्णय, निर्णय, अंपायर, पंच
अंतर: अंतर, अंतर, विभिन्न, अलग, अलग, अलग, परिवर्तन, अलग, परिवर्तनशीलता, झगड़ा, डिवाइड
चिंतित: आपातकालीन, तात्कालिकता, चिंतित, चिंतित, चिंतित, चिंता, चिंता, चिंता, सावधान, असुविधाजनक, चिंता, भयभीत, इच्छुक, परेशान, खतरनाक, उत्साही, उत्सुक, बेचैन, बेचैन
कप्तान: 
समाप्त: अंत, समाप्त, सीमित, तैयार
समाप्ति-पहलू: 
जिज्ञासु: उत्सुक, दिलचस्प, उत्तेजित-करनेवाला
विदेशी: विदेश-में, विदेशी, विदेशी, विदेशी, अजनबी, बाहरी
intensifier: तेज
महत्त्व: अनिवार्यता, प्रासंगिकता, अर्थ, मूल्य
अंत-में: अंत-में, अंततः, सीमित, अंतिम, परम, टर्मिनल, पतले
बिल: अधिनियम, हस्तलिपि, कारण, गणना
साबित-करना: प्रमाण, इस-बात-की पुष्टि, वाणी, दिखाना, गवाही-देना
रोकना: रोकना, रोकना, रोकना, रोकना, रोकना, रोकना, खंड, नियंत्रित-करना, रोक-रखना, निषेध, से-बचने, पीछे-हटाना, दबाना, निलंबित
गरदन: गला
कानूनी: अदालती, कानून, वैध, ढांचा
सूखा: तना
की-सेवा: सेवा, कमाना, पूरा, प्रस्ताव
खोना: कमी, ग़लत-जगह-रखना
सबूत: प्रत्यक्ष, प्रमाण, गाइड, संकेत, निर्देशिका, प्रदर्शन, गवाह
प्रत्यक्ष-मामला: 
प्रगति: प्रगति, प्रगति, विकास, प्रगतिशील, विकासात्मक, अग्रिम, बढ़ना, सुधार, उत्थान
इमारत: निर्माण, संरचना, निर्माण, निर्माण, घर
खोज: खोज, खोज, खोज, खोज, खोज, मांग, तलाश, अनुसंधान, सर्वेक्षण, लक्ष्य, जांच, जांच, जांच
उदास: उदास, अफसोस-की-बात है, दुखी, परेशान, परेशान, पश्चाताप, निराशाजनक
पाप: अपराध
तीस: 
ईमानदार: ईमानदार, निष्ठावान, ईमानदारी-से, फ्रैंक
बंद: बंद-करे, बंद, समापन, बंद, स्थापित, बन्द-करने-के लिए, पैक, बंडल, पार्सल, पोटली, पैकेज, ज़ब्त-करना
बैंक: बेंच, टिन
भाग्य: भाग्य, भाग्य, वाक्य-रचना-के-नियमों के अनुसार, गंतव्य, बहुत-कुछ
वन: जंगल
माप: नाप, माप, तौलना, मीटर, मीटर
अन्यथा: वैकल्पिक-रूप-से
धारा: प्रवाह, धारा, वर्तमान, बिजली, प्रवाह, जेट
रोटी: सेंकना, बुआई-करना, सैंडविच
अतिरिक्त: अतिरिक्त, अतिरिक्त, अतिरिक्त, अतिरिक्त, अतिरिक्त, आगे, इसके-अलावा, पूरक, जोड़ना, परिशिष्ट
चुनना: चुनाव, चयन, चुनना, चयनात्मक, चुनना, चुनाव, डायल, वोट, जांच, पसंद
जानवर: 
Zoic-लिंग: 
eventive-मनोदशा: 
वही-घटना-निशान: 
गुणक-मामला: 
मोटा: मोटा, घनी, घना, वसा
प्राणी: जीव, सार
बारिश: गीला, वर्षा, शावर
सतह: चेहरा, स्तर, विमान, क्षेत्र
पवित्र: धार्मिक, जाल, विशुद्ध
जुलाई: 
रिपोर्ट: दृढ़-संकल्प, कथन, अनुपात, संबंध, संबंध, मेला, प्रदर्शनी, निबंध, जोखिम, स्कोर
तट: किनारा, समुद्र-तट
फ़ाइल: दस्तावेज़, कुंडल, लॉज, प्रोफ़ाइल, पुरालेख
कंधा: दस्ता, अक्ष, चित्रलेखन, कंघी, बांह
हैरान: हैरान, आश्चर्य-है
राजकीय: शाही, साम्राज्य, राज्य, साम्राज्य, वास्तविक, वास्तविक
गीत: धुन, ट्रैक, गायन, कविता
आराम: आराम, आराम, आराम, प्रोत्साहन, सुविधा, शेष, राहत
किसी-को-भी: कोई, कोई-व्यक्ति, कोई, कोई-भी-नहीं, हर
घास: सूखी-घास, निराना, जड़ी-बूटी, लॉन, ग्राम
खींचना: खींचना, खींचें, ढोना, दिलचस्प, अपील, आकर्षक, निकालना, उत्तेजित-करनेवाला, को-आकर्षित, सुहावना-होते-हुए, चि-त्र-का री, हटाना, घटाना
प्रारंभिक: प्रारंभिक, प्रारंभिक, खोज, अन्तर, स्लॉट, खुले-तौर-पर
जून: 
मछली: मछलीघर
राजधानी: अध्याय, निधि, संपत्ति
स्तन: छाती
हिमपात: हिम
शिक्षा: शिक्षित, शिक्षा, शिक्षात्मक, साक्षरता, गठन, ट्रेनिंग, शिक्षित, अकादमिक
तेज़: उज्ज्वल, भयंकर, कठोर, तेज़ी-से, मसालेदार, नुकीला, तीव्र, इच्छुक, कुरकुरा
दया: दया, दया, सहानुभूति, सहानुभूतिपूर्ण, दयालु, भयंकर, दंड, पंख, बदकिस्मत, विलाप-करना, बुराई, क्षति, पश्चाताप
व्यय: शुल्क, व्यय, लागत, संस्करण, उत्पादन, चार्ज
तुम्हारा: आपके
दस-लाख: दस-लाखवाँ
थका: थकान, थकाऊ
हत्या: हत्या, मारना
छाया: छाया
भार: भार, भारी, भारी, तौलना, दबाव
सामूहिक: गुणवत्ता, सामूहिक, मात्रा, थोक, बहुवचन, बहुत-कुछ, गांठ, समूह, भीड़, अपमान, लोई, पास्ता
स्थापित: स्थापित, ठोस, दृढ़ता-से, स्थिर, सृजन, स्थापित-करना, निर्भर
बहादुर: बोल्ड
पतला: पतला, पतला, पतला, संकीर्ण, दुबला, जुर्माना, सूक्ष्म, पतले, थोड़ा, अरे-नहीं, rarefied, नाज़ुक, नाप
संतुष्ट: प्रसन्न, संतुष्टि, संतोष, मगन, मुआवज़ा-देना, संतोषजनक
चेक: चेक, देखना, घड़ी, चुनाव, की-जांच, निरीक्षण, जांच, कसौटी, आडिट, मध्यम, सर्वेक्षण, जांच, पता-लगाने-के, संशोधन, नियंत्रण
सदाचार: दयालुता, धार्मिक, भलाई, कृपा
राष्ट्रीय: राष्ट्र, राष्ट्रीयता, जातीय, घरेलू
दिव्य: धार्मिक
घाटी: घाटी
अनुमान: अनुमान, संदिग्ध, मानना, आकलन, आकलन, भविष्यवाणी, भविष्यवाणी, पूर्वानुमान, कल्पना-करना
काल्पनिक-मनोदशा: काल्पनिक-मनोदशा
पीला: पीला, अंबर, गोरा
अवशेष: छाछ, अवशिष्ट, शेष, कूड़ा, शेष
तुला-हुआ: वक्र, मोड़, चकरा, प्रवृत्ति, मुड़, ढाल, sloped, तिरछा, तह
डिब्बा: सूटकेस, दराज, निधि, किट, कर-सकते-हैं, बिन
ऋतु: मौसमी, अध्याय, स्टेशन, युग
विज्ञान: वैज्ञानिक
छेद: छेद, ड्रिल, कुंठित, उबाऊ, बींधना, झुंझुला-देना, मंच
चाचा: 
सूची: सूची, सूची, मेन्यू, रजिस्टर
अगस्त: 
लोकप्रिय: प्रसार, प्रसिद्ध, प्रसिद्ध, लोक
अज्ञात: अजनबी
परिचित: परिचित, वंशावली, वंशज
परिचित-रजिस्टर: 
पाठक: गायक
पहुंच: पहुंच, पहुंच, तकनीक, युक्ति, कार्यप्रणाली, रवैया, ढंग, विधि, फैशन, प्रक्रिया, सन्निकटन, इंटरफ़ेस
दो-बार: दोगुना
बौद्धिक: मन, बुद्धि, मानसिक, बुद्धिमान, मानसिक-रोगों-का, विचारक, बुद्धिमत्ता, आध्यात्मिक
वास्तव-में: वास्तव-में, वास्तव-में, वास्तव-में, वास्तव-में, वास्तव-में, वास्तव-में, सच, ईमानदार, यथार्थवादी, पूरी-तरह-से, निश्चित-रूप-से, ज़रूर, निश्चित-रूप-से, निश्चित-रूप-से
पुरोहित: पादरी
घायल: घायल, घाव, चोट
गम: शोक, उदासी, मंदी, उदास, शोक, पीड़ा
महल: 
हराना: हार, पंच, थप्पड़, दस्तक, स्लैम, ताल, पर-काबू-पाने
ना?: 
मूर्ख: मूर्ख, चाल, धोखा-देना, धोखा, बेवकूफ, मूढ़, पागल, पागल, पागल, गुमराह
धार: कगार, झब्बे, सीमांत, तीव्र, सीमा, हाशिया, बोर्ड
नौ: नौवां, नई
विस्फोट: विस्फोट, विस्फोट, विस्फोट, फटा, उछाल, ऐंठन, धमाके
भुगतना: सहना, बनाए-रखना
शोर: शोर, चिल्लाना, गड़बड़, गर्जन
साहित्य: साहित्यिक
सलाह: परिषद, की-सिफारिश, संस्तुति, सलाह-देना, परामर्श, बोर्ड, टिप
खाली: रिक्त, रिक्त, ढोल, अवकाश, शून्य, शून्यता, वैक्यूम, व्यर्थ
पद: पद, ग्रेड, उपलब्धि, श्रेणी, मूल्य, कक्षा
आंधी: 
जेब: बैग, पोटली
कल्पना: कल्पना, कल्पना, कल्पना, कल्पना, उपन्यास, काल्पनिक
वाक्य: निर्णय, निर्णय, प्रस्ताव, प्रमेय, सुझाव, प्रस्ताव, सज़ा, दोषसिद्धि, मुहावरा, की-निंदा, आरोप-लगा-देना, दंड
नवंबर: 
दिसंबर: 
अनुपस्थिति: अनुपस्थित, कमी, कमी
धन्यवाद: आभार, आभारी, धन्यवाद, धन्यवाद
पता: 
पक्षी: उड़ान, विमान, जेट, विमान, हवाई-जहाज़, एयरलाइन
मालिक: मालिक, ज़मींदार
कोट: गाउन, म्यान, आवरण, जैकेट, फर
तैयार-करना: तैयार, तैयार, का-आयोजन, तैयारी, तैयार
संबंधों: संबंध, संबंध, अनुपात, प्रासंगिकता, संबंधित-हैं, मामला, संचार, संवाद
धुआं: धूम्रपान, तंबाकू, जलाना
जनवरी: 
मशीन: मशीनरी, इंजन, विमान, वाहन
सामग्री: सामग्री, सामग्री, पालन-​​करना, मुआवज़ा-देना, शामिल, शामिल, मिलकर, शामिल
दांत: दांत, गियर
शर्म-की-बात है: अपमान, शर्मिंदा, शर्मीला, परेशान, शर्मनाक, शर्मिंदगी, नंगा, नंगा, अपमान, बलात्कार
खाड़ी: बेरी, योनी
दिमाग: विख्यात-मन, मज्जा
अंगूठी: क्षुद्र, डायल, कर्ल, पाश, टायर, टायर, सील, डाक-टिकट
मुहावरा-निशान: 
वर्ग: 
फल: 
चाय: 
समझाना: व्याख्या, उदाहरण-देकर-स्पष्ट करना, अभिव्यक्त, स्पष्ट, घोषित, स्पष्ट-करना, व्याख्या, टिप्पणी
स्वागत: शुभकामना, स्वागत, का-मनोरंजन, अरे, नमस्ते, नमस्कार
कविता: कविता, कविता
खरीदने-के-लिए: क्रय, अधिग्रहण, बर्दाश्त, बाजार
श्रद्धालु: बेईमान, निष्ठावान, ईमानदारी, भक्त, सही, विश्वसनीय
उत्तेजना: उत्तेजना, उत्तेजित, गड़बड़, तनाव, भड़काना, हर्ष, कामोत्तेजना, लालिमा, चिंता
चालीस: 
अप्रैल: 
कृपया: कृपया, अनुकूल, धीरे
अक्टूबर: 
कड़वा: कष्ट, व्यथा, पीड़ा, कटु, पीड़ा, दर्दनाक, डंक
दास: गुलामी
ढीला: स्वतंत्र, शिथिल, संकल्प, हल, सुस्त, रिक्त, आज़ादी-से
टेक्स्ट: शब्दों
श्रेय: बंधक, क्रेडिट-कार्ड, ऋण, देना, उधार, ऋण, प्रतिष्ठा, वैधता, साख
पंद्रह: 
निर्दयी: भयंकर, कड़ा
शामिल-हो: भाग-लेना, भाग-लेने-के लिए, लिप्त, लगना, पालन, प्रतिभागी, भागीदारी, एकजुट, कनेक्ट
प्रक्रिया: संभालना, प्रक्रिया, इलाज, आपरेशन, परीक्षण
अपराध: अपराध, अपमान, अपमान
धूल: बांध, पाउडर
व्यावहारिक: कार्यात्मक, व्यावहारिक, वास्तव-में, सुविधाजनक, वास्तव-में, सुविधाजनक, आवेदन-किया-है
रंग: रंग, रंग, रंग, रंग, पीला, रंगीन, रंगीन, लालिमा, अंत
नष्ट: जहाज-के-मलबे, कमजोर, तोड़-फोड़, नीचा-दिखाना, ध्वस्त, क्रश, गरज, तबाह, उलझाना, मिटाना, नकारना, विनाश
बढ़ना: बढ़ना, बढ़ाने, पर्वत, उठाना, जोड़ना, डालें, विकास, विस्तार-करना
नाक: 
स्वीकार-करना: मान्यता, स्वीकार-करना, स्वीकार-करना, पहचानना, स्वीकार-करते-हैं, अनुमोदन, समर्थन, अनुदान, पुरस्कार
कल: कल
hesternal-काल: 
असफल: असफलता, असफल, हार, झटका, असमर्थ, उलझाना, निराश
जारी-रखने-के लिए: बढ़ना, निरंतर, ज़िद्दी, सिलसिला, निरंतर, दृढ़-रहना
पहनना: ले-जाना, कुली
अंधा: 
दर्जन: कई
उड़ना: उड़ान, छलांग, उड़ान, विमानन
प्रशंसा: प्रशंसा, प्रशंसा, साख, योग्यता, बधाई-देना, बधाई, महिमा, प्रसिद्धि
शैतान: 
धीरे-धीरे: धीरे-धीरे, क्रमिक
त्याग: शिकार, शिकार, दुर्घटना
व्यायाम: व्यायाम, व्यायाम, काम, अभ्यास, अभ्यास, खेल, फिटनेस, रिहर्सल
अंतरात्मा-की-आवाज: सर्वनाम, चेतना
सिद्धांत: सिद्धांत, विचारक, प्रमेय
मंत्री: 
नफ़रत: बुरा, घिनौना, घृणा, घृणा, पक्षपात, असन्तोष, क्रोध-करना, घृणा-करनेवाला, घृणा, घृणा
झील: 
केंद्र: केंद्रीय, केंद्र, स्टेशन, मुख्यालय
बेहोश: बेहोश, निराशा, निराश, निर्बल, पीला
तर्कसंगत-लिंग: 
सावधान: सावधान, सावधान, ध्यान-केंद्रित, सतर्क, ठीक, शुद्ध, ठीक, विस्तृत
आनंद: भोग, सराहना
पूजा: अनुष्ठान
माल: उत्पाद, मद, व्यापार, वस्तु, सामग्री
त्वचा: चमड़ा, अवशोषण, छाल, खोल, छाल, फर, दिलचस्पी
छत: छत, अधिकतम-सीमा, को-कवर, कवरेज, ढक्कन
ताज: 
गढ़: पिंजरा, कौआ, ताला
सिंहासन: 
संलग्न: संलग्न, सशर्त, जोड़ना, लॉग-इन, आश्रित, साथी
मील: झुकाव, ढाल, दुबला, ढाल, तैयार
चरम: अधिकतम, परम, खंभा, ध्रुवीय, अतिवादी, गंभीर, तीव्र, गहन, अवयव, टिप
जेल: जेल
कप: मग, कटोरा
सदस्य: अंग, सदस्यता, अवयव, अंदरूनी-सूत्र
नागरिक: घरेलू, नागरिक, नागरिक, असैनिक
हर-जगह: पूरे, कहीं-भी
प्रत्यक्ष: ज़ाहिर, जाहिर-है, प्रत्यक्ष, प्रत्यक्ष, स्पष्ट, निश्चित-रूप-से, निश्चित, स्पष्ट, स्पष्ट-रूप-से, पारदर्शक, अस्पष्ट, ध्यान-देने-योग्य
युगल: जोड़ा, सममूल्य, दोगुना, दोहरी, कुछ, कई, वाष्प
आयतन: अटेरन, बहुत, सीमा, मात्रा, अपेक्षाकृत, मात्रात्मक, खंड, जत्था, मॉड्यूल, थोक, क्षमता, कवरेज
रिवाज: ग्राहक, ऐच्छिक, पोशाक, कस्टम, अभ्यास, आदत, अभ्यस्त
धनुष: मेहराब, प्याज, वक्र
सूट: फिट, पोशाक, उपयुक्त, समझौते, अनुरूप, मिलान, मामला, अभियोग, मुकदमेबाज़ी, गाउन, दावा
मांस: मांस, गाय-का-मांस
दूध: डेयरी, नल, जेली
वनस्पतिक-लिंग: 
दृष्टि: दृष्टि, ट्रान्स, अंतर्दृष्टि, मुखौटा, राय, झलक, आशा, परिदृश्य, आउटलुक
दुर्लभ: शायद-ही-कभी, शायद-ही
चचेरा-भाई: संबंधी
पुल: ग्रेड, डेक
रक्षा-करना: सुरक्षा, संरक्षण, गार्ड, ढाल, बचाव, की-रक्षा, रखना, संरक्षण, सुरक्षित
नमक: अतिरंजित, अतिरंजना-करना, नमकीन
मासूम: 
रानी: 
गिनती: विभाजन, मानना, गणना, भरोसा-करना, निराशा, कारण
जिज्ञासा: जिज्ञासा
नृत्य: ढोल, नाच, छलांग, छोड़ें
होटल: आवास, सराय
भरना: 
बंदी: 
दुकान: दुकान, दुकान, व्यापार, सौदा, खरीदारी
सीढ़ियों: सीढ़ी, सीढ़ी, सीढ़ी, दराज
मान-लेना: मांग, मान-लेना, निवेदन-करना
रेत: 
हिंसात्मक: हिंसा, भयंकर, अशांत, आश्चर्यजनक, कठोर, दृढ़, तीव्र, जोरदार, बेतहाशा, गहन
सितंबर: 
प्रस्थान: छुट्टी, रवाना, आउटलेट, उत्पादन
विनाश: विनाश, विनाश, क्षति, लूट, आपदा, मलबा
कौशल: योग्यता, सक्षम, क्षमता, प्रभावशीलता, क्षमता, शिल्प, विशेषज्ञता
मवेशी: गाय
उपकरण: उपकरण, युक्ति, किट, गियर, संगठन, पकड़ना, हार्डवेयर, तकनीक, प्रौद्योगिकी, सुविधा, स्थिरता
रसोई: खाना-पकाने, कुकर
बेचना: बिक्री, अर्द्ध
गति: वेग, गति, गति, तेज़ी-से
निष्कर्ष: अनुमान, वापसी, उत्पादन, निहितार्थ, संकल्प, परिणाम, परिणाम, संग्रह, निष्कर्ष-निकालना, प्रस्ताव
कंप्यूटर: कंप्यूटिंग
सनातन: कभी, सदैव, अनंत
सीमित: सीमित, सीमित, सीमित, सीमांकित, प्रतिबंधित, विवश-करना
पुस्तकालय: किताबों-की-अलमारी
आधार: बुनियाद, आधार, आधारित, मौलिक, मुख्य, प्राथमिक, कोर, बुनियादी, तल
भ्रम-की-स्थिति: गंदगी, अराजकता, गड़बड़, भ्रामक
यशस्वी: प्रतिभाशाली, सुंदर, महान
इसी-तरह: उसी-प्रकार, भी, समान-रूप-से
भयभीत: भयभीत, भयभीत, भय, डराना
अप्रसन्न: बदकिस्मत, बदकिस्मत, दुखी
लेख: निबंध, मद
पकाना: खाना-पकाने, सेंकना, फोड़ा
बैंड: बेल्ट, रिबन, टेप, दस्ता, समूह, पट्टी, पट्टी, क्षेत्र, किनारा, झुंड, समूह, लेन
रेगिस्तान: जंगल, सुनसान
चुंबन: 
गेंद: रबर, क्षेत्र, तोप, गोली
छड़ी: स्टॉक, गन्ना, पालन, लकड़ी, लकड़ी, बल्ला, संकेत
तर्क: तर्क, चाल, विचार, विवाद, विचार-विमर्श, बहस, विवाद, प्रणाली
निरीक्षण: निरीक्षण, की-जांच, का-पता-लगाने, जांच, अवलोकन
आशीर्वाद-मनोदशा: 
हड़ताली: बकाया, तेजस्वी, हड़ताल, महत्वपूर्ण, महत्वपूर्ण, ठोस, ध्यान-देने-योग्य, प्रभावशाली, आश्चर्य-की-बात, आश्चर्यजनक, स्पष्ट, उज्ज्वल
दोषी: अपराध, कर्जदार, अपमान, अपराधी, मिद्धदोष-अपराधी
बंदूक: राइफल, हथियार, तोप, कौआ
पुलिस: लागू-करना, की-निगरानी
छिपाना: छिपाना, छिपाना, भेस
अभियान: अभियान, ड्राइव, यात्रा, यात्रा, जलयात्रा, दौरा
अनजान: अज्ञान, अनजान, अनजान, मूढ़, मूर्ख, बेवकूफ, हास्यास्पद
उदार: उदार, अतिथि-सत्कार, कृपा
बादल: 
बेकार: बेकार, बेकार, मना, इनकार, अस्वीकार, छाछ, कूड़ा, कचरा
फरवरी: 
रोग: रोग, रोग, कोरोनरी, संतोषजनक, संतोषजनक, सिंड्रोम
बिताना: फूल, उपयोग, व्यय, आगे-बढ़ाने, छोड़ें, कमी
स्रोत: संसाधन, कच्चा, फव्वारा
पहल-मामला: 
चाची: 
विलंब: टालना
विलंबित-अनिवार्य: 
की-सूचना-दी प्रत्यक्ष: 
आधी-रात: उत्तर
नायक: योद्धा, चैंपियन
दर्शन: दार्शनिक
उंगली: पैर-की-अंगुली
आरामदायक: अच्छी-तरह-से, बिलकुल, ठीक-से, सुचारू-रूप-से, आराम-से, सुविधाजनक, आराम, सुखद, गरम, सुविधाजनक
कहीं-न-कहीं: कहीं-भी
दबाएँ: मीडिया, पत्रिका, पत्रिका, मुद्रण, टाइप, सूत्र
स्टाफ़: कर्मीदल, व्यक्तिगत
इनाम: इनाम, उपहार, पुरस्कार, बोनस
दोष: दोष, दोष, दोष, ऋण, अपराध, चपटी, पर-मुकदमा-चलाने के, दायित्व, उत्तरदायित्व
कष्ट: कष्ट, पीड़ा, पीड़ा, दुखी, उदासी
माथा: 
विज्ञापन: विज्ञापन, विज्ञापन, विज्ञापित, विज्ञापन, घोषणा, प्रचार, नोटिस, घोषणा
देवदूत: ज़मींदार, परी
विलक्षण-संख्या: 
भोर: सांझ
व्यावसायिक: व्यावसायिक, विज्ञापन, व्यापार, व्यापार
माफ-कर-दो: बहाना, क्षमा, सहना, मुक्त, राहत-देने, बर्खास्त
भेड़: मेमना
धैर्य: धैर्य, सहनशीलता
खेत: खेत, विकसित-करना, पेड़-लगाना, कृषि
referential: संदर्भ, का-उल्लेख
मक्का: गेहूँ, सींग
कुंजी: बंधन, बटन, रिंच, स्विच, मुख्य, महत्वपूर्ण, प्रसिद्ध, संवेदनशील, प्रमुख, आला, मुख्य-धारा, संकेत
बहुमत: अनेक, सबसे
दुर्बलता: असमर्थता
वातावरण: वातावरण, आकाश, विमानन, स्थानिक
झोंका: हांफी
मानवता: मानव
विरोध: विरोधी, का-विरोध, का-विरोध, विरोध, विरोध, विरोध, विरोध, प्रतिरोध, काउंटर, प्रतिद्वंद्वी, अस्वीकृति, विरोधी, प्रतिरोधी, विरोधी, आपत्ति
डिस्क: डिस्क, टुकड़ा, काउंटर, बेलन, प्लेट, अभिलेख, ट्रे, ड्राइव
अकेला: अकेला, अकेलापन, अलग, एक, केवल
कलाकार: अभिनेता, चित्रकार, मनोरंजन
शूरवीर: सवार
आकर्षण: करिश्माई, आकर्षण, जादू, जादू
निर्णय: तय, निर्णय, निर्णय, निर्णय, दृढ़-संकल्प, संकल्प, समाधान
राज्यपाल: रूढ़िवादी, शासक
शाखा: 
स्वभाव: व्यवस्था, विन्यास, झुकाव, प्रवृत्ति, प्रावधान, ख़ाका, मनोदशा, अनुसूची, समय-सारणी
उत्साह: उत्साह, गर्मजोशी, उत्साही, दिलचस्पी, उत्साह, जोश, परमानंद, जयकार
अधिष्ठापन-का-मनोदशा: आनुमानिक-मनोदशा, वियोजक-मनोदशा
समुदाय: समाज, श्रेणी, लोग
तेल: वसा, ईंधन, जीवाश्म, मज्जा, थर्मल, मक्खन
पाइप: ट्यूब, नल, नल, गोली-चलाने-की आवाज़, नहर
छाप: संस्करण, दबाव, मुद्रण, अक्ष, ढालना, प्रभाव
ओह: फिर
प्रवचन-प्रसंग: 
सम्बोधन-मामला: 
केबिन: कुटिया, तंबू, लॉज
अलार्म: घंटी, चेतावनी, डराना, ख़ौफ़-में-डालना
परेशान: काल, परेशान, परेशान, परेशान, परेशान, परेशान, परेशान, परेशान, तंत्रिका, चिंतित, नस
स्थायी: अवधि, बहुधा, नियमित, ज़िद्दी, स्थिर, स्थिर, नियमित
चाकू: चिल्लाना, ब्लेड
रेशम: 
घृणा: तिरस्कार-किया, घृणा, घृणा, घृणा, घृणा, चपटी, अपमान, बलात्कार, लापरवाही
नरक: 
अलग: अलग, अलग, अलग, अलग, अलग, अलग, अलग, अलग, अलगाव, बहिष्कृत, सीमांकित, पृथक्करण
गंभीरता-से: गंभीर, ईमानदारी-से, भारी, भारी, तेज़ी-से, सक्रिय-रूप-से
मिश्रित: मिश्रण, संयोग, समग्र, मिश्रण, संयुक्त
लकड़ी-का: लकड़ी, लकड़ी
पसंद-करते-हैं: पसंद
चेतावनी: सावधानी, चेतावनी-देना, चेतावनी, स्मारक, नोटिस
चेतावनी-मनोदशा: 
आवेग: प्रेरणा, नाड़ी, जत्था, आग्रह-करता-हूं, गति, जोर
महत्वाकांक्षा: निराश, निराशा, हवस, लालची, हतोत्साहित, महत्त्वाकांक्षी
इनकार: इनकार, अस्वीकार, इनकार, अस्वीकार, इनकार, मना, नकारना, पतन, अस्वीकार-करना, बर्खास्त, रोकना, प्रतिबंध, निषेध, खंडन
संविधान: चार्टर, संवैधानिक
साधन: साधन, पात्र, सत्ता, अंग, पात्र, उपयोगिता
निरंतर-पहलू: 
ज्वार: लहर, तस्वीर
कॉलेज: संकाय, अकादमी, कैंपस, विश्वविद्यालय
पूंछ: कतार
पीढ़ी: वंशज
बिल्ली: 
प्रत्यक्ष-प्रत्यक्ष: 
छोड़-दिया: उपेक्षा, छुट्टी, सुनसान, छोड़ना, छोड़-देना-चाहिए
ग्यारह: 
स्वाभाविक: स्वाभाविक
विशेषता: विशेषता, विशेषता, चरित्र, आदत, झुकाव, व्यवहार, व्यवहार, सुविधा, निस्र्पण, गुणात्मक, ठेठ
जनजाति: ट्रंक, तना, भार
भयभीत-मनोदशा: 
आश्रय: आश्रय, निवास, समझौता, वास, आवासीय, सुरक्षा, छात्रावास, अस्पताल
अशिष्ट: बुरी-तरह, असभ्य, बद
सवारी: सवारी, सवार
मंथन: मंथन
उद्योग: क्षेत्र, उत्पादन, औद्योगिक, औद्योगिक-करना
व्यवसाय: व्यावसायिक, व्यवसाय, कब्जे, पेशेवर
दीपक: बल्ब
कॉफ़ी: कैफ़े
आज्ञा-का-पालन: प्रस्तुत-करने, पालन-​​करना, सुनना
उत्तरी: उत्तर
नर्स: 
विश्वास-दिलाता-हूं: बीमा, वारंट, प्रतिज्ञा, गारंटी, ठीक-कर-लेना, सुनिश्चित, पता-लगाने-के, इस-बात-की पुष्टि, प्रदान, पूरा, ज़रूर, को-समझाने, वाणी, सुरक्षित
श्रृंखला: अनुक्रम, शृंखला, तार, जेल
शिक्षण: अनुदेश, शिक्षित, ट्रेनिंग
जूते: जूता, चप्पल
यार्ड: कोड, पृष्ठ, प्रेमालाप
अस्पष्ट: अस्पष्टता, अस्पष्ट, अस्पष्ट, अस्पष्ट, रहस्यमय, ढुलमुल, अनिश्चितकालीन, लहर, रिक्त
अन्यत्र: अन्य
फ्लैट: समतल, वृत्त, कम्पार्टमेंट, सुइट
गतिविधि: सौदा, समारोह
शनिवार: विश्राम-का-समय
धूप: सौर
विधवा: 
तत्त्व: पहलू, सुविधा, मद, घटक, अंग
प्रतिबिंब: चिंतन
संगठन: ऊतक, संगठन, का-आयोजन, संगठन, निगम, उपयोगिता, एजेंसी, सत्ता, व्यवस्था, संरचना, बनावट, ख़ाका, संस्था, संस्थान
तारा: 
घटना: घटना, घटना, घटना, घटना, दुर्घटना, मामला
अतिथि: अजनबी, आगंतुक, विदेशी, विदेशी, नवागंतुक, ग्राहक, ग्राहक, मेज़बान
बार: नंगा, पब, भार, भाड़ा, कैफ़े, बेरियम
बोतल: जार
भला-करे: आशीर्वाद
हलचल: हेरफेर, मिश्रण, पुकारना, दंगा
आंतरिक: अंदर, अंदर, आंतरिक, आंतरिक, स्थानीय, घरेलू, इनडोर, मानसिक, अंदरूनी-सूत्र
को-ठीक: स्थिर, समायोजित, संशोधन, समाधान, संकल्प, हल, उपाय, में-सुधार, सीधा-करना, ठीक, ठीक-है, स्थिर, नियमित, घूरते, सही, निर्धारित, स्थापित-करना, पहचान, पता-लगाने-के
निकाले-जाते-हैं: प्राप्त, अधिग्रहण, यौगिक, मिलना, प्राप्त
खोखला: मैदान, नंगा, रिक्त, केबल
प्रांत: प्रांतीय
सभ्यता: 
लटकना: 
झटका: झटका, झटका, आघात, चौंका-देने-वाला, संघर्ष
अपवाद: आंशिक, भेदभाव, टकसाली, छूट
तनाव: तनाव, तनाव, भार, थकान, प्रयास, तीव्रता
मानक: मापदंड, मानदंड, दर, स्तर, चूक, आदर्श, स्थिर, स्थिर, नियमित, स्थिर, स्थिर, सतत, मानकीकरण-करना, पैटर्न
ड्राइव: ड्राइव, ड्राइवर, गाइड, प्रबंध, सवारी
छुटकारा: हटाना, निकालना, को-समाप्त, उन्मूलन, मुक्त, राहत-देने, रिहा-करना
कसम-से: शपथ---ग्रहण
खजाना: गहना
बीज: शुक्राणु, अखरोट, कण
मीनार: कौआ
पसंदीदा: पसंदीदा
हाल-ही-में: हाल-का, हौसले-से, नव
हाल-का-अतीत काल: 
सचेत: सचेत, हौसला, जागना, चेतावनी
फर्नीचर: 
रस्सी: रस्सी, तार, पट्टा
साहसिक-कार्य: उद्यम, जुआ
रॉयल्टी: राज
दावत: पार्टी, उत्सव, भोज, छुट्टी
वर्णन: विवरण, निस्र्पण, शब्दों-में-वर्णन करना, चित्रित, परिभाषित
साठ: 
स्केल: ढांचा, नाप, अनुपात, सीढ़ी, सीढ़ी, सीढ़ी
समारोह: अनुष्ठान, समारोह
शिकार: शिकार, शिकार, शिकार, पीछा, शूटिंग
फुसफुसाना: बुदबुदाना
काफी-हद-तक: काफी-हद-तक, काफी, सबसे, मुख्य-रूप-से, अधिकतर, बहुत, व्यापक-रूप-से, मुख्य-रूप-से
ईसाई-धर्म: 
वकील: प्रतिनिधि, वकील
विस्तार: विस्तार, विस्तार, विस्तार, विस्तार, विस्तार, गहरा, विस्तृत
राजकुमारी: 
वेदी: मंदिर
वेब: नेटवर्क, जाल, ग्रिड, ऊतक, कैनवास, पोस्टर
बैंगनी: मैजेंटा
इकट्ठा: इकट्ठा, जमा, हटना, डायल
चुनाव: चुनाव, चुनाव, निशान, मतदान, ह्वेल, चयन, मतदान
धारणा: धारणा, संकल्पना, गर्भ-धारण, अनुभूति, समझना, वैचारिक, डिज़ाइन, पकड़, गिरफ्तार, कब्जा
शराबी: शराबी
बहना: गिर-पड़ना, बहाना, शलाका, पराभव
लिफ़्ट: लिफ्ट, ऊपर-उठाना, उत्थान, उठाना, बढ़ोतरी
इशारा: संकेत, संकेत, प्रतीक, प्रतीकात्मक, रवैया, आसन
प्रबंधन: प्रबंध, की-निगरानी, संभालना, प्रशासन, शासन, बधिया, नियंत्रण
विनिमय: विनिमय, पारस्परिक, प्रहार, प्रतिस्थापन
निश्चित-लेख: 
सम्राट: सम्राट
दूरस्थ: दूर, दूर, अलग
कुरूप: बुरा, घिनौना
हानिरहित: 
रोल: पुस्तक, कुंडल
इंच: कस्टम, अंगूठा
समाचार-पत्र: पत्रिका, सूचित-करना, डायरी
दाढ़ी: टिप, ठोड़ी
आंसू: छीनना
आयोग: समिति, बोर्ड
जबकि: जबकि, दौरान
चौराहा: पार, संगम, मार्ग, मृत्यु, संक्रमण, गलियारा
स्वतंत्रता: स्वतंत्र, स्वतंत्रता, आज़ादी-से, आजादी, स्वायत्तता
गंध: बदबू, इत्र
अठारह: 
ऐतिहासिक: ऐतिहासिक-दृष्टि-से, इतिहास, इतिहासकार
कुल: कुल, कुल, गंदा, कच्चा, अपरिष्कृत
जड़: तना, हौसले-से
कीचड़: धरती, कीचड़, मिट्टी, गंदगी, फूल
दुल्हन: दादी
परदा: परदा, पाल, नौकायन
थिएटर: थिएटर
तुलना: तुलना, तुलनात्मक, सह-संबंध, अनुपात, आमना-सामना
प्रतिद्वंद्वी: प्रतिद्वंद्वी, मतभेद-करनेवाला, प्रतियोगिता, प्रतियोगी, प्रतिस्पर्धा
संतुलन: संतुलन, समान-रूप-से, समानता, क्षैतिज, आनुपातिक, सममूल्य, बजट
कोच: ट्रेनर, व्यवसायी, ट्यूटर, संरक्षक
हास्य: हास्य, विनोदपूर्ण, मनोदशा, कॉमेडी
उपन्यास: उपन्यास, नई, नव
बदला: असन्तोष
ईर्ष्यालु: ईर्ष्या-द्वेष, डाह
पहिया: बाइक, वृत्त
जला-दिया: जलाना, भड़का
फ़्लैश: बिजली, चमक, चमक
बनाने: सृजन, निर्माण, निर्माण, रचनात्मक, बनाना, गढ़ना, लिखना, बनाना, उत्पन्न
संघर्ष: संघर्ष, संघर्ष, आमना-सामना, विरोध, दुर्घटना, प्रभाव
अभिशाप: 
फटकार-का-मनोदशा: 
असहाय: दुखी
सकारात्मक: सकारात्मक
क्लब: बल्ला, लॉग-इन-करें
बाढ़: 
अनाज: अनाज, गेहूँ
उदासीनता: उदासीनता, लापरवाह, लापरवाही
क्षितिज: 
स्वीकृत-मनोदशा: काल्पनिक-मनोदशा
खड़ी: ऊंचाई, sloped
सामंजस्य: समझौता, धुन
गड़गड़ाहट: 
बचपन: 
घुटना: गोद
सॉफ्टवेयर: आवेदन, प्रदर्शनों-की-सूची
चोट: चोट, बुराई, क्षति, चोट-पहुंचाना, घाव, आघात, घायल, उल्लंघन
रसीद: प्राप्त, प्रवेश, स्वागत, प्रवेश, स्वीकार, वाउचर, अंगीकरण
सक्षम: सक्षम, सक्षम, सक्रिय, अनुमति-देते-हैं, समर्थ-बनाना, ले-जाना, लागू-करना, चलो, प्राधिकृत
नाटक-का-पहला भाग: 
सरक: रपटीला, स्लाइड, सरकना
क्रांति: क्रांतिकारी, तख्तापलट, रोटेशन, विद्रोह, विद्रोह
किसान: किसान
स्ट्रोक: झटका, तख्तापलट, भीड़, हाथापाई
मंच: मंच, मंच, बुनियाद
मैसेंजर: प्रतिनिधि, दूत, राजनयिक
विशेषाधिकार: विशेषाधिकार-प्राप्त, पसंद, कोटा, मताधिकार, प्रस्ताव, रियायत
संगठित: संस्था, का-आयोजन, संस्थान, व्यवस्था, व्यवस्था
छात्र: छात्र, छात्र, अवर
गुफा: 
परंपरा: परंपरागत, पारंपरिक-रूप-से, कस्टम, आत्मसमर्पण
त्रासदी: महामारी, उदासी
बिदाई: अलविदा, नमस्ते
आलोचना: आलोचना-करना, आलोचना, समीक्षा
कपास: ऊन
अस्पताल: अस्पताल
किराया: किराया, किराया, टैक्स, श्रद्धांजलि, पट्टा, रोजगार, संलग्न, किराए-पर, चार्टर
गैस: 
अपरिहार्य: अनिवार्य-रूप-से
घातक: 
पत्ती: चादर, ब्लेड
प्रकाशन: प्रकाशित-करना, प्रकाशन, मुद्रण, प्रचार, प्रसारण, रिहाई, उत्पादन, प्रसार, संस्करण, घोषणा
शत्रुतापूर्ण: अमित्र, शत्रुता
अनुवाद: अनुवाद-करना, अनुवाद-करना, व्याख्या, महामारी, हस्तांतरण
अंतिम-संस्कार: दफन, कब्रिस्तान
आटा: पाउडर, लोई, ठीक, शुद्ध, ठीक, भोजन
पत्र-व्यवहार: अनुरूप, संपर्क, संचार, मिलनसार
रोमानी: 
कुटिया: कुटिया, लॉज
प्रस्ताव: ढोंग, प्रस्ताव, प्रस्ताव, प्रस्ताव, प्रस्ताव, सुझाव-है, की-सिफारिश, सुझाव, बोली, मनोनीत
अनुकरण-करनेवाला: 
डॉलर: 
दिन-का-प्रकाश: 
सोलह: 
सभा: बैठक, सम्मेलन, कांग्रेस, विन्यास
कालोनी: 
विंग: परवरिश, सुइट
शेर: 
संस्कृति: सांस्कृतिक
स्तंभ: सरणी, परत, खंभा, मार्ग
चालाक: मुश्किल, चाल, कुशल
नाटक: नाटक, नाटकीय
परिहास: मज़ाक, wisecrack
धुंध: कोहरा
दवा: दवा, उपाय, फुहार, पर्चे
चौदह: 
अम्ल: खट्टा, अम्लीय
यानी: कोई, अर्थात, विशेष
आमदनी: फीता
बिशप: 
नारंगी: 
स्नान: बाथरूम, शावर, बाथटब
आदिम: जल्दी, प्रारंभिक
टोकरी: बिन, बैग
सचिव: 
पुआल: सूखी-घास
अधीर: उत्सुक
मोक्ष: सुरक्षा, मुक्ति, नमस्ते
अव्तन-काल: 
इरादा: इरादा, इरादा, रुचि, इच्छुक, प्रेरणा, तैयार-नहीं, समर्पित, को-समर्पित
भाप: वाष्प
विष: विषैला, विषैला, शाक
प्रतिभा: प्रतिभा, प्रतिभावान, योग्यता, योग्यता, प्रदर्शनों-की-सूची
जलवायु: मौसम
प्रभावी: वैध, प्रभावी-ढंग-से, कुशल, प्रभावशीलता, प्रभावशाली, उपयोगी, व्यवहार्य
भेद: अंतर, भेदभाव, भेदभाव, भेदभाव, आवंटित, विभाजित-करने-के लिए, बर्खास्त, निकालना, छिपाना
धुलाई: धुलाई
स्वीकारोक्ति: स्वीकार-करते-हैं, पंथ, मान्यता
बकवास: बकवास, अकारण, बेमेल
कोयला: कार्बन
डोंगी: 
अस्थायी: अंतराल, अवधि, लौकिक, आकस्मिक, जबकि
delimitative-पहलू: 
हड्डी: पैर
सोमवार: 
मंगलवार: तिहाई
बुधवार: चौथा
संघीय: रूस, केंद्रीय
वांछनीय: आकर्षक, अनुकूल
प्रतिनिधि: प्रतिनिधित्व, पक्ष, प्रतिनिधि, प्रतिनिधि, डिप्टी, के-प्रवक्ता
लिनन: सन, अंडरवियर
सिंक: डूबना, घाटी, जस्ता
भतीजा: भांजी, पोता, पोता
रक्तरंजित: रक्तपात, खून-बहाना
घेराबंदी: चारों-ओर, बैठिये
पेट: पेट, पेट, उदर, मैट्रिक्स
पीतल: पीतल, तांबा, चावल
शिखर: शिखर, चोटी, टिप
पांचवां: पंज
सस्ता: सस्ते-में, कम
अनन्य-व्यक्ति: 
पकड़ना: पकड़ना, सीमित, रोकना, आरक्षण, छीनना, अधिकृत, पर-कब्जा, ज़ब्त-करना, हथियाना, समझ
बाड़: बाड़ा
प्रतिमा: मूर्ति
तोपें: तोप
आलिंगन: अवशोषित, ठहरना
आसपास-के: चारों-ओर, आस---पड़ोस, पड़ोसी, पड़ोसी, आस---पड़ोस, परिधीय, परिवेश, आसन्न, समीप
सख्ती: कठोर, सुसंगत, सही, तंग, कठोर, निश्चित-रूप-से, बिल्कुल, निश्चित-रूप-से, दृढ़ता-से, कठोर
मृग: 
झाड़ी: 
रेल: रेलवे, रेल
मुक्ति: मुक्ति, उतारना, रिहाई, त्यागना, निष्कासित
वारिस: वारिस
बलूत: 
अप्रिय: सुख, मनभावन, बेचैन, नाराज, परेशान, बुरा, असुविधाजनक
आविष्कार: आविष्कार-करना, खोज, नवोन्मेष
पियानो: 
मनाना: को-समझाने, मनाना, मनाना
अदृश्य: रहस्यमय
श्रुत: प्रसिद्ध, कुख्यात, प्रसिद्ध
क्रूरता: 
प्रलोभन: 
TELIC-पहलू: 
आर्थिक: अर्थव्यवस्था, आर्थिक-रूप-से, अर्थशास्री, वित्तीय
अंतरराष्ट्रीय: वैश्विक, बहुराष्ट्रीय
हस्तक्षेप: हस्तक्षेप, हस्तक्षेप, हस्तक्षेप-करना, परेशान, परेशानी, परेशान, बाधा, झुंझुला-देना, जलन, परेशान, संघर्ष
दार्शनिक: दार्शनिक
शिष्ट: फैशनेबल, नाज़ुक
कल्याण: कृपा, समृद्धि, प्रावधान
मछली-पकड़ना: 
चुराना: चोरी, लूटना, डकैती, कड़ी-चोट
ओंठ: चोंच, मौखिक, कगार
रिटायर: निवृत्ति, सेवानिवृत्त, रिटायर, पीछे-हटना, शेष, अवकाश, निकालना, त्यागपत्र-देना
खिंचाव: सीधा-करना, विस्तार, प्रणाली, विशेषता, टुकड़ा, मार्ग, टुकड़ा, टुकड़ा
गेलरी: संग्रह
समानांतर: साथ, संगत, साथी, प्रत्यय
atelic-पहलू: 
महाद्वीप: महाद्वीपीय
निषेधात्मक-मनोदशा: निषेधात्मक-मनोदशा
टाई: नेकटाई, ईगल
सेल: सार, नाभिक, पिंजरा, संस्करण, मोबाइल, सेल-फोन, सेल-फोन
अंडा: अंडा
कृत्रिम: कृत्रिम
इस-बीच: एक-साथ
संकट: मंदी, निर्णय, निर्णय, आपातकालीन
सभ्य: शिष्टाचार, शिक्षित
लंच: नाश्ता, डिनर
देवदार: जबड़ा
धक्का-दें: निचोड़, ड्राइव, प्रोत्साहित-करना, को-बढ़ावा-देने के, जोर, दबाव
गठबंधन: संघ, संघ, गठबंधन, गठबंधन, साझेदारी
कमर: नितंब, जिंदगी, जीवित, बीच, मध्य, मध्य
चमत्कार: आश्चर्य-है
नाविक: 
पवित्रता: शुद्धता
गणतंत्र: जनतंत्र
टेलीफोन: फ़ोन, मोबाइल
कोड़ा: 
कमीज: टीशर्ट
परिचय-कराना: परिचय, प्रदर्शन, स्थापित-करना, आरंभ, प्रस्तुत-करना, प्रावधान, की-सिफारिश, रेफरल, इंजेक्षन, उद्धार, वितरण, शब्दों-में-वर्णन करना, चित्रित
सोफ़ा: बंहदार-कुरसी
घुमाव: पोंछ, जेली, स्कैन
चोर: मालिक
बनाए-रखने-के: की-रक्षा, रिज़र्व, आरक्षण, बहाल, रखना, नियंत्रित-करना, रोकना, झेलने, संलग्न, परिरक्षण, बनाए-रखना, संरक्षण, रखना, पालन
चैनल: नहर
व्यक्तित्व: चरित्र
सुधार: सुधार, सुधार, विकास, संशोधन-करना
धमकी: धमकी, धमकाना, ख़तरनाक, भयावह
हथेली: मेपल
वक्ता: के-प्रवक्ता
डेवढ़ी: बैरियर
प्रेरित-करना: लॉबी, आग्रह-करता-हूं, कारण, चेतावनी-देना, उत्तेजित, ढोंग, नेतृत्व, लुभाना, पुकारना
भाला: अतिरिक्त
स्वच्छ: साफ, साफ, तना-हुआ
अधिवेशन: बैठक, सम्मेलन
यंत्रणा: पीड़ा
नम: गंदगी, गीला, बढनेवाला, उमसदार
चोटी: चोटी, चोटी, ढेर, कंघी
यात्री: आगंतुक, यात्री, पर्यटक, यात्री
चक्की: कारखाना, विनिर्माण, पौधा
नक्शा: कार्ड, आरेख, ग्राफ, किराया, टिकट
कॉलर: चारों-ओर
की-जगह: प्रतिस्थापन, विस्थापित-करना, अतिरिक्त, विकल्प, विकल्प, प्रतिस्थापन, विस्थापन, बदलना, भिन्न-हो, संशोधन-करना, उप
जान-बूझकर: जान-बूझकर, जानबूझकर, अवगत, सचेत, एकाग्र
बीयर: पिंट
मख़मली: 
गंभीरता: आकर्षण, क्रश
उपदेश: प्रचारित-करना
गाली: गलत, गलत-तरीके-से
झुण्ड: समूह, झुंड, जत्था, झुंड
तेरह: 
औचित्य-साबित: वारंट, निवेदन-करना, वकील, औचित्य, न्यायसंगत
शुक्रवार: चांदी, शुक्र
ब्रश: कंघी
डाउनलोड: 
क्रीम: आइसक्रीम
चट्टान: चट्टान, कगार
जूरी: 
राक्षस: विशाल, राक्षसी
जमे-हुए: फ्रीज
पॉट: कड़ाही, जार, पात्र
पैसे: प्रतिशत
जोर: जोर, जोर, जोर, रेखांकित-करना, ज़ोर-देना, दृढ़-रहना, आग्रह, आवश्यकता, लोगों-का-तर्क
सेब: 
पर-चर्चा: विचार-विमर्श, बातचीत, लोगों-का-तर्क
पृष्ठभूमि: 
टाइप-करना: अनुकूलन, फिर-से-लिखना
सामयिक: नियमित, चक्रीय
मनोरंजन: मनोरंजन, मनोरंजन, अवकाश, मनोरंजक, का-मनोरंजन, मज़ा, शौक
वाइरस: 
बचकाना: सोप्रानो
प्रतिबिंबित: चिंतन, ध्यान, ध्यान-करें, उदाहरण-देकर-स्पष्ट करना, शब्दों-में-वर्णन करना
बदलना: बदलना, परिवर्तन, स्विच, परिवर्तन
रूपरेखा: प्रोफ़ाइल, समोच्च, सारांश, स्केच, पर्दाफाश, अवलोकन, मसौदा
ओपेरा: 
अनुमोदन: अनुमोदन, अनुमोदन, सहमति, स्वीकार, अभिकथन, को-मंजूरी, समर्थन, अंगीकरण, वाहवाही
प्रकट-करना: पता-चलता-है, धोखा-देना, निराश
सज़ा-देना: मिद्धदोष-अपराधी
कोहनी: ब्रैकेट
आसक्ति: परिशिष्ट, संबंध, पैच, लिंक, योजक
मरम्मत: मरम्मत, सुधार, फिर-से-बनाना, सुधार
संदेहजनक: संदेह, संदिग्ध
सत्तर: 
इंजील: बाइबिल, लिपि
गड्ढा: छेद, उत्खनन, पूल
विकार: अराजकता, अराजकता, अशांति, अशांति, गंदगी, परेशान, हस्तक्षेप, शर्मिंदगी
बाइनरी: dyadic
ऐबी: मठ
तीर: 
करते-हैं: उत्तरदायी, आमतौर-पर, सामान्य-रूप-से, आम-तौर-पर
विस्तृत: विस्तृत, परिभाषित, स्पष्ट-करना, विकसित-करना, जटिल, मुश्किल, व्यायाम
निष्ठा: भक्त, निष्ठावान, भरोसा, ईमानदारी, ईमानदारी-से, शक, साख, श्रद्धा, आस्था
सिक्का: मुद्रा
सिहरना: कंपकंपी
निर्वासन: गोली-मार, विदेश-में
मशीनी: मशीनरी, मैकेनिक, इंजीनियर
फंदा: पकड़, मिद्धदोष-अपराधी
केक: पाई, कुकी, लोई
महोदय: श्री, श्रीमान, भगवान, सज्जन
संकोच: दस्तक, अड्डा, आवृत्ति, मंडराना
सत्रह: 
मधु: 
दाँव: शर्त, अनुपात, कील, ढेर, शेयर, अंश, योगदान
चाल: चाल, चाल, चलना, घूमना, पेडल, कदम, प्रगति, छड़
ईंट: टाइल
अस्सी: 
दुर्भाग्य-से: बदकिस्मत, बदकिस्मत, अफसोस-की-बात है
परामर्श-करना: परामर्श, का-उल्लेख
किंवदंती: कल्पित-कथा
फ़सल: फ़सल
पदोन्नति: ऊपर-उठाना, को-बढ़ावा-देने के, परिचय, प्रदर्शन, प्रचार
स्टोव: कुकर, पत्थर-की-पटिया, ओवन
विद्रोही: विद्रोह, विद्रोह
पुराने-ढंग-का: प्राचीन
महातरंग: फुलाना, सूजा-हुआ, मुद्रास्फीति, सूजन, विस्तार-करना
दलदल: दलदल
ड्रेसिंग: चटनी, पट्टी
तपस्वी: सन्यासी
प्रबंधक: प्रबंधक, प्रमुख, मालिक, प्रशासक, निदेशक, मध्यस्थ, नेता, कार्यकारी
सहगान: ड्राइव, टीम
तर्कसंगत: न्यायसंगत, तर्क, तार्किक, अकारण, समझदार, यथोचित, उचित
प्रसंस्करण: 
भेड़िया: 
गलीचा: गलीचा
प्राचीन-काल: 
उपजाऊ: 
सीटी: बांसुरी
पनीर: 
काटना: काटना, काटना, डंक
आमंत्रण: निमंत्रण
कैथेड्रल: मंदिर
बन्दरगाह: बंदरगाह
भटकना: चहलक़दमी, विस्थापित, बढ़ोतरी
फसलों: फ़सल
नौसेना: समुद्री, बेड़ा
मुखौटा: मुखौटा, कीड़ा
पेंसिल: लेखनी
सब्ज़ी: शाकाहारी
एक्ज़िबिट: प्रदर्शनी, प्रस्ताव, प्रदर्शन, प्रदर्शन, लक्षण, जोखिम
पतलून: पतलून, पैंट
दूषण: घोटाले, प्रदूषण
मंत्रिमंडल: अलमारी, कोठरी, कपड़े, शौचालय
सूप: 
सर्जन: शल्य-चिकित्सा, शल्य, आपरेशन
भत्ता: प्रतिस्थापन, विकल्प, नुकसान-भरपाई, समानाधिकरण, आवंटन, परिशिष्ट
जासूस: 
लापरवाह: लापरवाह, लापरवाह
गपशप: अफवाह, अफवाह
टोकन: 
अमूर्त: सारांश, पाठ्यक्रम
गुरूवार: 
यातायात: प्रसार, ट्रांसपोर्ट, ढुलाई
आर्किटेक्चर: 
दरार: दरार, फटा, रवाना, छोड़ना, भंग
आभूषण: सजावट, सजावटी, सजाना, आभूषण, ट्रिम
उलटा: विरोध, उलटा, स्विच, पलटना, विपरीत, उल्टा, पीछे
मन-बहलाना: का-मनोरंजन, मनोरंजक, खुश
वसूली: मरम्मत, बचाव, सुधार, पुनरुद्धार, की-वसूली, बहाल, फिर-से-बनाना
फुटपाथ: फुटपाथ, पिच, राल, कीचड़, आवरण
निर्णयात्मक: महत्वपूर्ण, महत्वपूर्ण, निर्धारित, तय, मुखर
नकारात्मक: विपरीत
त्यौहार: संगीत-कार्यक्रम
कम-हो: कमी, कमी, आराम, राहत-देने, कम-से-कम, नीचा-दिखाना, स्लेश, ट्रिम, घटाना, सीमित, रोकना
राज-द्रोह: 
शिकारी: 
साँप: साँप
बैटरी: 
मोम: मोमबत्ती
जासूसी: अन्वेषक
विश्लेषण: विश्लेषण, अनुसंधान, अध्ययन, की-जांच, निरीक्षण, अन्वेषण, संकल्प, विभाजन, विभाजन
ज़ोर: ज़ोरदार, दबाव, रेखांकित-करना, ज़ोर-देना, पर-जोर-दिया, उच्चारण, अभिकथन, ध्यान
तैरना: तैराकी
लिफ़ाफ़ा: परिस्थिति, क्रिया-विशेषण, म्यान
जो-कोई: कौन, कोई-व्यक्ति, जिसे, कोई
सिगरेट: धूम्रपान, तंबाकू
मोटर: मोटर, इंजन, प्रेरणा, मोटरसाइकिल
स्वयंसेवक: को-समर्पित, स्वैच्छिक
प्रतिक्रिया: प्रतिक्रियाशील, प्रतिक्रिया, प्रतिक्रिया, प्रतिक्रिया, प्रतिक्रिया
सामान: सामान, भाड़ा, ट्रंक, सूटकेस
बहरा: 
रस: उद्धरण
विनम्रता: सादगी, मामूली
मंत्रालय: 
यौन: लिंग, लैंगिकता
व्यास: 
कुल्हाड़ी: 
हीरा: 
वैकल्पिक: अतिरिक्त, विकल्प, विकल्प, विकल्प, डिप्टी, प्रतिस्थापन, प्रत्यारोपण
गूंज: 
संयम: नियंत्रित-करना, फुटपाथ, सीमा, सीमा, बाधा
पहचान: पहचान, पहचान, प्रतीकात्मक
स्क्रीन: प्रदर्शन, परदा
आलसी: सड़ा-हुआ
momentane-पहलू: 
सघन: समझौते, ठोस, घना
अभिप्राय: आपरेशन, नीचे-को-झुकाव, झुकाव, प्रवृत्ति
गायब: विलुप्त
रे: किरण, गलियारा, त्रिज्या
स्याही: 
बड़ा: बड़ा, बड़ा, विशाल, विशाल, भयानक, बड़े, अत्यंत
तहख़ाना: 
अविस्मरणीय: प्रसिद्ध
चमक: चमक, चमक, प्रतिभा
सिनेट: संसद
ताबूत: 
माफी: 
निगलना: घूंट
तृप्त: आगे-बढ़ाने, मुआवज़ा-देना
झूला: 
घास-का-मैदान: चरागाह, पूर्व, लॉन
जटिल: जटिल, उलझा, जटिल, यौगिक, मुश्किल
इस्तीफा: त्यागपत्र-देना, निवृत्ति
नम्र-रजिस्टर: 
साजिश: भूखंड
मिर्च: 
टट्टू: 
उम्मीदवार: आवेदक
लोमड़ी: 
चिमनी: चिमनी, ढेर
अधिकार-क्षेत्र: अधिकार, निर्णय, निर्णय, क्षमता
कृषि: खेती, कृषि
शुद्धता: शुद्धता, शुद्धता, सही, सही-ढंग-से, सत्यवादिता
भूतपूर्व-मृतक: 
डेमोक्रेटिक: 
कली: दस्ता, अंकुर
कंबल: अधिकतम-सीमा, आवरण, गलीचा, कवरेज
जय-हो: अधिकृत, नमस्कार
सूअर: बुआई-करना
आकार-का: आकृति, आकार, अंजीर, पहलू
हाथी-दांत: 
क्लासिक: क्लासिक, परंपरागत
पर्यवेक्षक: पर्यवेक्षक, आगंतुक
हाथी: 
नाखून: नाखून
मधुमक्खी: 
दफनाना: दफन, ट्वीट
अभिनेता: अभिनेत्री, अभिनेता, वादी
पसीना: 
पोलिश: बोली
माया: धोखा
अनिश्चितता: ढुलमुल, अस्पष्टता
माध्यमिक: नाबालिग, मध्यम, औसत, मध्यम, मुख्य-धारा, मध्य
तह: तह
ग्रामीण: प्रांतीय, ग्रामीण-इलाकों, ग्रामवासी
कराह: 
जैसे-लगते-हैं: समान, समानता, याद-दिलाना
उद्धरण: उद्धरण, उद्धरण, गंदें-शब्द-बोलना, देना, उधार, ऋण
थैला: बर्खास्त, पदच्युति, बैग
चिढ़: अशांति, हस्तक्षेप, व्यवधान, कष्ट, उदासी, परेशानी
सुई: इंजेक्शन, सिरिंज, लेखनी, पिन
संगृहीत: नियंत्रण
मुर्गी: मुर्गी
संगत: ज़िद्दी, संगत, ठोस, अंतर्निहित, उपयुक्त, आला, प्रासंगिक, सुसंगत, क्रमबद्ध, संतुलित, नियमित
बैरल: बाल्टी
अभ्यस्त-पहलू: 
विशेषज्ञ: विशेषज्ञ, अनुभवी, विशेष, विशिष्ट
प्रभावित-करना: प्रभावित-कर, प्रभाव, को-आकर्षित
जैतून: 
वैन: वाल्व
बाधा: बाधा, बाधा, बाधा, बैरियर, झटका
सिर-का-इशारा: 
पालक: विकसित-करना, पालक, को-बढ़ावा-देने के, की-सुविधा, चारा, पक्ष, पक्ष
परिभाषा: टीका, पहचान, विवरण, दृढ़-संकल्प
जन्मदिन: सालगिरह
हथौड़ा: 
सुगंधित: 
दुहराव: भारी, गंतव्य, दोहराना, दोहराने, रिहर्सल
तुच्छ: क्षुद्र, महत्वहीन
लात: मारा, टक्कर, फ़ुटबॉल, कैल्शियम, फ़ुटबॉल, झटका
खुदाई: खोदना, ड्रिल, उत्खनन
पालतू: 
खोपड़ी: 
विधायिका: संसद, विधायी, विधान
एड़ी: छलांग
भ्रूभंग: 
पेटेंट: 
एक-अरब: 
रासायनिक: रसायन, रसायन, रसायनज्ञ
पायलट: प्रयोग, प्रयोगात्मक
की-नकल: भेष-बदलना, सिमुलेशन, दोहराने, प्रतिलिपि-प्रस्तुत-करना
स्कर्ट: चट्टान
असामान्य-रूप-से: असामान्य, असामान्य, अजीब, असाधारण, असाधारण, अविश्वसनीय, अनियमित, अभूतपूर्व, अविश्वसनीय-रूप-से, अत्यंत, विचित्र-रूप-से
साप्ताहिक: 
तकनीकी: तकनीक, प्रौद्योगिकी, तकनीकी-रूप-से, तकनीक
वनस्पतियां: 
कौआ: कौआ
सूर्योदय: 
जीवन-काल: जिंदगी, उत्तरजीविता, जीवन-शैली, जीवित
योगदान: योगदान, दान-करना, साझेदारी, को-बढ़ावा-देने के, की-सुविधा
अंकुड़ा: संबंधित-हैं, कनेक्ट, सहसंबंधी-बनाना, ब्रैकेट
बाघ: 
घुसना: बींधना, के-माध्यम-से, प्रभावशाली
आस्तीन: बांह
हाइवे: सड़क
मिलिशिया: 
खाई: ट्रेंच, दस्ता
अखंडता: 
उन्नीस: 
कार्बनिक: 
धर्मशास्र: 
नाव: नाव, मंडराना, बेड़ा
डायन: 
ऊब: उबाऊ, उदासी
राजनयिक: राजनयिक
स्टूडियो: लेबल, कार्यशाला, अध्ययन
से-अधिक: आक्रमण, बलात्कार, पर-काबू-पाने, पार
शैंपेन: 
को-प्रेरित: प्रोत्साहित-करना, प्रेरणा, उत्साहजनक, साँस-लेना
बैनर: झंडा, पोस्टर, टिकट
तलाक: तलाकशुदा
पेंच: बिजली, नाखून, मोड़, स्क्रू
नस: नस
निष्क्रिय: दर्शक, विकलांग
झाग: बुलबुला
कंकड़: 
तहबंद: गोद
ग्रह: 
शेल्फ: रैक, अलमारी
प्रशंसक: 
उष्णकटिबंधीय: 
अवस्था: फोटो, मंच, अवधि, निर्माण, कदम
मनमाना: स्वाभाविक
उच्चारण: उच्चारण, उच्चारण, उक्ति, निरा
पारा: 
रेंगना: क्रॉल, चढ़ना, मेमना
आत्महत्या: 
रिपोर्टर: पत्रकार
वंचित: हानि, वापस-लेना, निकालना, घटाना
कुशल: कुशल, कुशल, सक्षम, प्रतिभावान, अनुभवी, योग्य, चतुर
बालकनी: छत, ओसारा
कांटा: 
कर्मचारी: मज़दूर, मज़दूर, काम-कर, फ़ैक्टर, आश्रित, क्लर्क
नियोक्ता: मालिक
चौड़ाई: मोटे-तौर-पर, सप्लाई, चौड़ा, अर्द्ध
कुपित: नाराज, उत्तेजित, जलन, भड़काना, उत्तेजना
आरोप-लगाते-हैं: आरोप-लगा-देना
पेंशन: निवृत्ति, वाक्य-विन्यास
क्रिया: अधिनियम, प्रतिक्रिया
बंदर: 
स्वीकार्य: स्वीकार-करना, स्वीकार, प्रशंसनीय
हस्ताक्षर: 
रूढ़िवादी: रूढ़िवादी
व्यंग्य: मज़ाक, मोड़
नर्सरी: पेड़-लगाना
अनिच्छा: घृणा
आयात: परिचय
मशाल: 
व्याकरण: व्याकरण-का
जमा: जमा
औपनिवेशिक: 
नौका: नौका, नाव
अहम: परिणाम, प्रकरण, जरूरी, महत्वपूर्ण, प्रमुख, प्रसिद्ध, काफी, महत्वपूर्ण, ठोस, सार्थक
गुंबद: 
मोटाई: 
हठी: मुखर
मांसपेशी: 
परिमाण: आकार, थोक, आयाम, नाप, मात्रा
रगड़: 
राड़: 
साज़: एकजुट, विलय, एकता-कायम-करना, उपयोग, बेल्ट
टोस्ट: नाश्ता
माउस: चूहा
शब्दांश: 
थपथपाना: ताली, दस्तक
संवाद: संवाद, बातचीत
तटस्थ: नपुंसक-लिंग
लगन: उत्साह, हिरासत
अंतर्विरोध: असंगत, विवाद, अस्पष्ट, भ्रामक, विवादास्पद, अस्पष्टता, विरोधाभास, खंडन, झगड़ा, आपत्ति
लक्ष्य-को-हासिल: एहसास, पहुंच, पहुंचें
बकरा: 
पनपने: समृद्धि, समृद्ध, उछाल, गहना, मणि
थोपना: बल, लागू-करना, निर्धारित
गुमनाम: 
औपचारिक-रजिस्टर: 
बछड़ा: जल्दी
गाइड: गाइड, दिशानिर्देश, ब्रांड, नेतृत्व, पाठयपुस्तक, अनुदेश, नेता, पर्यवेक्षक
पिघल: लुप्त-हो-जाना, पिघलना, विलय
मिटाना: मिटाना, भंग, रद्द-करना, हटाना, निकालना, समाप्त-करना, को-समाप्त, उन्मूलन
छाता: पैराशूट
बूट: जूता, ट्रंक
खनिज: आयोडीन, पुष्टिकर, धातु
संघर्ष-विराम: संघर्ष-विराम
बत्तख: 
आयोजन: 
साबुन: 
गुड़िया: बच्चा, खिलौना
कंकाल: 
विला: परी
सिलाई: टांका, सीना
समाधान-करना: मध्यस्थ, एकजुट, एकता-कायम-करना
केतली: 
प्रौढ़: वयस्क
खरगोश: 
कंडक्टर: सीढ़ी, अधीक्षक, ड्राइवर, नेता
निर्भरता: निर्भर, भरोसा, आश्रित, लत-लग, समानता, रवैया
खिलाड़ी: अभिनेता
कीट: कीट
भोजनालय: 
उल्लू: 
उग्र: आतंकवादी, अतिवादी, प्रगतिशील
निवासी: निवासी, जन्म-का, घरेलू, स्वदेशी
अजगर: पतंग
श्रवण-प्रत्यक्ष: 
प्यास: 
ठहराना: लंबा
गणना: गणना, गणना, कंप्यूटिंग, गणना, मानना, कारण, जनगणना
विनियमन: सेंसरशिप, नियंत्रण, बाधा, सीमा, समझौता
महापौर: 
अल्पसंख्यक: 
अर्जन: प्राप्त, लाभ, अधिग्रहण, पहुंच, उपलब्धता
दिग्गज: वरिष्ठ
ऑर्केस्ट्रा: 
बेकन: 
हानि: हानि, हानि, विपरीत, दोष, बाधा
कपड़ा: कपड़ा, कपड़ा, तौलिया, कैनवास, ऊतक
संगीतकार: संगीतकार, संगीत
मानसिक-रूप-से: आध्यात्मिक, मानसिक, हौसला, मन, व्यक्तिपरक
संयोजन: सहयोग, संबंध, यौगिक, संगति, साथी, गठबंधन, सुसंगत, साथ, निरंतरता, लिंकर
अपर्याप्त: कमी, नाकाफी, कमी, दुखी, अवर, भद्दा, प्रचुर, बदकिस्मत, बेमेल, अनुचित
वास्तुकार: 
नींबू: 
खांसी: खाँसी
सिरदर्द: 
किरायेदार: योजनाकर्ता
उपजाऊपन: प्रजनन
चंगा: इलाज, में-सुधार, बढ़ाने, सुधार, इलाज
नव्वे: 
बिना-सोचे-समझे: बेतरतीब-ढंग-से, randomize, आकस्मिक
चम्मच: बाल्टी
गुब्बारा: 
चाक: प्लास्टर
आनुमानिक-प्रत्यक्ष: 
प्रकाशक: संपादक
सिरका: 
एश: भूरा, भूरा
दुर्वचन: शपथ---ग्रहण
पुनर्जीवित: पुनरुद्धार
कोमल: चपेट-में, संवेदनशील, समझदार, भावुक, उत्तरदायी
सुरंग: भूमिगत-मार्ग
पहेली: भ्रमित, भ्रामक
तंत्र: प्रक्रिया, सामान्य, व्यवस्थित, मशीनरी
गणित: गणित, गणितीय
मुरझाना: 
जिगर: 
Sublative-मामला: 
डुबकी: डुबकी, ट्वीट, ड्रॉप, गिरना, घटना, ढाल, झुकाना, sloped, ढाल, भिगोना
इकाई: एकता, सत्ता, मॉड्यूल, चोंच, विलक्षण
एकाधिकार: अनन्य
जुआ: जुआ, खेल, मैच, निकासी, खिलौना
पनडुब्बी: पानी-के-नीचे
भूकंप: ऐंठन
प्रयोगशाला: प्रयोगशाला
काग: मशरूम, कुकुरमुत्ता, टोपी
स्वयं-नियंत्रण: 
बुद्धा: 
बुनना: बुनना, बुनना, जोर, बुना-हुआ, गांठ, नोड, चोटी
दूतावास: 
सब-से-अधिक दूर: 
कथात्मक-मनोदशा: 
प्रोत्साहन: प्रोत्साहन, प्रोत्साहन, विधि, प्रेरणा, प्रेरणा
चॉकलेट: कैंडी
संयोग: संयोग, संयोग, बदकिस्मत, बेतरतीब-ढंग-से, आकस्मिक, मैच
दस्ताना: 
घुटना-टेकना: 
भूगोल: 
निवेश: निवेश, उद्यम
मौखिक: मौखिक, मौखिक, अपमान
समानता: समानता, समानता, समानता, समानता, अनुपात
धर्म-निरपेक्ष: रखना
बाज़: ईगल
मनोविज्ञान: 
जकड़ना: संबंधित-हैं, बाँध, कनेक्ट, पट्टी, गिरफ्तार, जोड़ना
स्क्रैप: रद्द-करना, बकवास, कचरा, टुकड़ा
भूमिका: चरखी, शेयर, स्टॉक, प्रतिभागी
ख़ुराक: मात्रा
सैल्मन: 
पुडिंग: 
चुंबकीय: आकर्षक
पंप: बम
ऑक्सीजन: 
प्रमाणपत्र: 
पदक: 
वक्रपटुता: 
परिमार्जन: खरोंच, नोच
डांड़: बेलचा, पंख
दूरबीन: माइक्रोस्कोप
हार: हार, पेस्ट
वर्तनी: जादू
व्हिस्की: 
विलो: चरागाह
ऊंट: 
शौकिया: 
बाहर-जाएं: निर्यात, आउटलेट, उद्भव, उत्पादन
जीवनी: 
गधा: 
मासिक: 
उपेक्षा: उपेक्षा, अनदेखी, बर्खास्त, अज्ञान
छुट्टी: छुट्टी, छुट्टी, मनोरंजन, शेष
क्लिक-करें: गिरोह, तस्वीर
अंडाकार: 
लोचदार: रबर, लचीला
शब्दकोश: शब्द-भांडार-का, शब्दावली
जांघ: जांघ, चूतड़
इंद्रधनुष: 
उपभोग-करना: सेवन, उपयोग, तैनात
थूक: दोस्त, जीभ
टैंक: जलाशय, पात्र, टब
सहयोगी: सहयोगी, साथी, दोस्त, साथी
तितली: 
चार्ट: आरेख, ग्राफ, ग्राफिक, ग्राफिक्स, अनुसूची, योजना
जुड़वां: दोगुना, दोहरी
स्वतंत्र-रूप-से: स्वतंत्र, आज़ादी-से, अलग
बांस: 
विक्रेता: फुटकर-विक्रेता, विक्रेता, विक्रेता, सौदागर
संचय: जमा, संग्रह, एकाग्रता
इंस्पेक्टर: लेखा-परीक्षक, अधीक्षक
निवाला: टुकड़ा, टुकड़ा, बिट
बुरा-सपना: ख्वाब
जाम: जेली
संग्रहालय: 
वर्णमाला: वर्णमाला-सम्बन्धी
बिखराव: तैनात, विस्तार
छापा: कब्जे, आक्रमण, हमला, अपमानजनक, शुरुआत, प्रमुख, निर्वासित-करना
खुलासा: घोषणा, पता-चलता-है, खोज, पर्दाफाश, पूर्ववत, प्रकाशित-करना, खोज
सड़ांध: क्षय, बिगड़ना
आक्रामक: परेशान, गंदगी, कब्जे, आक्रमण, अपमानजनक, मुखर
टकराव: 
घाट: 
मकड़ी: 
आलू: 
संशोधन: समायोजित, संशोधन, संशोधन, सुधार, संशोधन-करना, समीक्षा, आडिट
लालच: लालची
असामयिक: जल्दी, टक्कर
गुणा-करना: मारा, नस्ल, टक्कर
स्पिन: घुमाना, रोटेशन, घुमावदार, धागा, मोड़
सांख्यिकी: सांख्यिकीय, आकृति, बातचीत
कैलेंडर: अनुसूची, समय-सारणी, डायरी, राय
नामांकन: मनोनीत, नियुक्ति, चयन, सगाई
ट्रिलियन: 
अटारी: हवा
सकारात्मक-मनोदशा: 
आवेदन: 
नाममात्र: 
असंतोष: 
संक्रमण: संक्रमित, संक्रमित, संक्रमण, हस्तांतरण, संक्रामक
मटकी: जार
कंधे-उचकाने-की क्रिया: चिकोटी
अगुआ: प्रमुख, हरावल
चूक: चूक, चूक, कमी, लापरवाही, उपेक्षा, उन्मूलन
गोभी: 
पुष्ट: व्यायाम, गणितीय, एथलीट
मादकता: चीनी
idiophone: 
उत्तोलक: जिज्ञासा
सीनेटर: 
आँख-की-पुतली: 
चींटी: 
बग: 
गर्भवती: माता-संबंधी
वेग: तेज़ी, तलछट, वेग, अति-आवश्यक, में-तेजी-लाने
टखने: 
वर्गीकरण: तरह, वर्गीकृत, वर्गीकारक
परिवर्तनशील: भिन्न-हो
कपड़े-में-लपेटकर: पैक, पार्सल, पोटली, पैकेज, अटेरन, रैपिंग, आवरण, को-कवर
घुंघराले: कर्ल, उछालना, कुंडल, पुस्तक, कुंडलित-वक्रता
गंधक: गंधक, टूटा
हुक्म: 
उभरना: दिखाई, दिखावट, उठता, उद्भव, छोड़ना
मेढक: 
अत्यधिक-मामला: 
स्पंज: कुकुरमुत्ता, मशरूम
कष्टप्रद: परेशान, परेशान, परेशानी, गड़बड़, झुंझुला-देना, उबाऊ, दुराराध्य, परेशान
गिलहरी: 
पीसना: आधा, अर्द्ध
irrealis-मनोदशा: 
ज्वालामुखी: 
घर-के-अंदर: इनडोर, अंदर, अंदर, घर
शोषण: उपयोग, अवशोषित, उपलब्धि, का-पता-लगाने
भूवैज्ञानिक: 
पासपोर्ट: 
अनैतिक: शातिर, सड़ा-हुआ
बिस्कुट: कुकी
सहयोग: सहयोग, साझेदारी, एकीकरण, सहायता
गोली: गोली, गोली, पत्थर-की-पटिया
विश्राम: सुस्त, आराम, अवकाश, आराम-करें, आराम, मनोरंजन
परमाणु: परमाणु, कण, व्यक्ति
एड्स: सहायता, राहत, सहायक
पिरामिड: 
चक्र: वृत्त, प्रसार, आवृत्ति, रोटेशन, घुमाना, साइकिल, बाइक
झपकी: 
ग़ैरक़ानूनी: अवैध
पंजा: पंजा, पैर-की-अंगुली
शर्म: शर्मीला, संकुचन
ग्रहण: अस्पष्ट
वीणा: तिरछा
झाड़ू: 
पैनल: प्लेट, पत्थर-की-पटिया, चित्र, बोर्ड, समूह, समिति
खगोल: 
भूल-भुलैया: 
छात्रवृत्ति: प्रायोजन
कछुआ: 
सलाहकार: संरक्षक, सलाह-देना
रेशा: रेशा, बंडल
क्रिकेट: 
कबूतर: 
अनुकूलन: अनुकूलन, स्थिरता, अनुपालन, परिवर्तन, समायोजित
त्रिकोण: 
कोषाध्यक्ष: 
हाइड्रोजन: 
नाज़ुक: नाज़ुक, कुरकुरा
मुद्रक: 
गला-घोंटना: 
जीर्ण: प्रतिरोधी
सामना: सामना, अनुकूलन, सामना-करना, ओफ़्सेट, पर-काबू-पाने, पकड़ना, परस्पर-विरोधी, संभालना
दुविधा: 
इंजीनियरिंग: तकनीक, तकनीकी-रूप-से
कैमरा: कक्ष
माफी-माँगता-हूँ: क्षमायाचना, क्षमा
चाटना: 
नर्तकी: 
प्रवास: विस्थापित, आप्रवासन
टेनिस: 
रीढ़-की-हड्डी: 
तलना: 
करघा: बंद, समापन
आवेश: डंक, बींधना, हथियाना, प्रयास, का-प्रयास
पासवर्ड: संकेत, संकेत, नारा
गोलार्द्ध: नुकीला, टिप
रणनीति: सामरिक
क्वार्ट्ज: 
कैंची: खींचें, खींचना
पहरा: 
हिमनद: 
आधे-रास्ते: आधा, आंशिक-रूप-में, अर्द्ध, बीच, मध्य
ज्ञापन: संधि, अनुबंध, सम्मेलन, समझौते, वारंट
शंकु: पतला
समरूपता: 
उत्पादक: उत्पादक, उत्पादक, रचनात्मक
प्रतिवादी: वकील
मस्जिद: 
शतरंज: 
टोल: चार्ज, शुल्क, शिकार, आकृति, उलझन
चेरी: 
बड़े-पैमाने-पर: व्यापक, व्यापक-रूप-से, विस्तार, चौड़ा, व्यापक
ठोकर: गिरना
ट्रक: लॉरी, भाड़ा, लादनेवाला-जहाज़
सरसों: 
प्रतिशत: प्रति--प्रतिशत, प्रतिशत
नीलाम: बिक्री
चलनी: 
अस्थिर: अस्थिर, अस्थिरता, ढुलमुल, बेचैन
चुंबक: 
चूसना: अवशोषित, भिगोना
इसलाम: 
छिपकर-जाना: पैर-की-अंगुली, तैयार, तैयार
झिल्ली: 
हजामत: 
गिटार: 
चमकदार: उज्ज्वल, सुबह, प्रतिभाशाली
एल्म: 
ऊंची-उड़ान-भरना: बढ़ोतरी, मंडराना, गला, उड़ान
सर्वनाम-निशान: 
प्रधान: क्लिप, ब्रैकेट, आवश्यक, मौलिक, बुनियादी, मुख्य, प्रमुख, परम, मुख्य
मसाला: दिलचस्पी
जमानत: बंधन, बीमा, प्रतिज्ञा, गारंटी
वाहक: वेक्टर, वादी, कुली
कंपन: गूंज
चिढ़ाना: लुभाना, झुंझुला-देना, जलन, रिझाना
हल: हल, कुदाल, डाका-डालना
शारीरिक: शारीरिक
नाली: नाली
धूमकेतु: अपराधी
मध्यकालीन: मध्य
गौरैया: 
क्षतिपूर्ति: पुरस्कार-देना, नुकसान-भरपाई, ओफ़्सेट, के-एवज-में, मेकअप, मेकअप
प्लास्टिक: 
फुटनोट: 
कक्षा: कक्षा, कक्षा, प्रक्षेपवक्र
मितव्ययी: मामूली
गोल्फ़: 
शून्य: शून्य
टुकड़ा: टुकड़ा, टुकड़ा, टुकड़ा, टुकड़ा
अत्याचार-करना: दबाना, रोकना, दबाना, डूब
जंभाई: लुप्त-हो-जाना
असमानता: 
तिल: तिल, मिट्टी
मिट्टी-के-बर्तनों: 
गृहिणी: 
राई: 
आज्ञा-का-उल्लंघन करना: का-उल्लंघन
सहिष्णु: सहनशीलता
भ्रूण: टायर, टायर, भ्रूण, भ्रूण, नाभिक
खान-में-काम करनेवाला: नाबालिग
सराहना: सराहना, वाहवाही, ताली
ख़मीर: एंजाइम, लोई
प्रीमियम: बोनस, इनाम, पुरस्कार
बेर: 
दिवालियापन: असफलता
सिंचाई: 
पुदीना: कैंडी
पूंजीवादी: पूंजीवाद
लोच: लचीलापन
शार्क: 
रंगरूट: चाल, नौसिखिया
भंडारण: की-रक्षा, संरक्षण, दुकान, बचत
यथार्थवाद: 
अदरक: 
एम्बुलेंस: 
तुलनीय: आनुपातिक, समान
बटुआ: पोर्टफोलियो
मुंह-बनाना: मग, मुसकान, wriggle
वैज्ञानिक: वैज्ञानिक, छात्र, शोधकर्ता, अन्वेषक
आंत: आंत, आंतें
समभाव: 
रेडियो: रेडियम
असंगत: असंगत, अनुचित, बेमेल, महत्वहीन
सेम: अखरोट, मटर, मूंगफली, अनाज
अनौपचारिक: 
पोती: पोता, पोता, भांजी, वंशज
बहस: आपत्ति, बहस, विवाद, असहमत
स्टेक: काटना
नाइट्रोजन: 
उस्तरा: 
विषम: विरोध, परस्पर-विरोधी, असंगत, विरोधी, विरोध
प्रचार: प्रचार, प्रचार, विज्ञापन, विज्ञापन, विज्ञापित
आतिशबाजी: 
पॉप: तस्वीर, धमाके
घर-का-कपड़ा: 
कुंड: 
हानिकारक: बुराई, ख़तरनाक, विपरीत
जूदाईस्म: 
पूरक-हैं: पूरक, लैस, इसके-अलावा
लेंस: मसूर, टॉर्च
pegative-मामला: 
कैंसर: 
प्यादा: बंधक, सैनिक, प्रतिज्ञा
व्याख्याता: 
रिसाव: शलाका, हानि, ड्रॉप
अर्हता: योग्य, योग्यता, लायक, योग्य, योग्यता
घनत्व: भीड़, तीव्रता
अधिष्ठापन: 
जुगल: 
बातूनी: मिलनसार
झींगा-मछली: 
छूट: छूट, बिक्री, रियायत
टैक्सी: 
पदक्रम: नेतृत्व, व्यवस्था
जेड: 
गिरह: 
छिपकली: 
झरना: 
निराशाजनक: निराशाजनक, निराशा, निराश, निराश, बुरा
वीटो: मना, निशान, अस्वीकार, बर्खास्त, अस्वीकृति, शर्त, संकर्षण
राष्ट्रपति-पद: अध्यक्षीय
क्रेता: ग्राहक
गैलन: 
मच्छर: 
विचलन: नीचे-को-झुकाव, विरूपण, ओफ़्सेट
कुश्ती: प्रतिस्पर्धा
मौज़ेक: 
प्लग: योजक, वाउचर
फूहड़: झुकना
किराना: 
साम्यवादी: 
विस्मित-करना: आश्चर्य-की-बात, अद्भुत, तेजस्वी, गुमराह, भ्रमित, अचेत-करना, उलझाना
prosecutive-मामला: 
नक्षत्र: आकाशगंगा
तानाशाह: 
अति-व्यस्तता: रोज़गार, चिंता, चिंता, चिंता
उपग्रह: 
चप्पल: चप्पल
व्यंजन: 
अनुमानित: सन्निकटन, लगभग, समीपवर्ती
बेरोज़गार: रोज़गार
समर्थक: सहायक, सहायक, सहना, ब्रैकेट
कमल: 
सलाद: सलाद, पालक
क्लोराइड: 
जीवाणु: कुकुरमुत्ता, बैक्टीरियल
चिपचिपा: चिपचिपा
अंग: 
गुठली: 
बहाना-करना: नाटक, भेष-बदलना
बाइट: 
स्राव: छिपाना
स्पष्ट-रूप-से: स्पष्ट-रूप-से, खुले-तौर-पर, जाहिरा, जाहिर-है, निश्चित-रूप-से
मेल-खाना: मैच, उपयुक्त, अनुकूल, समझौते, मिलान
बैले: पंख
मूत्र: पेशाब
लहसुन: 
गुजर-चुके: अतीत, मृत्यु
अर्थशास्त्र: अर्थव्यवस्था, मंदी, बचत
मध्यम-वर्ग: 
चुस्त: उपवास, शीघ्र, तीव्र, शीघ्र
चिमटा: बेलचा, क्लिप
लॉन्ड्री: धुलाई
स्ट्रॉबेरी: 
शहरी: नागरिक
असमंजस-में-डालना: हतोत्साहित, बाधा, शर्मनाक, उलझाना, भ्रमित
नोटबुक: 
एल्बम: 
बेसबॉल: 
सूंघना: 
बुफ़े: 
कृदंत: प्रतिभागी, शामिल-होनेवाला
गेराज: 
निदान: नैदानिक, का-निदान, संज्ञानात्मक, पहचानना
बैसाखी: 
धमकी-देकर-मांगना: भयादोहन, साहस, विवश-करना
पंजीकरण: अभिलेख, रजिस्टर, रिकॉर्डिंग, लॉग-इन-करें
घुलनशील: भंग
फास्फोरस: 
संरचनात्मक: संरचना, विन्यास, कॉन्फिग
गोंद: 
थीसिस: निबंध
शिल्पी: मैकेनिक
केला: 
स्वयंसिद्ध: प्रमेय, फ्रैंक, स्पष्ट, ज़ाहिर, मुखर, सिद्धांत
पसली: गियर
निकल: कोई-नहीं
गड़बड़ी: नमस्ते, पाई, सिलिकॉन
बस: चलो
सेंसर: सेंसरशिप
मिसाइल: राकेट
सॉस: हॉट---डॉग
जोड़-तोड़: संचालित, हेरफेर, परिचालन, चाल, धोखा, संभालना
टमाटर: 
को-मजबूत: समेकित, तेज, इस-बात-की पुष्टि
सॉकेट: वापसी, आउटलेट, योजक, घोंसला
पोटैशियम: 
पुनः-प्राप्त: लाना, की-वसूली, बहाल, मरम्मत
वास्तविक: वास्तविक, वास्तविक, वास्तविक
बीजगणित: 
दंत-चिकित्सक: दांत
ऑप्टिकल: दृश्य
हिलना: रियायत, मुलायम, चाल, चलती, विस्थापित-करना
जीवविज्ञान: 
बेरोजगारी: 
कमला: 
एकल: अलग, अभूतपूर्व, अलग, धरती, अकेला
ब्राउज़र: 
दूरस्थ-अतीत-काल: 
ऐतिहासिक-काल: 
नाभिकीय: नाभिक, परमाणु
स्पेक्ट्रम: 
सोडियम: 
हिस्टीरिया: 
ट्रस्टी: प्रशासक
बंधक: बंधक, प्रतिज्ञा
लौकी: कद्दू, मज्जा
शिकन: दोष
पारदर्शिता: पारदर्शक, मुखर, सरल
कील: कील, फीता, टिप, नाखून
प्राथमिकता: ध्यान
पैदल-यात्री: घूमना
नास्तिकता: 
मॉनिटर: ट्रैक, की-निगरानी, घड़ी, आगे-बढ़ाने
चुनाव-क्षेत्र: मतदाता, मतदाताओं
अनियंत्रित: 
जांच: जांच, जांच, जांच, जांच, जांच, अन्वेषण, परीक्षण
प्लैटिनम: 
दोहरी-संख्या: 
फेफड़ा: 
सुपर: अभूतपूर्व, अत्यंत, अविश्वसनीय-रूप-से
ट्राली: गाड़ी, गाड़ी, गाड़ी
स्थानीय-स्तर-पर: स्थानीय
उत्तेजित-करना: उत्तेजित, झुंझुला-देना
पेट्रोल: पेट्रोल
गुर्दे: 
लूटमार: डकैती, लूटपाट, शिकार, लूट, लूटना, ढोना
मूल्यांकन: आकलन, आकलन, मूल्यांकन-करना, ग्रेड
संखिया: 
घोंघा: कुंडलित-वक्रता
टिड्डी: 
समीकरण: सूत्र, समानता
समाजवादी: समानता
फिल्टर: 
ग्रहणशील-प्रत्यक्ष-मनोदशा: 
चौड़ा: विस्तार, चौड़ा, जोड़ना, उठाना, बढ़ाने, विस्तार, मोटे-तौर-पर, संकल्प, विस्तार, विस्तार
फेंकना: लांच, फेंकना, बाष्पीभवन, गोली-मार, चलो
पट्टा: पट्टा, पट्टा
अकर्मण्य: 
जॉकी: 
निमोनिया: 
एकजुटता: एकजुट, रैली, समानता, एकता, समानता
काज: विस्तृत, पाश
अनुदैर्ध्य: खड़ा
लाभांश: आवंटन
स्केट: स्की
प्रतिपादक: सूची, घातीय
विकलांगता: बाधा, असमर्थता, दोष, अपूर्ण, विकलांग, दोष, धब्बा
जुनून: परेशान
आवंटन: आवंटन, आवंटित, प्रावधान, कोटा, काम
फोटोग्राफर: फोटो
डेल्टा: भाग-लेना
डिजिटल: आकृति, अंक, संख्यात्मक
कुतिया: 
पपोटा: 
विकर्ण: 
अचेतन: 
भौं: 
छींक: 
उल्लसित: हंसमुख, मज़ा, मगन, मजेदार, मनोरंजक, मनोरंजक, खुश, विनोदपूर्ण, हास्यास्पद
हिन्दू-धर्म: 
शरणार्थी: आप्रवासी
शटल: अंतरिक्ष-यान, गाड़ी, ट्रांसपोर्ट, ढुलाई
प्रोटीन: अंडे-सा-सफेद हिस्सा
ढेर: ढेर, ढेर, निर्वासित-करना, बकवास, कचरा
निखारने: 
वमन: 
जीन: आनुवंशिक-रूप-से, आनुवंशिक
नए: 
समाजशास्त्र: 
स्क्वाश: कद्दू, क्रश
मछुआ: 
क्षेत्रीय: काउंटी, क्षेत्र, क्षेत्र, परवरिश, क्षेत्र, क्षेत्र, परिधीय
प्रस्ताव-ऊपर-की ओर: 
पूर्वप्रभावी: अतीत, आत्मनिरीक्षण
बवंडर: 
पलटना: पलटना, विरोध, पारस्परिक, उलटा
टीवी: टेलीविजन, फ़िल्म
घनक्षेत्र: 
उत्पादकता: प्रदर्शन, उत्पादन
गाजर: 
आणविक: अणु, सब्सट्रेट
समूह: गिरोह, समूह, समूह
मुनीम: लेखा-परीक्षक
खीरा: विकल्प, गला
नंगा-नाच: 
विलायक: भंग
फॉस्फेट: 
भजन-की-पुस्तक: चारा, परिचित, परिचय
क्षारीय: 
कसरत: फिटनेस
अल्पविराम: अचेतन-अवस्था, पार्टी
प्रस्ताव-उतार: 
गर्भपात: गर्भपात, कम, असफलता
फली: खोल, म्यान, छाल
दाता: 
मैंगनीज: 
मनोविज्ञानी: 
क्लोरीन: 
कीबोर्ड: 
अभिजात-वर्ग: 
कोष्टक: 
रग्बी: 
व्रण: पीड़ादायक, घाव, आघात, फोड़ा
विभक्ति: 
कुतरना: 
मात्रा: मात्रा, मात्रा, कोटा, अनुपात
स्वेटर: जैकेट
विकासवादी: विकासात्मक, विकास
नोटेशन: संकेत, प्रतीक, ध्यान-दें
उछाल: उछाल, छलांग
विच्छेदन: आवंटित, अनुभाग
कैश: 
रैखिक: सरल
सुरमा: 
superessive-मामला: 
फोडा: फोडा, थोक, टक्कर
कटाव: 
अल्फा: 
नाभि: पेट, खंभा
प्रतिरक्षा: साँस-लेने-का, प्रतिरोधी
इंफ्लुएंजा: फ़्लू, बढनेवाला, बुखार, प्रभाव
शराब-की-भठ्ठी: 
आसान-बनाने-में: 
संक्षेप-करना: सीमा, सीमित, रोकना
काटने-का-निशान: गांठ, टक्कर, दांत
बंदी-बनाना: कब्जा, रिझाना
मजबूर-करना: विवश-करना, बल, लागू-करना, प्रवर्तन
मौज़ा: 
चलचित्र: फ़िल्म, सिनेमा, रिबन, टेप, पट्टी
कास्मोस-\-ब्रह्मांड: जगत
नापाक-किया-हुआ: प्रदूषण, संक्रमित
झुण्ड-में-रहनेवाला: 
लिंग: लिंग
वानिकी: 
अल्युमीनियम: अल्युमीनियम
कंपन: अस्थिरता
कुंडली: 
बेदखल-करना: जेट, निष्कासित, बाहर-निकालना, निर्वासित-करना, छिपाना, विस्थापित-करना, घटाना
समावेश: रिकॉर्डिंग, एकीकरण, ट्वीट, आवरण, शामिल, को-कवर, निहितार्थ, शामिल, भागीदारी
लाभार्थी: निर्भर, उपयोगकर्ता
डॉल्फिन: 
हत्यारा: 
स्तनपायी: 
सूचक: आसन, सूची, मानदंड, तर्जनी, नाप
डाइऑक्साइड: 
पेट-के: 
नौकरशाही: नौकरशाही
बिगाड़ना: गुमराह, हाथापाई, विरूपण
फ्रिज: फ्रिज
पुरातात्विक: पुरातत्त्व, पुरातत्त्व, जीवाश्म
अस्वीकार्य: अनुमोदन
विनिर्देश: आदर्श, मानकीकरण-करना
पत्रक: बुलेटिन, थिसिस, चादर
नृविज्ञान: 
स्वादिष्ट: स्वादिष्ट
सकर्मक: बहाना, संक्रमण
cower: क्रॉल
सूरजमुखी: 
जूं: टिकटिक, बिट
आयन: 
पर्यटन: पर्यटक, यात्रा
मोडम: 
त्वरण: को-बढ़ावा-देने के, की-सुविधा, उत्तेजना
मिथ्या-सिद्ध-करना: उलझाना, बनाना
उत्सर्जन: गंदा, मुद्दा
अपहरण-करना: डाका-डालना, प्रवाहकत्त्व, छीनना
ओवरलैप: बातचीत, इंटरैक्टिव
नाई: 
लोक-साहित्य: गेहूँ
केशिका: 
राष्ट्रवाद: राष्ट्रीयता
नितंबों: नितंब, चूतड़
मूल-भाव: विषय, विषय, प्रेरणा, इस-आधार
उदात्तीकरण-करना: 
निराशा: झटका, निराशा, निराशा, परेशान, रद्द-करना
कोबाल्ट: 
जई: 
प्रस्ताव-upriver: 
गुदा: 
मंद: 
फ्लिप: अनुवाद-करना, अनुवाद-करना
फालतूपन: बहुत-सारे, अवशिष्ट, अतिरिक्त, बर्खास्त, पदच्युति, छूट
वीडियो: 
बहिष्कार: काउंटी, बहिष्कृत, उपेक्षा
प्रश्नोत्तरी: प्रयास, परीक्षा, प्रश्नावली
हॉकी: 
गुरिल्ला: 
मैग्नीशियम: 
राडार: 
चिंपांज़ी: 
विश्वसनीयता: साख
आयत: 
सिवार: 
सामान्यीकरण: सामान्यकरण
निषेधाज्ञा: 
समलैंगिक: 
परिदृश्य: लिपि, परिदृश्य
सूत्रीकरण: निर्माण, निर्माण, रचनात्मक, शब्दों, सृजन, गठन, तैयार
पुनर्जन्म: 
आग-लगना: 
यूरेनियम: 
पकड़ने-वाला: रिसेप्टर
समन्वय-स्थापित: समन्वय
करदाता: 
एकीकृत: अविभाज्य
राय: राय, राय, टिप्पणी
गामा: 
सफारी: सवारी, जलयात्रा, यात्रा, यात्रा
प्रस्ताव-downriver: 
गुणक: ग्रेड, फ़ैक्टर
शीर्षक: शीर्षक, विषय
विश्लेषक: विश्लेषण
मात: 
मॉल: सुपरमार्केट
विस्मुट: 
पोस्टकार्ड: शुभकामना
अभिसरण: सन्निकटन, मिलना
पीछे-हटना: पीछे-हटना, रवाना
हिस्सेदार: साथी
सूक्ष्म-जीव: 
जनन: 
रूपात्मक: आनुवंशिक, आकृति-विज्ञान
बीटा: 
जीन्स: 
डेटाबेस: 
कैलकुलेटर: कंप्यूटिंग
एक्स-रे: 
पार्स: 
पर्यावरण: परिदृश्य, परिवेश, वातावरण, प्रसंग, पारिस्थितिक, आस---पड़ोस, आस---पड़ोस, समोच्च
सिग्मा: 
अलगाव: अलगाव, पृथक्करण, विभाजन, विभाजन
कार्यसूची: कार्यक्रम, कार्यक्रम, पाठ्यक्रम
वीसा: 
बुनियादी-ढांचे: 
जुगनू: 
डिटेक्टर: 
अनुकूली: 
जीवविज्ञानी: 
ब्याह: प्रत्यय, संशोधन-करना, जोड़ना, कनेक्ट
ब्रोमिन: 
दुर्ग: 
हिचकी: 
पस्टेल: पीला
चिड़ियाघर: 
क्लिनिक: 
अर्थ: निहितार्थ, अर्थ, अर्थ, धारणा, संकल्पना, समझ, प्रसंग
योग: योग
किताबों-की-दुकान: किताबों-की-अलमारी
चिकित्सा: इलाज, इलाज, इलाज, उपाय, चिकित्सक
राष्ट्रवादी: जातीय
सिर-काट-लेना: 
हाँ: हाँ
समस्यात्मक: मुद्दा, समस्या, उलझन
जाज: 
टंगस्टन: 
आतंकवादी: आतंकवादी, आतंक
बूँद-बूँद-कर टपकना: कीचड़
चयापचय: 
गुजारा-भत्ता: 
सप्ताह-के-अंत में: 
गुलदाउदी: 
टीका: टीका, कवरेज
मोटरसाइकिल: मोटरसाइकिल
मंत्र: 
छमाही: अवधि
हेरोइन: 
फ़ोल्डर: 
कैथोड: 
विचारधारा: विचार
पार्किंग: 
थीटा: 
अवनति: निराशा
सेलेनियम: 
साइकिल-चलाना: प्रसार, पाश, चक्रीय, साइकिल, बाइक
कोर्टेक्स: छाल, खोल, छाल
समानक: समानता
वर्तमान-प्रासंगिकता-निशान: 
हवाई-अड्डा: 
अंग-विच्छेद-करना: बाधा
बास्केटबाल: 
ढोंगी: 
तिलचट्टा: 
क्रोमियम: 
लीटर: लीटर
फिर-भी: फिर-भी, अभी-तक, तथापि, वैसे-भी
हार्मोन: 
त्रुटिपूर्ण: कमी, कमी, अपूर्ण, गलत, झूठा, कमी
छेदना: बींधना
सर्वात्मवाद: 
बहुभुज: कोण
नारीवादी: 
एकत्रित: झुकाना, लॉग-इन
यूरो: 
जिनसेंग: 
कलन-विधि: 
लेज़र: 
दवा-की-दुकान: 
मिलीमीटर: मिलीमीटर
फ्लेक्स: मोड़, वक्र, लचीला, अनुकूल, केबल
एनोड: 
अति-सूक्ष्म-अंतर: छाया
पार्ट-टाईम: 
संवेदनशीलता: 
प्रदर्शक: 
हीलियम: 
द्विभाषिक: 
संक्षिप्त: संक्षिप्त, संक्षिप्त, हटना
initialism: 
क्रियावाचक-संज्ञा: 
प्लाज्मा: 
क्रोमोसाम: 
क्रमवाचक: संगम, पंक्ति, नियमित, क्रमबद्ध
किलोमीटर: किलोमीटर
फैक्स: 
आनुवंशिकी: आनुवंशिक, आनुवंशिक-रूप-से
झाई: 
पेंचकस: रिंच
ब्रोकली: 
भूत-काल: 
विटामिन: 
कैडमियम: 
बमवर्षक: 
चित्रात्मक: 
टाइटेनियम: 
शेख़ी: डींग
लैम्ब्डा: 
प्रेमिका: साथी, प्रेमी, प्रेमी, लड़की
मैथुन-करना: 
hourglass: 
सहानुभूति: सहानुभूति, दया, समझ
बोरान: 
हेलीकाप्टर: 
टेल्यूरियम: स्कैंडियम, लेण्टेनियुम
समयसीमा: अवधि
संरेखित: 
सेंटीमीटर: 
मोलिब्डेनम: 
लिथियम: 
मल्टीमीडिया: 
अद्यतन: आधुनिकीकरण, ताजा
कैलोरी: 
रोबोट: 
घर-का-पाठ: 
लोगारित्म: 
एक-प्रकार-का कीड़ा: 
जमाना: पर्वत, स्थापित, संश्लेषण
अमीनो: 
ग्लिफ़: राहत
AORIST: अनिश्चितकालीन
परिस्थितिकी: पारिस्थितिक
मिलावट-करना: लूट
मारिजुआना: 
सूक्ष्म: सूक्ष्म, छोटा, छोटे, छोटा, माइक्रोफ़ोन
किलोग्राम: 
पेट-भर-खा जाना: 
उम्मीद-के-मुताबिक: भविष्यवाणी, भविष्यवाणी, पूर्वानुमान
पिज़्ज़ा: 
छिपकर-बातें-सुनना: 
भाषा-विज्ञान: भाषाई
बाल-काटना: 
इरीडियम: 
जातिवाद: जातीय
इष्टतम: चोटी, अनुकूलतम
औद्योगीकरण: औद्योगिक-करना, औद्योगिक, विनिर्माण
मुख्यालय: मुख्यालय, बैठिये
सैरियम: 
अनुकूल: अनुकूल, अनुकूल, अनुकूल, संगत, समान
ज़ाती-मामला: 
कैसेट: टेप
इच्छा-शक्ति: इच्छा, होगा
आकार: आकार, आकार, आयाम, स्थानिक
पैरामीटर: 
सिंक्रनाइज़: सिंक
अधिकतम: अधिकतम, बढ़ाने, अतिरंजना-करना
सेमिनार: कार्यशाला
डिस्को: प्लेट
नीयन: 
आज़मियम: 
इपिफ़नी: 
plagiarize: चोरी
विरूपण-साक्ष्य: 
रिएक्टर: 
अजवायन-की-पत्ती: 
प्लूटोनियम: 
yttrium: 
वृद्धि-करनेवाला: 
उपयोगकर्ता-नाम: 
स्नातकोत्तर: 
दांया-विंग: 
आर्गन: 
भय: भय, भय, अड्डा, घृणा
सामूहीकरण-करना: संवाद, बातचीत
भूमंडलीकरण: 
तरंग-दैर्ध्य: 
सांकेतिक-शब्दों-में बदलना: कोड
अपनी-बात-दोहराना: प्रयुक्त
पुनः-आरंभ-करें: रिबूट
हैपेटाइटिस: 
टोरस्र्स: गांठ
कीमोथेरपी: धार्मिक
सापेक्ष: ढालना, मॉड्यूल
प्रोटॉन: 
डिस्केट: 
मिलीग्राम: 
पिक्सेल: 
टैंटलम: 
घुला-हुआ-पदार्थ: तय
नरसंहार: 
दरिंदा: भयंकर
गैलियम: 
zirconium: 
निर्धारक: निर्धारित, परिभाषित, अन्वेषक
nonlinear: 
कीटनाशक: 
फीरोज़ा: 
न्यूरॉन: 
विधेय: मुखर
जांघिया: अंडरवियर
कारख़ाने-का: संकाय
न्यूट्रॉन: 
नाइओबियम: 
जर्मेनियम: 
धातु-के-रूप-रंग का एक अधातु पदार्थ: गैर-धातु
डाल-पर: 
prolative-मामला: 
जैव-विविधता: 
जोस्टिक: 
एंटीबायोटिक-दवाओं: 
जंगी: 
अंतरिक्ष-यात्री: अंतरिक्ष
अलौकिक: विदेशी
बेवकूफ: बेवकूफ, पागल, पागल, पागल, असामान्य
मैराथन: 
ytterbium: 
आत्मकेंद्रित: 
योण-बनाना: 
राडोण: 
Nerium: 
महामारी-विज्ञान: 
बुढ़ापा: वयोवृद्ध
कैंपिंग: शिविर
धारीदार: पट्टी, योजना, योजनाकर्ता
ईण्डीयुम: 
सत्यप्रिय: ईमानदार, विशुद्ध, जाल
वेबसाइट: वेबसाइट, साइट, प्रोफ़ाइल
कुरान: 
flatware: 
वें-जड़: 
लॉरेंशियम: 
नागरिक-अधिकार: 
मोबाइल-फोन: सेल-फोन, सेल-फोन
स्तंभित: 
एक-प्रकार-का रसायनिक मूलतत्त्व: 
विकिरण: चमक
निर्भर-पर: 
थोरियम-परमाणु: थ्यूलियम-परमाणु, टर्बियम-परमाणु, रोडियाम-परमाणु, रूबिडीयाम-परमाणु, वैनेडियम-परमाणु, एक-अधातु-तत्त्व परमाणु, एक-विशेष-तत्त्व जिस का प्रभाव रेडियो पर पड़ता है परमाणु, थालियम-परमाणु, स्ट्रोंटियम-परमाणु, दयाता-परमाणु
ब्लू-जीन: 
घरेलु-पौध्ाा: 
व्यक्तिगत-रूप-से: व्यक्तिगत-रूप-से, व्यक्ति, व्यक्तिगत, अलग
प्रवाह-चालू: 
तीन-बिंदु: 
मानव-शरीर: 
भौतिक-विज्ञान: भौतिक, शारीरिक-रूप-से
खुदरा-दुकान: 
सीज़ियम: 
लंबा-पूर्व: 
स्प्रेडशीट: 
यूनिट-के-द्रव्यमान: 
संकलन: 
द्विआधारी-मूल्य: 
मानव-किया-जा रहा है: 
द्वारा-मतलब-का: 
depan-dari: 
प्रेसियोडीमियम: 
गत्ता: कार्ड
सीमित-क्रिया: 
परीक्षण-संख्या: 
समर्थक-वाक्य: समर्थक-मुहावरा
आलोचक: महत्वपूर्ण, गंभीर-रूप-से
पैकेजिंग: रैपिंग, पैक
अनस्थिरता: अस्थिर
पर-अधिकांश: 
वर्णनकर्ता: विवरण
Neodymium: 
मित्रता: अनुकूल, मित्र
पढ़ना-केवल: 
founds: 
सूक्ति-का-मनोदशा: 
स्वनिम: 
चेतना: चेतना, तर्क
ध्वनी: 
भोजन-कक्ष: 
जीवित-कक्ष: 
केंद्रीय-मामला: 
पूर्व-अव्तन: 
मरीज-मामला: 
परोक्ष-मामला: 
ग्रामीण-क्षेत्र: 
recurse: 
मध्य-आवाज़: 
meitnerium: 
डाक-वाहक: 
noncommittal: समतल
स्टॉक-बाजार: 
पहचान-योग्य: पहचान, पहचान
लक्ष्य-ट्रिगर: 
एक-क्षण: 
lative-मामला: 
राशन: भाग
गैर-मानव: 
जीवित-चीज़: 
बहुत-थोड़ा: 
सिनेमा-घर: सिनेमा
हैशियम: 
attenuative: 
multal-संख्या: 
दूध-का-मार्ग: 
नैप्टुनियम: 
असली-लेखक: 
ट्रांस-अंक: 
सुस्ती-में-समय गंवाना: 
रेडियोऐक्टिव: 
सुबह-महिमा: 
फायर-फाइटर: 
बर्कीलियम: 
आकाशगंगा-लिंग: 
Nobelium: 
अलविदा: नमस्ते, अलविदा, जब-तक
बुद्ध-धर्म: 
Fermium: 
सियान: मैजेंटा
सोया: 
वितरक: 
हड़ताल-तोड़नेवाला: 
प्रोसेसर: 
abessive-मामला: 
adessive-मामला: 
को-मामला: पर-मामला, बेतरतीब-ढंग-से
agentive-मामला: 
रदरफोर्डियम: 
एंटीबॉडी: 
जैसा-बहुत-जैसा: 
एजेंट-ट्रिगर: 
अभिनेता-भूमिका: 
ethidium: 
सामान्य-लिंग: 
accompanier: 
कुसुम: 
francium: 
अर्बियम: 
निष्क्रिय-आवाज़: 
एस्टाटिन: 
चबाने-गम: 
तारा-लिंग: 
उद्धरण-प्रपत्र: 
क्यूरियम: 
कॉमिक-स्ट्रिप: 
रंग-अंधा: 
euler's-संख्या: 
देखना-पर: 
crosswalk: मार्ग
रणभूमि: 
मोटर-यात्री: ड्राइवर
शार्ट-सर्किट: 
मौखिक-संज्ञा: 
रोना-बाहर: 
सांख्यिकीय-रूप-से: सांख्यिकीय
दही: 
क्सीनन: 
सम्मोहित: 
लेना-बंद: 
खंड---पूंछ: 
प्रत्यक्ष-वस्तु: अप्रत्यक्ष-वस्तु
किराना-दुकान: 
मिलकर-का: 
ergative-मामला: 
इन--भाषा: 
पहली-हाथ: प्रत्यक्ष
लोकैटिव-मामला: 
स्विमिंग-पूल: पूल, घाटी
क्रिया-विशेषण-संबंधी-मामला: 
sightsee: यात्रा, निरीक्षण, प्रसार
टेलीविजन-सेट: 
अंतिम-कण: 
evitative-मामला: 
पुनर्वास: 
वापसी: वापसी, वापसी, पीछे-हटना, झटका
खंड-का-फ्लैटों: 
जागना-ऊपर: 
पुलिस-अफ़सर: 
शपथ-लेना: 
साक्षात्कारकर्ता: साक्षात्कार
रेनीयाम: 
एयरोसोल: 
मालिकाना-मामला: मालिकाना-मामला
nominalization: संज्ञा
अधीन-मामला: 
पल्ला-झुकना: 
सहायक-क्रिया: 
मुख्य-वस्तु: 
कंप्यूटर-वायरस: 
व्यापारी: व्यापार-व्यक्ति, सौदागर
ए-लोग: लोग, लोक
antessive-मामला: 
प्रधान-मंत्री: 
ल्यूटेशियम: 
युरोपियम: 
भाव-का-प्रकट करना: 
लोक-संगीत: 
कवि: 
डाक-घर: पद, मेल
माना-जाता-है कि: कल्पना, परिकल्पना-बनाना, मुमकिन-है, जाहिरा, संभावना
चेतन-लिंग: 
subessive-मामला: 
गैस-पेडल: 
polarity: ध्रुवीय
वाहन-लिंग: 
खनिज-लिंग: 
क्रिया---प्रत्यय: 
आवेशपूर्ण: भावना, भावुक, ग्रहणशील
समैरियम: 
फैसिलिटेटर: मध्यस्थ
काल्पनिक-इकाई: 
प्रकाश-कि-गति: 
वायु-सेना: 
empathetic-हर्ष: 
क्रांतिक-बिंदु: 
पूरा-समय: 
हेफ़नियम: 
निषेध: नियंत्रित-करना, फुटपाथ, रोकना, निषेध
परिवर्तन-का-घटना: 
holmium: 
अलग-घटना: 
ब्रम्हांड-लिंग: 
इलाके-लिंग: 
वास्तविक-मशीन: 
अनुसंधान-लिंग: 
कलात्मक-लिंग: 
crastinal-काल: 
सार-लिंग: 
exocentric-मामला: 
सकर्मक-क्रिया: 
शब्द-का-भाग: 
अंधराष्ट्रीवादी: 
अतीत-साधक: 
व्यवसायिक: विशेषता, व्यावसायिक, कब्जे, शिल्प, पेशेवर
अप्रत्यक्ष-भाषण: 
दूसरा-भाषा: 
को-होना: 
कब्रस्तान-खिसक-जाना: 
सामूहिक-संज्ञा: 
absolutive-मामला: 
मरीज-ट्रिगर: 
स्वयं-आत्मविश्वास: 
मल: स्टूल, गोली-चलाने-की आवाज़, गंदगी
कर्मकर्त्ता-आवाज़: 
अवैयक्तिक-क्रिया: 
सीबोर्गियम: 
सफेद-स्थान: 
मोडल-मामला: 
अचेतन-लिंग: 
प्रेरणा-का: 
propositive-मनोदशा: 
बिजली-वर्तमान: 
जोड़नेवाला-मामला: 
अतिशयोक्ति-मामला: 
बहुत-बहुत: 
ग्रहों-लिंग: 
एनिमेटेड-कार्टून: 
पारस्परिक-आवाज़: 
कानून-बनाना: विधान, विधायी, व्यवस्था, का-आयोजन
पर-कम-से कम: 
व्याकरण--मामला: 
उपयोगकर्ता: 
कोर-benefactive: 
गोलकीपर: 
:-Akssept-For: 
भाजक: 
किसी-और-यदि: 
बग़ल-में: अलग
एक-दूसरे: एक-दूसरे, आपसी
क्रमिक-धारा: 
थकना: 
निकर: 
डिस्प्रोसियम: 
शीघ्र-भविष्य-काल: 
si-इकाइयों: 
क्रीप्टोण: 
मेण्डेलीवियम: 
अनुप्रयोगी-आवाज़: 
antipassive-आवाज़: 
सतत-पहलू: 
विकिरण-बीमारी: 
necessitative-मनोदशा: 
एक-कार्य-क्रिया: 
railcar: 
अतिशयोक्ति-उपाधि: 
अस्तित्व-धारा: 
कलिफ़ोरनियम: 
वर्तमान-कृदंत: 
प्रकाशयुक्त-तीव्रता: 
singulative-संख्या: 
व्याकरण---वस्तु: 
निष्क्रिय-कृदंत: 
अत्यधिक-अवधि: 
सुपर-तरल: 
रकम-का-पदार्थ: 
पूछे-मामला: 
निर्वाचित-quantifier: 
gadolinium: 
epenthetic-शब्द-का भाग: 
निगेटिव-quantifier: 
आइंस्टिनियम: 
कृत्रिम-भाषा: 
संयोजी-कण: 
दूरस्थ-भविष्य-काल: 
किसी-कार्य-की पुनरावृत्ति दिखानेवाला पहलू: 
बांटनेवाला-सर्वनाम: 
व्याख्यान-समझौता: 
गंजा: नंगा
उपनगर: पुरवा, ग्रामीण-इलाकों
सार्वभौमिक-quantifier: 
कंप्यूटर-प्रोग्रामिंग: 
टेलीविजन-कार्यक्रम: 
चल-बिन्दु-संख्या: 
अस्तित्व-quantifier: 
दिन-बाद-आने वाला कल: 
विकल्प-quantifier: 
उतावला: असभ्य
अतीत-निष्क्रिय-कृदंत: 
दिन-से-पहले बिता कल: 
लोकैटिव-दिशात्मक-मामला: 
प्रतितथ्यात्मक-सशर्त: 
