infinito: infinito, infinito
nominativo-caso: 
accusativo-caso: 
argomento-caso: soggetto-caso
genitore: parentale, principale, anziano
padre: padre
mamma: mamma, madre, materno
Ciao: addio, Salve, Ciao
antenato: predecessore, nonno
nonno: nonno, nonna
Affamato: fame, morire-di-fame
genitivo-caso: possessivo-caso
aggettivo: 
e: somma, di
me: io-stesso, io, il-mio, noi
tu: loro, ti, tu
noi: noi, i-nostri, nostro
esso: lui, che, lei, Questo, queste
destinazione-caso: obbiettivo-caso
dativo-caso: 
interno-contesto: 
persona-contesto: 
dipendente-clausola: 
perfective-aspetto: 
passato-teso: 
maschile-Genere: neutro-Genere
comitative-caso: 
presente-teso: 
benefactive-caso: 
essive-caso: 
non: no, non, quasi, incapace, non-, intonazione
la-sua: i-loro, il-suo, lei, lui, quelli, la-sua, di
superficie-contesto: 
adpositional-caso: 
luogo-caso: 
spazio-contesto: 
modo-caso: 
strumentale-caso: 
quale: chi, come, di-chi, qualsiasi, nessuno-dei-due, che, chi, ciò-che, che-cosa, ogni, qualunque
interrogativo-umore: 
e-o: 
esclusivo---o: 
fonte-caso: 
ablativo-caso: 
espansivo: solido, sostanziale, calcestruzzo, convincente, direttiva, drammatico
ma: ancora, però
tutti: tutti, tutti, totale, intero, complessivamente, totale, ogni-cosa, qualsiasi, sempre-più
femminile-Genere: 
essi: loro, lei, quelli, i-loro, il-loro, cognome, queste
plurale-numero: 
uno: singolo, un, in, da-sola
futuro-teso: 
sociale-contesto: 
quando: ogni-volta-che
imperfective-aspetto: 
Là: 
condizionale-umore: congiuntivo-umore, ipotetico-umore
Di-più: al-di-sopra, maggior-parte, ulteriore, al-di-là, verso-l'alto, verso-l'alto, Multi, di, piuttosto, anche, inoltre, più, ancora, ancora, altro, parecchi, multiplo
su: al-di-fuori, esterno, esterno, all'aperto, all'aperto, via, al-di-fuori del, al-di-là, su, su, su
parente-caso: parente-caso
illative-caso: 
fare: compiere, eseguire, intraprendere, rendere, attivare, ha-fatto, commettere
direttiva-umore: indicativo-umore
deontica-umore: 
domanda-parola: 
copula: connettore, legame, mazzo
persona: uomo, la-gente, individuale, qualcuno, qualcuno, ragazzo, umano, faccia, bocca, entità
maschio: maschile, menzione, signore, uomo
poteva: lattina, potrebbe, forse, può-essere
altro: altro, riposo, secondo, un-altro, diverso, l'un-l'altro
numero: importo, somma, figura, numerico, cifra, quantità
molto: molto, estremamente, terribilmente, molto, anche, terribilmente, ampiamente, altamente, davvero, male, enorme, considerevolmente, lotto, Multi, enormemente, maggior-parte, abbastanza, abbastanza, lontano, bella, ok, va-bene, Tutto-ok
orario: mentre, momento, durante, tempestivo, durata, temporale, teso, orario, periodo, tempo
tempo-contesto: 
temporale-caso: 
di: per-quanto-riguarda, circa, quasi, circa, di, di, di, in-giro-per, per, utente, lamentarsi, in-data
epistemica-umore: 
solo: appena, semplicemente, semplicemente, punto, semplice, puramente, ristretto
piccolo: piccolo, piccolo, leggero, leggermente, po, minore, meschino, diminutivo, portatile, pochi
poi: ancora, ri-, ya, da, fa, dopo, poi
hortative-umore: 
retrospettiva-aspetto: 
ottimo: di-grandi-dimensioni, grande, nobile, grave, vasto, ad-alta-voce, enorme, gigante, enorme, dominante, Buona, bene, considerevole, enorme, sostanziale, meraviglioso, eccellente, ottimale, grande, principale, perfezionare, notevole, brillante
volitiva-umore: 
prima: precedente, pre, fa, precedere, fin-quando, anteriore, precedentemente, contro
deve: dovrebbero, necessariamente, non-necessario, dovere, bisogno, deve, dovrebbe, volere, a
due: doppio, entrambe-le-parti
vedere: Guarda, vista, vista, Avviso, percepire, orologio
sapere: accertare, a-conoscenza, insegnare, bandiera, visibile
fuori-uso: verso-il-basso, verso-il-basso, sotto, qui-di-seguito, sotto, sotto, Di-meno, fondo, inferiore, Piano-di-sotto
a-seguito-di: parte-posteriore, su, inviare, dimensione, dopo, poi, in-seguito, a-seguire, passato, sotto, sotto
primo: debutto, iniziale, da, avanti, pugno
proprio: lui-stesso, te-stesso, possedere, personalmente, il-suo, si, se-stesso
alienabile-possesso: 
mai: mai
inalienabile-possesso: 
vecchio: usato, antica, anziano, anziano, ex, ex, ex-, età
deliberativo-umore: 
giorno: quotidiano, oggi, questa-sera
dove: dovunque, per-cui, luogo
venga: a, raggiungere, arrivo, arrivare, diventare, moda, si-verificano
modo: metodo, metodologia, si-intende, il-percorso, percorso, tratto, via, pista, modo, strada, Via, lo-zucchero, traccia, traiettoria, abitudine
lavoro: lavoro, assegnazione, attivo, compito, lavoro, lavoro, carriera, funzione, operare, funzionale, attività-commerciale, atto, allenarsi, occupazione, professionale, lavoro, opera-d'arte
vocale: famoso, vita, sopravvivenza
partire: camminare, tariffa, partire
perlative-caso: 
progressivo-aspetto: 
lungo: prolungata, durevole, alto, lungo
dire: verbale, raccontare, parlare
Come: come, come, di
anche: anche, entrambi, fin-quando, inoltre, anche
indietro: alle-spalle, parte-posteriore, indietro, a-rovescio, ritorno, ri-, ripristinare, annullare, ancora, ripetere, fa, secondo
Qui: 
pensare: pensiero, pensato, prendere-in-considerazione, immaginare, concepire, meditare, voluto, chiamato, mente
stesso: identico, simile, pari, equivalente, giustamente, ok, Tutto-ok, lui-stesso, ugualmente, allo-stesso-modo
ultimo: fine, quest'ultimo, definitivo, finale, un-altro, altro, più-recente, recente, fine, passato, il-passato, sopportare, resistere, mettere, persistere
lontano: lontano, lontano, via, a-parte, distaccato, sinistra, lasciare, assente
sotto-contesto: 
prendere: ricorrere, occupare, andare-a-prendere, adottare, afferrare, ottenere, ricevere, scegliere, fermo, catturare, accettare, ottenere, carica
trovato: trova, scoprire, scoperta, rivelazione, accessibile
mano: braccio, polso
giovane: gioventù, junior, adolescente, adolescente, nuovo
anche-se: sebbene, tuttavia, fisso, azienda, solido, fermamente, nonostante, però, qualcuno
dare: prestare, fornire, offrire, fornitura, consegnare, rendere, permettersi, mettere, donare, lasciare
Dio: 
delative-caso: 
Niente: qualche-cosa, oggetto, nessuno, nulla, nessuna, nessuno
destra: coppia, correggere, con-precisione, fiera, giustizia, giustificato, sleale, idoneo, diritto, legge, correttamente, vero, certa, certo, intitolare, bene
una-volta: subito, prontamente, metodo, modello, metodologia, ancora
semelfactive-aspetto: 
parte: sezione, parzialmente, porzione, in-parte, pacco, frazione, quota, po, pezzo, passaggio, sottoinsieme, capitolo, dipartimento, episodio, parziale, divisione, reparto, settore, proporzione, per-conto
sega: 
casa: casa, premesse, tempio, alloggiamento, famiglia
mondo: regno, globale, universo
capo: titolo, principale, capo, capitolo, capo, Presidente, presidente, direttore, capo, anziano, penna
tre: Terzo
neo: nuovo, recentemente
messa-a-fuoco: destinato, scopo, goal, obbiettivo, concentrarsi, Attenzione, concentrazione, accento, convergere
amore: affetto, carità, come
sempre: per-sempre, costantemente, mai, solito
notte: sera, cena, p.m.
a-testa: per, ogni, qualsiasi
re: regno, signore, monarca, magnate
fra: tra, tra, di
cuore: rallegrare, incoraggiante, rovesciare
paucal-numero: 
perché: dovuto, da, caso, causa
causale-caso: 
cosa: importa, affare, fenomeno, cose, che-cosa
impostato: gruppo, mettere, tenere, posare, incolla, collezione, combinazione, schieramento, suite, pacchetto, portafoglio, sintesi, insieme, serie, turno, gamma, riga, stringa, kit, corpo
nome: cognome, sostantivo
corretto-sostantivo: 
hortative: esortativo
nazione: nazione, terra, terra, stato, terra, contea, suolo, partito
chiesto: 
visibile-probatorio: 
meglio: superiore, migliore, eccellente, ideale, eccezionale
lato: laterale, favore, favore, per-conto, turno, pagina, aspetto, metà, sfaccettatura
corso: programma-scolastico, lezione, conferenza, certamente, certamente, decisamente, tasso
femmina: signora, femminile, femminile, donne, ragazza, moglie
abbastanza: sufficiente, sufficientemente, adeguato, ampio, abbastanza, abbondanza, insufficiente, abbastanza, bella
presto: in-breve, rapido, richiesta, rapidamente, veloce, immediato, rapido, fretta, urgente, così, subito, prontamente, vicino, presto, schiocco
completo: completamente, sufficientemente, assoluto, completare, imperfetto, totale, di-preciso, esatto, totale, per-l'appunto, completo, intero, globale, dimensione
camera: camera, quarto, la-Camera-da letto, pace
quasi: quasi, in-pratica, circa, circa, vicino, in-giro-per, chiudere, adiacente, potenzialmente, vicino, in-breve, prossimale, approssimativamente, quasi
non-può: incapace
acqua: liquido, fluido, spartiacque
desiderativo-umore: 
leggero: ardere, luminosa, candela, leggero, stile, leggermente, mite, accendino, pallido, chiaro
né: nessuno-dei-due, non-, ancora, che-cosa, accadere, o
parola: lessicale
porta: cancello, portone, Ingresso, capitolo, porta
uso: utilizzare, uso, consumo, spesa, consumatore, impegnarsi, applicazione, utilità, Applica, impiegare
mattina: antimeridiano, colazione
terminative-caso: 
energia: forza, energia, potrebbe, forte, vigore, potente, dinamico, insalata, dominanza, autorità
loro-stessi: noi-stessi, te-stesso, lui-stesso, io-stesso, se-stessa, si, se-stesso, ego, capitolo
presente: corrente, il-presente, adesso, attualmente, regalo, esistere, a-disposizione
voce: suono, ad-alta-voce, scrutinio, Audio, votare, voce, voce, voce
bianco: vuoto, denuncia
i-soldi: ricchezza, argento, finanziario, Contanti, valuta, finanza, monetario
Il-prossimo: accanto, a-fianco-di, accanto-a, a-seguire, dopo, dimensione, avanti, successivo
povero: braccio, la-povertà, cattivo, peggio, marcio, debole
morte: mortalità, morente, morto
forma: forma, muffa, formato, contorno, modello
inessive-caso: 
genere: classe, ordinare, specie, varietà, tipo, amichevole, voce, Buona, piacevole, piacevole, piacevole
di-frequente: frequentemente, costantemente, regolarmente, frequente, comunemente, normalmente, tipicamente
anno: annuale, annualmente, cinque
amico: alleato, fidanzato, compagno, compagno
ordine: sistema, disposizione, organizzare, contrarre, schieramento, comando, turno, riga, coda
imperativo-umore: 
tondo: arrotondata, cerchio, giro
credere: fiducia, fare-i-conti, presumere, fede, convinzione, fiducia, fiducioso, ottimismo, ottimista
pubblico: il-pubblico, generale, pubblico
stato-contesto: 
figlio: sciame, ragazzo
centinaio: centesimo, faccia, centesimo
bambini: ragazzo, prole, bambino, bambino
così: in-tal-modo, così, quindi, come, sì
speranza: desiderio, prospettiva, anticipare, ottimismo, ottimista
al-di-sopra: su, al-di-sopra, al-piano-di sopra, alto, superiore, avanzato, superiore, attraverso, circa, via, su, in-alto, su, avanti, verso-l'alto
caro: amante, caro
leggere: lettura, cantare, giglio
città: cittadina, comunale, contea
già: pronto, preparato, disposto, comunque
fatto: verità, la-realtà, veracità, vero, vero, reale, infatti, davvero, in-realtà, ha-fatto
Factive-probatorio: 
sentire: ascolta, udito, sentire
meno: minimo, minimo, minimizzare, meno, Di-meno
forse: probabilmente, può-essere, presumibilmente, potrebbe, forse, possibile, probabile, probabile
aprire: chiaro, pianura, chiaramente, spoglio, ovviamente, vacante, esplicito, ovvio, all'aperto, disavanzo, pallido, apertamente, esporre
corpo: carne, corporale, fisico, fisicamente, corpo, organo, cadavere
aria: vento, brezza, aviazione, tempo, linea-aerea
natura: naturale, nativo, naturalmente, origine, discesa, indigeno, natura, carattere
Aiuto: assistere, utile, aiuto, assistenza, assistente, posare
lettera: posta, scrittura
quattro: quarto
ottativo-umore: congiuntivo-umore
fuoco: caldo, fiamma, febbre
dunque: quindi
ora: orologio, alle, campana
gratuito: libertà, la-libertà, esonerare, gratis, vano, liberamente, vacante, vagamente, uscita
guerra: battaglia, lotta
se: Se, si
ragionare: causa, conto, fattore, ragionevolmente, scusa, motivo, diffusione, attore
unito: singolare, unità, inclusivo, unione, alleato, alleato, unico, unanime
chiamata: sfida, ossidare, appello, in-data, connessione, combinazione, comune, fusione, invito
come-mai: 
perso: perdita, mancante
mille: millesimo
famiglia: famiglia, superstite
anima: spirito, fantasma, mente
domanda: problema, domanda, lettura, importa
cura: interessato, preoccupazione, Attenzione, meditazione, servizio, sponsorizzazione, guardia, sicurezza, protezione, sicurezza, conservazione, conservazione, copertura, difesa, Attenzione, cura, trattamento, custodia
Realis-umore: 
significare: implicare, senso, significato, significativo, indicare, mezzo, agente, medio, media, moderare
potenziale-umore: 
in-direzione: verso, contro, contrario, avversario, per, il-rispetto, per
allativo-caso: 
antropico-Genere: 
breve: Di-meno, Basso, breve, in-breve, brevemente, carta, restringere, leggero
capace: lattina, qualificato, idoneo, capace, capacità, capacità, incapace, competente, potenziale, possibilità, probabilità, forte, potente, abile, può
abitare: vita, sopravvivere, comportarsi, vita, nido, quartiere, Quartiere, Quartiere, vivo, vivace, crudo, risiedere
soggetto: disciplina, tema, argomento, lezione, sostanza, problema, oggetto, significato, materiale, semantico, importa, affare, titolo
stesso-soggetto-marcatore: 
diverso-soggetto: 
risposta: nord, risposta, risposta, soluzione, corrispondere, rispondere
mare: oceano, marino
la-paura: terrore, impaurito, terrore, soggezione, impaurito, panico, ansia, angoscia, orrore, paura
capire: comprensione, comprensione, percepire, stretta, concepire, incomprensibile, includere, rendersi-conto
difficile: difficile, rigido, complicato, duro, ad-alta-voce, violentemente, feroce, difficile, rigoroso, stimolante, difficile, pesante, tomba, grave, inquieto
condizioni: termine, terminologia, problema, basato, motivo, base, essenzialmente, fondamentalmente, fondamentalmente
dubbio: sospetto, diffidenza, sospettare
dubitativa-umore: 
chiedere: pregare, richiedere, ascolta, per-favore
braccia: arma, disarmare, armato, braccio
nero: 
portare: andare-a-prendere, trasportare, voluto, condurre
bellissimo: Buona, simpatico, bello, magnificamente, piacevolmente, bella, fantasia, raffreddare, carina
buio: oscurità
tenere: tenere, mantenere, fermo, presa, contrarre, concludere, nodo, decennio, sequestrare, attesa, come, sostenere
dieci: decennio, decimo, fiera
mostrare: display, eseguire, prestazione, dimostrazione, presentazione, indicare, indicare, evento, proiezione
storia: mito, storia, finzione, complotto
comune: generale, solito, routine, di-solito, ordinario, fuori-dal-comune, comunemente, modesto, normale, irregolare, convenzionale, tipico, normalmente, tipicamente, comune, compagno, socio, aggregato, complessivamente, reciproco, aziendale
libro: pergamena, prenotare, libbra, manuale
elettronico: elettronica, elettrone, fulmine, elettrico, elettricità, elettrico
parlare: conversazione, chiacchierare, negoziare, interazione, interagire, trattativa, parlare, discorso, verbale, discorso
marchio: marcatore, traccia, pista, Punto, evidenziare, zecca, segno, segnale, indicazione, spunto, marca, carattere, etichetta
interesse: fiore, interessato, preoccupazione
scrivere: comporre, scrittura, tipo, scritto
letto: 
necessario: essenziale, importante, utile, critico, vitale, significativo, senza-importanza, integrante, cruciale, importante, bisogno, necessariamente, intransitivo, intransitivo, intransitivo
idea: pensato, considerazione, ragionamento, opinione, nozione, Brainstorm
arte: mestiere, artistico
Vialis-caso: 
fratello: fratello, sorella
a-volte: raramente, di-tanto-in tanto, a-volte
linea: filo, filo, riga, corsia, conduzione, trattino, banda, tassare, copione
tavola: scrivania, programma, catalogo
fiume: cuscino, cuscino, flusso
occhio: nominare, in-giro-per
informazioni: messaggio, la-spiegazione, descrizione, bollettino, conoscenza, dati
ad-un-tratto: improvviso
strano: stranamente, sorprendente, stranamente, dispari, meraviglia, meraviglioso, notevole, straordinario, incredibile, sorprendente, bizzarro, divertente, sconosciuto, esotico, scomodo
in-profondità: profondamente, profondità, esteso, superficiale, completo, dettagliato, globale, criticamente, profondo, entro, dentro, interno, verme
cambiamento: modifica, variazione, trasformazione, trasformare, mutazione, spostamento, alterare, emendare, transizione, emendamento, sostituzione
sensazione: sentire, sensazione, percezione, impressione, emozione, stato-d'animo, impressionato, emotivo, sensoriale, sentimento, senso, passione, consapevole, coscienza
incontrare: ottenere, convergere, incontrare, soddisfare, soddisfare, incontro
scopo: oggetto, scopo, obbiettivo, goal, destinazione, intenzione, destinato, motivo, bersaglio
contento: allegro, divertito, piacere, lieto, gioia, felicità, diletto, Contentissimo, divertente, felicemente, fortunato, contento
sembrare: aspetto, apparire, a-quanto-pare
sangue: sanguinare, penale
rosa: rosa
Sud: meridionale, mezzogiorno, mezzogiorno
freddo: inverno, raffreddare, freddamente
inoltrare: ulteriore, più-lontano, avanti, vista, anteriore, avanzato, fa, pipistrello, su, avanti
posizione: posizione, situazione, stato, opportunità, opportunità, spazio, posizione, posizione, luogo, inviare, voce
in-ritardo: lentamente, fine
stare-in-piedi: stazione, verticale, atteggiamento, posizione, fermare, posizione, posa, stallo
supporre: assunzione, ipotesi, assumere, adottare, presumere, porre-come-ipotesi, suggerire
figlia: ragazza, vergine
il-mio: il-mio
tagliare: la-mancanza, carente, riduzione, deficienza, diminuire, carenza, Perdere, taglio, interrompere, tagliare, barra, raccolto, tagliare, rotte, violare
copia: riprodurre, replicazione, replicare, trascrizione, fotocopia, clone, versione, prescrizione
marito: uomo, coniuge
sei: sesso
ricorda: Nota, richiamo, ricordare, imparare-a-memoria
effetto: influenza, influenzare, impressione, urto, dominanza, efficiente, efficacemente, efficacia, conseguenza, risultato, esposizione
cadere: autunno, caso, collocato, schianto, caduta, abbattersi, crollo, far-cadere, declino, diminuire
tranne: a-meno-che, al-di-fuori, al-di-fuori del, oltre-ad, a-parte, esclusa, accanto, a-parte, a-parte-- da
capelli: 
passaggio: di, attraverso, passaggio, via, vicino, accanto, consistere, diplomato, ruggine, attraversare, passaggio, procedere
diritto-d'autore: 
esercito: truppe, truppe, ospite, soldato
correre: fuggire, drenare, in-esecuzione, eseguire, operare, guidare, che-cola, ingranaggio
cavallo: ferro-di-cavallo, a
futuro: il-futuro, dopo, in-seguito, poi
ovest: occidentale
paga: salari, salario, stipendio, spinta, pagamento, retribuire, tassa, costo
rosso: 
oro: 
desiderio: volontà, desideroso, appetito, desiderio, anelare, sollecitare
giocare: danza, giocare, gioco, guancia, giocattolo
maestro: signore, primario, principale, Professore, dominare, governare, Sig, signore, principale, signore
ufficio: agenzia, scrivania
governo: stato, riga
chiesa: 
lunghezza: altezza, altitudine, campata, lungo, durata
azienda: azienda, società, società, attività-commerciale, aziendale, entità, istituzione, agenzia, istituto, avventurarsi
carta: foglio, carta, carta
probabilità: possibilità, probabilità, probabile, forse, improbabile, prospettiva, opportunità
particolarmente: speciale, appositamente, specificamente, in-particolar-modo, particolare, di-preciso, principalmente, per-lo-più, in-primis, specifica
orso: trasportare, sopportare, resistere, pazienza, tolleranza, avere, possedere, permettersi
finestra: 
accordo: protocollo, insediamento, compromesso, consenso, trattato, d'accordo, affare, accordo, gara, accordo, contrarre, convenzione, disposizione
bellezza: magnificamente, brillantezza, estetico
dovere: responsabilità, responsabilità, obbligo, responsabile, dogana, compito, assegnazione, debito, dovere, dovere
inviare: trasmettere, sottomissione, inviare, trasmissione, e-mail
distanza: rimozione, gamma, separazione
silenzio: immobilità
piede: gamba, arresto, coscia, dito-del-piede, trimestre, camminare, a-passeggio
selvaggio: selvaggiamente, illegale, feroce, natura
morire: morto, morente
salvare: risparmio, conservazione, recuperare, conservare, conservazione, imparare-a-memoria, negozio, riscattare, salvare, disco
verde: crudo, greggio
problemi: preoccuparsi, problema, problema, disagio, difficoltà, impastare, sofferenza
sorriso: sorriso
sbagliato: errore, errore, sbagliato, male, trattare-male, falso, colpa, fallimento, difetto, a-torto, gaffe
vario: diverso, vario, multiplo, gamma, diverso, Multi, a-differenza-di, variante, differire, variare, varietà
dormire: addormentato, sogno
quotative-caso: 
inizio: inizio, cominciare, intraprendere, graffiare, inizio, presto, iniziale, iniziazione, debutto, principio
azione: compito, punto, passo, palcoscenico, atto, procedura, attivo, operazione, operativa, attivare, attivista, movimento, pratica, pratica, operare, azione, rally, esecuzione, eseguire
visita: accesso, colloquio, accessibile, viaggiare, viaggio, viaggio, giro
seguire: conformità, aderire, a-seguire, perseguire, traccia, accompagnare
provare: tentativo, tentato, sforzo, iniziativa, sperimentare, test, campione
presenza: esistenza, esistere, entità, bene
dolce: caramella, dolce, blando, carina
ricco: abbondanza, abbondante, ricco
nemico: 
nave: barca, navigare, flotta, andare-in-barca, nave, crociera, traghetto
condizione: scommettere, scommesse, stato, situazione, circostanza, stato, fortuna, palcoscenico, livello, fitness, requisito
Compreso: contenere, includere, coinvolgere, appartenere
inclusivo-persona: 
segreto: misterioso, mistero, perno, metropolitana, secernere
precative-umore: 
gentile-registro: 
Male: danno, cattiva, vizioso, cattivo, male
marzo: parata, protesta, dimostrazione, Marte
qualunque: nulla, qualunque
restare: rimanere, sedersi, risolvere, sopravvivere, risiedere, attesa
anziché: invece-di, piuttosto, sostituzione, sostituzione
blu: Fata
impossibile: 
scuola: città-universitaria, scala
occasione: opportunità, evento, evento, opportunità, viale, affare
sposato: matrimonio, sposare, matrimonio
cibo: pasto, dieta, piatto, alimentazione, nutriente
venti: 
silenzioso: calma, tranquillo, stabilizzare, silenzioso, tranquillo, lento, rilassato, dolcemente
con-facilità: probabile, prontamente, responsabile, facile, convenienza, leggero, leggermente, leggermente, conveniente, lineare
potenziale-aspetto: 
lingua: linguistico, lingua
espressione: esprimere, dichiarazione, frase, articolare, rivelazione, esposizione, espressione
settimana: Domenica
sala: veranda, Teatro, corridoio, spazio, camera, salone, salotto, corridoio, corridore, atrio
Pericolo: pericolosi, rischio, il-rispetto, minaccia
Proprietà: bene, appartenere, proprietà, monarchia, possesso, caratteristica, tratto, tenuta, fortuna, ricchezza
Nato: nascita
corte: giudiziario, piatto, foro, processo
generalmente: solito, tipicamente, generale, complessivamente, ampiamente, di-solito, comunemente, normalmente, a-grandi-linee
gnomic-aspetto: 
di-valore: meritare, valore, prezioso, validità, merito
semplice: semplicità, lineare, conveniente, flessibile, facile, appena, semplicemente, pianura, modesto, semplicemente, semplice, dritto, ordinario
albero: piantare, Di-legno, albero, legname
combattimento: lotta, battaglia, confronto, lite, corsa
parete: 
Paradiso: cielo
incoativo-aspetto: 
jussive-umore: 
tono: intonazione, melodia, tonnellata, tonnellata, ombra
considerare: il-rispetto, assumere, presumere, Attenzione, considerazione, prendere-in-considerazione, relazione, associazione, relazione, circa, per-quanto-riguarda, osservazione, copertura
previsto: anticipazione
mese: luna
esperienza: empirico, empirico, esperto, competenza, gusto, sperimentare
interamente: totalmente, perfettamente, completamente, completamente, abbastanza, tutto, assolutamente, assoluto, intero, a-fondo, abbastanza, puramente, di-preciso
fresco: appena, puro, pulire, rinfrescato, nuovo, novizio
duca: righello, Principe
coperto: copertura, copertura, via, chiusa, interno
limite: estensione, limitazione, limite, confine, restrizione, limitato, collegato, dipendere, legare
est: orientale, fa, precedente, precedente, pre, Oriente
pietra: marmo, roccia, gemma
piuttosto: qualche-cosa, nulla, alcuni, abbastanza, piuttosto, leggermente, in-parte, in-qualche-modo
direzione: orientamento, dimensione, tendenza, sfaccettatura, istruzione
sedia: posto-a-sedere, poltrona, sgabello
supporto: sostenere, approvare, assistenza, assistere, supporto, aiuto
data: storia, incontrare
villaggio: frazione, campagna
campo: sfera, regno, regione, territorio, area, zona, settore, dominio, arena, stadio, spazio, margine, campagna, campo
autorizzazione: consentire, orecchio, permesso, autorizzazione, lasciare, Patente, Patente, consenso, edizione
permissivo-umore: 
successo: di-successo, avere-successo, prosperità, realizzazione, vittoria, vincere, colpire, vincente, vincitore
corretto: propriamente, correggere, ragionevole, adeguata, preciso, preciso, diritto, esatto, per-l'appunto, prontamente, fedelmente, giustamente, correttamente, varianza, adattarsi, adatto, conveniente, adatto, corrispondere, idoneo, pertinente, perfezionare, adeguato, regolarmente
collina: montagna, montare
musica: musicale
distale-espansivo: 
pomeriggio: p.m., mezzogiorno, mezzogiorno, sera
piangere: piangere, gridare, urlare
onore: onore, il-rispetto, dignità, rispettabile, onorevole, onorifico, cortesia, gloria, tasso, prezzo
Sette: 
privato: personale, se-stesso, personalmente, auto-, speciale, vita-privata, specifica, esclusivo
notizie: messaggio
scena: luogo, vista, contesto, display, visivo, palcoscenico, vista, prospettiva, tenda
giardino: parco
gara: razziale, da-corsa, in-esecuzione, concorso, torneo, gara, razza, incontro
distributivo-caso: 
imparare: studio, insegnare
politico: politica, politicamente, politico, politica
menzogna: falso
lanciare: scagliare, gettare, scagliare, scossa, formato, muffa, lanciare, capannone, smettere
mangiare: pasto, alimentazione, piatto, cenare, consumo
pavimento: tappeto, terra, fondo, suolo, camminare, alto, alto
malato: malato, paziente, dolorante, malattia, falso, male
originale: origine, in-origine, preliminare, iniziale, sintesi, inizialmente, nativo, genuino, innato, indigeno, principale, primario, prototipo
estate: calore
religione: religioso, debito
immagine: ritratto, la-pittura, Immagine, fotografia, fotografico, fotografia, foto, fotocopia, disegno, schiocco, film, illustrazione, rappresentazione, Fico, figura
fuga: fuggire
autore: scrittore, insegnante, editore
colore-marrone: grigio, grigio, abbronzatura, bronzo
determinato: determinazione, decidere, determinare, definito, assertivo, designer, specificata, accertare, stabile, certa
dolore: male, angoscia, doloroso, dolore, dolorante
molla: piuma, i-nostri, nostro
secolo: età
morbido: concessivo, liscio, finemente, gara, delicatamente, dolcemente, dolce, blando, mite
angolo: angolo, cuneo, annegare
produrre: produzione, generare, produttivo, fabbricare, produzione, produzione
ridere: scherzo
dimenticare: trascurare
Europa: 
otto: ottavo
vestito: costume, capi-di-abbigliamento, toga, toga, vestito, uniforme, attrezzatura
terribile: terribile, orribile, terribilmente, spaventoso, enorme, tragico, allarmante, paura, mostruoso, terribilmente
respiro: respiratorio, respirare, respirazione, esalare, ego, respiro
saggio: ragionevole, sensibile, discreto, riflessivo, intelligente, intelligente, intelligente
possessivo-marcatore: 
memoria: imparare-a-memoria, riferimento, memoriale
moderno: contemporaneo, sofisticato, modernizzare, alla-moda, recente, discorso
individuare: punto, punto, alle, posizione, macchia, macchia, toppa, luogo, Da-nessuna-parte, premesse, località, luogo, del-posto, individuare, segno, terra
salire: piantare, arrampicata, seminare, salita, su, bordo, cavalcata, sollevamento, sorgere, aumentare, emersione, crescere
interruzione: irrompere, freno, ricorrere, salotto, interruzione, intervallo, divario, distruggere, frantumare, fermare, pausa, interrompere
cinquanta: 
isola: 
toccare: contatto
promessa: commettere, impegno, impegno, appuntamento
commissivo-umore: 
grado: pari, estensione, grado, qualità
piano: schema, affare, programma, programma, iniziativa, progettista, proposta, progetto, complotto, schizzo, proiezione, disposizione, appartamento, disegno, design
condotta: tendenza, comportamento, comportamento, comportamentale
sorpresa: sorprendente, inaspettato, accidentale, sorprendente
minuto: 
tiro: sparare, tiro, proiettile, cartucce, fotografia, foto, soffio, scoppio, colpo-di-stato, gettare, portafoto
peggio: cattivo, peggio, ruvido, avverso, male, terribilmente, inferiore, su, al-piano-di sopra
bicchiere: specchio, cristallo, vaso, bicchieri, occhiali
esempio: esempio, illustrazione, modello, modello, metafora, prototipo, come, rappresentare, campione, caso, precedente, campione, paradigma, per-esempio
al-sicuro: sicuro, sicurezza, sicurezza, tranquillamente, fiducioso, assicurazione
medico: medico, terapista, professionista, medico
completive-aspetto: 
ripetuto: frequentemente, regolare, costante, costantemente, di-tanto-in tanto, frequente, regolarmente, ripetere
militare: truppe, militante
caldo: caldo, accogliente, calore, calore, temperatura, il-riscaldamento, grammo, afoso
bere: bevanda
domande: 
rabbia: arrabbiato, rabbia, indignazione, irritare, dispetto
direttamente: dritto, diretto, indiretto, automatico, lineare, immediato
cappello: berretto, casco
cane: 
servitore: steward, Cameriere, cameriera
orgoglio: arrogante, orgoglioso, orgoglio
folla: corsa, affollato, folla, importo, quantità, popolazione, ospite, mucchio
treno: trasporto, auto, carro, carrello, ferrovia, rotaia, educare
morale: moralità, moralmente, etico, etica, morale, spirituale
associato: socio, rilevanza, correlare, collegato, interessato, preoccupazione, pertinente, lungo, collegato, riferirsi, alleato
inserire: ceppo, iscrizione, stato, indicare, inserire, includere
regola: amministrazione, dominio, regime, sentenza, verdetto, sentenza, arbitro, arbitro, governare, legge, legislazione, norma
spada: lama
attacco: invasione, invadere, aggressione, offesa, assalto, offesa, sciopero, inizio, offensivo
Salute: salutare, salutare
paragrafo: versetto, clausola, pezzo, punto, atteggiamento, posizione
sociale: società, socialmente
rimborso: risposta, rispondere, ritorno
scusa: rammarico, polo, perdono, scusa, scusa
coraggio: coraggio, grassetto, fiducioso, nervo, forza-d'animo, osare
grazia: favore, favore, misericordia, gentilezza, benevolenza, per-conto, perdono
ufficiale: formale, formalmente, ufficialmente, ufficiale, impiegato
fornito: fornire, offrire, fornitura, introduzione, a-disposizione, fornitura, fornitura, approvvigionare, Se
richiesta: preghiera, domanda, Richiesta, richiedere, requisito, inchiesta, inchiesta, richiesta, offerta, applicazione
colpo-d'occhio: intravedere, vista, atteggiamento, percezione, prospettiva, vista, Guarda
movimento: movimento, campagna, sport, crociata, atto, movimento, mobilità, attività-commerciale, in-movimento
aspettarsi: aspettativa, anticipazione, anticipare, attesa
di-fronte: anteriore, contrario, contrario, avversario, attraverso, contatore
dodici: 
impegnato: fidanzamento, impegnato, coinvolti, partecipare, occupato
vino: uva, alcol, alcolico
gusto: sapore, sapore, delizioso, esca, gusto
ferro: acciaio, metallo
distribuire: trasmettere, schierare, pubblicare, editoriale, diffusione, circolare, distribuzione, assegnare, quota, dividere, Diviso, dividere, classificare
commercio: commercio, attività-commerciale, commercio, merce, Internet, affare, transazione, mercantile, acquisti, marketing
vantaggio: guadagno, profitto, beneficio, praticabile, bontà, bene, preferenza, dominanza
Abiti: armadio, stoffa, capi-di-abbigliamento, attrezzatura, indumento, caduta
giudice: sentenza, sentenza, arbitro, arbitro
differenza: differenziale, differenziare, diverso, separato, distinto, differire, variazione, separatamente, variabilità, varianza, dividere
ansioso: emergenza, urgenza, interessato, allarmato, preoccupato, ansia, preoccupazione, preoccupazione, riflessivo, scomodo, preoccupante, impaurito, acuto, inquietante, allarmante, entusiasta, desideroso, agitato, inquieto
Capitano: 
finito: finitura, fine, finito, pronto
cessazione-aspetto: 
curioso: desideroso, interessante, emozionante
straniera: all'estero, alieno, straniero, esotico, sconosciuto, esterno
intensificatore: intensificare
importanza: necessità, rilevanza, significato, valore
finalmente: in-definitiva, alla-fine, finito, definitivo, finale, terminale, finemente
fattura: atto, manoscritto, conto, calcolo
dimostrare: prova, confermare, affermare, dimostrare, testimoniare
prevenire: cessare, vietare, detenere, reprimere, limitare, inibire, bloccare, trattenere, scoraggiare, vietare, evitare, respingere, reprimere, sospendere
collo: gola
legale: giudiziario, legge, legittimo, portafoto
asciutto: gambo
servire: servizio, guadagnare, approvvigionare, offrire
perdere: Perdere, misplace
le-prove: probatorio, prova, guida, indizio, elenco, display, testimonianza
probatorio-caso: 
progresso: passo, progressione, Sviluppo, progressivo, sviluppo, anticipo, procedere, miglioramento, sollevamento
costruzione: costruire, struttura, costruire, costruzione, premesse
ricerca: trova, scoprire, scoperta, ricerca, rivelazione, cerca, cercare, la-ricerca, indagine, ricerca, inchiesta, indagine, inchiesta
giù-di-morale: depresso, purtroppo, miserabile, sconvolgente, irritato, rimorso, deprimente
peccato: colpa
trenta: 
onesto: sincero, leale, onestamente, franco
chiuso: chiudere, chiusa, chiusura, via, installare, chiudere, pacchetto, impacchettare, pacco, pacchetto, pacchetto, sequestrare
banca: panca, lattina
destino: fortuna, fortuna, sintattica, destinazione, lotto
foresta: giungla
misura: valutare, misurazione, pesare, metro, metro
altrimenti: in-alternativa
ruscello: flusso, clausola, corrente, elettricità, flusso, getto
pane: infornare, seminare, panino
aggiuntivo: extra, scorta, inoltre, eccesso, surplus, ulteriore, aggiunta, integrativo, aggiungere, appendice
scegliere: scelta, selezione, selezionare, selettivo, scegliere, eletto, comporre, votare, esame, preferenza
animale: 
Zoic-Genere: 
eventive-umore: 
stesso-evento-marcatore: 
moltiplicativo-caso: 
spesso: obeso, fittamente, denso, grasso
creatura: organismo, essenza
pioggia: bagnato, piovosità, doccia
superficie: faccia, livello, aereo, area
santo: sacro, netto, puramente
luglio: 
relazione: determinazione, dichiarazione, rapporto, relazione, relazione, fiera, mostra, prova, esposizione, Punto
costa: filo, spiaggia
file: documento, bobina, casetta, profilo, archivio
spalla: albero, asse, rappresentazione, pettine, braccio
sorpreso: stupito, meraviglia
reale: imperiale, monarchia, regno, impero, vero, reale
canzone: mettere-a-punto, traccia, canto, poesia
comfort: alleviare, rilassato, rilassante, incoraggiamento, convenienza, riposo, sollievo
chiunque: nessuno, qualcuno, qualcuno, nessuno, tutti
erba: fieno, erbaccia, erba, prato, grammo
disegnare: trascinare, Tirare, bottino, interessante, appello, attraente, ritirarsi, emozionante, attirare, È-interessante-notare che, disegno, rimuovere, sottrarre
apertura: preliminare, iniziale, scoperta, divario, fessura, apertamente
giugno: 
pescare: acquario
capitale: capitolo, fondo, bene
seno: il-petto
la-neve: ghiaccio
formazione-scolastica: educare, lezione, educativo, alfabetizzazione, formazione, formazione, educato, accademico
acuto: luminosa, feroce, rigoroso, acutamente, piccante, appuntito, acuto, acuto, croccante
pietà: misericordia, compassione, simpatia, simpatico, compassionevole, terribile, calcio-di-punizione, piuma, sfortunato, deplorare, danno, danneggiare, rimorso
spese: tassa, spesa, costo, edizione, produzione, carica
il-tuo: il-tuo
milione: milionesimo
stanco: fatica, faticoso
uccidere: omicidio, uccisione
ombra: ombra
il-peso: caricare, pesante, pesantemente, pesare, pressione
massa: qualità, collettivo, quantità, massa, plurale, lotto, grumo, grappolo, folla, offesa, pasta, Pasta
stabilito: installare, solido, fermamente, stabile, creazione, stabilire, incombente
coraggioso: grassetto
magro: magro, diluire, conico, restringere, magro, bene, sottile, finemente, leggero, Dannazione, rarefatto, delicato, valutare
soddisfatto: contento, soddisfazione, contentezza, lieto, soddisfare, soddisfacente
dai-un'occhiata: dai-un'occhiata, Guarda, orologio, scelta, esaminare, ispezionare, esame, test, revisione, intermedio, indagine, indagare, accertare, rivedere, controllo
virtù: gentilezza, virtuoso, bontà, benevolenza
nazionale: nazione, nazionalità, etnico, domestico
divine: sacro
valle: bacino
indovina: inferenza, sospettare, presumere, stima, stima, predizione, predire, previsione, speculare
speculativo-umore: ipotetico-umore
giallo: pallido, ambra, biondo
resti: residui, residuo, rimanente, avanzi, riposo
piegato: curvo, piegare, meandri, tendenza, ritorto, pendenza, inclinata, inclinazione, pieghevole
scatola: valigia, cassetto, fondo, kit, lattina, bidone
la-stagione: Stagionale, capitolo, stazione, epoca
la-scienza: scientifico
foro: foro, trapano, noioso, noioso, forare, infastidire, foro
zio: 
lista: indice, catalogo, menu, registro
agosto: 
popolare: prevalenza, famoso, prominente, popolare
sconosciuto: sconosciuto
familiare: conoscenza, lignaggio, discendente
familiare-registro: 
lettore: cantante
approccio: raggiungere, accesso, tecnica, tattica, metodologia, atteggiamento, modo, metodo, moda, procedura, approssimazione, interfaccia
due-volte: raddoppiare
intellettuale: mente, intelligenza, mentale, intelligente, psichiatrico, pensatore, saggezza, spirituale
veramente: davvero, infatti, di-preciso, in-realtà, in-pratica, potenzialmente, vero, sincero, realistico, perfettamente, decisamente, certo, certamente, certamente
sacerdote: clero
ferito: ferito, ferita, male
tristezza: dolore, tristezza, depressione, depresso, lutto, angoscia
palazzo: 
battere: la-sconfitta, punch, schiaffo, battere, sbattere, ritmo, superare
eh?: 
scemo: sciocco, trucco, ingannare, imbrogliare, stupido, stolto, pazzo, pazzo, folle, indurre-in-errore
bordo: orlo, frangia, marginale, intenso, confine, margine, bordo
nove: nono, nuovo
scoppiare: esplosione, esplosione, esplodere, screpolato, boom, convulsione, scoppio
soffrire: sopportare, sostenere
rumore: rumoroso, gridare, confusione, ruggito
letteratura: letterario
consigli: consiglio, raccomandare, raccomandazione, consigliare, consultazione, bordo, mancia
vuoto: vuoto, vacante, tamburo, tempo-libero, nullo, vuoto, vuoto, vano
rango: inviare, grado, realizzazione, categoria, valore, classe
tempesta: 
tasca: borsa, pacchetto
immaginazione: fantasia, immaginare, assunzione, fantasia, finzione, immaginario
frase: sentenza, sentenza, proposta, teorema, suggerimento, proposta, punizione, convinzione, frase, condannare, denunciare, calcio-di-punizione
novembre: 
dicembre: 
assenza: assente, la-mancanza, carenza
ringraziare: gratitudine, grato, Grazie, grazie
indirizzo: 
uccello: volo, aereo, getto, aereo, aereo, linea-aerea
proprietario: capo, proprietario
cappotto: toga, guaina, coprire, giacca, pelliccia
preparare: pronto, preparato, organizzare, preparazione, formulare
relazioni: relazione, relazione, rapporto, rilevanza, riferirsi, affare, comunicazione, comunicare
fumo: fumo, tabacco, bruciare
gennaio: 
macchina: macchinario, motore, aereo, veicolo
soddisfare: materiale, cose, soddisfare, soddisfare, contenere, includere, consistere, coinvolgere
denti: dente, ingranaggio
vergogna: disonore, si-vergogna, timido, imbarazzato, imbarazzante, imbarazzo, spoglio, nudo, insulto, indignazione
baia: bacca, vagina
cervello: mente, midollo
anello: meschino, comporre, arricciare, ciclo-continuo, pneumatico, pneumatico, foca, francobollo
frase-marcatore: 
piazza: 
frutta: 
tè: 
spiegare: la-spiegazione, illustrare, esprimere, articolare, dichiarare, chiarire, interpretare, commento
ben-arrivata: saluto, reception, intrattenere, Ciao, Salve, salutare
poesia: poesia, versetto
acquistare: acquisto, acquisire, permettersi, mercato
fedele: disonesto, leale, fedelmente, devoto, correggere, affidabile
eccitazione: stimolazione, ECCITATO, confusione, tensione, provocare, gioia, eccitazione, rossore, ansia
quaranta: 
aprile: 
gentilmente: per-favore, amichevole, delicatamente
ottobre: 
amaro: disagio, agonia, angoscia, amaramente, sofferenza, doloroso, puntura
schiavo: schiavitù
sciolto: indipendente, vagamente, risolvere, risolvere, allentato, vacante, liberamente
testo: formulazione
credito: mutuo, carta-di-credito, debito, prestare, prendere-in-prestito, prestito, prestigio, validità, credibilità
quindici: 
crudele: feroce, difficile
aderire: partecipare, assistere, coinvolti, imbarcarsi, aderire, partecipante, coinvolgimento, unire, collegare
processo: maneggiare, procedura, trattare, operazione, processo
crimine: colpa, offesa, offesa
polvere: diga, polvere
pratico: funzionale, pragmatico, in-pratica, conveniente, potenzialmente, a-portata-di mano, applicato
colore: colore, vernice, capriccio, colorante, pallido, colorato, colorato, rossore, finitura
distruggere: relitto, minare, sabotaggio, degradare, demolire, schiacciare, distruggere, rovinato, confondere, cancellare, negare, distruzione
aumentare: procedere, accrescere, montare, aumentare, aggiungere, inserire, crescita, ingrandire
naso: 
ammettere: riconoscimento, concedere, accettare, riconoscere, riconoscere, approvazione, approvare, concedere, premio
ieri: domani
hesternal-teso: 
fallire: fallimento, infruttuoso, la-sconfitta, contrattempo, incapace, confondere, deludere
continuare: procedere, continuo, persistente, continuazione, costantemente, persistere
indossare: trasportare, facchino
cieco: 
dozzina: parecchi
volare: volante, saltare, volo, aviazione
lode: ammirazione, ammirare, reputazione, merito, congratularsi-con, congratulazione, gloria, fama
diavolo: 
gradualmente: lentamente, graduale
sacrificio: vittima, preda, vittima
esercizio: Atletica, allenarsi, assegnazione, pratica, pratica, sport, fitness, prova
coscienza: pronome, coscienza
teoria: principio, teorico, teorema
ministro: 
odiare: cattiva, disgustoso, odio, avversione, pregiudizio, astio, risentirsi-di, disgustato, ripugnanza, disgusto
lago: 
centro: centrale, centro, stazione, quartier-generale
svenire: inconscio, disperazione, disperato, debole, pallido
razionale-Genere: 
attento: riflessivo, memore, concentrarsi, prudente, esatto, preciso, preciso, dettagliato
godere: godimento, apprezzare
culto: rituale
articoli: prodotto, voce, merce, merce, cose
Pelle: pelle, assorbimento, abbaiare, conchiglia, buccia, pelliccia, gusto
tetto: terrazza, soffitto, copertura, copertura, coperchio
corona: 
castello: gabbia, torre, chiudere-a-chiave
trono: 
allegato: impegnarsi, condizionale, allegare, collegato, dipendente, socio
miglio: tendenza, pendenza, magro, pendenza, disposto
estremo: massimo, finale, polo, polare, estremista, grave, intenso, intensivo, arto, mancia
prigione: prigione
tazza: boccale, ciotola
membro: organo, membri, arto, membro
civile: domestico, cittadino, civico, civile
ovunque: per-tutto, dovunque
evidente: ovvio, ovviamente, probatorio, diretto, apparente, decisamente, definito, chiaro, chiaramente, trasparente, non-chiaro, evidente
coppia: coppia, par, raddoppiare, doppio, pochi, parecchi, vapore
volume: bobina, molto, estensione, importo, relativamente, quantitativo, bloccare, partita, modulo, massa, capacità, copertura
costume: cliente, opzionale, costume, dogana, pratica, abitudine, abituato-a
arco: arco, cipolla, curva
tuta: adattarsi, costume, adeguata, accordo, corrispondere, accoppiamento, caso, accusa, lite, toga, Richiesta
carne: carne, Manzo
latte: latteria, rubinetto, gelatina
vegetale-Genere: 
visione: vista, trance, intuito, facciata, vista, intravedere, prospettiva, paesaggio, prospettiva
cottura-al-sangue: raramente, quasi
cugino: parente
ponte: grado, ponte
proteggere: protezione, conservazione, guardia, scudo, difendere, conserva, mantenere, conservare, sicuro
sale: esagerato, esagerare, salato
innocente: 
regina: 
contare: partizione, fare-i-conti, calcolare, fare-affidamento, delusione, conto
curiosità: leva
danza: tamburo, danza, saltare, saltare
albergo: alloggio, Locanda
riempire: 
prigioniero: 
negozio: negozio, stallo, attività-commerciale, affare, acquisti
le-scale: scala, scala, scala, cassetto
elemosinare: cerca, assumere, supplicare
sabbia: 
violento: violenza, feroce, turbolento, meraviglioso, grave, forte, intenso, vigoroso, selvaggiamente, intensivo
settembre: 
partenza: lasciare, partire, presa, produzione
rovina: distruzione, sovversione, danneggiare, rovinare, disastro, relitto
abilità: capacità, capace, capacità, efficacia, competenza, mestiere, competenza
bestiame: mucca
attrezzatura: apparato, dispositivo, kit, ingranaggio, attrezzatura, attrezzatura, hardware, tecnica, tecnologia, facilità, infisso
cucina: cucina, fornello
vendere: vendita, semi
velocità: velocità, ritmo, impulso, acutamente
conclusione: inferenza, ritiro, produzione, implicazione, risoluzione, risultato, conseguenza, collezione, concludere, proposta
computer: informatica
eterno: mai, per-sempre, infinito
limitato: finito, ristretto, confinare, delimitato, limitato, vincolare
biblioteca: libreria
base: fondazione, base, basato, fondamentale, primario, elementare, nucleo, di-base, fondo
confusione: pasticcio, caos, confusione, confusione
glorioso: brillante, bello, nobile
allo-stesso-modo: allo-stesso-modo, anche, ugualmente
spaventati: impaurito, impaurito, terrore, paura
infelice: sfortunato, sfortunato, miserabile
articolo: prova, voce
cuoco: cucina, infornare, Bollire
banda: cintura, nastro, nastro, squadra, gruppo, striscia, banda, zona, filo, mazzo, grappolo, corsia
deserto: natura-selvaggia, abbandonato
bacio: 
palla: gomma-da-cancellare, sfera, cannone, proiettile
bastone: azione, canna, aderire, Di-legno, legname, pipistrello, spunto
discussione: logica, movimento, ragionamento, controversia, discussione, discussione, controversia, tratto
osservare: ispezionare, esaminare, esplorare, indagare, osservazione
benedizione-umore: 
suggestivo: eccezionale, assordante, sciopero, considerevole, significativo, sostanziale, evidente, impressionante, sorprendente, sorprendente, chiaro, luminosa
colpevole: colpa, dovere, offendere, colpevole, galeotto
pistola: fucile, arma, cannone, torre
forze-dell'ordine: imporre, sorvegliare
nascondere: nascondere, secernere, travestimento
spedizione: campagna, guidare, viaggio, viaggio, viaggio, giro
ignorante: ignoranza, ignaro, ignorante, stolto, sciocco, stupido, ridicolo
generoso: liberale, accoglienza, benevolenza
nube: 
rifiuto: inutile, non-necessario, rifiuto, rifiuto, rifiuto, residui, avanzi, spazzatura
febbraio: 
malattia: malattia, malattia, coronario, soddisfacente, soddisfacente, sindrome
trascorrere: fiore, utilizzare, spesa, perseguire, saltare, Perdere
fonte: risorsa, crudo, Fontana
iniziativa-caso: 
zia: 
ritardo: rinviare
ritardato-imperativo: 
segnalati-probatorio: 
mezzanotte: nord
eroe: guerriero, campione
filosofia: filosofico
dito: dito-del-piede
confortevole: bene, a-fondo, propriamente, liscio, comodamente, conveniente, rilassante, piacevole, accogliente, a-portata-di mano
da-qualche-parte: dovunque
stampa: media, rivista, rivista, stampa, tipo, formula
personale: equipaggio, personale
ricompensa: premio, regalo, premio, premio
colpa: colpa, difetto, difetto, debito, colpa, affronto, perseguire, responsabilità, responsabilità
miseria: disagio, sofferenza, angoscia, miserabile, la-noia
fronte: 
anno-Domini: annuncio-pubblicitario, la-pubblicità, pubblicizzare, annuncio, annuncio, pubblicità, Avviso, dichiarazione
angelo: possidente, Fata
singolare-numero: 
alba: crepuscolo
commerciale: professionale, annuncio-pubblicitario, commercio, attività-commerciale
perdonare: scusa, perdono, tollerare, esonerare, alleviare, respingere
pecora: agnello
pazienza: forza-d'animo, pazienza
azienda-agricola: ranch, coltivare, piantagione, agricolo
referenziale: riferimento, fare-riferimento
mais: Grano, corno
chiave: legame, pulsante, chiave-inglese, interruttore, principale, vitale, prominente, delicato, principale, nicchia, corrente-principale, indizio
maggioranza: molti, maggior-parte
debolezza: incapacità
atmosfera: ambiente, cielo, aviazione, spaziale
sospiro: respiro
umanità: umano
opposizione: contrario, opporsi, avversario, contrasto, resistere, protesta, contrario, resistenza, contatore, avversario, disapprovazione, anti-, resistente, anti, obiezione
disco: disco, fetta, contatore, cilindro, piatto, disco, vassoio, guidare
solitario: da-sola, solitudine, separatamente, singolo, semplicemente
artista: esecutore, pittore, intrattenitore
cavaliere: ciclista
fascino: carismatico, attrazione, Magia, incantesimo
decisione: decidere, sentenza, verdetto, sentenza, determinazione, risoluzione, soluzione
governatore: prudente, righello
ramo: 
disposizione: disposizione, configurazione, tendenza, tendenza, fornitura, disposizione, stato-d'animo, programma, orario
entusiasmo: zelo, calore, entusiasta, gusto, euforia, passione, estasi, rallegrare
induttivo-umore: induttivo-umore, deduttivo-umore
comunità: società, categoria, la-gente
il-petrolio: grasso, carburante, fossile, midollo, termico, burro
tubo: tubo, rubinetto, rubinetto, cacca, canale
stampare: edizione, pressione, stampa, asse, muffa, impressione
Oh: ya
discorso-contesto: 
vocativo-caso: 
cabina: Cottage, tenda, casetta
allarme: campana, allarme, spaventare, terrorizzare
nervoso: teso, confuso, disturbare, irritato, imbarazzato, inquietante, molestare, sconvolgente, neurale, preoccupato, nervo
permanente: durata, frequentemente, regolarmente, persistente, costante, fisso, costante
coltello: gridare, lama
seta: 
disprezzo: disprezzare, odio, avversione, disgusto, ripugnanza, affronto, insulto, indignazione, negligenza
inferno: 
diviso: separato, a-parte, a-parte, distinto, differire, separatamente, distaccato, separato, isolamento, ostracizzato, delimitato, separazione
seriamente: grave, Cordialmente, pesante, pesantemente, acutamente, attivamente
misto: miscela, combinazione, composito, mescolare, comune
di-legno: Di-legno, legname
preferire: preferenza
avvertimento: Attenzione, avvertire, allarme, memoriale, Avviso
ammonizione-umore: 
impulso: ispirazione, impulso, partita, sollecitare, impulso, spinta
ambizione: deluso, delusione, lussuria, avido, scoraggiare, ambizioso
negare: rifiuto, rifiutare, negazione, rifiuto, negazione, rifiuto, negare, declino, disapprovare, respingere, vietare, bandire, vietare, contraddire
costituzione: carta, costituzionale
strumento: strumento, nave, entità, organo, contenitore, utilità
continuo-aspetto: 
marea: onda, schiocco
college: facoltà, accademia, città-universitaria, Università
coda: coda
generazione: discendente
gatto: 
diretto-probatorio: 
abbandonato: trascurare, lasciare, abbandonato, smettere, abbandono
undici: 
istinto: spontaneo
caratteristica: tratto, specialità, carattere, abitudine, tendenza, comportamento, comportamento, caratteristica, caratterizzazione, qualitativo, tipico
tribù: tronco, gambo, caricare
apprensivo-umore: 
riparo: ricorrere, residenza, insediamento, habitat, Residenziale, protezione, dormitorio, asilo
maleducato: duramente, ruvido, scortese
equitazione: cavalcata, ciclista
scuotere: Brainstorm
industria: settore, produzione, industriale, industrializzare
la-professione: professionale, carriera, occupazione, professionale
lampada: lampadina
caffè: bar
obbedire: sottomissione, soddisfare, ascolta
settentrionale: nord
infermiera: 
assicurare: garanzia, mandato, impegno, garanzia, assicurare, garantire, accertare, confermare, fornire, approvvigionare, certo, convincere, affermare, sicuro
catena: sequenza, serie, stringa, prigione
insegnamento: istruzione, educare, formazione
scarpe: scarpa, sandalo
yard: codice, pagina, corteggiamento
vago: ambiguità, oscuro, ambiguo, non-chiaro, misterioso, incerto, indefinito, onda, vacante
altrove: altro
appartamento: appartamento, cerchio, scomparto, suite
attività: transazione, funzione
Sabato: sabato
luce-del-sole: solare
vedova: 
elemento: aspetto, caratteristica, voce, ingrediente, organo
riflessione: contemplazione
organizzazione: fazzoletto-di-carta, organizzazione, organizzare, attrezzatura, società, utilità, agenzia, entità, sistema, struttura, struttura, disposizione, istituzione, istituto
stella: 
incidente: evento, evento, fenomeno, incidenza, incidente, caso
ospite: sconosciuto, visitatore, alieno, straniero, nuovo-venuto, cliente, cliente, ospite
bar: spoglio, pub, caricare, nolo, bar, bario
bottiglia: vaso
benedire: benedizione
agitare: manipolare, mescolare, evocare, rivolta
interno: entro, dentro, interno, interno, del-posto, domestico, interno, mentale, membro
fissare: fisso, regolare, rivedere, soluzione, risolvere, risolvere, rimedio, Migliorare, raddrizzare, ok, va-bene, costante, costante, fissare, correggere, determinare, stabilire, identificare, accertare
derivare: ottenere, acquisire, derivato, ottenere, ricevere
cavo: pianura, spoglio, vuoto, cavo
Provincia: provinciale
civiltà: 
appendere: 
shock: soffio, contrattempo, trauma, scioccante, scontro
eccezione: parziale, discriminazione, stereotipo, esenzione
sforzo: stress, tensione, caricare, fatica, sforzo, intensità
standard: criterio, criteri, tasso, livello, predefinito, norma, fisso, costante, costante, stabile, statico, sostenibile, standardizzare, modello
guida: guidare, autista, guida, gestione, cavalcata
sbarazzare: rimuovere, ritirarsi, eliminare, eliminazione, esonerare, alleviare, assolvere
giurare: giuramento
tesoro: gioiello
seme: sperma, Noce, particella
Torre: torre
favorito: favorito
da-poco-tempo: recente, appena, recentemente
recente-passato-teso: 
sveglio: consapevole, morale, svegliare, allarme
arredamento: 
corda: cordone, stringa, cinghia
avventura: avventurarsi, giocare
reali: regno
festa: partito, celebrazione, banchetto, vacanza
descrivere: descrizione, caratterizzazione, rappresentare, ritrarre, definire
sessanta: 
scala: portafoto, valutare, rapporto, scala, scala, scala
cerimonia: rituale, funzione
caccia: caccia, vittima, preda, inseguire, tiro
sussurrare: borbottio
in-gran-parte: sostanzialmente, in-modo-significativo, maggior-parte, principalmente, per-lo-più, molto, ampiamente, prevalentemente
cristianesimo: 
avvocato: rappresentante-legale, avvocato
dettaglio: diffusione, estendere, estensione, espansione, espandere, profondamente, dettagliato
Principessa: 
altare: santuario
tela: Rete, netto, griglia, fazzoletto-di-carta, tela, poster
porpora: magenta
raccogliere: raccogliere, accumulare, restringersi, comporre
elezione: scelta, eletto, pista, sondaggio, balena, selezione, scrutinio
concezione: nozione, concetto, concepire, percezione, percepire, concettuale, design, fermo, arresto, catturare
ubriaco: alcolico
versare: rovesciare, capannone, caduta, rovesciare
sollevamento: ascensore, elevare, sollevamento, aumentare, escursione
gesto: segno, segnale, simbolo, simbolico, atteggiamento, posizione
gestire: gestione, sorvegliare, maneggiare, amministrazione, governare, governare, controllo
scambio: scambiare, reciproco, barattare, sostituzione
definito-articolo: 
imperatore: monarca
remoto: lontano, lontano, distaccato
brutta: cattiva, disgustoso
innocuo: 
rotolo: pergamena, bobina
pollice: dogana, pollice
giornale: rivista, far-sapere, diario
barba: mancia, il-mento
lacrima: strappare
commissione: comitato, bordo
mentre: mentre, durante
incrocio: attraversare, giunzione, passaggio, passaggio, transizione, corridoio
indipendenza: indipendente, libertà, liberamente, la-libertà, autonomia
odore: puzza, profumo
diciotto: 
storico: storicamente, storia, storico
lordo: totale, aggregato, sporco, crudo, greggio
radice: gambo, appena
fango: suolo, limo, argilla, sporcizia, fiore
sposa: nonna
velo: tenda, navigare, andare-in-barca
Teatro: Teatro
confronto: confrontare, comparativo, correlazione, rapporto, confronto
rivale: avversario, dissidente, concorrenza, competitivo, competere
bilancio: equilibrio, ugualmente, uguaglianza, orizzontale, proporzionale, par, bilancio
allenatore: allenatore, professionista, precettore, mentore
umore: umore, umoristico, stato-d'animo, commedia
romanzo: finzione, nuovo, recentemente
la-vendetta: astio
geloso: gelosia, invidia
ruota: bicicletta, cerchio
bruciato: bruciare, svasato
flash: fulmine, ardere, brillare
creare: creazione, costruire, costruire, costruttivo, compiere, fabbricare, comporre, fucina, generare
conflitto: scontro, lotta, confronto, contrasto, schianto, urto
maledizione: 
imprecatorio-umore: 
indifeso: miserabile
positivo: positivamente
club: pipistrello, ceppo
inondazione: 
grano: cereale, Grano
indifferenza: apatia, sbadato, negligenza
orizzonte: 
presunto-umore: ipotetico-umore
ripido: elevazione, inclinata
armonia: compromesso, mettere-a-punto
tuono: 
infanzia: 
ginocchio: giro
software: applicazione, repertorio
ferita: male, danno, danneggiare, ferire, ferita, trauma, ferito, violazione
ricevuta: ricevere, Ingresso, reception, ammissione, accettazione, voucher, adozione
permettere: capace, competente, attivare, consentire, intitolare, trasportare, imporre, lasciare, autorizzare
protasi: 
scivolare: scivoloso, diapositiva, planata
rivoluzione: rivoluzionario, colpo-di-stato, rotazione, rivolta, ribellione
contadino: contadino
corsa: soffio, colpo-di-stato, corsa, corsa
piattaforma: palcoscenico, foro, fondazione
messaggero: delegare, ambasciatore, diplomatico
privilegio: privilegiato, preferenza, quota, franchigia, offrire, concessione
organizzato: istituzione, organizzare, istituto, disposizione, organizzare
studente: allievo, studioso, studente-universitario
grotta: 
tradizione: tradizionale, tradizionalmente, dogana, resa
tragedia: epidemia, tristezza
addio: arrivederci, addio
critica: criticare, critica, recensione
cotone: lana
ospedale: asilo
affitto: tariffa, assumere, tassare, omaggio, contratto-di-affitto, impiegare, impegnarsi, affittato, carta
gas: 
inevitabile: inevitabilmente
mortale: 
foglia: foglio, lama
pubblicazione: pubblicare, editoriale, stampa, proclamare, trasmissione, uscita, produzione, diffusione, edizione, annunciare
ostile: ostile, ostilità
la-traduzione: tradurre, Tradurre, interpretazione, epidemia, trasferimento
cerimonia-funebre: sepoltura, cimitero
Farina: polvere, pasta, esatto, preciso, preciso, pasto
corrispondenza: corrispondere, contatto, comunicazione, comunicativo
romantico: 
capanna: Cottage, casetta
proporre: posa, offrire, movimento, proposta, proposta, suggerire, raccomandare, suggerimento, offerta, nominare
mimetico: 
dollaro: 
luce-del-giorno: 
sedici: 
montaggio: incontro, conferenza, congresso, configurazione
colonia: 
ala: reparto, suite
leone: 
cultura: culturale
colonna: schieramento, strato, polo, passaggio
abile: difficile, trucco, abile
dramma: Fai-finta, drammatico
scherzo: scherzo, frizzo
nebbia: nebbia
medicina: droga, rimedio, spray, prescrizione
quattordici: 
acido: aspro, acida
cioè: qualsiasi, cioè, particolare
reddito: pizzo
vescovo: 
arancia: 
bagno: bagno, doccia, vasca
primitivo: presto, iniziale
cestino: bidone, borsa
la-segretaria: 
cannuccia: fieno
impaziente: desideroso
salvezza: sicurezza, liberazione, Salve
hodiernal-teso: 
avere-intenzione: destinato, intenzione, interessato, acuto, motivo, riluttante, dedicare, dedicare
vapore: vapore
veleno: velenoso, tossico, erbicida
talento: brillantezza, talentuoso, qualificazione, capacità, repertorio
clima: tempo
efficace: valido, efficacemente, efficiente, efficacia, influente, utile, praticabile
distinguere: differenziare, discriminare, discriminazione, differenziazione, assegnare, dividere, respingere, escludere, secernere
lavaggio: lavaggio
confessione: riconoscere, credo, riconoscimento
sciocchezza: sciocchezze, irragionevole, incongruo
carbone: carbonio
canoa: 
temporaneo: intervallo, durata, temporale, accidentale, mentre
delimitative-aspetto: 
osso: gamba
Lunedi: 
martedì: Terzo
mercoledì: quarto
federale: federazione, centrale
auspicabile: attraente, favorevole
rappresentante: rappresentare, per-conto, delegare, rappresentante-legale, vice, portavoce
biancheria: lino, biancheria-intima
lavello: annegare, bacino, zinco
nipote: nipote, nipote, nipote
sanguinoso: spargimento-di-sangue, sanguinare
assedio: circondare, posto-a-sedere
stomaco: pancia, addome, addominale, matrice
ottone: bronzo, rame, riso
vertice: picco, superiore, mancia
quinto: cinque
a-buon-mercato: a-buon-mercato, Basso
esclusivo-persona: 
sequestrare: attrezzatura, confinare, detenere, prenotazione, strappare, occupato, occupare, sequestrare, afferrare, stretta
recinto: siepe
statua: scultura
artiglieria: cannone
abbraccio: assorbire, rannicchiarsi
circostante: in-giro-per, Quartiere, vicino, vicino, Quartiere, periferica, dintorni, adiacente, vicino
rigorosamente: rigoroso, coerente, con-precisione, stretto, grave, certamente, assolutamente, decisamente, strettamente, duro
cervo: 
boscaglia: 
ferrovia: ferrovia, rotaia
scarico: liberazione, scaricare, uscita, rinunciare, espellere
erede: ereditare
quercia: 
antipatico: diletto, piacevole, inquieto, seccato, sconvolgente, cattiva, scomodo
invenzione: inventare, scoperta, innovazione
pianoforte: 
persuadere: convincere, celebrare, commemorare
invisibile: misterioso
notorio: famoso, famigerato, prominente
crudeltà: 
tentazione: 
Telic-aspetto: 
economico: economia, economicamente, economista, finanziario
internazionale: globale, multinazionale
interferire: interferenza, intervento, intervenire, disturbare, preoccuparsi, inquietante, interrompere, infastidire, irritare, molestare, scontro
filosofo: filosofico
elegante: alla-moda, delicato
benessere: benevolenza, prosperità, fornitura
la-pesca: 
rubare: furto, rapinare, rapina, rubare
labbro: becco, orale, orlo
andare-in-pensione: la-pensione, pensionato, pensionato, ritiro, riposo, tempo-libero, ritirarsi, dare-le-dimissioni
tratto: raddrizzare, estendere, tratto, tratto, pezzo, passaggio, frammento, pezzo
galleria: collezione
parallelo: a-fianco-di, compatibile, socio, apporre
atelic-aspetto: 
continente: continentale
proibitivo-umore: proibitivo-umore
cravatta: cravatta, aquila
cella: essenza, nucleo, gabbia, versione, mobile, cellulare, cellulare
uovo: testicolo
artificiale: sintetico
nel-frattempo: contemporaneamente
crisi: crollo, sentenza, sentenza, emergenza
gentile: cortesia, educato
il-pranzo: colazione, cena
pino: mascella
spingere: spremere, guidare, incoraggiare, promuovere, spinta, pressione
alleanza: unione, lega, coalizione, combinare, associazione
vita: anca, vita, vita, mezzo, medio, metà
miracolo: meraviglia
marinaio: 
purezza: castità
repubblica: democrazia
telefono: telefono, mobile
frusta: 
camicia: maglietta
introdurre: introduzione, presentazione, stabilire, iniziato, rendere, fornitura, raccomandare, rinvio, iniettare, consegnare, consegna, rappresentare, ritrarre
divano: poltrona
spazzata: pulire, rastrello, scansione
ladro: capo
conservare: conserva, prenotare, prenotazione, ripristinare, tenere, trattenere, detenere, resistere, impegnarsi, conservazione, sostenere, conservare, mantenere, aderire
canale: canale
personalità: carattere
riforma: miglioramento, correzione, evoluzione, emendare
minaccioso: minaccia, minacciare, pericolosi, spaventoso
palma: acero
altoparlante: portavoce
soglia: barriera
indurre: atrio, sollecitare, causa, avvertire, eccitare, posa, condurre, tentare, evocare
lancia: scorta
pulito: ordinata, pulire, teso
sessione: incontro, conferenza
tortura: sofferenza
umido: sporcizia, bagnato, che-cola, afoso
cresta: superiore, treccia, pila, pettine
viaggiatore: visitatore, viaggiatore, turista, passeggeri
mulino: fabbrica, produzione, piantare
carta-geografica: carta, diagramma, grafico, tariffa, biglietto
collare: circondare
sostituire: sostituzione, spostare, scorta, alternativa, sostituire, sostituzione, spostamento, alterare, variare, emendare, sub
deliberatamente: intenzionale, deliberare, a-conoscenza, consapevole, intenzionale
birra: pinta
velluto: 
gravità: attrazione, schiacciare
sermone: predicare
abuso: sbagliato, a-torto
gregge: gruppo, mandria, partita, sciame
tredici: 
giustificare: mandato, supplicare, avvocato, giustificazione, giustificato
Venerdì: argento, Venere
pennello: pettine
Scaricare: 
crema: gelato
scogliera: roccia, orlo
giuria: 
mostro: gigante, mostruoso
congelato: congelare
pentola: Pan, vaso, contenitore
penny: centesimo
insistere: ad-alta-voce, spinta, affermare, sottolineare, enfatizzare, persistere, insistenza, richiedere, discutere
mela: 
discutere: discussione, negoziare, discutere
sfondo: 
trascrivere: adattare, riscrivere
periodico: regolare, ciclico
divertimento: ricreazione, intrattenitore, tempo-libero, divertente, intrattenere, divertente, hobby
virus: 
infantile: soprano
riflettere: contemplazione, meditazione, meditare, illustrare, rappresentare
convertire: alterare, trasformare, interruttore, mutazione
contorno: profilo, contorno, sommario, schizzo, esporre, panoramica, bozza
opera: 
approvazione: approvazione, disapprovazione, consenso, accettazione, asserzione, approvare, approvare, adozione, applausi
tradire: svelare, ingannare, deludere
punire: galeotto
gomito: supporto
attaccamento: appendice, connessione, toppa, collegamento, connettore
riparazione: restauro, miglioramento, ricostruire, correzione
sospetto: sospetto, sospettare
settanta: 
Sacre-scritture: Bibbia, copione
fossa: foro, scavo, piscina
disturbo: caos, anarchia, agitazione, disturbo, pasticcio, sconvolgente, interferenza, imbarazzo
binario: diadica
abbazia: monastero
freccia: 
tendere: responsabile, di-solito, normalmente, tipicamente
elaborare: dettagliato, definire, chiarire, sviluppare, complicato, difficile, allenarsi
lealtà: devoto, leale, fiducia, fedelmente, onestamente, diffidenza, credibilità, fede, convinzione
coniare: valuta
tremare: brivido
esilio: sparare, all'estero
meccanico: macchinario, meccanico, ingegnere
trappola: presa, galeotto
torta: torta, biscotto, pasta
signore: Sig, signore, signore, signore
esitare: battere, infestare, frequenza, librarsi
diciassette: 
miele: 
palo: scommettere, proporzione, cuneo, mucchio, quota, frazione, contributo
battistrada: movimento, trucco, camminare, a-passeggio, pedale, passo, passo, gradino
mattone: piastrella
ottanta: 
purtroppo: sfortunato, sfortunato, purtroppo
consultare: consultazione, fare-riferimento
leggenda: mito
raccolto: raccolto
promozione: elevare, promuovere, introduzione, presentazione, pubblicità
stufa: fornello, lastra, forno
ribelle: rivolta, ribellione
antiquato: antica
rigonfiamento: gonfiare, gonfio, inflazione, gonfiore, ingrandire
palude: palude
condimento: salsa, bendare
ascetico: eremita
gestore: steward, capo, capo, amministratore, direttore, moderatore, capo, esecutivo
coro: guidare, squadra
razionale: giustificato, logica, logico, irragionevole, sensibile, ragionevolmente, ragionevole
lavorazione: 
lupo: 
tappeto: tappeto
antichità: 
fertile: 
fischio: flauto
formaggio: 
morso: tagliare, intagliare, puntura
invitare: invito
Cattedrale: tempio
porto: porta
vagare: passeggiare, migrare, escursione
colture: raccolto
Marina-Militare: marino, flotta
maschera: facciata, verme
matita: penna
vegetale: vegetariano
mostra: mostra, offrire, display, presentazione, sintomo, esposizione
i-pantaloni: pantaloni, pantaloni
corruzione: scandalo, inquinamento
gabinetto: credenza, armadio, armadio, gabinetto
la-minestra: 
chirurgo: chirurgia, chirurgico, operazione
assegno: sostituzione, sostituire, compensazione, apposizione, assegnazione, appendice
spiare: 
spericolato: sbadato, disordinato
pettegolezzo: voce, voce
gettone: 
astratto: sommario, programma
giovedi: 
traffico: circolazione, trasporto, mezzi-di-trasporto
architettura: 
crepa: fessura, screpolato, partire, smettere, frattura
ornamento: decorazione, decorativo, decorare, gioielleria, tagliare
inverso: contrario, inverso, interruttore, invertire, avverso, sottosopra, parte-posteriore
divertire: intrattenere, divertente, divertito
recupero: restauro, salvare, miglioramento, rinascita, recuperare, ripristinare, ricostruire
marciapiede: frenare, intonazione, catrame, limo, coprire
decisivo: cruciale, vitale, determinare, decidere, assertivo
negativo: avverso
festival: concerto
ridurre: riduzione, diminuire, alleviare, alleviare, minimizzare, degradare, barra, tagliare, sottrarre, confinare, limitare
tradimento: 
cacciatore: 
serpente: rettile
batteria: 
cera: candela
investigatore: investigatore
analisi: analizzare, la-ricerca, studio, esaminare, ispezionare, esplorazione, risoluzione, abbattersi, abbattersi
enfasi: enfatico, pressione, sottolineare, enfatizzare, stressato, accento, asserzione, Attenzione
nuotare: il-nuoto
busta-da-lettere: circostanza, avverbio, guaina
chi: chi, qualcuno, chi, nessuno
sigaretta: fumo, tabacco
motore: automobile, motore, motivo, motocicletta
volontario: dedicare, volontario
reazione: reattivo, risposta, rispondere, reagire, feedback
Bagaglio: bagagli, nolo, tronco, valigia
sordo: 
succo: estratto
umiltà: semplicità, modesto
ministero: 
sessuale: sesso, sessualità
diametro: 
ascia: 
diamante: 
alternato: scorta, alternativa, sostituire, opzione, vice, sostituzione, trapianto
eco: 
moderazione: trattenere, frenare, limitazione, restrizione, costrizione
identità: identificare, identificazione, simbolico
schermo: display, tenda
pigro: marcio
momentane-aspetto: 
compatto: accordo, solido, denso
deriva: operazione, deviazione, tendenza, tendenza
scomparire: estinto
raggio: fascio, corridoio, raggio
inchiostro: 
massiccio: di-grandi-dimensioni, grande, enorme, enorme, enorme, grande, enormemente
cantina: 
memorabile: prominente
bagliore: ardere, brillare, brillantezza
senato: parlamento
bara: 
perdono: 
rondine: sorso
indulgere: perseguire, soddisfare
swing: 
prato: pascolo, pre, prato
complesso: complicato, complicare, sofisticato, composto, difficile
dimissioni: dare-le-dimissioni, la-pensione
umile-registro: 
cospirazione: complotto
Pepe: 
pony: 
candidato: richiedente
volpe: 
camino: camino, pila
Giurisdizione: autorità, sentenza, sentenza, competenza
agricoltura: agricoltura, agricolo
precisione: precisione, castità, con-precisione, correttamente, veracità
ex-deceduto: 
democratico: 
germoglio: manopola, germoglio
coperta: soffitto, coprire, tappeto, copertura
grandinare: occupato, salutare
maiale: seminare
a-forma-di: figura, forma, Fico, sfaccettatura
avorio: 
classico: classico, tradizionale
osservatore: supervisore, visitatore
elefante: 
chiodi: chiodo
ape: 
seppellire: sepoltura, incorporare
attore: attrice, esecutore, attore
sudore: 
polacco: dialetto
illusione: frode
incertezza: incerto, ambiguità
secondario: minore, medio, media, moderare, corrente-principale, metà
piega: pieghevole
rurale: provinciale, campagna, abitante-del-villaggio
gemito: 
somigliare: simile, somiglianza, ricordare
citazione: estratto, preventivo, chiudere-le-virgolette, prestare, prendere-in-prestito, prestito
sacco: respingere, licenziamento, borsa
fastidio: disturbo, interferenza, interruzione, disagio, la-noia, preoccuparsi
ago: iniezione, siringa, stilo, perno
controllata: controllo
pollo: gallina
coerente: persistente, compatibile, calcestruzzo, implicito, adeguata, nicchia, pertinente, coerente, sequenziale, equilibrato, costante
barile: benna
abituale-aspetto: 
esperto: specialista, esperto, speciale, specifica
impressionare: influenzare, impressione, attirare
oliva: 
furgone: valvola
ostacolo: interrompere, costrizione, handicap, barriera, contrattempo
cenno: 
adottivo: coltivare, spinaci, promuovere, facilitare, alimentazione, favore, favore
definizione: commento, identificazione, descrizione, determinazione
compleanno: anniversario
martello: 
fragrante: 
ripetizione: pesante, destinazione, ripetere, replicare, prova
banale: meschino, senza-importanza
calcio: colpire, urto, calcio, calcio, calcio, soffio
scavare: scavare, trapano, scavo
animale-domestico: 
cranio: 
legislatura: parlamento, legislativo, legislazione
tallone: saltare
cipiglio: 
brevetto: 
miliardo: 
chimico: chimica, prodotti-chimici, chimico
pilota: sperimentare, sperimentale
imitare: simulare, simulazione, replicare, riprodurre
gonna: roccia
insolitamente: fuori-dal-comune, anormale, dispari, notevole, straordinario, incredibile, irregolare, fenomenale, incredibilmente, estremamente, stranamente
settimanale: 
tecnico: tecnica, tecnologia, tecnicamente, Tech
vegetazione: 
corvo: torre
Alba: 
tutta-la-vita: vita, sopravvivenza, filosofia-di-vita, vita
contribuire: contributo, donare, associazione, promuovere, facilitare
gancio: riferirsi, collegare, correlare, supporto
tigre: 
penetrare: forare, attraverso, influente
manicotto: braccio
autostrada: strada
milizia: 
fosso: trincea, albero
integrità: 
diciannove: 
biologico: 
teologia: 
galleggiante: barca, librarsi, flotta
strega: 
annoiato: noioso, la-noia
diplomatico: diplomatico
studio: etichetta, Officina, studio
superare: aggressione, stupro, superare, attraversare
Champagne: 
ispirare: incoraggiare, ispirazione, incoraggiante, inalare
bandiera: bandiera, poster, biglietto
divorzio: divorziato
bullone: fulmine, chiodo, twist, vite
vena: nervo
passivo: pubblico, Disabilitato
schiuma: bolla
ghiaia: 
grembiule: giro
pianeta: 
lo-scaffale: cremagliera, credenza
fan: 
tropicale: 
fase: fotografico, palcoscenico, periodo, costruire, passo
arbitrario: spontaneo
pronunciare: pronuncia, accento, espressione, totale
mercurio: 
strisciamento: strisciare, arrampicata, agnello
suicidio: 
reporter: giornalista
privare: privazione, revocare, escludere, sottrarre
qualificato: abile, efficiente, capace, talentuoso, esperto, qualificato, intelligente
balcone: terrazza, veranda
forchetta: 
dipendente: lavoratore, lavoratore, lavoro, fattore, dipendente, impiegato
datore-di-lavoro: capo
larghezza: a-grandi-linee, fornitura, largo, semi
irritata: seccato, ECCITATO, irritare, provocare, stimolazione
accusare: denunciare
pensione: la-pensione, sintassi
verbo: atto, reagire
scimmia: 
accettabile: accettare, accettazione, plausibile
firma: 
ortodosso: prudente
ironia: scherzo, twist
asilo-nido: piantagione
riluttanza: avversione
importare: introduzione
torcia: 
grammatica: grammaticale
depositare: accumulare
coloniale: 
yacht: traghetto, barca
consequenziale: conseguenza, episodio, importante, considerevole, principale, prominente, considerevolmente, significativo, sostanziale, significativo
cupola: 
spessore: 
testardo: assertivo
muscolo: 
grandezza: dimensione, massa, ampiezza, valutare, quantità
strofinare: 
vile: 
imbracatura: unire, fondersi, unificare, utilizzare, cintura
brindare: merenda
topo: ratto
sillaba: 
picchiettare: applaudire, battere
dialogo: comunicare, conversazione
neutro: neutro
diligenza: zelo, custodia
contraddizione: contraddittorio, controversia, ambiguo, confusione, controverso, ambiguità, paradosso, contraddire, varianza, obiezione
raggiungere: rendersi-conto, raggiungere, arrivare
capra: 
fiorire: prosperità, prosperare, boom, gioiello, gemma
imporre: vigore, imporre, determinare
anonimo: 
formale-registro: 
vitello: fretta
manuale: guida, linea-guida, marca, comando, manuale, istruzione, capo, supervisore
fusione: evaporare, scongelare, fusione
cancellare: cancellare, sciogliere, cancellare, rimuovere, escludere, abolire, eliminare, eliminazione
ombrello: paracadute
avvio: scarpa, tronco
minerale: iodio, nutriente, metallo
tregua: cessate-il-fuoco
anatra: 
pianificazione: 
sapone: 
Bambola: bambino, giocattolo
scheletro: 
villa: Fata
cucito: cucire, cucire
conciliare: mediare, unire, unificare
bollitore: 
maturo: adulto
coniglio: 
conduttore: scala, sovrintendente, autista, capo
dipendenza: dipendere, dipendenza, dipendente, dedito, affinità, atteggiamento
giocatore: esecutore
insetto: peste
ristorante: 
gufo: 
radicale: militante, estremista, progressivo
residente: abitante, nativo, domestico, indigeno
drago: aquilone
uditorio-probatorio: 
assetato: 
indugiare: prolungata
calcolo: calcolare, calcolo, informatica, calcolo, fare-i-conti, conto, censimento
regolamento: censura, controllo, costrizione, restrizione, insediamento
Sindaco: 
minoranza: 
acquisizione: ottenere, guadagno, acquisire, accesso, disponibilità
veterano: anziano
orchestra: 
Bacon: 
svantaggio: perdita, privazione, avverso, difetto, handicap
tessuto: stoffa, capi-di-abbigliamento, asciugamano, tela, fazzoletto-di-carta
musicista: compositore, musicale
mentalmente: spirituale, mentale, morale, mana, soggettivo
congiunzione: cooperare, connessione, composto, associazione, socio, combinare, coerente, a-fianco-di, continuità, linker
insufficiente: carente, insufficiente, deficienza, miserabile, inferiore, scomodo, ampio, sfortunato, incongruo, non-appropriato
architetto: 
limone: 
tosse: tosse
mal-di-testa: 
inquilino: progettista
fertilità: riproduzione
guarire: cura, Migliorare, accrescere, miglioramento, trattare
novanta: 
casuale: a-caso, rendi-casuale, accidentale
cucchiaio: benna
palloncino: 
gesso: gesso
induttivo-probatorio: 
editore: editore
aceto: 
cenere: grigio, grigio
espletivo: giuramento
ravvivare: rinascita
suscettibile: vulnerabile, delicato, sensibile, emotivo, responsabile
tunnel: metropolitana
puzzle: confondere, confusione
meccanismo: procedura, routine, sistematico, macchinario
matematica: matematica, matematico
dissolvenza: 
fegato: 
Sublative-caso: 
tuffo: immersione, incorporare, far-cadere, caduta, incidenza, pendenza, pendenza, inclinata, pendenza, bagnare
unità: unità, entità, modulo, becco, singolare
monopolio: esclusivo
gioco: giocare, gioco, incontro, autorizzazione, giocattolo
sottomarino: sott'acqua
terremoto: convulsione
laboratorio: laboratorio
sughero: fungo, fungo, berretto
se-stesso-controllo: 
Budda: 
maglia: lavoro-a-maglia, tessere, spinta, a-maglia, nodo, nodo, treccia
ambasciata: 
il-più-lontano: 
dichiarativa-umore: 
stimolo: incoraggiamento, incentivo, ricetta, motivazione, motivo
cioccolato: caramella
coincidenza: opportunità, combinazione, sfortunato, a-caso, accidentale, incontro
guanto: 
inginocchiarsi: 
geografia: 
investimento: investire, avventurarsi
verbale: verbale, orale, offensivo
analogia: uguaglianza, somiglianza, affinità, parentela, rapporto
secolare: posare
falco: aquila
psicologia: 
allacciare: riferirsi, legare, collegare, bendare, arresto, allegare
rottame: cancellare, sciocchezze, spazzatura, frammento
ruolo: puleggia, quota, azione, partecipante
dose: quantità
salmone: 
budino: 
magnetico: attraente
pompa: bomba
ossigeno: 
certificato: 
medaglia: 
retorica: 
raschiare: graffiare, pascolare
remo: pala, pinna
telescopio: microscopio
collana: la-sconfitta, incolla
ortografia: incantesimo
whisky: 
salice: pascolo
cammello: 
dilettante: 
Uscita: esportare, presa, emersione, produzione
biografia: 
asino: 
mensile: 
ignorare: trascurare, trascurare, respingere, ignoranza
vacanza: lasciare, vacanza, ricreazione, riposo
clic: cricca, schiocco
ovale: 
elastico: gomma-da-cancellare, flessibile
dizionario: lessicale, vocabolario
prosciutto: coscia, natica
arcobaleno: 
consumare: consumo, utilizzare, schierare
sputare: compagno, lingua
carro-armato: serbatoio, contenitore, I.V.A
collega: cooperativa, compagno, compagno, socio
farfalla: 
grafico: diagramma, grafico, grafico, grafica, programma, schema
gemello: raddoppiare, doppio
in-autonomia: indipendente, liberamente, a-parte
bambù: 
commerciante: rivenditore, venditore, venditore, mercantile
accumulazione: accumulare, collezione, concentrazione
ispettore: uditore, sovrintendente
boccone: frammento, fetta, po
incubo: sogno
la-marmellata: gelatina
Museo: 
alfabeto: alfabetico
spargimento: schierare, diffusione
incursione: occupazione, invasione, assalto, offensivo, inizio, dominante, bandire
rilevare: annunciare, svelare, rivelazione, esporre, annullare, pubblicare, scoprire
marcire: decadimento, deteriorare
aggressivo: disturbare, pasticcio, occupazione, aggressione, offensivo, assertivo
attrito: 
molo: 
ragno: 
patata: 
revisione: regolare, emendamento, rivedere, correzione, emendare, recensione, revisione
avidità: avido
precoce: presto, urto
moltiplicare: colpire, razza, urto
rotazione: ruotare, rotazione, spirale, filo, twist
statistica: statistico, figura, chiacchierare
calendario: programma, orario, diario, vista
nomina: nominare, appuntamento, selezione, fidanzamento
trilione: 
Attico: vento
affermativa-umore: 
applicazioni: 
nominale: 
insoddisfazione: 
infezione: infettare, infetto, transizione, trasmissione, infettivo
brocca: vaso
alzata-di-spalle: contrazione
pioniere: principale, avanguardia
omissione: predefinito, gaffe, deficienza, negligenza, trascurare, eliminazione
cavolo: 
atletico: Atletica, matematico, atleta
ubriachezza: lo-zucchero
idiophone: 
leva: leva
senatore: 
iris: 
formica: 
insetto: 
incinta: materno
precipitato: precipitazione, sedimento, velocità, urgente, accelerare
caviglia: 
classificazione: ordinare, classificare, classificatore
variabile: variare
avvolgere: pacchetto, pacco, pacchetto, pacchetto, bobina, involucro, coprire, copertura
Riccio: arricciare, scagliare, bobina, pergamena, elica
zolfo: zolfo, rotte
dettare: 
emergere: apparire, aspetto, sorgere, emersione, smettere
rana: 
eccessivo-caso: 
spugna: fungo, fungo
fastidioso: sconvolgente, disturbare, preoccuparsi, confusione, infastidire, noioso, fastidioso, inquietante
scoiattolo: 
macinare: metà, semi
irrealis-umore: 
vulcano: 
in-casa: interno, dentro, entro, premesse
exploit: utilizzare, assorbire, realizzazione, esplorare
geologica: 
passaporto: 
immorale: vizioso, marcio
biscotto: biscotto
cooperazione: cooperare, associazione, integrazione, assistere
tavoletta: proiettile, pillola, lastra
relax: allentato, rilassato, tempo-libero, rilassare, rilassante, ricreazione
atomo: atomico, particella, individuale
AIDS: aiuto, sollievo, ausiliario
piramide: 
ciclo: cerchio, circolazione, frequenza, rotazione, ruotare, bicicletta, bicicletta
pisolino: 
illegale: illegale
zampa: artiglio, dito-del-piede
timidezza: timido, contrazione
eclissi: oscuro
liuto: inclinazione
scopa: 
pannello: piatto, lastra, la-pittura, bordo, gruppo, comitato
astronomia: 
labirinto: 
borsa-di-studio: sponsorizzazione
tartaruga: 
consigliere: mentore, consigliare
fibra: fibra, impacchettare
cricket: 
piccione: 
adattamento: adattare, infisso, conformità, modifica, regolare
triangolo: 
tesoriere: 
idrogeno: 
fragile: delicato, croccante
stampante: 
soffocare: 
cronico: resistente
far-fronte: incontrare, adattare, affrontare, compensare, superare, attrezzatura, contrastiva, maneggiare
dilemma: 
ingegneria: tecnica, tecnicamente
macchina-fotografica: camera
scusarsi: scusa, perdono
leccare: 
ballerino: 
migrazione: migrare, immigrazione
tennis: 
colonna-vertebrale: 
friggere: 
telaio: chiusa, chiusura
pugnalata: puntura, forare, afferrare, tentativo, tentato
parola-d'ordine: segnale, spunto, slogan
emisfero: appuntito, mancia
strategia: strategico
quarzo: 
forbici: Tirare, trascinare
pattuglia: 
ghiacciaio: 
a-metà-strada: metà, in-parte, semi, mezzo, medio
memorandum: trattato, contrarre, convenzione, accordo, mandato
cono: conico
simmetria: 
fabbricante: produttivo, produttore, costruttivo
imputato: avvocato
moschea: 
scacchi: 
Pedaggio: carica, tassa, vittima, figura, complicazione
ciliegia: 
molto-diffuso: esteso, ampiamente, diffusione, largo, ampio
inciampare: caduta
camion: camion, nolo, cargo
senape: 
per-cento: per-cento, centesimo
vendita-all'asta: vendita
setaccio: 
instabile: instabile, instabilità, incerto, inquieto
magnete: 
succhiare: assorbire, bagnare
Islam: 
punta-di-piedi: dito-del-piede, pronto, disposto
membrana: 
farsi-la-barba: 
chitarra: 
lucente: luminosa, antimeridiano, brillante
olmo: 
librarsi: escursione, librarsi, gola, volo
pronome-marcatore: 
di-base: clip, supporto, essenziale, fondamentale, di-base, principale, principale, finale, primario
Spezia: gusto
cauzione: legame, garanzia, impegno, garanzia
vettore: vettore, attore, facchino
vibrazione: risonanza
stuzzicare: tentare, infastidire, irritare, affascinare
aratro: risolvere, zappa, dirottare
fisiologico: corporale
grondaia: drenare
cometa: colpevole
medievale: medio
passero: 
compensare: retribuire, compensazione, compensare, riscattare, trucco, trucco
plastica: 
nota: 
orbita: classe, aula, traiettoria
frugale: modesto
golf: 
zero: nullo
patata-fritta: pezzo, frammento, fetta, pezzo
opprimere: reprimere, reprimere, deprimere, sopraffare
sbadiglio: evaporare
disuguaglianza: 
talpa: sesamo, argilla
ceramica: 
casalinga: 
segale: 
disobbedire: violare
tollerante: tolleranza
embrione: pneumatico, pneumatico, fetale, feto, nucleo
minatore: minore
applaudire: apprezzare, applausi, applaudire
lievito: enzima, pasta
premio: premio, premio, premio
prugna: 
fallimento: fallimento
irrigazione: 
menta: caramella
capitalista: capitalismo
elasticità: flessibilità
squalo: 
reclutare: trucco, novizio
Conservazione: conserva, conservare, negozio, risparmio
realismo: 
zenzero: 
ambulanza: 
paragonabile: proporzionale, simile
portafoglio: portafoglio
smorfia: boccale, sorriso, guizzo
scienziato: scientifico, studioso, ricercatore, investigatore
intestino: intestini, intestino
equanimità: 
Radio: radio
non-pertinente: contraddittorio, non-appropriato, incongruo, senza-importanza
fagiolo: Noce, pisello, arachide, cereale
informale: 
nipotina: nipote, nipote, nipote, discendente
disaccordo: obiezione, discussione, controversia, dissentire
bistecca: tagliare
azoto: 
rasoio: 
contrasto: contrasto, contrastiva, contraddittorio, contrario, contrario
propaganda: proclamare, pubblicità, annuncio-pubblicitario, la-pubblicità, pubblicizzare
fuochi-d'artificio: 
pop: schiocco, scoppio
spogliarsi: 
solco: 
dannoso: danno, pericolosi, avverso
giudaismo: 
complemento: integrativo, attrezzare, aggiunta
lente: lenticchia, torcia-elettrica
pegative-caso: 
cancro: 
pegno: mutuo, soldato, impegno
docente: 
perdita: caduta, perdita, far-cadere
qualificarsi: idoneo, merito, meritare, qualificato, qualificazione
densità: affollato, intensità
induzione: 
masticare: 
loquace: comunicativo
aragosta: 
sconto: esenzione, vendita, concessione
Taxi: 
gerarchia: comando, sistema
giada: 
ringhio: 
lucertola: 
cascata: 
deludente: deprimente, delusione, deludere, deluso, cattiva
veto: rifiuto, traccia, rifiutare, respingere, disapprovazione, scommettere, trazione
presidenza: presidenziale
acquirente: cliente
gallone: 
zanzara: 
deviazione: deviazione, distorsione, compensare
lottare: competere
mosaico: 
spina: connettore, voucher
tozzo: accovacciarsi
drogheria: 
comunista: 
stupire: sorprendente, sorprendente, assordante, indurre-in-errore, confondere, stordire, confondere
prosecutive-caso: 
costellazione: galassia
dittatore: 
preoccupazione: occupazione, ansia, preoccupazione, preoccupazione
satellitare: 
pantofola: sandalo
consonante: 
approssimativo: approssimazione, circa, approximative
disoccupato: occupazione
sostenitore: assistente, ausiliario, sopportare, supporto
loto: 
lattuga: insalata, spinaci
cloruro: 
batteri: fungo, batterico
appiccicoso: viscoso
componente: 
nocciolo: 
fingere: Fai-finta, simulare
byte: 
secrezione: secernere
espressamente: chiaramente, apertamente, a-quanto-pare, ovviamente, decisamente
coincidere: incontro, adatto, adatto, accordo, accoppiamento
balletto: pinna
urina: pisciare
aglio: 
trascorso: passato, passaggio
economia: economia, recessione, risparmio
classe-media: 
agile: veloce, rapido, rapido, richiesta
tenaglie: pala, clip
lavanderia: lavaggio
fragola: 
urbano: civico
imbarazzare: scoraggiare, handicap, imbarazzante, confondere, confondere
quaderno: 
album: 
baseball: 
annusare: 
buffet: 
participio: partecipante, concorrente
box-auto: 
diagnosi: diagnostico, diagnosticare, conoscitivo, riconoscere
stampella: 
estorcere: ricatto, coraggio, vincolare
registrazione: disco, registro, registrazione, ceppo
solubile: sciogliere
fosforo: 
strutturale: struttura, configurazione, config
colla: 
tesi: dissertazione
artigiano: meccanico
banana: 
assioma: teorema, franco, apparente, ovvio, esplicito, principio
costola: ingranaggio
nichel: nessuna
pi: addio, torta, silicio
autobus: lasciare
censurare: censura
missile: razzo
salsiccia: hot-dog
manipolazione: operare, manipolare, operativa, trucco, imbrogliare, maneggiare
pomodoro: 
rafforzare: consolidare, intensificare, confermare
presa-di-corrente: ritiro, presa, connettore, nido
potassio: 
richiamare: andare-a-prendere, recuperare, ripristinare, restauro
virtuale: vero, reale, genuino
algebra: 
dentista: dente
ottico: visivo
muoversi: concessione, concessivo, movimento, in-movimento, spostare
biologia: 
disoccupazione: 
bruco: 
assolo: separato, fenomenale, separato, suolo, da-sola
del-browser: 
a-distanza-passato teso: 
storico-teso: 
nucleare: nucleo, atomico
spettro: 
sodio: 
isterismo: 
fiduciario: amministratore
ostaggio: mutuo, impegno
zucca: zucca, midollo
grinza: difetto
trasparenza: trasparente, esplicito, lineare
spuntone: cuneo, pizzo, mancia, chiodo
priorità: Attenzione
pedonale: a-passeggio
ateismo: 
tenere-sotto-controllo: traccia, sorvegliare, orologio, perseguire
collegio-elettorale: elettore, elettorato
sfrenato: 
sonda: esame, inchiesta, indagine, indagare, inchiesta, esplorazione, processo
platino: 
doppio-numero: 
polmone: 
super: fenomenale, enormemente, incredibilmente
carrello: trasporto, carrello, carro
localmente: del-posto
incitare: eccitare, infastidire
benzina: benzina
rene: 
bottino: rapina, saccheggio, preda, rovinare, rapinare, bottino
valutazione: stima, stima, valutare, grado
arsenico: 
lumaca: elica
cavalletta: 
equazione: formula, uguaglianza
socialista: parentela
filtro: 
sensoriale-probatorio-umore: 
allargare: espandere, largo, aggiungere, aumentare, accrescere, estendere, a-grandi-linee, risoluzione, estensione, espansione
emettere: lanciare, gettare, esalare, sparare, lasciare
guinzaglio: contratto-di-affitto, cinghia
mandarino: 
fantino: 
polmonite: 
solidarietà: unire, rally, affinità, unità, somiglianza
cerniera: dettagliato, ciclo-continuo
longitudinale: verticale
dividendo: assegnazione
pattinare: sciare
esponente: indice, esponenziale
invalidità: handicap, incapacità, difetto, imperfetto, Disabilitato, difetto, macchia
ossessione: molestare
assegnazione: assegnazione, assegnare, fornitura, quota, assegnazione
fotografo: fotografico
delta: partecipare
digitale: figura, cifra, numerico
cagna: 
palpebra: 
diagonale: 
subconscio: 
sopracciglio: 
starnuto: 
ilare: allegro, divertente, lieto, divertente, divertente, divertente, divertito, umoristico, ridicolo
induismo: 
profugo: immigrante
navetta: navicella-spaziale, trasporto, trasporto, mezzi-di-trasporto
proteina: albume
cumulo-di-rifiuti: mucchio, pila, bandire, sciocchezze, spazzatura
raffinare: 
vomito: 
gene: geneticamente, genetico
matricola: 
sociologia: 
schiacciare: zucca, schiacciare
pescatore: 
regionale: contea, area, zona, reparto, sfera, settore, periferica
movimento-salita: 
retrospettiva: passato, introspezione
tornado: 
inversione: invertire, contrario, reciproco, inverso
tv: televisione, film
cubo: 
produttività: prestazione, produzione
carota: 
molecolare: molecola, substrato
conglomerato: cricca, gruppo, grappolo
contabile: uditore
cetriolo: opzione, gola
orgia: 
solvente: sciogliere
fosfato: 
Primer: esca, conoscenza, introduzione
alcalino: 
ginnastica: fitness
virgola: coma, partito
movimento-discesa: 
aborto-spontaneo: aborto, Basso, fallimento
baccello: conchiglia, guaina, buccia
donatore: 
manganese: 
psicologo: 
cloro: 
tastiera: 
elite: 
parentesi: 
rugby: 
ulcera: dolorante, ferita, trauma, Bollire
flesse: 
sgranocchiare: 
quantistico: importo, quantità, quota, proporzione
maglione: giacca
evolutiva: sviluppo, evoluzione
notazione: segno, simbolo, Nota
rimbalzo: boom, saltare
dissezione: assegnare, sezione
nascondiglio: 
lineare: lineare
antimonio: 
superessive-caso: 
tumore: tumore, massa, urto
erosione: 
alfa: 
ombelico: pancia, polo
immune: respirazione, resistente
influenza: influenza, che-cola, febbre, influenza
fabbrica-di-birra: 
semplificare: 
abbreviare: limite, confinare, limitare
ammaccatura: grumo, urto, dente
affascinare: catturare, affascinare
costringere: vincolare, vigore, imporre, applicazione
calzino: 
film: film, cinema, nastro, nastro, banda
cosmo: universo
inquinare: inquinamento, infettare
gregario: 
pene: sesso
silvicoltura: 
alluminio: alluminio
oscillazione: fluttuazione
oroscopo: 
espellere: getto, espellere, cacciare, deportare, secernere, spostare, sottrarre
inclusione: registrazione, integrazione, incorporare, coprire, includere, copertura, implicazione, coinvolgere, coinvolgimento
beneficiario: incombente, utente
delfino: 
killer: 
mammifero: 
indicatore: posizione, indice, criteri, indice, valutare
biossido: 
colon: 
burocrazia: burocratico
distorcere: indurre-in-errore, corsa, distorsione
frigorifero: frigo
archeologico: archeologia, archeologia, fossile
inaccettabile: disapprovazione
specificazione: norma, standardizzare
opuscolo: bollettino, volantino, foglio
antropologia: 
gustoso: delizioso
transitivo: scusa, transizione
accasciarsi: strisciare
girasole: 
pidocchio: zecca, po
ione: 
turismo: turista, viaggiare
modem: 
accelerazione: promuovere, facilitare, stimolazione
falsificare: confondere, fucina
emissione: sporco, problema
rapire: dirottare, conduzione, strappare
sovrapposizione: interazione, interattivo
parrucchiere: 
folclore: Grano
capillare: 
nazionalismo: nazionalità
natiche: anca, natica
motivo: tema, argomento, motivo, motivo
sublimare: 
frustrazione: contrattempo, disperazione, delusione, confuso, cancellare
cobalto: 
avena: 
movimento-a-monte: 
ano: 
bovino: 
capovolgere: tradurre, Tradurre
ridondanza: abbondanza, residuo, eccesso, respingere, licenziamento, esenzione
video: 
boicottare: contea, ostracizzato, trascurare
quiz: tentativo, esame, questionario
hockey: 
guerriglia: 
magnesio: 
radar: 
scimpanzé: 
affidabilità: credibilità
rettangolo: 
fuco: 
generalizzare: generalizzazione
coprifuoco: 
omosessuale: 
scenario: copione, paesaggio
formulazione: costruire, costruire, costruttivo, formulazione, creazione, formazione, formulare
reincarnazione: 
infiammare: 
uranio: 
Catcher: recettore
coordinata: coordinazione
contribuente: 
integrato: integrante
opinato: vista, opinione, osservazione
gamma: 
safari: cavalcata, viaggio, viaggio, viaggio
movimento-a-valle: 
coefficiente: grado, fattore
titolo: titolo, argomento
analista: analizzare
scacco-matto: 
centro-commerciale: supermercato
bismuto: 
cartolina: saluto
convergenza: approssimazione, convergere
divagare: ritiro, partire
azionista: compagno
microbo: 
genitale: 
morfologico: genetico, morfologia
beta: 
jeans: 
Banca-dati: 
calcolatrice: informatica
raggi-X: 
parse: 
ambientale: paesaggio, dintorni, ambiente, contesto, ecologico, Quartiere, Quartiere, contorno
sigma: 
disgiunzione: isolamento, separazione, abbattersi, abbattersi
ordine-del-giorno: programma, programma, programma-scolastico
Visa: 
infrastruttura: 
lucciola: 
rivelatore: 
adattabile: 
biologo: 
giuntura: apporre, emendare, allegare, collegare
bromo: 
palladio: 
singhiozzo: 
pastello: pallido
zoo: 
clinica: 
connotazione: implicazione, significato, semantico, nozione, concetto, senso, contesto
yoga: somma
libreria: libreria
terapia: trattamento, trattare, cura, rimedio, terapista
nazionalista: etnico
decapitare: 
sì: sì
problematico: problema, problema, complicazione
jazz: 
tungsteno: 
terrorista: militante, terrore
dribblare: limo
metabolismo: 
alimenti: 
fine-settimana: 
crisantemo: 
vaccino: commento, copertura
motociclo: motocicletta
Mantra: 
semestre: termine
eroina: 
cartella: 
catodico: 
ideologia: pensato
parcheggio: 
theta: 
anticlimax: delusione
selenio: 
Ciclismo: circolazione, ciclo-continuo, ciclico, bicicletta, bicicletta
corteccia: abbaiare, conchiglia, buccia
equivalenza: uguaglianza
corrente-rilevanza-marcatore: 
aeroporto: 
amputare: interrompere
pallacanestro: 
impostore: 
scarafaggio: 
cromo: 
litro: litro
ciò-nonostante: tuttavia, ancora, però, comunque
ormone: 
imperfetto: la-mancanza, deficienza, imperfetto, sbagliato, falso, carente
perforare: forare
animismo: 
poligono: angolo
femminista: 
coniugare: pendenza, collegato
euro: 
ginseng: 
algoritmo: 
laser: 
farmacia: 
millimetro: millimetro
flettere: piegare, curvo, flessibile, favorevole, cavo
anodo: 
sfumatura: ombra
mezza-giornata: 
sensibilità: 
dimostratore: 
elio: 
bilingue: 
acronimo: breve, brevemente, restringersi
sigla: 
gerundio: 
plasma: 
cromosoma: 
ordinale: giunzione, riga, regolare, sequenziale
chilometro: chilometro
fax: 
genetica: genetico, geneticamente
lentiggine: 
cacciavite: chiave-inglese
broccoli: 
preterito: 
vitamina: 
cadmio: 
bombardiere: 
grafico: 
titanio: 
sfoggiare: vantarsi
lambda: 
fidanzata: compagno, fidanzato, amante, ragazza
accoppiarsi: 
clessidra: 
empatia: simpatia, compassione, comprensione
boro: 
elicottero: 
tellurio: scandio, lantanio
scadenza: termine
allineare: 
centimetro: 
molibdeno: 
litio: 
multimedia: 
aggiornare: modernizzare, rinfrescato
caloria: 
robot: 
compiti-a-casa: 
logaritmo: 
mantide: 
installare: montare, installare, sintesi
amino: 
glifo: sollievo
aoristo: indefinito
ecologia: ecologico
sofisticare: rovinare
marijuana: 
micro: sottile, piccolo, piccolo, diminutivo, microfono
chilogrammo: 
mangiare-troppo: 
prevedibile: predizione, predire, previsione
pizza: 
origliare: 
linguistica: linguistico
taglio-di-capelli: 
iridio: 
razzismo: razziale
ottimale: superiore, ottimale
industrializzazione: industrializzare, industriale, produzione
sede-centrale: quartier-generale, posto-a-sedere
cerio: 
congruenti: amichevole, adatto, favorevole, compatibile, simile
partitivo-caso: 
cassetta: nastro
forza-di-volontà: volontà, volere
dimensionale: dimensione, forma, dimensione, spaziale
parametro: 
sincronizzare: sincronizzare
massimizzare: massimo, accrescere, esagerare
seminario: Officina
discoteca: piatto
neon: 
osmio: 
Epifania: 
plagiare: furto
artefatto: 
reattore: 
origano: 
plutonio: 
ittrio: 
accrescitivo: 
nome-utente: 
postlaurea: 
ala-destra: 
argo: 
fobia: terrore, soggezione, infestare, disgusto
socializzare: comunicare, interagire
globalizzazione: 
lunghezza-d'onda: 
codificare: codice
riciclare: usato
ricomincia: riavvio
epatite: 
toro: grumo
chemioterapia: religioso
modulo: muffa, modulo
protone: 
dischetto: 
milligrammo: 
pixel: 
tantalio: 
soluto: decidere
genocidio: 
predatore: feroce
gallio: 
zirconio: 
determinante: determinare, definire, investigatore
non-lineare: 
pesticida: 
berillio: 
neurone: 
predicativo: assertivo
mutande: biancheria-intima
fattoriale: facoltà
neutrone: 
niobio: 
germanio: 
simile-a-metallo: metalloide
mettere-sopra: 
prolative-caso: 
biodiversità: 
joystick: 
antibiotico: 
attinio: 
astronauta: spazio
extraterrestre: alieno
picchiatello: stupido, pazzo, pazzo, folle, anormale
maratona: 
itterbio: 
autismo: 
ionizzare: 
radon: 
Nerium: 
epidemiologia: 
vecchiaia: anziano
campeggio: campo
strisce: banda, schema, progettista
indio: 
veridico: sincero, puro, netto
sito-web: sito-web, luogo, profilo
Corano: 
posate: 
nth--root: 
lawrencium: 
diritti-civili: 
cellulare: cellulare, cellulare
paralizzato: 
protactinio: 
radiazione: ardere
dipendere-sopra: 
torio-atomo: tulio-atomo, terbio-atomo, rodio-atomo, rubidio-atomo, vanadio-atomo, fluoro-atomo, polonio-atomo, tallio-atomo, stronzio-atomo, rutenio-atomo
blu-jeans: 
pianta-della-casa: 
individualmente: personalmente, individuale, personale, separatamente
flusso-di-corrente: 
triple---point: 
corpo-umano: 
fisica: fisico, fisicamente
Al-dettaglio-negozio: 
cesio: 
lungo-fa: 
foglio-elettronico: 
di-unità-di massa: 
compilare: 
binary--valore: 
umano-essere: 
di-si-intende di: 
depan-dari: 
praseodimio: 
cartone: carta
finito-verbo: 
prova-numero: 
professionista-condanna: professionista-frase
critico: critico, criticamente
imballaggio: involucro, pacchetto
impermanenza: instabile
a-maggior-parte: 
descrittore: descrizione
neodimio: 
amicizia: amichevole, alleato
leggi-solo: 
fonda: 
gnomic-umore: 
fonema: 
razionalità: coscienza, logica
fonologica: 
pranzo-camera: 
vita-camera: 
centrico-caso: 
pre-hodiernal: 
paziente-caso: 
obliquo-caso: 
rurale-la-zona: 
recurse: 
in-mezzo-voce: 
meitnerio: 
postino: 
senza-impegno: appartamento
azione-mercato: 
identificabile: identificazione, identificare
goal-grilletto: 
un-secondo: 
lative-caso: 
razione: porzione
non-umano: 
vita-cosa: 
pure-piccolo: 
cinema: cinema
hassium: 
attenuante: 
multal-numero: 
latteo-modo: 
nettunio: 
ghostwriter: 
trans-numerale: 
ingannare--around: 
americio: 
mattina-gloria: 
pompiere: 
berkelium: 
galassia-Genere: 
Nobelium: 
Ciao-ciao: addio, arrivederci, fin-quando
buddismo: 
fermium: 
ciano: magenta
soia: 
distributore: 
crumiro: 
processore: 
abessive-caso: 
adessive-caso: 
a-caso: a-caso, a-caso
agentive-caso: 
rutherfordium: 
anticorpo: 
come-tanto-come: 
agente-grilletto: 
attore-ruolo: 
etidio: 
Comune-Genere: 
accompagnatore: 
cartamo: 
francium: 
erbio: 
passivo-voce: 
astato: 
masticazione-gomma: 
stella-Genere: 
citazione-modulo: 
curio: 
fumetto: 
daltonico: 
euler's--number: 
Guarda-a: 
attraversamento-pedonale: via
campo-di-battaglia: 
automobilista: autista
corto-circuito: 
verbale-sostantivo: 
piangere-su: 
statisticamente: statistico
yogurt: 
xeno: 
ipnotizzare: 
prendere-via: 
Clausola---coda: 
diretto-oggetto: indiretto-oggetto
drogheria-negozio: 
consistere-di: 
ergative-caso: 
in-lingua: 
di-prima-mano: diretto
locative-caso: 
piscina: piscina, bacino
avverbiale-caso: 
giro-turistico: viaggio, ispezionare, circolazione
televisione-impostato: 
finale-particella: 
evitative-caso: 
reinserimento: 
regressione: ritorno, ritiro, ritiro, contrattempo
bloccare-di-appartamenti: 
svegliare-su: 
polizia-ufficiale: 
giuro--in: 
intervistatore: colloquio
renio: 
aerosol: 
possessivo-caso: possessivo-caso
nominalizzazione: sostantivo
posseduto-caso: 
sovraccarico: 
ausiliario-verbo: 
primario-oggetto: 
virus-informatico: 
uomo-d'affari: attività-commerciale-persona, mercantile
un-persone: la-gente, popolare
antessive-caso: 
primo-ministro: 
lutezio: 
europio: 
emote: 
musica-popolare: 
poeta: 
ufficio-postale: inviare, posta
presumibilmente: assunzione, porre-come-ipotesi, presumibilmente, a-quanto-pare, probabile
animare-Genere: 
subessive-caso: 
pedale-dell'acceleratore: 
polarità: polare
veicolo-Genere: 
minerale-Genere: 
verbo---suffisso: 
appassionato: emozione, emotivo, sensoriale
samario: 
facilitatore: moderatore
immaginario-unità: 
velocità-della-luce: 
air--force: 
empatico-gioia: 
punto-critico: 
tempo-pieno: 
afnio: 
inibizione: trattenere, frenare, inibire, vietare
cambiamento-di-evento: 
olmio: 
diverso-evento: 
universo-Genere: 
località-Genere: 
virtuale-macchina: 
ricerca-Genere: 
artistico-Genere: 
crastinal-teso: 
astratto-Genere: 
esocentrica-caso: 
transitivo-verbo: 
morfema: 
sciovinista: 
passato-perfective: 
professionale: specialità, professionale, occupazione, mestiere, professionale
indiretto-discorso: 
secondo-linguaggio: 
a-essere: 
cimitero-spostamento: 
collettivo-sostantivo: 
absolutive-caso: 
paziente-grilletto: 
se-stesso-fiducia: 
feci: sgabello, cacca, sporcizia
riflessivo-voce: 
impersonale-verbo: 
seaborgium: 
spazio-bianco: 
modale-caso: 
inanimato-Genere: 
causativo: 
propositivo-umore: 
elettrico-corrente: 
associativo-caso: 
superlativo-caso: 
pure-tanto: 
planetario-Genere: 
animato-cartone-animato: 
reciproco-voce: 
legiferare: legislazione, legislativo, organizzare, organizzare
a-meno: 
grammaticale--case: 
utente: 
nucleo-benefactive: 
portiere: 
:-except-for: 
denominatore: 
else-if: 
lateralmente: a-parte
l'un-l'altro: l'un-l'altro, reciproco
successivo-clausola: 
usura---out: 
corti: 
disprosio: 
presto-futuro-teso: 
SI-unità: 
krypton: 
mendelevio: 
applicativa-voce: 
antipassive-voce: 
continuativo-aspetto: 
radiazioni---malattia: 
necessitative-umore: 
singolo-azione-verbo: 
automotrice: 
superlativo-grado: 
esistenziale-clausola: 
californio: 
presente-participio: 
luminoso-intensità: 
singulative-numero: 
grammaticale---oggetto: 
passivo-participio: 
eccessivo-durata: 
supercritico-fluido: 
quantità-di-sostanza: 
postpositional-caso: 
elettivo-quantificatore: 
gadolinio: 
epenthetic-morfema: 
negatory-quantificatore: 
einsteinium: 
artificiale-linguaggio: 
connettivo-particella: 
a-distanza-futuro teso: 
frequentative-aspetto: 
distributivo-pronome: 
allogamento-accordo: 
calvo: spoglio
sobborgo: frazione, campagna
universale-quantificatore: 
computer-programmazione: 
televisione-programma: 
virgola-mobile-- numero: 
esistenziale-quantificatore: 
il-giorno-dopo domani: 
alternativa-quantificatore: 
di-cattivo-umore: ruvido
passato-passivo-participio: 
il-giorno-prima ieri: 
locative-direzionale-caso: 
controfattuale-condizionale: 
