infinito: ni
nominativo-caso: na
accusativo-caso: ka
argomento-caso: ta
Ciao: ca
genitivo-caso: sa
aggettivo: ci
e: wa
me: mi
tu: ya
noi: nlah
esso: yi
destinazione-caso: ti
dativo-caso: pa
interno-contesto: tu
persona-contesto: pi
dipendente-clausola: yu
perfective-aspetto: fa
passato-teso: ki
maschile-Genere: si
comitative-caso: mwih
presente-teso: ma
benefactive-caso: pwah
essive-caso: swih
non: nu
la-sua: tsih
superficie-contesto: su
adpositional-caso: pu
luogo-caso: te
spazio-contesto: no
modo-caso: ra
strumentale-caso: se
interrogativo-umore: ri
e-o: to
esclusivo---o: ku
fonte-caso: so
ablativo-caso: lwah
espansivo: di
ma: la
femminile-Genere: ne
plurale-numero: lu
futuro-teso: we
sociale-contesto: mo
imperfective-aspetto: me
Là: klah
condizionale-umore: co
Di-più: kcoh
parente-caso: nwih
illative-caso: lwih
direttiva-umore: de
deontica-umore: da
domanda-parola: slah
copula: ksah
persona: psoh
altro: tcoh
numero: do
molto: tcah
orario: trah
tempo-contesto: ro
temporale-caso: mrah
di: ke
epistemica-umore: pe
solo: twuh
poi: pcah
hortative-umore: twah
retrospettiva-aspetto: rwih
volitiva-umore: li
prima: tceh
a-seguito-di: ba
alienabile-possesso: lyih
inalienabile-possesso: nlih
deliberativo-umore: drih
perlative-caso: pwih
progressivo-aspetto: psih
Qui: tcih
sotto-contesto: ce
delative-caso: dwih
semelfactive-aspetto: mweh
neo: nyoh
messa-a-fuoco: fo
amore: pyah
paucal-numero: ploh
perché: yo
causale-caso: ksih
nome: gi
corretto-sostantivo: tsah
hortative: re
visibile-probatorio: crih
desiderativo-umore: dwah
terminative-caso: twih
inessive-caso: nweh
imperativo-umore: prih
credere: kcah
stato-contesto: ga
speranza: cwah
Factive-probatorio: fwih
ottativo-umore: pcih
Realis-umore: le
potenziale-umore: tlah
allativo-caso: lweh
antropico-Genere: fi
soggetto: wo
stesso-soggetto-marcatore: cyah
diverso-soggetto: fe
la-paura: ko
dubbio: cu
dubitativa-umore: tweh
interesse: nyih
Vialis-caso: wi
strano: trih
cambiamento: ryih
contento: clah
tranne: swah
desiderio: kwah
lunghezza: lo
probabilità: bi
accordo: grah
problemi: mlah
quotative-caso: kwih
inclusivo-persona: lwoh
precative-umore: rwah
gentile-registro: brih
potenziale-aspetto: tfah
gnomic-aspetto: go
incoativo-aspetto: zi
jussive-umore: jwih
permissivo-umore: mwah
corretto: kcih
distale-espansivo: tseh
distributivo-caso: nwah
determinato: treh
dolore: droh
saggio: ja
possessivo-marcatore: srah
commissivo-umore: mu
sorpresa: crah
completive-aspetto: kweh
rabbia: nrah
orgoglio: brah
scusa: pceh
coraggio: krah
grazia: nreh
movimento: mroh
ansioso: cwih
cessazione-aspetto: za
intensificatore: tfih
probatorio-caso: ryah
giù-di-morale: syah
altrimenti: tyah
Zoic-Genere: zo
eventive-umore: nwoh
stesso-evento-marcatore: cwoh
moltiplicativo-caso: plah
sorpreso: prah
pietà: lyah
massa: mlih
soddisfatto: srih
virtù: be
speculativo-umore: po
familiare-registro: krih
ferito: frah
tristezza: proh
eh?: nyah
ringraziare: kyah
vergogna: ru
frase-marcatore: fyah
fedele: cyih
eccitazione: tyeh
hesternal-teso: tleh
odiare: tyih
razionale-Genere: tlih
estremo: kreh
vegetale-Genere: slih
curiosità: kyih
spaventati: kcuh
articolo: myah
benedizione-umore: bwih
colpevole: dlih
ignorante: nrih
generoso: drah
iniziativa-caso: twoh
ritardato-imperativo: ji
segnalati-probatorio: psah
colpa: dlah
miseria: kfah
singolare-numero: gu
perdonare: pfah
pazienza: je
referenziale: freh
solitario: kyoh
fascino: croh
entusiasmo: tsuh
induttivo-umore: tcuh
discorso-contesto: ye
vocativo-caso: bo
disprezzo: grih
ammonizione-umore: tyuh
ambizione: bwah
continuo-aspetto: nyeh
diretto-probatorio: troh
apprensivo-umore: pcoh
shock: cruh
recente-passato-teso: clih
definito-articolo: klih
geloso: ryuh
imprecatorio-umore: mrih
indifferenza: du
presunto-umore: syih
ferita: kroh
protasi: rwoh
ostile: cyuh
mimetico: mreh
cioè: gwih
hodiernal-teso: dloh
delimitative-aspetto: dweh
esclusivo-persona: kwuh
Telic-aspetto: tfeh
atelic-aspetto: tsoh
proibitivo-umore: jrih
tortura: nroh
lealtà: nloh
momentane-aspetto: myeh
perdono: jrah
umile-registro: myih
ex-deceduto: frih
citazione: wu
fastidio: zrah
abituale-aspetto: bu
consequenziale: kseh
diligenza: dyih
formale-registro: sreh
uditorio-probatorio: creh
congiunzione: ksoh
induttivo-probatorio: flih
espletivo: sleh
Sublative-caso: swoh
dichiarativa-umore: ksuh
verbale: kceh
affermativa-umore: fwah
insoddisfazione: dyah
idiophone: dyoh
eccessivo-caso: zwah
irrealis-umore: ze
timidezza: cyoh
adattamento: pyih
pronome-marcatore: ryeh
opprimere: zroh
equanimità: jyah
pegative-caso: pweh
prosecutive-caso: pwuh
preoccupazione: byah
participio: pfih
a-distanza-passato teso: dzah
storico-teso: sroh
isterismo: syeh
doppio-numero: dluh
sensoriale-probatorio-umore: xi
movimento-salita: ryoh
retrospettiva: txih
movimento-discesa: myoh
flesse: blih
superessive-caso: psuh
transitivo: t6
frustrazione: xrah
movimento-a-monte: truh
movimento-a-valle: txah
disgiunzione: xo
anticlimax: tloh
corrente-rilevanza-marcatore: xa
acronimo: qi
sigla: nl6h
gerundio: ge
preterito: preh
aoristo: broh
partitivo-caso: pxih
Epifania: pf6h
accrescitivo: xe
fobia: xyoh
determinante: txeh
predicativo: plih
prolative-caso: pxah
veridico: vyih
binary--valore: vrih
finito-verbo: vi
prova-numero: pc6h
professionista-condanna: r6
amicizia: va
gnomic-umore: kxih
centrico-caso: dreh
pre-hodiernal: x6
paziente-caso: qa
obliquo-caso: bwoh
in-mezzo-voce: tyoh
identificabile: xyah
goal-grilletto: groh
lative-caso: dvah
non-umano: n6
attenuante: nyuh
multal-numero: mloh
trans-numerale: ts6h
galassia-Genere: gjah
Ciao-ciao: jwah
abessive-caso: bvah
adessive-caso: dvih
a-caso: kxah
agentive-caso: dveh
agente-grilletto: greh
attore-ruolo: nruh
Comune-Genere: k6
accompagnatore: kloh
passivo-voce: pyoh
stella-Genere: qrah
citazione-modulo: xu
verbale-sostantivo: xlih
Clausola---coda: kluh
diretto-oggetto: rweh
ergative-caso: gvih
in-lingua: byih
locative-caso: kwoh
avverbiale-caso: vlah
finale-particella: nluh
evitative-caso: ve
possessivo-caso: kfih
nominalizzazione: mleh
posseduto-caso: djah
ausiliario-verbo: fyih
primario-oggetto: myuh
antessive-caso: nleh
animare-Genere: xrih
subessive-caso: bvih
veicolo-Genere: vlih
minerale-Genere: xwih
verbo---suffisso: kxeh
empatico-gioia: pfeh
cambiamento-di-evento: qrih
diverso-evento: txoh
universo-Genere: bjih
località-Genere: lyeh
ricerca-Genere: txuh
artistico-Genere: s6
crastinal-teso: sl6h
astratto-Genere: sruh
esocentrica-caso: zrih
transitivo-verbo: tfoh
passato-perfective: tr6h
indiretto-discorso: dyeh
secondo-linguaggio: sr6h
collettivo-sostantivo: kxoh
absolutive-caso: bvuh
paziente-grilletto: pruh
se-stesso-fiducia: swuh
riflessivo-voce: flah
impersonale-verbo: pseh
modale-caso: dleh
inanimato-Genere: djih
causativo: kruh
propositivo-umore: pxoh
elettrico-corrente: breh
associativo-caso: sloh
superlativo-caso: sluh
planetario-Genere: pxeh
reciproco-voce: syoh
nucleo-benefactive: kfeh
else-if: kyeh
successivo-clausola: lyoh
presto-futuro-teso: rwuh
applicativa-voce: pyuh
antipassive-voce: ps6h
continuativo-aspetto: tfuh
necessitative-umore: nr6h
singolo-azione-verbo: qyah
superlativo-grado: tluh
esistenziale-clausola: sy6h
presente-participio: vrah
luminoso-intensità: kyuh
singulative-numero: glih
passivo-participio: pfoh
eccessivo-durata: kxuh
quantità-di-sostanza: m6
postpositional-caso: pwoh
elettivo-quantificatore: vwih
epenthetic-morfema: p6
negatory-quantificatore: gwah
connettivo-particella: qyih
a-distanza-futuro teso: tl6h
frequentative-aspetto: f6
distributivo-pronome: bzih
allogamento-accordo: ks6h
universale-quantificatore: xlah
virgola-mobile-- numero: fu
esistenziale-quantificatore: sweh
alternativa-quantificatore: l6
passato-passivo-participio: xyih
locative-direzionale-caso: kfoh
controfattuale-condizionale: fyoh
