addio: Ciao-ciao, Ciao, pi, addio
il: 
di: fra, di, la-sua
a: venga, deve
in: 
:-first-person: 
io: me
:-third-person: 
che: esso, quale
il-suo: la-sua, proprio
lui: esso
con: 
per: di, in-direzione
come: quale, esempio, Come
:-second-person: 
essere: 
lei: la-sua
in-data: chiamata, di
a: cavallo
di: passaggio, e, di
avere: orso
o: né
da-parte-di: 
Questo: esso
lui: la-sua
lei: essi, esso
il-mio: il-mio, me
i-loro: la-sua, essi
così: così, presto
un: 
loro: essi, tu
noi: noi, me
chi: chi, quale
voluto: pensare, portare
volere: forza-di-volontà
no: non
Se: se, fornito
su: al-di-sopra, salire, su, peggio
in: uno
qualsiasi: cioè, quale, tutti, a-testa
il-tuo: il-tuo
che-cosa: né, quale, cosa
indicativo-umore: direttiva-umore
uomo: persona, marito, maschio
di: Di-più, di, Come
i-nostri: molla, noi
alcuni: piuttosto
su: a-seguito-di, al-di-sopra, su
può: capace
adesso: presente
come: Come, amore, tenere
lattina: capace, poteva, scatola
dovrebbero: deve
ha-fatto: fare, fatto
come: così
un: uno
queste: essi, esso
al-di-sopra: al-di-sopra, Di-più
molto: molto, volume
Sig: signore, maestro
Buona: bellissimo, ottimo, genere
maggior-parte: Di-più, in-gran-parte, maggioranza, molto
deve: deve
quelli: essi, la-sua
lui-stesso: proprio, stesso, loro-stessi
vita: abitare, tutta-la-vita, vocale, vita
senza: 
compiere: fare, creare
bene: confortevole, destra
discorso-marcatore: 
attraverso: passaggio, penetrare
potrebbe: energia, forse, poteva
anche: molto, anche
ancora: poi, indietro, una-volta
molti: maggioranza
ogni: a-testa, quale
la-gente: persona, comunità, un-persone
pensato: ideologia, idea, pensare
sotto: fuori-uso
ancora: Di-più
luogo: individuare, posizione, dove
mentre: mentre, orario, temporaneo
appena: solo, semplice
anche: anche, allo-stesso-modo, Di-più
ancora: ma, né, ciò-nonostante, Di-più
contro: in-direzione, prima
ottenere: incontrare, prendere, derivare
mai: eterno, mai, sempre
via: chiuso, lontano, su, coperto
faccia: superficie, centinaio, persona
un-altro: ultimo, altro
sinistra: lontano
nuovo: neo, romanzo, fresco, nove, giovane
Sig.ra: 
mettere: impostato, ultimo, dare
raccontare: dire
mente: intellettuale, pensare
pochi: coppia, piccolo
chi: quale, chi
lontano: lontano, remoto, molto
chiamato: pensare
totale: completo, tutti
entrambe-le-parti: due
trova: trovato, ricerca
Guarda: vedere, dai-un'occhiata, colpo-d'occhio
lasciare: autobus, emettere, dare, permettere
signore: maestro, signore, re
casa: casa
qualche-cosa: Niente, piuttosto
momento: orario
padre: padre
tra: fra
donne: femmina
madre: mamma
fine: finito, ultimo, in-ritardo
piccolo: piccolo, micro
tu: tu
volere: deve
però: ma, ciò-nonostante, anche-se
abbastanza: interamente, piuttosto, molto, abbastanza
di-chi: quale
migliore: meglio
io-stesso: me, loro-stessi
fin-quando: anche, prima, Ciao-ciao
da: poi, primo, perché
usato: vecchio, riciclare
piuttosto: anziché, piuttosto, Di-più
Di-meno: breve, fuori-uso, meno
entro: interno, in-profondità, in-casa
insieme: impostato
di-grandi-dimensioni: ottimo, massiccio
importa: cosa, soggetto, domanda
certa: determinato, destra
se-stessa: loro-stessi
metà: a-metà-strada, macinare, lato
vero: veramente, fatto, destra
nulla: qualunque, piuttosto, Niente
tenere: tenere, impostato, conservare
moglie: femmina
si-intende: modo
vicino: passaggio, quasi
stato: condizione, inserire, nazione, governo
da-sola: solitario, assolo, uno
caso: cadere, esempio, tuta, incidente, perché
ti: tu
alto: al-di-sopra, pavimento
ragazza: figlia, femmina, fidanzata
certo: assicurare, destra, veramente
infatti: veramente, fatto
si: loro-stessi, proprio, se
lungo: associato, lungo, lunghezza
terra: nazione
ritorno: regressione, indietro, rimborso
lasciare: partenza, vacanza, abbandonato, lontano, autorizzazione
entrambi: anche
legge: destra, legale, regola
posare: impostato, secolare, Aiuto
punto: individuare, azione, solo, paragrafo
bambino: bambini
desiderio: speranza, desiderio
parlare: dire, parlare
durante: orario, mentre
parecchi: dozzina, coppia, Di-più
attività-commerciale: commercio, negozio, azienda, lavoro, commerciale, movimento
modo: modo, approccio
secondo: altro
generale: comune, generalmente, pubblico
alle-spalle: indietro
diventare: venga
morto: morire, morte
terra: nazione
ragazzo: figlio
sentire: sensazione, sentire
spirito: anima
verità: fatto
terra: pavimento, nazione, individuare
davvero: veramente, molto, fatto
riposo: altro, comfort, andare-in-pensione, resti, vacanza
diverso: vario, differenza, altro
possibile: forse
umano: persona, umanità
cittadina: città
a-seguire: Il-prossimo, seguire, a-seguito-di
bisogno: necessario, deve
causa: ragionare, indurre, perché
sera: notte, pomeriggio
cinque: quinto, anno
forte: energia, capace, violento
signora: femmina
in-giro-per: circostante, quasi, di, occhio
turno: lato, impostato, ordine
senso: significare, sensazione, connotazione
chiudere: chiuso, quasi
carattere: caratteristica, personalità, marchio, natura
ordinare: classificazione, genere
vista: visione, inoltrare, scena, vedere, colpo-d'occhio
partito: festa, virgola, nazione
bene: ottimo, magro
pronto: preparare, già, punta-di-piedi, finito
conto: ragionare, fattura, calcolo, contare
scritto: scrivere
età: vecchio, secolo
altro: altro, ultimo, altrove, Di-più
vigore: energia, costringere, imporre
attraverso: al-di-sopra, di-fronte
presto: precoce, inizio, primitivo, presto
sole: 
dopo: futuro, poi, a-seguito-di, Il-prossimo
ogni-cosa: tutti
passato: trascorso, retrospettiva, ultimo, a-seguito-di
atto: fattura, verbo, azione, lavoro, movimento
ulteriore: inoltrare, Di-più, aggiuntivo
al-di-là: Di-più, su
nessuno-dei-due: né, quale
vista: opinato, colpo-d'occhio, vedere, visione, scena, calendario
suono: voce
nessuna: Niente, nichel
chiaro: aprire, evidente, suggestivo, leggero
strada: autostrada, modo
vero: virtuale, fatto, reale
quasi: quasi, di
conoscenza: informazioni
verso: in-direzione
cattivo: peggio, Male, povero
vita: abitare, vita, tutta-la-vita
pace: camera
Basso: breve, a-buon-mercato, aborto-spontaneo
nord: risposta, settentrionale, mezzanotte
naturale: natura
bella: bellissimo, molto, abbastanza
fiera: destra, relazione, dieci
servizio: servire, cura
qui-di-seguito: fuori-uso
piacere: contento
storia: storia, data, storico
Nota: ricorda, notazione
sebbene: anche-se
anteriore: di-fronte, inoltrare, prima
grande: ottimo, massiccio
certamente: rigorosamente, corso, veramente
vento: aria, Attico
ricevere: ricevuta, prendere, derivare
Attenzione: cura, priorità, messa-a-fuoco, considerare, enfasi
forza: energia
probabilmente: forse
lieto: contento, ilare, soddisfatto
importante: necessario, consequenziale
te-stesso: proprio, loro-stessi
compagno: collega, amico
opinione: opinato, idea
fede: credere, lealtà
fa: est, poi, prima, inoltrare, indietro
carica: Pedaggio, spese, prendere
braccio: mano, povero, manicotto, braccia, spalla
quest'ultimo: ultimo
oggetto: scopo, Niente, soggetto
signore: maschio, signore, maestro
particolare: particolarmente, cioè
quasi: non, quasi, cottura-al-sangue
capo: gestore, capo
opportunità: coincidenza, posizione, occasione, probabilità
affare: piano, negozio, accordo
pensiero: pensare
pesante: ripetizione, il-peso, seriamente, difficile
pianura: aprire, semplice, cavo
subito: una-volta, presto
bocca: persona
impaurito: spaventati, la-paura, ansioso
singolo: uno, solitario
gioia: contento, eccitazione
rotte: zolfo, tagliare
a-meno-che: tranne
trasportare: orso, indossare, portare, permettere
influenza: effetto, influenza
apparire: emergere, sembrare
al-di-fuori: su, tranne
per-favore: gentilmente, chiedere
aspetto: emergere, sembrare
lentamente: gradualmente, in-ritardo
periodo: fase, orario
sorella: fratello
battaglia: combattimento, guerra
ex: vecchio
gioventù: giovane
semplicemente: solo, semplice, solitario
raggiungere: approccio, raggiungere, venga
sistema: ordine, gerarchia, organizzazione
cena: notte, il-pranzo
in-seguito: futuro, a-seguito-di
camminare: battistrada, partire, pavimento, piede
meraviglia: miracolo, strano, sorpreso
solito: generalmente, comune, sempre
figura: digitale, statistica, a-forma-di, numero, Pedaggio, immagine
antica: vecchio, antiquato
il-rispetto: considerare, onore, Pericolo, in-direzione
Terzo: tre, martedì
rimanere: restare
società: sociale, comunità, azienda
risultato: conclusione, effetto
comando: ordine
semplice: solo, semplice
accanto: passaggio, Il-prossimo, tranne
silenzioso: silenzioso
perfezionare: corretto, ottimo
Via: modo
scrittura: scrivere, lettera
Di-legno: di-legno, albero, bastone
rapidamente: presto
Avviso: vedere, anno-Domini, avvertimento
luminosa: acuto, leggero, lucente, suggestivo
barca: nave, galleggiante, yacht
nobile: ottimo, glorioso
improvviso: ad-un-tratto
valore: di-valore, rango, importanza
dovuto: perché
lettura: leggere, domanda
d'accordo: accordo
attesa: aspettarsi, tenere, restare
pezzo: patata-fritta, parte, tratto
ex: vecchio
conversazione: parlare, dialogo
opportunità: occasione, posizione
costo: spese, paga
considerevole: ottimo, consequenziale, suggestivo
sedersi: restare
superiore: ottimale, cresta, al-di-sopra, vertice
matrimonio: sposato
passo: azione, battistrada, fase
inizio: inizio
per: a-testa, in-direzione
individuale: persona, individualmente, atomo
difficile: difficile
po: parte, piccolo, pidocchio, boccone
discorso: parlare
autorità: Giurisdizione, energia
felicità: contento
fornire: fornito, dare, assicurare
studio: imparare, analisi, studio
personale: privato, individualmente, personale
orologio: dai-un'occhiata, tenere-sotto-controllo, vedere
contento: soddisfatto, contento
caldo: caldo, fuoco
sforzo: provare, sforzo
preparato: preparare, già
tentativo: provare, quiz, pugnalata
veloce: presto, agile
sotto: fuori-uso, a-seguito-di
destinato: avere-intenzione, messa-a-fuoco, scopo
dritto: direttamente, semplice
probabile: con-facilità, probabilità, forse, presumibilmente
giustizia: destra
semplicemente: solo, semplice
fiducia: credere, lealtà
passaggio: parte, incrocio, colonna, passaggio, tratto
chiusa: chiuso, telaio, coperto
noi-stessi: loro-stessi
passaggio: passaggio, trascorso, incrocio
medio: secondario, significare
possesso: Proprietà
piacevole: confortevole, genere
perfettamente: interamente, veramente
di-solito: comune, generalmente, tendere
tomba: difficile
fisso: fissare, anche-se, standard, permanente
truppe: esercito
incontro: sessione, montaggio, incontrare
campo: campeggio, campo
nazione: nazione, nazionale
esistenza: presenza
risposta: risposta, rimborso
cielo: atmosfera, Paradiso
pari: stesso, grado
fortuna: destino, condizione, Proprietà
dominio: campo
situazione: posizione, condizione
mezzo: significare, a-metà-strada, vita
inverno: freddo
consentire: autorizzazione, permettere
pallido: giallo, colore, svenire, pastello, aprire, leggero
in-esecuzione: gara, correre
religioso: religione, chemioterapia
condurre: indurre, portare
movimento: battistrada, discussione, muoversi, movimento, azione
fermare: interruzione, stare-in-piedi
verbale: dire, verbale, parlare
bordo: salire, pannello, consigli, bordo, commissione
vano: gratuito, vuoto
perdita: svantaggio, perso, perdita
offrire: fornito, proporre, dare, mostra, servire, privilegio
classe: genere, orbita, rango
completare: completo
accesso: visita, approccio, acquisizione
passione: entusiasmo, sensazione
fisico: fisica, corpo
esempio: esempio
cominciare: inizio
dispetto: rabbia
grave: ottimo, seriamente, estremo
argento: i-soldi, Venerdì
sufficiente: abbastanza
principale: capo, maestro, chiave, originale, di-base
meraviglioso: strano, violento, ottimo
il-percorso: modo
significato: connotazione, significare, importanza, soggetto
adattarsi: tuta, corretto
lotto: massa, molto, destino
posto-a-sedere: sedia, assedio, sede-centrale
gioco: gioco, giocare
dichiarazione: espressione, relazione
sogno: incubo, dormire
roccia: scogliera, gonna, pietra
speciale: particolarmente, privato, esperto
tassa: spese, Pedaggio, paga
quota: parte, palo, ruolo, distribuire
diffusione: dettaglio, molto-diffuso, spargimento, ragionare
gloria: onore, lode
spazio: posizione, sala, campo, astronauta
ordinario: comune, semplice
prendere-in-considerazione: pensare, considerare
molto: molto, in-gran-parte
ufficiale: ufficiale
tasso: standard, onore, corso
segno: notazione, gesto, marchio, individuare
nativo: natura, originale, residente
lavoro: dipendente, lavoro
sposare: sposato
estensione: limite, volume, grado
metodo: modo, una-volta, approccio
eccellente: meglio, ottimo
fiducia: credere
di-preciso: veramente, particolarmente, completo, interamente
vasto: ottimo
fantasia: immaginazione, bellissimo
rapido: presto, agile
sì: sì, così
libertà: gratuito, indipendenza
interessante: disegnare, curioso
a-parte: diviso, lateralmente, tranne
puro: fresco, veridico
circa: al-di-sopra, di, considerare
probatorio: le-prove, evidente
lontano: lontano, remoto
simile: somigliare, stesso, congruenti, paragonabile
restringere: magro, breve
tutto: interamente
pagina: lato, yard
in-particolar-modo: particolarmente
montagna: collina
orgoglioso: orgoglio
chiaramente: espressamente, aprire, evidente
prezzo: onore
malato: malato
sentenza: decisione, frase, regola, giudice, Giurisdizione, crisi
accettare: accettabile, ammettere, prendere
specie: genere
cercare: ricerca
onore: onore
orecchio: autorizzazione
fondo: fuori-uso, pavimento, base
aiuto: AIDS, Aiuto, supporto
completamente: completo, interamente
diletto: contento, antipatico
importo: quantistico, volume, folla, numero
ottenere: acquisizione, derivare, prendere
tassare: affitto, linea
attraversare: incrocio, passaggio, superare
sconosciuto: ospite, strano, straniera, sconosciuto
osare: coraggio
crescere: salire
falso: menzogna, sbagliato, malato, imperfetto
alto: lungo, pavimento
cancello: porta
liberamente: indipendenza, gratuito, in-autonomia, sciolto
soffio: shock, corsa, tiro, calcio
moda: approccio, venga
quotidiano: giorno
distribuzione: distribuire
ricchezza: i-soldi, Proprietà
la-libertà: gratuito, indipendenza
anticipo: progresso
dolce: morbido, dolce
certamente: corso, veramente
sicuro: al-sicuro, proteggere, assicurare
occupato: sequestrare, grandinare, impegnato
palcoscenico: piattaforma, azione, fase, condizione, scena
porzione: parte, razione
lingua: lingua, sputare
arrabbiato: rabbia
trasporto: treno, carrello, navetta
tempo: clima, aria, orario
necessità: importanza
pratica: esercizio, azione, costume
Richiesta: richiesta, tuta
Principe: duca
gruppo: impostato, conglomerato, gregge, banda, pannello
per-tutto: ovunque
aggiungere: allargare, aggiuntivo, aumentare
pregare: chiedere
principale: consequenziale, maestro
grigio: colore-marrone, cenere
frequentemente: di-frequente, ripetuto, permanente
famoso: popolare, notorio, vocale
potente: energia, capace
vivo: abitare
debole: svenire, povero
materiale: soddisfare, soggetto
franco: onesto, assioma
calore: estate, caldo
guardia: proteggere, cura
ugualmente: bilancio, stesso, allo-stesso-modo
naturalmente: natura
notevole: strano, insolitamente, ottimo
luna: mese
leggero: piccolo, con-facilità, leggero, magro, breve
stile: leggero
appuntito: emisfero, acuto
principio: teoria, assioma, inizio
immediato: presto, direttamente
disposto: già, punta-di-piedi, miglio
conseguenza: consequenziale, effetto, conclusione
gara: morbido, accordo, gara
interessato: avere-intenzione, interesse
trimestre: piede
avanzato: al-di-sopra, inoltrare
a-quanto-pare: espressamente, presumibilmente, sembrare
attivo: lavoro, azione
a-conoscenza: deliberatamente, sapere
pericolosi: Pericolo, dannoso, minaccioso
calma: silenzioso
sacro: divine, santo
regno: reale
intero: interamente, tutti, completo
simpatico: bellissimo
abitudine: caratteristica, modo, costume
diretto: evidente, direttamente, di-prima-mano
in-realtà: veramente, fatto
udito: sentire
a-passeggio: battistrada, piede, pedonale
gettare: emettere, lanciare, tiro
saggezza: intellettuale
guidare: guida, coro, spedizione, spingere, correre, disco
colpa: colpa, sbagliato
affare: cosa, soggetto, relazioni
contatto: corrispondenza, toccare
stazione: stare-in-piedi, centro, la-stagione
ascolta: sentire, chiedere, obbedire
male: ferita, dolore, ferito
esprimere: espressione, spiegare
favore: lato, grazia, adottivo
altezza: lunghezza
dimensione: dimensionale, grandezza, completo
compito: azione, lavoro, dovere
simpatia: empatia, pietà
vestito: vestito
più-lontano: inoltrare
nave: strumento, nave
affetto: amore
sofferenza: tortura, miseria, amaro, problemi
carne: carne, corpo
grande: massiccio, ottimo
inviare: rango, ufficio-postale, a-seguito-di, inviare, posizione
collezione: accumulazione, impostato, galleria, conclusione
immaginare: immaginazione, pensare
arrivo: venga
ad-alta-voce: insistere, ottimo, difficile
bello: bellissimo, glorioso
straordinario: strano, insolitamente
accadere: né
colazione: mattina, il-pranzo
popolazione: folla
serie: catena, impostato
sollievo: AIDS, comfort, glifo
impressione: effetto, sensazione, impressionare, stampare
soddisfazione: soddisfatto
forma: dimensionale, forma, a-forma-di
nascita: Nato
considerazione: idea, considerare
regolare: periodico, ripetuto, ordinale
in-movimento: muoversi, movimento
impegnato: impegnato
qualità: massa, grado
scoprire: trovato, ricerca, rilevare
dentro: interno, in-profondità, in-casa
suolo: fango, pavimento, assolo, nazione
completamente: interamente
messaggio: informazioni, notizie
frase: espressione, frase
menzione: maschio
coppia: destra, coppia
titolo: titolo, capo, soggetto
comprensione: capire, empatia
Domenica: settimana
pazzo: picchiatello, scemo
assolutamente: interamente, rigorosamente
lento: silenzioso
misericordia: pietà, grazia
contenere: Compreso, soddisfare
dolore: tristezza, dolore
soldato: esercito, pegno
precedente: est
la-spiegazione: spiegare, informazioni
preghiera: richiesta
convinzione: credere, lealtà
costante: ripetuto, standard, fissare, permanente
definitivo: ultimo, finalmente
cavalcata: equitazione, safari, salire, guida
politica: politico
disegno: immagine, disegnare, piano
morente: morte, morire
domanda: richiesta, domanda
superiore: al-di-sopra
somma: e, yoga, numero
movimento: movimento, proporre
assistenza: supporto, Aiuto
dignità: onore
fermo: tenere, prendere, concezione
tra: fra
corrente: presente, ruscello
forse: probabilità, forse, poteva
separato: diviso, differenza, assolo
peggio: peggio, povero
terrore: la-paura, terrorista
controllo: regolamento, controllata, dai-un'occhiata, gestire
capace: permettere, capace, qualificato, abilità
azienda: azienda, anche-se
superiore: meglio
spirituale: mentalmente, morale, intellettuale
prova: dimostrare, le-prove
relazione: relazioni, relazione, considerare
interessato: cura, ansioso, associato
profondamente: in-profondità, dettaglio
cantare: leggere
amichevole: congruenti, gentilmente, amicizia, genere
Ingresso: porta, ricevuta
fornitura: larghezza, fornito
pulire: fresco, pulito
utile: necessario, efficace
delicato: fragile, magro, elegante
rimuovere: sbarazzare, cancellare, disegnare
scelta: scegliere, elezione, dai-un'occhiata
enorme: massiccio, ottimo
incapace: non-può, non, fallire
coprire: cappotto, inclusione, coperta, avvolgere, marciapiede
raddoppiare: gemello, due-volte, coppia
vittoria: successo
costantemente: di-frequente, ripetuto, sempre, continuare
livello: standard, condizione, superficie
uscita: scarico, pubblicazione, gratuito
ruvido: peggio, di-cattivo-umore, maleducato
avanti: inoltrare, al-di-sopra
collegato: limite, allegato, associato, coniugare
guadagno: acquisizione, vantaggio
aggiunta: aggiuntivo, complemento
camera: camera, sala, macchina-fotografica
conoscenza: familiare, Primer
errore: sbagliato
basato: base, condizioni
auto: treno
nessuno: chiunque, Niente
energia: energia
spoglio: aprire, bar, vergogna, cavo, calvo
in-parte: a-metà-strada, parte, piuttosto
colore: colore
sicurezza: al-sicuro, salvezza, cura
descrizione: descrivere, informazioni, descrittore, definizione
addormentato: dormire
far-cadere: tuffo, cadere, perdita
brillante: glorioso, lucente, ottimo
breve: acronimo, breve
grigio: colore-marrone, cenere
altamente: molto
ECCITATO: eccitazione, irritata
disperazione: frustrazione, svenire
alleviare: comfort, ridurre
totale: lordo, tutti
gentilezza: virtù, grazia
cerchio: ciclo, appartamento, tondo, ruota
noioso: foro
intenzione: avere-intenzione, scopo
termine: condizioni, semestre, scadenza
a-fondo: confortevole, interamente
Applica: uso
lavoro: lavoro
intelligenza: intellettuale
sciopero: attacco, suggestivo
abbastanza: interamente, abbastanza, molto
soddisfare: incontrare, obbedire, soddisfare
evento: incidente, occasione, mostrare
delicatamente: morbido, gentilmente
connessione: congiunzione, attaccamento, chiamata
protezione: proteggere, riparo, cura
consapevole: sveglio, deliberatamente, sensazione
edizione: spese, stampare, pubblicazione, autorizzazione
volo: uccello, volare, librarsi
varietà: genere, vario
a-parte: diviso, lontano, tranne, in-autonomia
terribile: terribile, pietà
tutti: tutti, chiunque
lavoro: lavoro
amante: caro, fidanzata
canto: canzone
desideroso: desiderio, impaziente, curioso, ansioso
richiedere: chiedere, richiesta, insistere
ogni-volta-che: quando
di-successo: successo
aumentare: allargare, sollevamento, aumentare, salire
Sviluppo: progresso
raffreddare: freddo, bellissimo
processo: sonda, processo, corte
all'estero: straniera, esilio
devoto: lealtà, fedele
letterario: letteratura
scrittore: autore
azione: bastone, ruolo, azione
tipo: genere, scrivere, stampa
abbondanza: ricco, ridondanza, abbastanza
evitare: prevenire
favore: lato, grazia, adottivo
mentale: intellettuale, mentalmente, interno
atteggiamento: colpo-d'occhio, stare-in-piedi, gesto, approccio, dipendenza, paragrafo
ammirazione: lode
ansia: ansioso, la-paura, preoccupazione, eccitazione
insegnare: sapere, imparare
visibile: sapere
guida: manuale, le-prove, guida
reale: virtuale, fatto, reale
miserabile: insufficiente, giù-di-morale, infelice, miseria, indifeso
danno: Male, dannoso, ferita, pietà
perdono: perdonare, scusa, scusarsi, grazia
raramente: a-volte
disco: registrazione, disco, salvare
grasso: il-petrolio, spesso
appartamento: appartamento, senza-impegno, piano
regalo: ricompensa, presente
tempio: casa, Cattedrale
Patente: autorizzazione
consenso: approvazione, autorizzazione
sufficientemente: completo, abbastanza
ferita: ferita, ferito, ulcera
grassetto: coraggio, coraggioso
dovunque: da-qualche-parte, ovunque
testimonianza: le-prove
stolto: ignorante, scemo
nessuno: chiunque, chi
se-stesso: privato, loro-stessi, proprio
estremamente: molto, insolitamente
trattamento: terapia, cura
gola: collo, librarsi, cetriolo
paziente: malato
crescita: aumentare
quantità: quantistico, massa, folla, dose, numero, grandezza
grave: rigorosamente, violento, difficile
scusa: perdonare, ragionare, transitivo, scusa
origine: originale, natura
pubblico: passivo, pubblico
rimanente: resti
vincere: successo
cameriera: servitore
dolcemente: morbido, silenzioso
la-realtà: fatto
luogo: scena, sito-web, individuare
navigare: nave, velo
negozio: negozio, Conservazione, salvare
osservazione: opinato, considerare
pausa: interruzione
prezioso: di-valore
quindi: così, dunque
piantare: salire, albero, mulino
ghiaccio: la-neve
assoluto: completo, interamente
prontamente: con-facilità, presto
feroce: acuto, violento, difficile, crudele, predatore, selvaggio
rabbia: rabbia
scoperta: trovato, ricerca, invenzione, apertura
collegato: associato
punizione: frase
leggermente: piccolo, con-facilità, piuttosto
misterioso: segreto, vago, invisibile
ombra: ombra, tono, sfumatura
omicidio: uccidere
emozione: sensazione, appassionato
distruzione: rovina, distruggere
orrore: la-paura
del-posto: localmente, interno, individuare
gamma: vario, distanza, impostato
ospite: esercito, ospite, folla
bagnato: pioggia, umido
mistero: segreto
possedere: proprio, orso
coscienza: razionalità, sensazione, coscienza
precedentemente: prima
produzione: produrre
ponte: ponte
tenuta: Proprietà
regno: re, reali
conformità: seguire, adattamento
la-sua: la-sua
sfortunato: purtroppo, coincidenza, infelice, pietà, insufficiente
fiore: trascorrere, interesse, fango
Grazie: ringraziare
appartenere: Proprietà, Compreso
mercato: acquistare
berretto: cappello, sughero
Contentissimo: contento
famiglia: famiglia, casa
flotta: nave, Marina-Militare, galleggiante
bambino: bambini, Bambola
regione: campo
esatto: Farina, corretto, completo, attento
Immagine: immagine
sospetto: dubbio, sospetto
rifiuto: negare, veto, rifiuto
responsabilità: dovere, colpa
si-vergogna: vergogna
pasto: cibo, mangiare, Farina
stato: posizione, condizione
indicare: inserire, mostrare
poesia: poesia, canzone
sorgere: emergere, salire
viaggio: safari, spedizione
assistere: aderire
permettersi: acquistare, dare, orso
donare: contribuire, dare
lavoro: lavoro
procedere: continuare, aumentare, progresso, passaggio
rammarico: scusa
rischio: Pericolo
rapido: presto, agile
distinto: diviso, differenza
propriamente: corretto, confortevole
fama: lode
singolare: unito, unità
errore: sbagliato
reputazione: lode
appello: disegnare, chiamata
la-mancanza: tagliare, imperfetto, assenza
violenza: violento
rendere: fare, introdurre, dare
carriera: la-professione, lavoro
design: concezione, piano
suggerimento: frase, proporre
totale: pronunciare, completo
risoluzione: decisione, conclusione, analisi, allargare
scorta: alternato, aggiuntivo, sostituire, lancia
domestico: civile, interno, residente, nazionale
riferimento: referenziale, memoria
esistere: presenza, presente
problema: problematico, condizioni, problemi, soggetto, domanda, emissione
fornitura: fornito, dare
fiamma: fuoco
ignoranza: ignorante, ignorare
di-tanto-in tanto: a-volte, ripetuto
volante: volare
stoffa: tessuto, Abiti
profitto: vantaggio
quarto: quattro, mercoledì, camera
campana: allarme, ora
beneficio: vantaggio
capitolo: porta, parte, capo, la-stagione, capitale, loro-stessi
foro: foro, fossa
ragionevole: corretto, saggio, razionale
lo-zucchero: ubriachezza, modo
sostituzione: sostituire, anziché, assegno, alternato, scambio
spinta: insistere, maglia, paga, spingere, impulso
portafoto: scala, legale, tiro
sostanza: soggetto
e-mail: inviare
divisione: parte
schiavitù: schiavo
versetto: poesia, paragrafo
probabile: forse
doloroso: amaro, dolore
per-sempre: sempre, eterno
oceano: mare
parte-posteriore: a-seguito-di, indietro, inverso
capo: capo, gestore, conduttore, manuale
acuto: avere-intenzione, ansioso, acuto
fortuna: destino
apparente: evidente, assioma
fretta: presto, vitello
schema: piano, strisce, grafico
inutile: rifiuto
tuttavia: anche-se, ciò-nonostante
liscio: morbido
solido: espansivo, stabilito, anche-se, compatto
necessariamente: deve, necessario
costruire: creare, costruzione, formulazione
tentato: provare, pugnalata
equivalente: stesso
recente: da-poco-tempo, moderno, ultimo
viaggiare: visita, turismo
mezzogiorno: pomeriggio, Sud
collocato: cadere
annuncio: anno-Domini
cessare: prevenire
circostanza: condizione, busta-da-lettere
tenda: cabina, scena
frequente: ripetuto, di-frequente
ad-alta-voce: voce
indipendente: indipendenza, sciolto, in-autonomia
essenziale: necessario, di-base
osservazione: osservare
gratitudine: ringraziare
conserva: conservare, Conservazione, proteggere
aspetto: elemento, lato
terrore: la-paura, fobia, spaventati
intelligente: qualificato, saggio
quartiere: abitare
fallimento: fallire, sbagliato, fallimento, aborto-spontaneo
centesimo: penny, per-cento, centinaio
sentimento: sensazione
agente: significare
disperato: svenire
unione: alleanza, unito
concedere: ammettere
colpire: moltiplicare, calcio, successo
enorme: ottimo, massiccio
convinzione: frase
febbre: fuoco, influenza
trattare: terapia, processo, guarire
nostro: molla, noi
sbagliato: sbagliato, abuso, imperfetto
ideale: meglio
corsa: folla, corsa
correggere: corretto, destra, fedele, fissare
eseguire: mostrare, fare
in-qualche-modo: piuttosto
nozione: concezione, connotazione, idea
discussione: discutere, discussione
fermamente: stabilito, anche-se
costante: standard, fissare, coerente, permanente
impero: reale
penna: matita, capo
permesso: autorizzazione
mantenere: tenere, proteggere, conservare
affollato: folla, densità
limitazione: limite, moderazione
orribile: terribile
porta: porto, porta
esperto: esperienza, qualificato, esperto
contrario: opposizione, di-fronte, in-direzione, contrasto
trattato: memorandum, accordo
si-verificano: venga
cerca: elemosinare, ricerca
in-pratica: quasi, veramente, pratico
traccia: marchio, veto
allegro: contento, ilare
disposizione: ordine, disposizione, organizzato, accordo
occidentale: ovest
pressione: enfasi, stampare, spingere, il-peso
politica: politico
scientifico: la-scienza, scienziato
merito: lode, qualificarsi, di-valore
colloquio: visita, intervistatore
territorio: campo
sesso: pene, sessuale, sei
creazione: creare, formulazione, stabilito
pista: marchio, elezione, modo
prospettiva: speranza, probabilità, visione, scena
operazione: deriva, processo, azione, chirurgo
profondo: in-profondità
incontro: gioco, coincidere, coincidenza, gara
uniforme: vestito
debito: colpa, religione, dovere, credito
avventurarsi: avventura, investimento, azienda
esecuzione: azione
stato-d'animo: sensazione, umore, disposizione
equipaggio: personale
percepire: capire, concezione, vedere
dichiarare: spiegare
versione: copia, cella
dispari: strano, insolitamente
grato: ringraziare
infinito: eterno, infinito
sicurezza: al-sicuro, cura
sensibile: saggio, razionale, suscettibile
Cottage: capanna, cabina
capacità: capace, abilità, volume
risolvere: restare
coinvolti: impegnato, aderire
consiglio: consigli
esame: sonda, dai-un'occhiata, scegliere
acciaio: ferro
test: dai-un'occhiata, provare
carità: amore
capannone: versare, lanciare
comunicazione: corrispondenza, relazioni
qualcuno: chi, persona, chiunque
riga: linea, ordinale, impostato, governo, ordine
la-povertà: povero
intenso: bordo, estremo, violento
lite: combattimento
a-disposizione: fornito, presente
resistenza: opposizione
fuori-dal-comune: insolitamente, comune
abbandonato: abbandonato, deserto
votare: scegliere, voce
sopportare: orso, sostenitore, ultimo, soffrire
avere-successo: successo
gamba: piede, osso
offerta: proporre, richiesta
interno: interno
leggermente: con-facilità, leggero
display: mostrare, mostra, schermo, scena, le-prove
ristretto: limitato, solo
scopo: scopo, messa-a-fuoco
critico: necessario, critico
borsa: tasca, sacco, cestino
ripetere: ripetizione, indietro, ripetuto
traccia: tenere-sotto-controllo, canzone, modo, seguire
residenza: riparo
divertente: contento, ilare, divertimento
difendere: proteggere
pesantemente: il-peso, seriamente
cose: soddisfare, articoli, cosa
sezione: parte, dissezione
insediamento: accordo, riparo, regolamento
piatto: pannello, disco, discoteca
superare: far-fronte, superare, battere
motivo: ragionare, condizioni, motivo
marmo: pietra
capacità: capace, abilità, talento
onda: marea, vago
popolare: un-persone, popolare
possibilità: probabilità, capace
burro: il-petrolio
odio: disprezzo, odiare
ricerca: ricerca
Tirare: disegnare, forbici
segnale: gesto, marchio, parola-d'ordine
tranquillamente: al-sicuro
bruciare: bruciato, fumo
lezione: formazione-scolastica, soggetto, corso
annuale: anno
carta: cartone, carta-geografica, breve, carta
applicazione: uso, software, richiesta
intelligente: intellettuale, saggio
contea: boicottare, regionale, città, nazione
formato: forma, lanciare
flusso: ruscello
danneggiare: rovina, ferita, pietà
inoltre: aggiuntivo, anche, Di-più
commercio: commercio
meridionale: Sud
esterno: su
media: secondario, significare
nudo: vergogna
ovvio: evidente, aprire, assioma
fondazione: base, piattaforma
preoccupazione: cura, ansioso, associato, interesse, preoccupazione
Magia: fascino
campagna: movimento, spedizione
liberale: generoso
comunemente: comune, di-frequente, generalmente
caccia: caccia
insegnante: autore
in-breve: presto, breve, quasi
benedizione: benedire
piccolo: piccolo, micro
acutamente: velocità, acuto, seriamente
il-petto: seno
profondità: in-profondità
prestazione: mostrare, produttività
prosperità: fiorire, successo, benessere
impiegato: dipendente, ufficiale
decidere: decisione, determinato, decisivo, soluto
vittima: caccia, sacrificio, Pedaggio
motivo: avere-intenzione, motivo, motore, scopo, stimolo
definito: determinato, evidente
tendenza: caratteristica, miglio, disposizione, deriva
finitura: finito, colore
bandiera: bandiera, sapere
amministrazione: regola, gestire
raramente: cottura-al-sangue
genuino: virtuale, originale
formazione: formazione-scolastica, insegnamento
male: sbagliato, molto, peggio, Male, malato
alimentazione: mangiare, adottivo, cibo
centrale: centro, federale
contrasto: contrasto, opposizione, conflitto
struttura: costruzione, strutturale, organizzazione
pagamento: paga
ritmo: velocità
inchiesta: sonda, richiesta, ricerca
dovunque: dove
dovere: colpevole, dovere
maneggiare: processo, gestire, far-fronte, manipolazione
viaggio: visita, safari, giro-turistico, spedizione
sparare: tiro, esilio, emettere
occupazione: disoccupato, preoccupazione, lavoro
taglio: tagliare
resistere: opposizione
determinare: determinante, determinato, decisivo, imporre, fissare
mercantile: commerciante, uomo-d'affari, commercio
vivace: abitare
brezza: aria
parente: cugino
in-tal-modo: così
fornitura: introdurre, fornito, benessere, assegnazione, disposizione
per-quanto-riguarda: di, considerare
scegliere: scegliere, prendere
rovinato: distruggere
consegnare: dare, introdurre
inaspettato: sorpresa
scrivania: tavola, ufficio
corsia: linea, banda
rappresentare: rappresentante, esempio
rispettabile: onore
responsabilità: dovere, colpa
deluso: ambizione, deludente
adatto: coincidere, corretto
dipendere: dipendenza, limite
gigante: ottimo, mostro
stretta: capire, sequestrare
arrivare: venga, raggiungere
semplicità: semplice, umiltà
autunno: cadere
assente: assenza, lontano
oscurità: buio
sospettare: indovina, dubbio, sospetto
determinazione: determinato, decisione, relazione, definizione
base: base, condizioni
esaminare: osservare, dai-un'occhiata, analisi
premio: ricompensa, premio
acquisto: acquistare
qualcuno: persona, chiunque, anche-se
rendersi-conto: raggiungere, capire
la-sconfitta: battere, collana, fallire
penale: sangue
sciocco: scemo, ignorante
richiamo: ricorda
occupazione: incursione, la-professione, professionale, aggressivo
discorso: moderno, parlare
assistere: Aiuto, supporto, cooperazione
vendita: vendita-all'asta, vendere, sconto
invito: invitare, chiamata
inferiore: insufficiente, fuori-uso, peggio
riconoscere: ammettere, diagnosi
ritratto: immagine
suggerire: proporre, supporre
delusione: frustrazione, ambizione, anticlimax, deludente, contare
costruzione: costruzione
zelo: entusiasmo, diligenza
responsabile: dovere
cura: terapia, guarire, cura
includere: Compreso, inserire, inclusione, capire, soddisfare
soddisfare: incontrare, soddisfatto, soddisfare, indulgere
agonia: amaro
stupido: picchiatello, ignorante, scemo
godimento: godere
nascondere: nascondere
per-l'appunto: corretto, completo
assumere: elemosinare, supporre, considerare
stima: valutazione, indovina
percorso: modo
visitatore: viaggiatore, ospite, osservatore
non: non
filo: linea
per-lo-più: particolarmente, in-gran-parte
inconscio: svenire
reciproco: l'un-l'altro, comune
esterno: su, straniera
universo: cosmo, mondo
orologio: ora
istruzione: insegnamento, direzione, manuale
dolorante: ulcera, malato, dolore
disciplina: soggetto
introduzione: introdurre, fornito, promozione, Primer, importare
natura-selvaggia: deserto
confuso: nervoso, frustrazione
matrimonio: sposato
per-conto: rappresentante, lato, grazia, parte
fare-i-conti: credere, calcolo, contare
incerto: incertezza, instabile, vago
fidanzamento: impegnato, nomina
sporco: emissione, lordo
medico: medico
copertura: coperto, inclusione, tetto, avvolgere
sincero: onesto, veramente, veridico
sensazione: sensazione
specifica: particolarmente, privato, esperto
Locanda: albergo
rigido: difficile
accompagnare: seguire
Punto: marchio, relazione
vergine: figlia
fame: Affamato
favorito: favorito
dogana: tradizione, pollice, dovere, costume
impressionato: sensazione
preda: caccia, bottino, sacrificio
musicale: musica, musicista
soddisfacente: malattia
ridicolo: ignorante, ilare
foglio: carta, foglia, opuscolo
disonore: vergogna
in-origine: originale
salari: paga
esteso: molto-diffuso, in-profondità
tempo-libero: divertimento, vuoto, andare-in-pensione, relax
il-mento: barba
ardere: bagliore, leggero, radiazione, flash
gelosia: geloso
ferrovia: ferrovia, treno
libbra: libro
orientale: est
cittadino: civile
spiaggia: costa
caratteristica: elemento, caratteristica, Proprietà
prenotare: conservare, libro
ruggito: rumore
stranamente: strano
abbaiare: corteccia, Pelle
reception: ben-arrivata, ricevuta
piacevole: antipatico, genere
svegliare: sveglio
la-ricerca: analisi, ricerca
monarca: imperatore, re
capi-di-abbigliamento: tessuto, vestito, Abiti
malattia: malattia, malato
scherzo: scherzo, ironia, ridere
commento: spiegare
metallo: ferro, minerale
soluzione: fissare, decisione, risposta
tabacco: sigaretta, fumo
entità: strumento, unità, presenza, organizzazione, azienda, persona
partire: partenza, divagare, crepa, partire
amaramente: amaro
tranquillo: silenzioso
allarmato: ansioso
trucco: reclutare, battistrada, scemo, manipolazione, abile
finanziario: i-soldi, economico
preparazione: preparare
conchiglia: baccello, corteccia, Pelle
nido: abitare, presa-di-corrente
concepire: concezione, capire, pensare
appuntamento: nomina, promessa
andare-a-prendere: portare, richiamare, prendere
candela: leggero, cera
offesa: attacco, crimine, massa
miscela: misto
modello: esempio
difetto: colpa, grinza, invalidità
obiezione: disaccordo, opposizione, contraddizione
mestiere: arte, professionale, abilità
trascurare: ignorare, abbandonato, omissione, boicottare
dati: informazioni
arma: braccia, pistola
rosa: rosa
utente: di, beneficiario
nonno: antenato, nonno
nullo: zero, vuoto
vigoroso: violento
fulmine: elettronico, bullone, flash
sport: movimento, esercizio
polvere: Farina, polvere
la-pittura: immagine, pannello
gridare: rumore, coltello, piangere
sbadato: spericolato, indifferenza
derivato: derivare
portone: porta
conveniente: semplice, pratico, confortevole, con-facilità, corretto
posta: ufficio-postale, lettera
vernice: colore
resa: tradizione
stabilire: introdurre, stabilito, fissare
mite: morbido, leggero
prontamente: una-volta, corretto
dipartimento: parte
meritare: di-valore, qualificarsi
smettere: abbandonato, emergere, crepa, lanciare
garanzia: assicurare, cauzione
specchio: bicchiere
complotto: cospirazione, piano, storia
verso-l'alto: Di-più
purtroppo: giù-di-morale, purtroppo
modesto: comune, semplice, umiltà, frugale
piatto: corte, cibo, mangiare
netto: tela, veridico, santo
calore: entusiasmo, caldo
agitato: ansioso
sperimentare: pilota, esperienza, provare
oggi: giorno
enorme: terribile, ottimo, massiccio, molto
miglioramento: riforma, riparazione, progresso, recupero, guarire
controversia: disaccordo, discussione
proposta: proporre, frase
può-essere: forse, poteva
fucile: pistola
scudo: proteggere
impiegare: affitto, uso
a-differenza-di: vario
recuperare: salvare, richiamare, recupero
compagno: sputare, collega, amico
organizzare: ordine, legiferare, organizzato
comitato: pannello, commissione
anziano: vecchio
fantasma: anima
rivelazione: espressione
riconoscimento: ammettere, confessione
argilla: fango, talpa
tronco: tribù, Bagaglio, avvio
gestione: gestire, guida
ripristinare: conservare, indietro, recupero, richiamare
protesta: opposizione, marzo
mucchio: cumulo-di-rifiuti, palo, folla
moderare: secondario, significare
incantesimo: fascino, ortografia
area: campo, regionale, superficie
formale: ufficiale
editore: autore, editore
riconoscere: confessione, ammettere
rimedio: medicina, terapia, fissare
perseguire: indulgere, tenere-sotto-controllo, trascorrere, seguire
polo: scusa, colonna, estremo, ombelico
vitale: necessario, decisivo, chiave
Presidente: capo
reparto: ala, regionale, parte
Signorina: 
rallegrare: cuore, entusiasmo
giustificato: razionale, destra, giustificare
ammirare: lode
apertamente: espressamente, aprire, apertura
modifica: cambiamento, adattamento
drammatico: dramma, espansivo
al-piano-di sopra: al-di-sopra, peggio
vario: vario
discesa: natura
invidia: geloso
caricare: il-peso, sforzo, bar, tribù
Fai-finta: fingere, dramma
interno: interno
tenda: velo, schermo
salutare: Salute
oscuro: vago, eclissi
centro: centro
concorso: gara
alterare: convertire, cambiamento, sostituire
intravedere: colpo-d'occhio, visione
contrarre: memorandum, ordine, tenere, accordo
risparmio: salvare, Conservazione, economia
stringa: corda, catena, impostato
combinazione: coincidenza, misto, impostato, chiamata
arresto: allacciare, concezione
temperatura: caldo
rigoroso: rigorosamente, acuto, difficile
professionale: la-professione, professionale
ferito: ferito, ferita
Quartiere: circostante, abitare, ambientale
fumo: fumo, sigaretta
medico: medico
far-sapere: giornale
prominente: popolare, memorabile, consequenziale, chiave, notorio
istituzione: organizzato, azienda, organizzazione
pacchetto: avvolgere, chiuso, imballaggio
angoscia: amaro, miseria, dolore, tristezza
ovviamente: evidente, aprire, espressamente
catturare: affascinare, prendere, concezione
ampio: abbastanza, insufficiente
la-Camera-da letto: camera
puramente: solo, interamente, santo
comune: comune, misto, chiamata
fare-riferimento: referenziale, consultare
identificare: identità, identificabile, fissare
panca: banca
salvare: recupero, salvare
limite: limite, abbreviare
aspettativa: aspettarsi
programma: piano, ordine-del-giorno
elettrico: elettronico
intervallo: temporaneo, interruzione
inseguire: caccia
occupare: prendere, sequestrare
toga: cappotto, vestito, tuta
chiudere-a-chiave: castello
proposta: proporre, frase, piano, conclusione
felicemente: contento
successivo: Il-prossimo
inquieto: instabile, antipatico, ansioso, difficile
brillare: bagliore, flash
macchinario: meccanico, macchina, meccanismo
attraente: magnetico, disegnare, auspicabile
prodotto: articoli
malattia: malattia
motore: motore, macchina
il-loro: essi
pelle: Pelle
sottile: micro, magro
pendenza: miglio, tuffo, piegato
preoccupazione: ansioso, preoccupazione
violentemente: difficile
specificata: determinato
legname: di-legno, bastone, albero
calcolare: calcolo, contare
uccisione: uccidere
divertente: strano, ilare
insulto: disprezzo, vergogna
incapace: capace
cenare: mangiare
delicato: suscettibile, chiave
appetito: desiderio
cortesia: gentile, onore
sfera: campo, palla, regionale
onorifico: onore
colpa: colpevole, crimine, colpa, peccato
delizioso: gustoso, gusto
Grano: folclore, grano, mais
umore: umore
incontrare: far-fronte, incontrare, data
crepuscolo: alba
parco: giardino
economia: economico, economia
governare: gestire, regola, maestro
formazione: formazione-scolastica, formulazione
magro: miglio, magro
battere: esitare, picchiettare, battere
unità: unito, unità, solidarietà
principale: pioniere, chiave, genitore, ottimo, di-base
preliminare: apertura, originale
confine: limite, bordo
respirare: respiro
esonerare: gratuito, sbarazzare, perdonare
ricco: ricco
ispirazione: impulso, ispirare
tutti: tutti
abbondante: ricco
pittore: artista
bicchieri: bicchiere
tiro: tiro, caccia
carro: treno, carrello
prestare: dare, credito, citazione
intraprendere: inizio, fare
foca: anello
clero: sacerdote
montare: installare, aumentare, collina
schieramento: colonna, impostato, ordine
rivista: stampa
duro: difficile, rigorosamente
nonostante: anche-se
stretto: rigorosamente
paesaggio: scenario, ambientale, visione
abbandono: abbandonato
artistico: arte
principalmente: particolarmente, in-gran-parte
leale: lealtà, onesto, fedele
adatto: congruenti, coincidere, corretto
consigliare: consigli, consigliere
stabile: stabilito, determinato, standard
massimo: massimizzare, estremo
commettere: promessa, fare
influenzare: effetto, impressionare
contadino: contadino
considerevolmente: molto, consequenziale
estendere: dettaglio, allargare, tratto
personalmente: individualmente, privato, proprio
moralità: morale
ribellione: ribelle, rivoluzione
filo: linea, rotazione
rame: ottone
risposta: reazione, risposta
imperiale: reale
vuoto: vuoto, cavo, bianco
minore: secondario, piccolo, minatore
affare: commercio, occasione
fatica: stanco, sforzo
avversione: disprezzo, odiare, riluttanza
normale: comune
schizzo: contorno, piano
virtuoso: virtù
comunque: ciò-nonostante, già
autista: automobilista, guida, conduttore
dichiarazione: anno-Domini
eccesso: aggiuntivo, ridondanza
separazione: disgiunzione, distanza, diviso
disgusto: disprezzo, fobia, odiare
giustamente: stesso, corretto
folla: folla, massa
non-necessario: rifiuto, deve
pelliccia: Pelle, cappotto
incoraggiare: ispirare, spingere
omaggio: affitto
alleviare: ridurre, sbarazzare, perdonare
legislazione: legiferare, regola, legislatura
progetto: piano
Fata: angelo, blu, villa
concludere: tenere, conclusione
fortunato: contento
giro: ginocchio, grembiule, tondo
rovinare: bottino, rovina, sofisticare
responsabile: con-facilità, tendere, suscettibile
riflessivo: attento, ansioso, saggio
favorevole: congruenti, flettere, auspicabile
lattina: banca
dipendente: dipendenza, allegato, dipendente
mandato: assicurare, giustificare, memorandum
denuncia: bianco
convenzione: memorandum, accordo
angolo: angolo, poligono
ampiamente: molto-diffuso, molto, generalmente, in-gran-parte
mucca: bestiame
pregiudizio: odiare
veranda: sala, balcone
sorprendente: strano, stupire, sorpresa, suggestivo
Fontana: fonte
adeguata: corretto, tuta, coerente
fiducioso: coraggio, al-sicuro, credere
organo: strumento, membro, elemento, corpo
selezione: scegliere, nomina, elezione
soggezione: fobia, la-paura
confrontare: confronto
riferirsi: allacciare, gancio, relazioni, associato
presumere: credere, indovina, supporre, considerare
mancante: perso
alla-moda: moderno, elegante
positivamente: positivo
ragionamento: idea, discussione
disturbare: nervoso, aggressivo, interferire, fastidioso
compagno: fidanzata, comune, azionista
associazione: congiunzione, considerare
nipote: nipote, nipotina
corporale: fisiologico, corpo
facoltà: college, fattoriale
cannone: palla, artiglieria, pistola
andare-in-barca: nave, velo
intelligente: saggio
meschino: anello, banale, piccolo
Attenzione: avvertimento, cura
manoscritto: fattura
guerriero: eroe
liquido: acqua
concetto: concezione, connotazione
appositamente: particolarmente
saltare: volare, danza, tallone, rimbalzo
riluttante: avere-intenzione
extra: aggiuntivo
intonazione: marciapiede, tono, non
scomodo: insufficiente, strano
apprezzare: applaudire, godere
sopravvivere: abitare, restare
brevemente: acronimo, breve
riso: ottone
ragazzo: persona
comportamento: caratteristica, condotta
adottare: supporre, prendere
regolarmente: di-frequente, ripetuto, permanente, corretto
indagine: sonda, ricerca
costituzionale: costituzione
più-recente: ultimo
allievo: studente
totalmente: interamente
ritorto: piegato
differire: diviso, differenza, vario
disastro: rovina
scommettere: palo, condizione, veto
crudo: abitare, fonte, lordo, verde
ceppo: inserire, registrazione, club
accoglienza: generoso
carrello: treno, carrello
toga: vestito
impegnarsi: allegato, uso, affitto, conservare
mandria: gregge
raccogliere: raccogliere
Pan: pentola
assalto: attacco, incursione
ingannare: scemo, tradire
lutto: tristezza
ritirarsi: sbarazzare, disegnare, andare-in-pensione
mettere-a-punto: canzone, armonia
compassione: empatia, pietà
travestimento: nascondere
trascrizione: copia
documento: file
vicino: circostante
bloccare: prevenire, volume
obbligo: dovere
declino: negare, cadere
ambizioso: ambizione
vacanza: vacanza, festa
pugno: primo
aquila: falco, cravatta
onorevole: onore
significativo: necessario, consequenziale, suggestivo
denso: compatto, spesso
finzione: romanzo, immaginazione, storia
raccomandare: proporre, introdurre, consigli
educativo: formazione-scolastica
verso-l'alto: Di-più, al-di-sopra
corno: mais
fondo: scatola, capitale
casetta: capanna, file, cabina
costume: vestito, tuta, costume
tariffa: affitto, partire, carta-geografica
applausi: applaudire, approvazione
ricordare: ricorda, somigliare
cuscino: fiume
Da-nessuna-parte: individuare
cadavere: corpo
essenza: cella, creatura
elevazione: ripido
regno: campo, mondo
scala: le-scale, scala
accordo: memorandum, compatto, tuta, coincidere, accordo
pizzo: spuntone, reddito
studioso: studente, scienziato
righello: duca, governatore
pazzo: picchiatello, scemo
intrattenere: ben-arrivata, divertire, divertimento
saluto: ben-arrivata, cartolina
femminile: femmina
mostruoso: mostro, terribile
facilità: attrezzatura
rapinare: rubare, bottino
scala: le-scale, conduttore, scala, scuola
fine: ultimo
dividere: differenza, distribuire
incredibile: strano, insolitamente
arco: arco
eletto: elezione, scegliere
timido: timidezza, vergogna
nebbia: nebbia
colorato: colore
avvertire: avvertimento, indurre
superficiale: in-profondità
incoraggiamento: stimolo, comfort
irregolare: comune, insolitamente
fedelmente: lealtà, fedele, corretto
trasferimento: la-traduzione
fondamentale: base, di-base
impacchettare: chiuso, fibra
tragico: terribile
recensione: revisione, critica
terribilmente: terribile, molto, peggio
cucina: cuoco, cucina
rivolta: ribelle, rivoluzione
Migliorare: fissare, guarire
relitto: distruggere
convincere: persuadere, assicurare
ciotola: tazza
illustrazione: esempio, immagine
nervo: vena, coraggio, nervoso
fissare: fissare
accertare: sapere, assicurare, determinato, dai-un'occhiata, fissare
impegno: assicurare, promessa, ostaggio, cauzione, pegno
guadagnare: servire
selezionare: scegliere
industriale: industrializzazione, industria
interpretazione: la-traduzione
sfida: chiamata
vietare: prevenire, negare
tema: motivo, soggetto
ammissione: ricevuta
piscina: piscina, fossa
conferenza: sessione, montaggio
uguaglianza: analogia, bilancio, equivalenza, equazione
recentemente: neo, da-poco-tempo, romanzo
dintorni: ambientale, circostante
invasione: attacco, incursione
modello: esempio, una-volta, standard, forma
svelare: rilevare, tradire
risolvere: sciolto, fissare
predicare: sermone
nonna: sposa, nonno
lana: cotone
comunicare: dialogo, socializzare, relazioni
essenzialmente: condizioni
opporsi: opposizione
campione: esempio
trascinare: disegnare, forbici
raccolto: colture, raccolto, tagliare
preciso: corretto, Farina, attento
ricorrere: prendere, riparo, interruzione
rifiuto: negare, rifiuto
legame: chiave, cauzione, copula
simpatico: pietà
stipendio: paga
continuo: continuare
eccitare: indurre, incitare
selvaggiamente: selvaggio, violento
tristezza: tristezza, tragedia
alleato: unito, associato
soffitto: coperta, tetto
goal: messa-a-fuoco, scopo
Contanti: i-soldi
vacante: aprire, gratuito, vuoto, sciolto, vago
disprezzare: disprezzo
prato: erba, prato
tacchino: 
vicino: circostante
finale: ultimo, estremo, finalmente, di-base
sottomissione: obbedire, inviare
iscrizione: inserire
completo: in-profondità, completo
emozionante: disegnare, curioso
vincente: successo
prudente: ortodosso, governatore
entusiasta: entusiasmo, ansioso
Piano-di-sotto: fuori-uso
Bollire: cuoco, ulcera
magnificamente: bellezza, bellissimo
domani: ieri
scomodo: ansioso, antipatico
apparato: attrezzatura
affermare: insistere
espressione: pronunciare, espressione
rotaia: ferrovia, treno
imperfetto: completo, invalidità, imperfetto
acquisire: acquisizione, derivare, acquistare
offensivo: incursione, attacco, aggressivo
freddamente: freddo
conferenza: corso
per-cui: dove
percezione: sensazione, colpo-d'occhio, concezione
sviluppare: elaborare
funzione: cerimonia, lavoro, attività
proiettile: tavoletta, tiro, palla
legare: allacciare, limite
identico: stesso
sostanziale: espansivo, ottimo, consequenziale, suggestivo
massa: massa, grandezza, volume, tumore
prolungata: lungo, indugiare
seccato: irritata, antipatico
irritato: nervoso, giù-di-morale
mazzo: copula, banda
fieno: erba, cannuccia
discussione: disaccordo, discussione
immobilità: silenzio
parziale: eccezione, parte
Manzo: carne
unire: solidarietà, imbracatura, conciliare, aderire
lama: foglia, spada, coltello
fabbrica: mulino
nullo: zero, vuoto
rivista: giornale, stampa
onestamente: lealtà, onesto
legittimo: legale
accento: pronunciare, enfasi, messa-a-fuoco
Cordialmente: seriamente
lega: alleanza
approvare: approvazione
arto: membro, estremo
steward: gestore, servitore
evoluzione: riforma, evolutiva
indagine: dai-un'occhiata, ricerca
contemporaneo: moderno
scandalo: corruzione
deliberare: deliberatamente
simbolo: notazione, gesto
lavaggio: lavaggio, lavanderia
preciso: corretto, Farina, attento
evento: incidente, occasione
albero: fosso, spalla, albero
gambo: asciutto, tribù, radice
società: azienda, organizzazione
preferenza: privilegio, preferire, vantaggio, scegliere
sollecitare: indurre, impulso, desiderio
rimozione: distanza
asserzione: approvazione, enfasi
accessibile: visita, trovato
commedia: umore
rossore: colore, eccitazione
codice: yard, codificare
adeguato: abbastanza, corretto
Diviso: distribuire
storico: storico
intensità: densità, sforzo
democrazia: repubblica
credo: confessione
attrazione: fascino, gravità
concerto: festival
verso-il-basso: fuori-uso
canale: canale, tubo
richiesta: presto, richiesta, agile
bronzo: ottone, colore-marrone
indumento: Abiti
rimorso: giù-di-morale, pietà
esclusivo: monopolio, privato
facchino: indossare, vettore
trattino: linea
striscia: banda
in-definitiva: finalmente
squadra: coro
caro: caro
quartier-generale: sede-centrale, centro
acuto: acuto
imbarazzato: nervoso, vergogna
prole: bambini
Rete: tela
aereo: uccello, superficie, macchina
parzialmente: parte
orgoglio: orgoglio
terrazza: balcone, tetto
presa: tenere, trappola
esplosione: scoppiare
truppe: esercito, militare
strettamente: rigorosamente
calcio-di-punizione: pietà, frase
sporcizia: umido, feci, fango
epoca: la-stagione
ambasciatore: messaggero
razza: moltiplicare, gara
interferenza: interferire, fastidio, disturbo
consistere: passaggio, soddisfare
accettazione: accettabile, approvazione, ricevuta
ingegnere: meccanico
arresto: piede
alternativa: alternato, sostituire
francobollo: anello
contatore: disco, opposizione, di-fronte
Venere: Venerdì
immaginario: immaginazione
arrampicata: salire, strisciamento
attirare: disegnare, impressionare
sorprendente: sorpresa, suggestivo
concorrenza: rivale
cristallo: bicchiere
doccia: bagno, pioggia
filosofico: filosofo, filosofia
rumoroso: rumore
dispositivo: attrezzatura
trasporto: traffico, navetta
alla-fine: finalmente
terribilmente: molto, terribile
contemplazione: riflettere, riflessione
produzione: industria, produrre
comodamente: confortevole
mostra: mostra, relazione
agricolo: agricoltura, azienda-agricola
ricerca: ricerca
estensione: dettaglio, allargare
controversia: contraddizione, discussione
approssimativamente: quasi
in-alto: al-di-sopra
trattenere: inibizione, prevenire, moderazione, conservare
conservazione: salvare, cura, conservare
pub: bar
bacino: valle, piscina, lavello
melodia: tono
assumere: affitto
preoccupato: ansioso, nervoso
anziano: vecchiaia, vecchio
Università: college
prudente: attento
precedente: est, prima
complicato: complesso, difficile, elaborare
scusa: scusarsi, scusa
impaurito: spaventati, la-paura
sostituire: alternato, assegno, sostituire
uso: uso
restauro: riparazione, recupero, richiamare
siepe: recinto
primario: maestro, base, originale, di-base
fascio: raggio
giro: visita, spedizione
esagerato: sale
competente: permettere, capace
urgente: presto, precipitato
allarme: avvertimento, allarme, sveglio
forno: stufa
arrotondata: tondo
convenzionale: comune
supplicare: elemosinare, giustificare
cordone: corda
a-fianco-di: parallelo, Il-prossimo, congiunzione
estratto: citazione, succo
accendino: leggero
pinta: birra
tubo: tubo
viale: occasione
efficiente: qualificato, efficace, effetto
mescolare: misto, agitare
disturbo: disturbo, fastidio
esecutivo: gestore
decimo: dieci
comparativo: confronto
antimeridiano: mattina, lucente
gabbia: castello, cella
prigione: prigione, catena
abile: qualificato, abile, capace
urlare: piangere
compromesso: accordo, armonia
cartucce: tiro
assistente: sostenitore, Aiuto
canna: bastone
discutere: discutere, insistere
logica: discussione, razionale, razionalità
panico: la-paura
circolazione: Ciclismo, ciclo, traffico, giro-turistico
stress: sforzo
consumo: uso, consumare, mangiare
sostenere: supporto, conservare, tenere, soffrire
schianto: cadere, conflitto
carente: insufficiente, tagliare, imperfetto
graduale: gradualmente
schiacciare: distruggere, gravità, schiacciare
fenomeno: incidente, cosa
eseguire: correre, azione
salutare: Salute, ben-arrivata, grandinare
monarchia: reale, Proprietà
comportarsi: abitare
barriera: ostacolo, soglia
curva: arco
fare-affidamento: contare
convenienza: con-facilità, comfort
agnello: pecora, strisciamento
logico: razionale
dieta: cibo
giudiziario: corte, legale
diffidenza: dubbio, lealtà
piuma: molla, pietà
volontario: volontario
giacca: cappotto, maglione
il-nuoto: nuotare
impressionante: suggestivo
sotto: fuori-uso, a-seguito-di
provinciale: rurale, Provincia
compensazione: compensare, assegno
Cameriere: servitore
promuovere: accelerazione, promozione, adottivo, spingere, contribuire
dedicare: avere-intenzione
ostilità: ostile
piantagione: azienda-agricola, asilo-nido
esporre: contorno, rilevare, aprire
toppa: individuare, attaccamento
interruzione: interruzione, fastidio
pollice: pollice
rivoluzionario: rivoluzione
sorprendente: strano, stupire
mancia: emisfero, spuntone, estremo, barba, vertice, consigli
minaccia: minaccioso, Pericolo
giungla: foresta
tipico: comune, caratteristica
carburante: il-petrolio
tranquillo: silenzioso
destinazione: ripetizione, scopo, destino
perno: segreto, ago
Marte: marzo
socio: associato, collega, congiunzione, comune, parallelo, allegato
vizioso: immorale, Male
banchetto: festa
dettagliato: elaborare, in-profondità, cerniera, dettaglio, attento
armadio: gabinetto
legislativo: legiferare, legislatura
margine: bordo, campo
campione: eroe
impulso: impulso
fuggire: correre, fuga
clausola: ruscello, paragrafo
composto: congiunzione, complesso
nodo: tenere, maglia
relazione: relazioni, relazione, considerare
agenzia: organizzazione, azienda, ufficio
sorriso: sorriso, smorfia
dimostrazione: mostrare, marzo
depressione: tristezza
veicolo: macchina
prendere-in-prestito: credito, citazione
gonfiore: rigonfiamento
argomento: motivo, soggetto, titolo
verdetto: decisione, regola
sabato: Sabato
identificazione: identificabile, identità, definizione
fotografia: immagine, tiro
alleato: amico, amicizia, unito
tratto: modo, tratto, discussione
nastro: banda, film
più: Di-più
trasparente: trasparenza, evidente
profumo: odore
preoccuparsi: problemi, interferire, fastidioso, fastidio
qualificato: capace, qualificarsi, qualificato
prova: articolo, relazione
ciclista: cavaliere, equitazione
solitudine: solitario
polso: mano
finemente: morbido, magro, finalmente
nullo: zero, vuoto
condannare: frase
mascella: pino
unico: unito
inevitabilmente: inevitabile
tamburo: danza, vuoto
bidone: scatola, cestino
durata: temporaneo, permanente, orario, lunghezza
pesare: misura, il-peso
monastero: abbazia
pubblicare: pubblicazione, distribuire, rilevare
intuito: visione
decisamente: evidente, rigorosamente, corso, veramente, espressamente
spostamento: cambiamento
questa-sera: giorno
fattore: ragionare, dipendente, coefficiente
pasticcio: aggressivo, disturbo, confusione
pratica: esercizio, azione
santuario: altare
restringersi: acronimo, raccogliere
spesa: spese, uso, trascorrere
incoraggiante: cuore, ispirare
esposizione: espressione, mostra, relazione, effetto
greggio: lordo, verde
biglietto: bandiera, carta-geografica
indietro: indietro
scarpa: scarpe, avvio
frode: illusione
esplosione: scoppiare
camino: camino
vaso: bicchiere, bottiglia, brocca, pentola
salsa: condimento
marcio: pigro, immorale, povero
comportamento: caratteristica, condotta
prestito: credito, citazione
irragionevole: razionale, sciocchezza
lussuria: ambizione
annualmente: anno
fluido: acqua
ragazzo: bambini
folle: picchiatello, scemo
rovesciare: versare
realizzazione: successo, rango, exploit
assunzione: supporre, immaginazione, presumibilmente
umoristico: umore, ilare
estasi: entusiasmo
la-pensione: andare-in-pensione, dimissioni, pensione
parlamento: legislatura, senato
emergenza: ansioso, crisi
pacco: avvolgere, parte, chiuso
cassetto: scatola, le-scale
contributo: contribuire, palo
collegamento: attaccamento
coraggio: coraggio, estorcere
stampa: pubblicazione, stampare, stampa
avvocato: avvocato, giustificare, imputato
ambiente: atmosfera, ambientale
confermare: dimostrare, assicurare, rafforzare
annunciare: rilevare, pubblicazione
dare-le-dimissioni: dimissioni, andare-in-pensione
rifiutare: negare, veto
difficile: difficile, crudele
frammento: patata-fritta, boccone, rottame, tratto
meditazione: cura, riflettere
macchia: individuare
sepoltura: cerimonia-funebre, seppellire
ipotesi: supporre
ipotetico-umore: speculativo-umore, presunto-umore, condizionale-umore
transazione: attività, commercio
indignazione: rabbia, disprezzo, vergogna
variare: variabile, vario, sostituire
rappresentante-legale: avvocato, rappresentante
offendere: colpevole
pacchetto: avvolgere, tasca, chiuso
classico: classico
ranch: azienda-agricola
torta: torta, pi
con-precisione: destra, precisione, rigorosamente
scagliare: lanciare
marino: Marina-Militare, mare
cantante: lettore
elettricità: elettronico, ruscello
alieno: straniera, ospite, extraterrestre
screpolato: scoppiare, crepa
depresso: giù-di-morale, tristezza
fittamente: spesso
ragionevolmente: ragionare, razionale
cavo: cavo, flettere
illustrare: spiegare, riflettere
adozione: approvazione, ricevuta
famigerato: notorio
ferire: ferita
correttamente: precisione, corretto, destra
pascolo: salice, prato
verme: maschera, in-profondità
stima: valutazione, indovina
attrezzatura: organizzazione, Abiti, attrezzatura, vestito
sfortunato: infelice, purtroppo
ottavo: otto
rilassato: comfort, relax, silenzioso
adiacente: quasi, circostante
anziano: veterano, genitore, capo
spaventare: allarme
precettore: allenatore
rapina: bottino, rubare
commercio: commercio, commerciale
estinto: scomparire
grumo: massa, toro, ammaccatura
accidentale: casuale, temporaneo, coincidenza, sorpresa
premesse: casa, individuare, costruzione, in-casa
consegna: introdurre
curvo: piegato, flettere
produttivo: fabbricante, produrre
gonfio: rigonfiamento
coltivare: adottivo, azienda-agricola
variazione: cambiamento, differenza
avversario: rivale, opposizione
nipote: nipotina, nipote
chiodo: chiodi, spuntone, bullone
benevolenza: generoso, benessere, virtù, grazia
precisione: precisione
indicazione: marchio
riduzione: ridurre, tagliare
pancia: stomaco, ombelico
disgustato: odiare
comporre: scrivere, creare
passeggeri: viaggiatore
puntura: pugnalata, amaro, morso
contemporaneamente: nel-frattempo
episodio: consequenziale, parte
persistente: coerente, continuare, permanente
morire-di-fame: Affamato
consultazione: consultare, consigli
aspro: acido
sottolineare: insistere, enfasi
parata: marzo
casco: cappello
proclamare: propaganda, pubblicazione
alloggio: albergo
spray: medicina
formalmente: ufficiale
inquietante: nervoso, interferire, ansioso, fastidioso
anticipazione: previsto, aspettarsi
grado: ponte, coefficiente, rango, valutazione, grado
sgabello: feci, sedia
giustificazione: giustificare
straniero: straniera, ospite
mezzi-di-trasporto: traffico, navetta
comprensione: capire
direttore: gestore, capo
temporale: temporaneo, orario
piacevolmente: bellissimo
imporre: imporre, costringere, permettere, forze-dell'ordine
globale: in-profondità, completo
minacciare: minaccioso
progressivo: progresso, radicale
risorsa: fonte
confinare: limitato, sequestrare, abbreviare, ridurre
congratularsi-con: lode
assicurazione: al-sicuro
nominare: occhio
interrompere: ostacolo, tagliare, interferire, amputare, interruzione
reprimere: opprimere, prevenire
strato: colonna
indizio: le-prove, chiave
dente: denti, dentista, ammaccatura
garanzia: assicurare, cauzione
procedura: processo, meccanismo, azione, approccio
raccomandazione: consigli
divario: interruzione, apertura
implicare: significare
allegare: allegato, giuntura, allacciare
posizione: gesto, indicatore, posizione, stare-in-piedi
suite: ala, impostato, appartamento
gioiello: tesoro, fiorire
emotivo: sensazione, appassionato, suscettibile
calcestruzzo: espansivo, coerente
combinare: alleanza, congiunzione
picco: vertice
valuta: i-soldi, coniare
obbiettivo: scopo, messa-a-fuoco
memoriale: memoria, avvertimento
separatamente: diviso, differenza, individualmente, solitario
vassoio: disco
orizzontale: bilancio
carta: costituzione, carta, affitto
voce: articoli, articolo, elemento, voce, genere, posizione
espansione: dettaglio, allargare
twist: bullone, rotazione, ironia
tradizionale: tradizione, classico
coinvolgere: Compreso, inclusione, soddisfare
routine: comune, meccanismo
risolvere: aratro, sciolto, fissare
tentare: stuzzicare, indurre
infruttuoso: fallire
politico: politico
coperchio: tetto
violazione: ferita
giunzione: ordinale, incrocio
capo: proprietario, gestore, datore-di-lavoro, capo, ladro
hardware: attrezzatura
filo: costa, banda
orlo: bordo, scogliera, labbro
merce: commercio, articoli
distaccato: diviso, lontano, remoto
asilo: ospedale, riparo
affermare: dimostrare, assicurare
programma: tavola, calendario, grafico, disposizione
trincea: fosso
comunale: città
rivolta: agitare
testimoniare: dimostrare
materno: incinta, mamma
scultura: statua
sapore: gusto
marca: manuale, marchio
bagagli: Bagaglio
sciocchezze: sciocchezza, rottame, cumulo-di-rifiuti
strumento: strumento
caos: disturbo, confusione
accusa: tuta
teso: nervoso, orario
gallina: pollo
tagliare: ornamento, ridurre, tagliare
discreto: saggio
piangere: piangere
dialetto: polacco
elementare: base
nolo: Bagaglio, bar, camion
pulire: spazzata
negazione: negare
metropolitana: segreto
intermedio: dai-un'occhiata
formula: equazione, stampa
imbrogliare: scemo, manipolazione
infestare: esitare, fobia
registro: lista, registrazione
indefinito: vago, aoristo
surplus: aggiuntivo
brivido: tremare
fazzoletto-di-carta: organizzazione, tela, tessuto
bozza: contorno
giocattolo: Bambola, giocare, gioco
scala: le-scale, scala
transizione: infezione, cambiamento, transitivo, incrocio
pulsante: chiave
scortese: maleducato
programma: piano, ordine-del-giorno
produzione: industrializzazione, mulino, produrre
zona: campo, regionale, banda
nono: nove
alcol: vino
avido: ambizione, avidità
governare: gestire
influente: efficace, penetrare
circondare: collare, assedio
annegare: lavello, angolo
diapositiva: scivolare
seminare: salire, pane, maiale
dominante: ottimo, incursione
comando: gerarchia, manuale
diario: giornale, calendario
celebrare: persuadere
confusione: eccitazione, rumore, fastidioso, confusione
vice: rappresentante, alternato
automobile: motore
emendamento: revisione, cambiamento
verticale: stare-in-piedi, longitudinale
insufficiente: insufficiente, abbastanza
Dannazione: magro
inferenza: indovina, conclusione
induttivo-umore: induttivo-umore
annuncio-pubblicitario: anno-Domini, commerciale, propaganda
furto: rubare, plagiare
spontaneo: istinto, arbitrario
utilità: organizzazione, uso, strumento
collegare: allacciare, gancio, giuntura, aderire
verso-il-basso: fuori-uso
intervento: interferire
rinascita: ravvivare, recupero
Internet: commercio
fisicamente: fisica, corpo
punto: individuare
scioccante: shock
duramente: maleducato
equilibrato: coerente
indice: esponente, lista, indicatore
trasmettere: inviare, distribuire
su: al-di-sopra, su, inoltrare
chiacchierare: parlare, statistica
ambra: giallo
tonnellata: tono
liscio: confortevole
tensione: sforzo, eccitazione
balena: elezione
velenoso: veleno
concessione: muoversi, privilegio, sconto
lavoratore: dipendente
pendenza: tuffo, coniugare
gabinetto: gabinetto
offesa: attacco, crimine
astio: odiare, la-vendetta
forza-d'animo: pazienza, coraggio
anticipare: speranza, aspettarsi
ritmo: battere
ratto: topo
corrispondere: corrispondenza, tuta, corretto, risposta
detenere: prevenire, sequestrare, conservare
interpretare: spiegare
salone: sala
operare: manipolazione, lavoro, correre, azione
drenare: grondaia, correre
salario: paga
cattiva: odiare, Male, antipatico, deludente, brutta
cimitero: cerimonia-funebre
gesso: gesso
rubinetto: tubo, latte
respingere: sacco, ignorare, negare, veto, distinguere, ridondanza, perdonare
provocare: eccitazione, irritata
risiedere: restare, abitare
decorazione: ornamento
dito-del-piede: punta-di-piedi, piede, dito, zampa
incapacità: invalidità, debolezza
inventare: invenzione
definire: determinante, elaborare, descrivere
limitato: limitato, limite
credenza: gabinetto, lo-scaffale
cremagliera: lo-scaffale
sovrintendente: conduttore, ispettore
presentazione: introdurre, mostrare, mostra, promozione
gomma-da-cancellare: palla, elastico
escludere: privare, cancellare, distinguere
privilegiato: privilegio
eremita: ascetico
graffiare: raschiare, inizio
vite: bullone
esplorare: osservare, exploit
assicurare: assicurare
cilindro: disco
sommario: contorno, astratto
improbabile: probabilità
sciame: gregge, figlio
sistematico: meccanismo
potenzialmente: veramente, quasi, pratico
cliente: costume, ospite
catalogo: lista, tavola
chimica: chimico
infornare: pane, cuoco
forare: pugnalata, penetrare, foro, perforare
strappare: lacrima, sequestrare, rapire
lanciare: emettere, lanciare
agricoltura: agricoltura
attrice: attore
Teatro: Teatro, sala
droga: medicina
avverso: peggio, svantaggio, inverso, negativo, dannoso
caramella: menta, cioccolato, dolce
incolla: impostato, collana
galeotto: trappola, punire, colpevole
indagare: sonda, osservare, dai-un'occhiata
pacchetto: avvolgere, impostato, chiuso
strisciare: strisciamento, accasciarsi
schiocco: pop, clic, immagine, marea, presto
pneumatico: embrione, anello
evidente: suggestivo, evidente
nucleo: base
predecessore: antenato
allo-stesso-modo: allo-stesso-modo, stesso
diga: polvere
scivoloso: scivolare
trasformazione: cambiamento
frangia: bordo
posizione: posizione, individuare
grappolo: conglomerato, massa, banda
preventivo: citazione
custodia: diligenza, cura
plausibile: accettabile
scossa: lanciare
gradino: battistrada
concentrazione: accumulazione, messa-a-fuoco
a-portata-di mano: pratico, confortevole
esca: gusto, Primer
diverso: vario
fetta: patata-fritta, disco, boccone
trapano: foro, scavare
rispondere: reazione, rimborso, risposta
mortalità: morte
erbaccia: erba
relativamente: volume
matematico: matematica, atletico
moralmente: morale
respiro: sospiro, respiro
da-corsa: gara
isolamento: disgiunzione, diviso
a-volte: a-volte
adulto: maturo
disagio: amaro, miseria, problemi, fastidio
voce: pettegolezzo, voce
resistere: conservare, orso, ultimo
junior: giovane
lavoro-a-maglia: maglia
indiretto: direttamente
precedente: esempio
corridoio: raggio, sala, incrocio
contraddire: contraddizione, negare
riscattare: salvare, compensare
via: modo, attraversamento-pedonale
ingranaggio: attrezzatura, denti, costola, correre
celebrazione: festa
accogliente: caldo, confortevole
editoriale: pubblicazione, distribuire
cliente: ospite, acquirente
tappeto: tappeto, pavimento, coperta
partizione: contare
prospettiva: colpo-d'occhio, visione
estetico: bellezza
risentirsi-di: odiare
posa: proporre, indurre, stare-in-piedi
contentezza: soddisfatto
organismo: creatura
incomprensibile: capire
enfatico: enfasi
mezzogiorno: pomeriggio, Sud
giglio: leggere
sostantivo: nominalizzazione, nome
pieghevole: piega, piegato
utile: Aiuto
persistere: insistere, continuare, ultimo
presa: Uscita, presa-di-corrente, partenza
ereditare: erede
velocità: velocità, precipitato
offensivo: verbale
deficienza: insufficiente, tagliare, omissione, imperfetto
garantire: assicurare
sleale: destra
sub: sostituire
benna: barile, cucchiaio
organizzazione: organizzazione
in-primis: particolarmente
rituale: cerimonia, culto
coscia: prosciutto, piede
armadio: Abiti, gabinetto
struttura: organizzazione
turbolento: violento
palude: palude
ignaro: ignorante
iniziale: apertura, originale, inizio, primo, primitivo
minimo: meno
correzione: riforma, revisione, riparazione
trascurare: ignorare, dimenticare
unanime: unito
carbonio: carbone
bobina: file, rotolo, Riccio
croccante: fragile, acuto
vocabolario: dizionario
passeggiare: vagare
fitness: esercizio, ginnastica, condizione
nazionalità: nazionalismo, nazionale
sapore: gusto
senza-importanza: necessario, banale, non-pertinente
punch: battere
passo: progresso, battistrada
asse: spalla, stampare
soddisfacente: malattia, soddisfatto
affidabile: fedele
disgustoso: odiare, brutta
etico: morale
crollo: cadere
cuscino: fiume
confondere: falsificare, distruggere, stupire, fallire, imbarazzare
mito: storia, leggenda
proprietà: Proprietà
paura: spaventati, terribile, la-paura
freno: interruzione
Noce: fagiolo, seme
ingrandire: rigonfiamento, aumentare
solare: luce-del-sole
becco: labbro, unità
contratto-di-affitto: guinzaglio, affitto
rapporto: relazioni, confronto, scala, relazione, analogia
pettine: pennello, spalla, cresta
tradurre: la-traduzione, capovolgere
ricreazione: divertimento, vacanza, relax
capriccio: colore
campione: esempio, provare
plurale: massa
iniziativa: piano, provare
gelatina: la-marmellata, latte
anarchia: disturbo
profilo: contorno, file, sito-web
finanza: i-soldi
di-base: base, di-base
bandire: cumulo-di-rifiuti, incursione
elettrico: elettronico
erba: erba
prosperare: fiorire
somiglianza: analogia, somigliare, solidarietà
vita-privata: privato
arena: campo
viaggiatore: viaggiatore
particella: atomo, seme
innato: originale
abitante: residente
flauto: fischio
riproduzione: fertilità
campata: lunghezza
insalata: lattuga, energia
colorante: colore
dimostrare: dimostrare
etica: morale
ufficialmente: ufficiale
infastidire: interferire, fastidioso, stuzzicare, incitare, foro
planata: scivolare
tratto: caratteristica, Proprietà, tratto
compositore: musicista
calcio: calcio
associazione: cooperazione, alleanza, contribuire
continuazione: continuare
anormale: insolitamente, picchiatello
sequenza: catena
spremere: spingere
attrezzatura: sequestrare, far-fronte, attrezzatura
frenare: inibizione, marciapiede, moderazione
la-pubblicità: anno-Domini, propaganda
ritiro: regressione, presa-di-corrente, conclusione
mutuo: ostaggio, credito, pegno
pazienza: pazienza, orso
reprimere: prevenire, opprimere
coniuge: marito
valido: efficace
valvola: furgone
costruire: creare, costruzione, formulazione, fase
vapore: vapore, coppia
pipistrello: bastone, club, inoltrare
contraddittorio: contraddizione, non-pertinente, contrasto
automatico: direttamente
esplicito: aprire, trasparenza, assioma
efficacemente: efficace, effetto
dipendenza: dipendenza
ispezionare: osservare, dai-un'occhiata, giro-turistico, analisi
stranamente: strano, insolitamente
bottino: disegnare, bottino
imbarazzante: vergogna, imbarazzare
Disabilitato: invalidità, passivo
arrogante: orgoglio
arricciare: Riccio, anello
gemma: pietra, fiorire
anniversario: compleanno
prestigio: credito
negligenza: omissione, disprezzo, indifferenza
auto-: privato
discriminazione: eccezione, distinguere
continentale: continente
bersaglio: scopo
stallo: negozio, stare-in-piedi
investire: investimento
crociera: nave
rally: solidarietà, azione
voce: pettegolezzo, voce
attivamente: seriamente
dai-un'occhiata: dai-un'occhiata
scomparto: appartamento
specificamente: particolarmente
scoppio: pop, scoppiare, tiro
aggregato: lordo, comune
frazione: parte, palo
illegale: illegale, selvaggio
sciogliere: cancellare, solubile, solvente
equilibrio: bilancio
esplorazione: sonda, analisi
cipolla: arco
affinità: analogia, solidarietà, dipendenza
disonesto: fedele
scontro: conflitto, shock, interferire
poltrona: sedia, divano
pasta: Farina, massa, lievito, torta
imbarcarsi: aderire
trance: visione
rifiuto: negare, rifiuto
varianza: differenza, corretto, contraddizione
assorbimento: Pelle
collettivo: massa
tempestivo: orario
invadere: attacco
licenziamento: sacco, ridondanza
in-modo-significativo: in-gran-parte
sperimentale: pilota
film: film, tv, immagine
pubblicità: propaganda, promozione, anno-Domini
espandere: allargare, dettaglio
caduta: inciampare, cadere, tuffo, Abiti
fucina: creare, falsificare
fossile: il-petrolio, archeologico
costrizione: ostacolo, regolamento, moderazione
gusto: entusiasmo, Spezia, esperienza, gusto, Pelle
fastidioso: fastidioso
frazione: sobborgo, villaggio
boom: fiorire, rimbalzo, scoppiare
riprodurre: copia, imitare
congresso: montaggio
uva: vino
Officina: studio, seminario
diminuire: ridurre, tagliare, cadere
pronuncia: pronunciare
sentenza: decisione, frase, regola, giudice, Giurisdizione, crisi
concentrarsi: attento, messa-a-fuoco
annullare: rilevare, indietro
traghetto: yacht, nave
lineare: semplice, direttamente, con-facilità, trasparenza, lineare
altitudine: lunghezza
indicare: mostrare, significare
esportare: Uscita
colpevole: cometa, colpevole
disapprovazione: opposizione, veto
par: coppia, bilancio
abolire: cancellare
regolare: revisione, fissare, adattamento
membri: membro
valutare: misura, scala, grandezza, magro, indicatore
tollerare: perdonare
anca: natiche, vita
aderire: seguire, aderire, bastone, conservare
respingere: prevenire
agitazione: disturbo
castità: precisione, purezza
allentato: relax, sciolto
contrazione: timidezza
giornalista: reporter
sintomo: mostra
bicicletta: Ciclismo, ciclo
catrame: marciapiede
spirale: rotazione
commento: vaccino, definizione
trasmissione: infezione
scrutinio: voce, elezione
potenziale: capace
idoneo: capace, destra, qualificarsi, corretto
ciclo-continuo: Ciclismo, cerniera, anello
lavoratore: dipendente
perseguire: colpa
Patente: autorizzazione
rinunciare: scarico
ego: loro-stessi, respiro
getto: espellere, uccello, ruscello
violare: disobbedire, tagliare
dedito: dipendenza
sopravvivenza: tutta-la-vita, vocale
congelare: congelato
tessere: maglia
incombente: stabilito, beneficiario
apatia: indifferenza
organizzare: organizzazione, preparare, legiferare, organizzato
presumibilmente: forse, presumibilmente
accordo: accordo
sanguinare: sangue, sanguinoso
rivelazione: trovato, ricerca, rilevare
distruggere: distruggere, interruzione
facilitare: accelerazione, adottivo, contribuire
frequenza: ciclo, esitare
cucire: cucito
elenco: le-prove
tagliare: morso, tagliare, bistecca
il-riscaldamento: caldo
deprimente: deludente, giù-di-morale
colpo-di-stato: rivoluzione, tiro, corsa
compassionevole: pietà
pensatore: intellettuale
bilancio: bilancio
civico: civile, urbano
inserire: inserire, aumentare
meditare: riflettere, pensare
flessibile: semplice, flettere, elastico
lastra: pannello, tavoletta, stufa
qualificazione: talento, qualificarsi
interruttore: inverso, convertire, chiave
asciugamano: tessuto
decennio: dieci, tenere
multiplo: vario, Di-più
bendare: condimento, allacciare
ordinata: pulito
applaudire: picchiettare, applaudire
acero: palma
rastrello: spazzata
vuoto: vuoto
midollo: il-petrolio, cervello, zucca
guaina: cappotto, busta-da-lettere, baccello
assorbire: exploit, succhiare, abbraccio
predizione: prevedibile, indovina
educare: formazione-scolastica, treno, insegnamento
inchiesta: sonda, richiesta, ricerca
dominio: regola
parentale: genitore
partecipare: delta, aderire, impegnato
ascensore: sollevamento
laterale: lato
rinviare: ritardo
ripugnanza: disprezzo, odiare
nucleo: nucleare, cella, embrione
metafora: esempio
diminutivo: piccolo, micro
bomba: pompa
criticamente: in-profondità, critico
ruggine: passaggio
prenotazione: conservare, sequestrare
cucire: cucito
chimico: chimico
salotto: interruzione, sala
inizio: inizio, incursione, attacco
immersione: tuffo
ostile: ostile
censimento: calcolo
denunciare: accusare, frase
lino: biancheria
sospendere: prevenire
schiaffo: battere
rilassare: relax
corteggiamento: yard
merce: articoli
continuità: congiunzione
reciproco: scambio, inversione
prescrizione: medicina, copia
bolla: schiuma
pala: tenaglie, remo
utilizzare: exploit, uso, trascorrere, imbracatura, consumare
durevole: lungo
lignaggio: familiare
zinco: lavello
qualunque: qualunque, quale
finito: limitato, finalmente, finito
ausiliario: sostenitore, AIDS
corsa: distorcere, combattimento, corsa
accademico: formazione-scolastica
pneumatico: embrione, anello
consumatore: uso
validità: di-valore, credito
circa: quasi, approssimativo
a-maglia: maglia
microscopio: telescopio
civile: civile
cinghia: guinzaglio, corda
simbolico: gesto, identità
adattare: adattamento, far-fronte, trascrivere
probabilità: probabilità, capace
soggettivo: mentalmente
pronome: coscienza
a-torto: sbagliato, abuso
scoraggiare: imbarazzare, ambizione
nuovo-venuto: ospite
infinito: infinito
grafico: grafico
Fico: a-forma-di, immagine
nicchia: coerente, chiave
deludere: deludente, tradire, fallire
proiezione: piano, mostrare
liberazione: scarico, salvezza
ricetta: stimolo
franchigia: privilegio
incongruo: sciocchezza, non-pertinente, insufficiente
rotazione: ciclo, rivoluzione, rotazione
manopola: germoglio
metro: misura
restrizione: limite, moderazione, regolamento
categoria: comunità, rango
razziale: gara, razzismo
sostituzione: anziché, sostituire, cambiamento
innovazione: invenzione
affrontare: far-fronte
bandire: negare
decorativo: ornamento
atrio: indurre, sala
scagliare: lanciare, Riccio
pergamena: libro, rotolo, Riccio
meccanico: meccanico, artigiano
aggressione: attacco, aggressivo, superare
Ciao: Ciao, ben-arrivata
misurazione: misura
competere: lottare, rivale
accademia: college
novizio: reclutare, fresco
divorziato: divorzio
latteria: latte
serbatoio: carro-armato
acquisti: negozio, commercio
implicito: coerente
strategico: strategia
muffa: modulo, forma, stampare, lanciare
prova: esercizio, ripetizione
insistenza: insistere
precedere: prima
medio: medievale, a-metà-strada, vita
turista: viaggiatore, turismo
bevanda: bere
memore: attento
articolare: spiegare, espressione
ri-: poi, indietro
emendare: revisione, cambiamento, sostituire, giuntura, riforma
diagramma: grafico, carta-geografica
deduttivo-umore: induttivo-umore
sopraffare: opprimere
mobile: telefono, cella
elevare: promozione, sollevamento
paradosso: contraddizione
esagerare: sale, massimizzare
biondo: giallo
spunto: marchio, parola-d'ordine, bastone
corridore: sala
negoziare: parlare, discutere
regime: regola
tolleranza: tollerante, orso
opzione: alternato, cetriolo
crociata: movimento
epidemia: tragedia, la-traduzione
tecnica: tecnico, approccio, ingegneria, attrezzatura
terminale: finalmente
diplomato: passaggio
produzione: spese, conclusione, pubblicazione, partenza, produttività, Uscita
individuare: individuare
predefinito: omissione, standard
contesto: ambientale, scena, connotazione
coalizione: alleanza
difetto: colpa, sbagliato, invalidità, svantaggio
concedere: ammettere
trasmissione: pubblicazione, inviare
comporre: scegliere, anello, raccogliere
prevalenza: popolare
sempre-più: tutti
trasformare: cambiamento, convertire
aquilone: drago
ambiguo: vago, contraddizione
bar: caffè, bar
premio: ricompensa, premio, ammettere
etichetta: studio, marchio
approvazione: approvazione, ammettere
parentela: analogia, socialista
realistico: veramente
rettile: serpente
all'aperto: su, aprire
politicamente: politico
residui: resti, rifiuto
nastro: cassetta, banda, film
blando: morbido, dolce
orale: verbale, labbro
speculare: indovina
espellere: espellere, scarico
macchia: individuare, invalidità
saltare: danza, trascorrere
boccale: tazza, smorfia
cuneo: spuntone, palo, angolo
esenzione: sconto, eccezione, ridondanza
portatile: piccolo
involucro: imballaggio, avvolgere
brillantezza: talento, bellezza, bagliore
pinna: remo, balletto
borbottio: sussurrare
bacca: baia
immigrazione: migrazione
zappa: aratro
chirurgia: chirurgo
accumulare: accumulazione, depositare, raccogliere
cacca: feci, tubo
addome: stomaco
implicazione: connotazione, inclusione, conclusione
incentivo: stimolo
chiave-inglese: cacciavite, chiave
campagna: rurale, sobborgo, campo, villaggio
degradare: distruggere, ridurre
indigeno: natura, originale, residente
pila: cumulo-di-rifiuti, cresta, camino
disco: disco
tendenza: condotta, direzione, piegato, disposizione, deriva
aziendale: azienda, comune
assolvere: sbarazzare
instabile: instabile, impermanenza
compatibile: coerente, parallelo, congruenti
telefono: telefono
vuoto: vuoto
afferrare: pugnalata, prendere, sequestrare
convulsione: terremoto, scoppiare
noioso: annoiato, foro, fastidioso
portafoglio: impostato, portafoglio
fessura: crepa
complicazione: problematico, Pedaggio
intervenire: interferire
polare: polarità, estremo
delegare: rappresentante, messaggero
volontà: forza-di-volontà, desiderio
predire: prevedibile, indovina
ottimismo: speranza, credere
buccia: Pelle, baccello, corteccia
intagliare: morso
librarsi: galleggiante, librarsi, esitare
settore: campo, industria, regionale, parte
cognome: nome, essi
istituto: organizzato, azienda, organizzazione
urgenza: ansioso
piacevole: genere
scoraggiare: prevenire
negazione: negare
vincitore: successo
composito: misto
urto: effetto, conflitto
fibra: fibra
sorso: rondine
visivo: ottico, scena
artiglio: zampa
attore: attore, vettore, ragionare
deplorare: pietà
indurre-in-errore: distorcere, stupire, scemo
vietare: inibizione, prevenire, negare
esecutore: attore, artista, giocatore
torneo: gara
requisito: richiesta, condizione
meno: meno
disordinato: spericolato
infettivo: infezione
enfatizzare: insistere, enfasi
pantaloni: i-pantaloni
confondere: puzzle, stupire, imbarazzare
dedicare: volontario, avere-intenzione
chirurgico: chirurgo
veracità: fatto, precisione
centesimo: centinaio
inclinata: ripido, tuffo, piegato
vicino: quasi, presto, circostante
normalmente: comune, di-frequente, generalmente, tendere
confusione: contraddizione, puzzle, confusione
proporzionale: paragonabile, bilancio
dissentire: disaccordo
irritare: rabbia, interferire, stuzzicare, irritata
eccezionale: meglio, suggestivo
iniziazione: inizio
precipitazione: precipitato
terrorizzare: allarme
hobby: divertimento
grammaticale: grammatica
numerico: numero, digitale
criterio: standard
previsione: prevedibile, indovina
disapprovare: negare
esotico: straniera, strano
lampadina: lampada
accrescere: allargare, aumentare, massimizzare, guarire
fusione: fusione, chiamata
sondaggio: elezione
talentuoso: talento, qualificato
scongelare: fusione
raddrizzare: tratto, fissare
decorare: ornamento
presidenziale: presidenza
urto: precoce, moltiplicare, calcio, ammaccatura, tumore
congratulazione: lode
scansione: spazzata
intitolare: permettere, destra
scommesse: condizione
tecnicamente: tecnico, ingegneria
empirico: esperienza
dominare: maestro
pubblicizzare: anno-Domini, propaganda
diffusione: distribuire, pubblicazione
pascolare: raschiare
kit: attrezzatura, scatola, impostato
professionista: medico, allenatore
bagnare: succhiare, tuffo
conservazione: proteggere, salvare, cura
limo: fango, marciapiede, dribblare
stimolante: difficile
inquinamento: inquinare, corruzione
prodotti-chimici: chimico
partita: gregge, impulso, volume
mamma: mamma
spaventoso: terribile, minaccioso
specialista: esperto
anelare: desiderio
bagno: bagno
giocare: gioco, giocare, avventura
integrante: necessario, integrato
eliminare: sbarazzare, cancellare
pisello: fagiolo
appendice: attaccamento, aggiuntivo, assegno
circolare: distribuire
inclusivo: unito
venditore: commerciante
molestare: nervoso, interferire, ossessione
esplodere: scoppiare
leva: curiosità, leva
caduta: perdita, versare
gratis: gratuito
ingrediente: elemento
disavanzo: aprire
sconvolgente: nervoso, fastidioso, antipatico, giù-di-morale, disturbo
alloggiamento: casa
fotografico: fase, immagine, fotografo
peste: insetto
pillola: tavoletta
attualmente: presente
media: stampa
relitto: rovina
corpo: corpo, impostato
menu: lista
frattura: crepa
foro: piattaforma, foro, corte
impulso: velocità, impulso
inclinazione: liuto, piegato
piastrella: mattone
libreria: biblioteca, libreria
calcolo: calcolo
produttore: fabbricante
monetario: i-soldi
rappresentare: descrivere, riflettere, introdurre
inflazione: rigonfiamento
marginale: bordo
fantasia: immaginazione
minare: distruggere
coerente: rigorosamente, congiunzione, coerente
fondamentalmente: condizioni
intenzionale: deliberatamente
superstite: famiglia
flusso: fiume, ruscello
competitivo: rivale
gioielleria: ornamento
alcolico: ubriaco, vino
discriminare: distinguere
militante: radicale, terrorista, militare
disarmare: braccia
cruciale: necessario, decisivo
assegnazione: lavoro, esercizio, dovere, assegnazione
quota: privilegio, assegnazione, quantistico
scavo: fossa, scavare
calcio: calcio
commemorare: persuadere
storicamente: storico
Salve: Ciao, ben-arrivata, salvezza
eliminazione: sbarazzare, omissione, cancellare
teso: pulito
rilassante: comfort, confortevole, relax
efficacia: efficace, effetto, abilità
vulnerabile: suscettibile
atleta: atletico
banda: strisce, linea, banda, film
facciata: maschera, visione
clip: di-base, tenaglie
prototipo: esempio, originale
compensare: far-fronte, compensare, deviazione
nullo: zero, vuoto
limitare: prevenire, abbreviare, ridurre
zecca: marchio, pidocchio
I.V.A: carro-armato
stupro: superare
nullo: zero, vuoto
condizionale: allegato
culturale: cultura
tecnologia: tecnico, attrezzatura
marketing: commercio
cravatta: cravatta
economicamente: economico
amministratore: gestore, fiduciario
ritrarre: descrivere, introdurre
nipote: nipotina, nipote
doppio: due, coppia, gemello
sintesi: originale, installare, impostato
specialità: professionale, caratteristica
bizzarro: strano
richiedente: candidato
linguistico: lingua, linguistica
fungo: sughero, spugna
zucca: schiacciare, zucca
sollevamento: sollevamento, salire, progresso
fenomenale: insolitamente, assolo, super
dinamico: energia
rivedere: revisione, fissare, dai-un'occhiata
abbattersi: disgiunzione, cadere, analisi
faticoso: stanco
città-universitaria: college, scuola
dissertazione: tesi
statistico: statistica, statisticamente
formulare: preparare, formulazione
panino: pane
nullo: zero, vuoto
stimolazione: accelerazione, eccitazione, irritata
censura: censurare, regolamento
attrezzare: complemento
nominare: nomina, proporre
cancellare: cancellare, rottame, frustrazione
metro: misura
deprimere: opprimere
signore: signore, maestro
ricostruire: riparazione, recupero
arbitro: regola, giudice
atomico: atomo, nucleare
controverso: contraddizione
sofisticato: complesso, moderno
contrazione: alzata-di-spalle
non-appropriato: non-pertinente, insufficiente
sedimento: precipitato
affronto: disprezzo, colpa
variante: vario
criticare: critica
la-noia: annoiato, fastidio, miseria
cooperare: cooperazione, congiunzione
analizzare: analisi, analista
piovosità: pioggia
germoglio: germoglio
aereo: uccello
piccante: acuto
flessibilità: elasticità
razzo: missile
avverbio: busta-da-lettere
instabilità: instabile
privazione: privare, svantaggio
accovacciarsi: tozzo
generare: produrre, creare
approssimazione: approssimativo, approccio, convergenza
morale: sveglio, morale, mentalmente
ottimista: speranza, credere
classificare: classificazione, distribuire
programma-scolastico: corso, ordine-del-giorno
all'aperto: su
reagire: reazione, verbo
copione: scenario, linea, Sacre-scritture
ricatto: estorcere
premio: ricompensa, premio
bene: Proprietà, presenza, vantaggio, capitale
variabilità: differenza
ambiguità: vago, contraddizione, incertezza
nullo: zero, vuoto
neutro: neutro
handicap: imbarazzare, ostacolo, invalidità, svantaggio
fotografia: immagine
carenza: tagliare, assenza
spostamento: sostituire
fungo: batteri, spugna, sughero
formulazione: formulazione, testo
diplomatico: diplomatico, messaggero
iniziato: introdurre
fondersi: imbracatura
frantumare: interruzione
inalare: ispirare
puleggia: ruolo
magro: magro
elettore: collegio-elettorale
federazione: federale
mobilità: movimento
scaricare: scarico
habitat: riparo
evocare: agitare, indurre
diluire: magro
arrivederci: Ciao-ciao, addio
demolire: distruggere
sintassi: pensione
ferro-di-cavallo: cavallo
distorsione: deviazione, distorcere
sbattere: battere
pertinente: coerente, corretto, associato
funzionale: pratico, lavoro
spostare: sostituire, espellere, muoversi
autonomia: indipendenza
puzza: odore
differenziazione: distinguere
disponibilità: acquisizione
studente-universitario: studente
grafico: grafico, carta-geografica
affascinare: affascinare, stuzzicare
carina: bellissimo, dolce
addominale: stomaco
alfabetizzazione: formazione-scolastica
sintetico: artificiale
allenatore: allenatore
conservare: Conservazione, salvare, proteggere, conservare
spazzatura: rottame, cumulo-di-rifiuti, rifiuto
foto: immagine, tiro
manuale: manuale, libro
consolidare: rafforzare
vincolare: costringere, limitato, estorcere
economista: economico
Atletica: atletico, esercizio
guizzo: smorfia
iodio: minerale
infettare: infezione, inquinare
designer: determinato
secernere: secrezione, nascondere, espellere, segreto, distinguere
spinaci: adottivo, lattuga
intensivo: estremo, violento
convincente: espansivo
debutto: primo, inizio
millesimo: mille
interno: interno, in-profondità, in-casa, coperto
revocare: privare
ampiezza: grandezza
dimensione: direzione, a-seguito-di, dimensionale, Il-prossimo
Bibbia: Sacre-scritture
poster: bandiera, tela
accelerare: precipitato
intensificare: rafforzare, intensificatore
aborto: aborto-spontaneo
tipicamente: generalmente, comune, di-frequente, tendere
impegno: promessa
coda: coda, ordine
supporto: di-base, gomito, gancio, sostenitore, supporto
ex-: vecchio
inverso: inverso, inversione
evaporare: fusione, sbadiglio
aviazione: atmosfera, aria, volare
correlazione: confronto
etnico: nazionalista, nazionale
barra: tagliare, ridurre
difficile: abile, elaborare, complesso, difficile
caratterizzazione: descrivere, caratteristica
apporre: giuntura, parallelo
molecola: molecolare
configurazione: disposizione, strutturale, montaggio
interazione: parlare, sovrapposizione
quantitativo: volume
introspezione: retrospettiva
Oriente: est
sperma: seme
approvare: supporto, ammettere, approvazione
non-: né, non
credibilità: lealtà, affidabilità, credito
sovversione: rovina
deviazione: deriva, deviazione
iniezione: ago
sandalo: pantofola, scarpe
pezzo: patata-fritta, paragrafo, tratto
televisione: tv
cereale: grano, fagiolo
contenitore: strumento, carro-armato, pentola
migrare: migrazione, vagare
terminologia: condizioni
elettorato: collegio-elettorale
cancellare: cancellare, distruggere
mediare: conciliare
capitalismo: capitalista
sciare: pattinare
autorizzazione: gioco, autorizzazione
selettivo: scegliere
statico: standard
convergere: incontrare, convergenza, messa-a-fuoco
alfabetico: alfabeto
globale: internazionale, mondo
vittima: sacrificio
ok: stesso, fissare, molto
pragmatico: pratico
arbitro: regola, giudice
differenziale: differenza
esalare: emettere, respiro
spartiacque: acqua
infisso: adattamento, attrezzatura
installare: installare, stabilito, chiuso
risonanza: vibrazione
tradizionalmente: tradizione
aula: orbita
protocollo: accordo
calcolo: calcolo, fattura
grammo: caldo, erba
benzina: benzina
galassia: costellazione
adolescente: giovane
impastare: problemi
radio: Radio
rarefatto: magro
aereo: uccello
pedale: battistrada
circa: quasi, di
torcia-elettrica: lente
valigia: scatola, Bagaglio
scambiare: scambio
opzionale: costume
matrice: stomaco
rappresentazione: spalla, immagine
pre: est, prima, prato
annuncio: anno-Domini
stordire: stupire
incidenza: incidente, tuffo
rovesciare: versare, cuore
sensoriale: sensazione, appassionato
consenso: accordo
sorvegliare: gestire, tenere-sotto-controllo, forze-dell'ordine
trapianto: alternato
alluminio: alluminio
fluttuazione: oscillazione
simulare: imitare, fingere
complicare: complesso
mentore: consigliere, allenatore
fessura: apertura
torre: corvo, Torre, castello, pistola
manipolare: manipolazione, agitare
vegetariano: vegetale
norma: specificazione, standard, regola
metropolitana: tunnel
respiratorio: respiro
simulazione: imitare
siringa: ago
mutazione: cambiamento, convertire
biancheria-intima: mutande, biancheria
vagina: baia
differenziare: distinguere, differenza
Stagionale: la-stagione
abitante-del-villaggio: rurale
sesamo: talpa
coma: virgola
invertire: inversione, inverso
supervisore: osservatore, manuale
cacciare: espellere
revisione: dai-un'occhiata, revisione
escursione: librarsi, vagare, sollevamento
località: individuare
recessione: economia
saccheggio: bottino
slogan: parola-d'ordine
feto: embrione
integrazione: cooperazione, inclusione
magenta: porpora, ciano
minimizzare: meno, ridurre
Residenziale: riparo
cifra: digitale, numero
salato: sale
nullo: zero, vuoto
teorico: teoria
acquario: pescare
trazione: veto
paracadute: ombrello
importante: necessario
complessivamente: generalmente, tutti, comune
deteriorare: marcire
nullo: zero, vuoto
sessualità: sessuale
bobina: volume, avvolgere
prevalentemente: in-gran-parte
viscoso: appiccicoso
intestino: intestino
archeologia: archeologico
arachide: fagiolo
apposizione: assegno
fornello: stufa, cucina
pantaloni: i-pantaloni
criteri: standard, indicatore
panoramica: contorno
qualitativo: caratteristica
occhiali: bicchiere
genetico: morfologico, genetica, gene
partecipante: aderire, ruolo, participio
repertorio: talento, software
ruotare: ciclo, rotazione
disposizione: organizzazione, piano, disposizione
voucher: spina, ricevuta
teorema: frase, teoria, assioma
conoscitivo: diagnosi
chiarire: elaborare, spiegare
tossico: veleno
stressato: enfasi
stilo: ago
crollo: crisi
approvvigionare: servire, fornito, assicurare
anti-: opposizione
resistente: cronico, opposizione, immune
merenda: brindare
cinema: film, cinema
rubinetto: tubo
marcatore: marchio
periferica: circostante, regionale
assertivo: determinato, predicativo, aggressivo, decisivo, testardo
nodo: maglia
obeso: spesso
sottrarre: espellere, ridurre, disegnare, privare
intransitivo: necessario
elica: lumaca, Riccio
biscotto: biscotto, torta
gonfiare: rigonfiamento
elettronica: elettronico
riscrivere: trascrivere
laboratorio: laboratorio
professionale: la-professione, commerciale, professionale, lavoro
pendenza: miglio, tuffo
colorato: colore
copertura: coperto, vaccino, cura, coperta, tetto, considerare, volume
coinvolgimento: aderire, inclusione
orientamento: direzione
fabbricare: creare, produrre
termico: il-petrolio
stereotipo: eccezione
Tech: tecnico
residuo: resti, ridondanza
camion: camion
stadio: campo
coordinazione: coordinata
batterico: batteri
interfaccia: approccio
silicio: pi
imparare-a-memoria: memoria, salvare, ricorda
diagnostico: diagnosi
programma: astratto
conduzione: linea, rapire
milionesimo: milione
rivenditore: commerciante
bario: bar
corrente-principale: chiave, secondario
significativo: significare, consequenziale
Audio: voce
concettuale: concezione
griglia: tela
spaziale: atmosfera, dimensionale
esame: quiz
metà: secondario, vita
trucco: compensare
separato: diviso, assolo
inibire: inibizione, prevenire
Multi: vario, Di-più, molto
afoso: umido, caldo
morfologia: morfologico
diagnosticare: diagnosi
influenza: influenza
grafica: grafico
coronario: malattia
natica: natiche, prosciutto
archivio: file
confronto: combattimento, conflitto, confronto
cargo: camion
ottimale: ottimale, ottimo
fondamentalmente: condizioni
motivazione: stimolo
testicolo: uovo
zolfo: zolfo
operativa: manipolazione, azione
traiettoria: orbita, modo
rilevanza: associato, importanza, relazioni
bicicletta: Ciclismo, ciclo, ruota
direttiva: espansivo
linea-aerea: uccello, aria
litro: litro
contrattempo: frustrazione, shock, regressione, fallire, ostacolo
unificare: imbracatura, conciliare
posizione: stare-in-piedi, posizione, paragrafo
minimo: meno
ciclico: Ciclismo, periodico
substrato: molecolare
sott'acqua: sottomarino
competenza: esperienza, abilità
nullo: zero, vuoto
elettrone: elettronico
interattivo: sovrapposizione
inizialmente: originale
sabotaggio: distruggere
interagire: parlare, socializzare
matematica: matematica
fetale: embrione
modernizzare: moderno, aggiornare
estremista: radicale, estremo
pisciare: urina
rannicchiarsi: abbraccio
va-bene: fissare, molto
rubare: rubare
intenzionale: deliberatamente
semi: a-metà-strada, vendere, macinare, larghezza
neurale: nervoso
anti: opposizione
lenticchia: lente
prossimale: quasi
nutriente: minerale, cibo
non-chiaro: vago, evidente
trauma: shock, ferita, ulcera
barattare: scambio
vettore: vettore
tattica: approccio
valutare: valutazione
nullo: zero, vuoto
clone: copia
praticabile: vantaggio, efficace
replicazione: copia
reattivo: reazione
orario: calendario, orario, disposizione
sintattica: destino
stabilizzare: silenzioso
dissidente: rivale
feedback: reazione
questionario: quiz
ossidare: chiamata
millimetro: millimetro
psichiatrico: intellettuale
sindrome: malattia
paradigma: esempio
attivare: permettere, fare, azione
a-caso: casuale, coincidenza, a-caso
ostracizzato: diviso, boicottare
sottoinsieme: parte
metodologia: modo, approccio, una-volta
opera-d'arte: lavoro
sequenziale: coerente, ordinale
sequestrare: tenere, sequestrare, chiuso
chilometro: chilometro
multinazionale: internazionale
progettista: inquilino, strisce, piano
esponenziale: esponente
misplace: perdere
ricercatore: scienziato
supermercato: centro-commerciale
assegnare: assegnazione, distinguere, distribuire, dissezione
nullo: zero, vuoto
calcio: calcio
diritto: destra, corretto
avanzi: resti, rifiuto
sostenibile: standard
navicella-spaziale: navetta
empirico: esperienza
semantico: connotazione, soggetto
membro: interno, membro
tonnellata: tono
modulo: modulo, unità, volume
enzima: lievito
filosofia-di-vita: tutta-la-vita
Pasta: massa
dormitorio: riparo
adolescente: giovane
evidenziare: marchio
negare: negare, distruggere
fidanzato: fidanzata, amico
comportamentale: condotta
grazie: ringraziare
mente: cervello, anima
ecologico: ecologia, ambientale
immigrante: profugo
incorporare: inclusione, tuffo, seppellire
fotocopia: copia, immagine
attivista: azione
maglietta: camicia
terapista: medico, terapia
magnate: re
eccitazione: eccitazione
sincronizzare: sincronizzare
acida: acido
lessicale: dizionario, parola
irrompere: interruzione
classificatore: classificazione
avanguardia: pioniere
presidente: capo
volantino: opuscolo
carismatico: fascino
scandio: tellurio
linea-guida: manuale
porre-come-ipotesi: supporre, presumibilmente
frigo: frigorifero
riavvio: ricomincia
Brainstorm: scuotere, idea
replicare: copia, imitare, ripetizione
angoscia: la-paura
cessate-il-fuoco: tregua
gaffe: omissione, sbagliato
industrializzare: industrializzazione, industria
fratello: fratello
portavoce: altoparlante, rappresentante
dirottare: rapire, aratro
metalloide: simile-a-metallo
che-cola: influenza, umido, correre
sfaccettatura: direzione, a-forma-di, lato
da-parte-di caso: 
bontà: virtù, vantaggio
vagamente: sciolto, gratuito
poi: futuro, poi, a-seguito-di
difficoltà: problemi
squadra: banda
a-grandi-linee: larghezza, allargare, generalmente
correlare: associato, gancio
secondo: indietro
nullo: zero, vuoto
bollettino: opuscolo, informazioni
disapprovazione: approvazione, inaccettabile
vasca: bagno
divertente: divertimento, divertire, ilare
a-parte-- da: tranne
emersione: emergere, Uscita, salire
nullo: zero, vuoto
guancia: giocare
dovere: deve, dovere
per-cento: per-cento
lite: tuta
nullo: zero, vuoto
via: passaggio, al-di-sopra
soprano: infantile
divertente: ilare
p.m.: pomeriggio, notte
albume: proteina
spargimento-di-sangue: sanguinoso
tulio-atomo: torio-atomo
piegare: piegato, flettere
linker: congiunzione
esortativo: hortative
terbio-atomo: torio-atomo
affittato: affitto
trucco: compensare
frizzo: scherzo
config: strutturale
il-passato: ultimo
dividere: distinguere, distribuire
Professore: maestro
rodio-atomo: torio-atomo
stato-marcatore: 
spazio-marcatore: 
burocratico: burocrazia
cintura: banda, imbracatura
nullo: zero, vuoto
venditore: commerciante
nullo: zero, vuoto
lantanio: tellurio
soggetto-caso: argomento-caso
costruttivo: creare, formulazione, fabbricante
nullo: zero, vuoto
femminile: femmina
uditore: ispettore, contabile
microfono: micro
al-di-fuori del: su, tranne
registrazione: inclusione, registrazione
indice: indicatore
sponsorizzazione: borsa-di-studio, cura
ignorante: ignorante
nullo: zero, vuoto
standardizzare: specificazione, standard
alle: individuare, ora
proprietario: proprietario
investigatore: determinante, scienziato, investigatore
svasato: bruciato
nullo: zero, vuoto
autorizzare: permettere
difesa: cura
corridoio: sala
trattativa: parlare
rinfrescato: fresco, aggiornare
meandri: piegato
avanti: primo, Il-prossimo, inoltrare
respirazione: immune, respiro
nullo: zero, vuoto
progressione: progresso
intransitivo: necessario
euforia: entusiasmo
largo: allargare, larghezza, molto-diffuso
intransitivo: necessario
contrastiva: contrasto, far-fronte
stupito: sorpreso
rinvio: introdurre
discendente: familiare, nipotina, generazione
gelato: crema
raggio: raggio
in-alternativa: altrimenti
Quartiere: circostante, abitare, ambientale
abituato-a: costume
imbarazzo: vergogna, disturbo
sostanzialmente: in-gran-parte
appena: fresco, da-poco-tempo, radice
danza: giocare, danza
nullo: zero, vuoto
quantità-marcatore: 
sociale-marcatore: 
critica: critica
rubidio-atomo: torio-atomo
lotta: combattimento, conflitto, guerra
lamentarsi: di
nullo: zero, vuoto
vanadio-atomo: torio-atomo
neutro-Genere: maschile-Genere
fluoro-atomo: torio-atomo
viaggio: visita, safari, spedizione
maschile: maschio
nullo: zero, vuoto
sviluppo: evolutiva, progresso
applicato: pratico
chiudere: chiuso
vantarsi: sfoggiare
a-rovescio: indietro
il-presente: presente
nullo: zero, vuoto
rendi-casuale: casuale
cooperativa: collega
pensionato: andare-in-pensione
nullo: zero, vuoto
divertito: contento, ilare, divertire
approximative: approssimativo
diadica: binario
integrativo: complemento, aggiuntivo
comunicativo: corrispondenza, loquace
nullo: zero, vuoto
a-caso: a-caso
polonio-atomo: torio-atomo
abbattersi: disgiunzione, analisi
abbronzatura: colore-marrone
problema: problematico, problemi
Tradurre: la-traduzione, capovolgere
nullo: zero, vuoto
tallio-atomo: torio-atomo
cricca: conglomerato, clic
facile: con-facilità, semplice
moderatore: facilitatore, gestore
socialmente: sociale
accoppiamento: tuta, coincidere
incidente: incidente
ciò-che: quale
È-interessante-notare che: disegnare
sottosopra: inverso
erbicida: veleno
nullo: zero, vuoto
concorrente: participio
per-esempio: esempio
tumore: tumore
decadimento: marcire
nullo: zero, vuoto
sito-web: sito-web
enormemente: massiccio, molto, super
sarà: 
parente-caso: parente-caso
obbiettivo-caso: destinazione-caso
retribuire: compensare, paga
trattare-male: sbagliato
treccia: cresta, maglia
invece-di: anziché
archeologia: archeologico
connettore: copula, spina, attaccamento, presa-di-corrente
nullo: zero, vuoto
generalizzazione: generalizzare
stronzio-atomo: torio-atomo
rutenio-atomo: torio-atomo
esclusa: tranne
nullo: zero, vuoto
ritiro: divagare, regressione, andare-in-pensione
pensionato: andare-in-pensione
l'un-l'altro: l'un-l'altro, altro
ampio: molto-diffuso
informatica: calcolo, computer, calcolatrice
attività-commerciale-persona: uomo-d'affari
hot-dog: salsiccia
dominanza: effetto, energia, vantaggio
chiudere-le-virgolette: citazione
possessivo-caso: genitivo-caso, possessivo-caso
geneticamente: gene, genetica
concessivo: muoversi, morbido
indiretto-oggetto: diretto-oggetto
proibitivo-umore: proibitivo-umore
allenarsi: esercizio, lavoro, elaborare
delimitato: limitato, diviso
contrario: inverso, opposizione, di-fronte, inversione, contrasto
salita: salire
incredibilmente: insolitamente, super
nullo: zero, vuoto
chiusura: chiuso, telaio
a-buon-mercato: a-buon-mercato
tela: tessuto, tela
educato: formazione-scolastica, gentile
natura: natura, selvaggio
avversario: opposizione, di-fronte, in-direzione
nullo: zero, vuoto
scavare: scavare
infetto: infezione
nullo: zero, vuoto
armato: braccia
cioè: cioè
nessuno: Niente
giuramento: giurare, espletivo
conico: magro, cono
intrattenitore: divertimento, artista
eccetera.: 
oltre-ad: tranne
contorno: contorno, ambientale, forma
cellulare: cellulare, cella
Perdere: tagliare, perdere, trascorrere
allarmante: terribile, ansioso
il-futuro: futuro
congiuntivo-umore: condizionale-umore, ottativo-umore
dovrebbe: deve
motocicletta: motociclo, motore
carta-di-credito: credito
nullo: zero, vuoto
il-pubblico: pubblico
cellulare: cellulare, cella
nullo: zero, vuoto
intestini: intestino
schierare: distribuire, spargimento, consumare
deportare: espellere
proporzione: palo, parte, quantistico
competenza: abilità, Giurisdizione
possidente: angelo
preposizionale-caso: 
assegnazione: assegnazione, dividendo, assegno
preoccupante: ansioso
Tutto-ok: stesso, molto
applicazione: costringere
professionista-frase: professionista-condanna
recettore: Catcher
iniettare: introdurre
assordante: stupire, suggestivo
tosse: tosse
accanto-a: Il-prossimo
