Infinitive: hnit
სახელობითი-შემთხვევაში: hnak
accusative-შემთხვევაში: hkak
თემის-შემთხვევაში: htak
მშობელი: hmat
მამა: hpap
დედა: hmam
მიესალმები: hnat
წინაპარი: htat
ბებია: hyat
მშიერი: hcac
ნათესაობით-შემთხვევაში: hnik
ზედსართავი-სახელი: hcit
და: hwan
მე: hmic
თქვენ: hnan
ჩვენ: hnam
ის: hyic
დანიშნულების-შემთხვევაში: htas
dative-შემთხვევაში: htik
შინაგან-საქმეთა-კონტექსტში: htis
პირი-კონტექსტში: hpak
დამოკიდებული-პუნქტი: htan
სრულყოფილი-ასპექტი: htap
ბოლო-დაძაბული: hkat
მამაკაცური-გენდერული: hsan
comitative-შემთხვევაში: hmik
იმყოფება-დაძაბული: hyan
benefactive-შემთხვევაში: hpik
essive-შემთხვევაში: swik
არა: hnic
მისი: hsis
ზედაპირზე-კონტექსტში: hsak
adpositional-შემთხვევაში: hpan
ადგილმდებარეობა-შემთხვევაში: hwak
სივრცეში-კონტექსტში: hnos
გზა-შემთხვევაში: hrak
ინსტრუმენტული-შემთხვევაში: hsik
რომელიც: hkan
კითხვითი-განწყობა: hnim
და-ან: htam
ექსკლუზიური-ან: hkit
წყარო-შემთხვევაში: hsok
ablative-შემთხვევაში: hlak
საჩვენებელი: hdit
მაგრამ: hlan
ყველა: hsut
ქალის-გენდერული: hnin
ისინი: hwin
მრავლობითი-ნომერი: hlun
ერთ-ერთი: hyik
მომავალი-დაძაბული: hwet
სოციალური-კონტექსტში: hson
როდესაც: hkap
imperfective-ასპექტი: hmap
იქ: hkac
პირობითი-განწყობა: hcan
მეტი: hdoc
გარეთ: htac
ნათესავი-შემთხვევაში: hrik
illative-შემთხვევაში: hlik
ამის: hkas
დირექტივა-განწყობა: hden
deontic-განწყობა: hdim
კითხვა-სიტყვა: hwac
copula: hkok
პირი: hpon
მამრობითი: hman
შეეძლო: kwat
სხვა: hcon
ნომერი: hnoc
ძალიან: tcac
დრო: htim
დრო-კონტექსტში: htos
დროებითი-შემთხვევაში: hmak
შესახებ: hkam
ეპისტემური-განწყობა: hsim
მხოლოდ: htun
პატარა: hcak
მაშინ: pcan
hortative-განწყობა: hton
რეტროსპექტივა-ასპექტი: hrip
შესანიშნავი: hcat
volitive-განწყობა: hlim
ადრე: hsec
უნდა: pcic
ორი: htut
ვხედავ: tcan
ვიცი,: hsat
ქვემოთ: hcin
შემდეგ: hcas
პირველი: hpas
საკუთარი: hpun
გადაეცემა-ბურთის-ფლობა დაფიქსირდა: hlic
არასოდეს: hnac
განუყოფელი-ბურთის-ფლობა დაფიქსირდა: hkic
ძველი: hwat
სათათბირო-განწყობა: hcim
დღეს: htin
სადაც: hnap
მოდის: hlat
გზა: hyas
მუშაობა: hkaf
ხმოვანთა: hwaf
წასვლა: hkun
perlative-შემთხვევაში: pwik
პროგრესული-ასპექტი: hpip
ხანგრძლივი: hlac
ამბობენ: hsac
როგორ: hkin
კი: hpit
უკან: hwap
აქ: hcic
ვფიქრობ,: hcik
იგივე: hsam
ბოლო: kcac
მოშორებით: twan
ქვეშ-კონტექსტში: hnas
მიიღოს: htit
ი: hfan
ხელი: cyat
ახალგაზრდა: hyac
მიუხედავად-იმისა,-რომ: hyap
მისცეს: hkik
ღმერთი: hmac
delative-შემთხვევაში: lwak
არაფერი: hmin
მარჯვენა: hyit
ერთხელ: hyam
semelfactive-ასპექტი: fwip
ნაწილი: hpat
ხერხი: htic
სახლი: hfas
მსოფლიოში: tcat
უფროსი: hcaf
სამი: tyin
neo: hnon
აქცენტი: hcok
მიყვარს: hpac
ყოველთვის: hsit
ღამის: hwit
თითოეულ: hmit
მეფე: hyak
შორის: hsin
გული: cyin
paucal-ნომერი: plom
იმიტომ,-რომ: hyok
მიზეზობრივი-შემთხვევაში: ksak
რამ: hkis
კომპლექტი: swat
სახელი: hnem
სათანადო-არსებითი-სახელი: hran
hortative: hrat
ქვეყანა: hlit
სთხოვა: hput
ჩანს-მტკიცებულების: crit
უკეთესი: pcac
მხარე: psac
რა-თქმა-უნდა,: hkus
ქალი: hfin
საკმარისი: kyat
მალე: hpuc
სრული: hcun
ოთახი: hfac
თითქმის: hlap
არ-შეუძლია: nyat
წყლის: hwik
desiderative-განწყობა: hdin
მსუბუქი: lyak
არც: hnun
სიტყვა: slat
კარი: tyan
გამოყენების: hpus
დილით: hsap
terminative-შემთხვევაში: twik
ძალა: hkuk
თავი: hmis
იმყოფება: hyin
ხმა: hwas
თეთრი: hpis
ფული: tlan
შემდეგი: kyak
ცუდი: hyis
სიკვდილი: hmut
ფორმა: hfam
inessive-შემთხვევაში: nwik
კეთილი: tyac
ხშირად: tsan
წელი: nwan
მეგობარს: myat
იმისათვის,: hyut
აუცილებელია-განწყობა: hpim
რაუნდი: hcut
მჯერა,: hban
საჯარო: hpin
სახელმწიფო-კონტექსტში: hsas
შვილი: psat
ასი: hmas
ბავშვები: hcis
შესაბამისად,: tyak
იმედი-მაქვს,: hcap
ზემოთ: hyip
ძვირფასო: pyin
წაკითხული: pyac
ქალაქი: hsic
უკვე: hpic
ის-ფაქტი,: hfat
factive-მტკიცებულების: hfit
გესმის: hsun
მინიმუმ: hmim
ალბათ: pyat
ღია: kcat
სხეულის: tcic
საჰაერო: cwac
ბუნება: nyit
დაეხმაროს: mlat
წერილი: lyat
ოთხ: ksat
optative-განწყობა: hpam
ცეცხლი: hfak
ამიტომ: hyif
საათი: hcam
უფასო: tyit
ომის: syat
თუ-არა: hsaf
მიზეზი: kyan
ერთიანი: hnut
დარეკეთ: hkuc
რატომ: hwam
დაკარგული: hkut
ათასი: tsas
ოჯახის: hfic
სული: twam
კითხვა: swac
ზრუნვა: kcan
რეალურ-განწყობა: hlin
ნიშნავს: mwit
პოტენციური-განწყობა: hten
მიმართ: cyan
allative-შემთხვევაში: lwik
anthropic-გენდერული: hrin
მოკლე: kyut
შეუძლია: hyuk
ცხოვრება: hkip
სათაური: hsek
იგივე-სათაური-marker: hcek
სხვადასხვა-სათაური: hfek
პასუხი: tsat
ზღვის: mwat
შიში: hcoc
მესმის,: pcat
მძიმე: kyin
ვადები: tyut
ეჭვი: hdac
dubitative-განწყობა: twin
ვთხოვთ: psan
იარაღის: tcas
შავი: clis
მოუტანს: tyat
ლამაზი: ksis
ბნელი: tcak
გამართავს: psak
ათი: htaf
შოუ: pyan
ისტორია: hkif
საერთო: kwan
წიგნი: hkup
ელექტრონული: lyin
განხილვა: plak
ჩანაწერები: myac
ინტერესი: nyis
დაწერა: kcit
საწოლი: pwat
აუცილებელია: syis
იდეა: hwis
ხელოვნება: klat
vialis-შემთხვევაში: hlas
ძმა: pyak
ზოგჯერ: ksas
ონლაინ: lyan
მაგიდა: tlas
მდინარე: nwit
თვალის: kyac
ინფორმაცია: fyin
მოულოდნელად: tfan
უცნაური: hgan
ღრმა: ksan
ცვლილება: hrit
შეგრძნება: nwac
შეხვდება: mlit
მიზნით: htuc
ბედნიერი: hcuc
როგორც-ჩანს,: syit
სისხლის: cyac
გაიზარდა: kwas
სამხრეთ: swan
ცივი: tlat
წინ: myik
პოზიცია: psis
ბოლოს: tyam
დავდგეთ: syan
ვარაუდობენ,: nlas
ქალიშვილი: pyit
აფეთქდა: myan
cut: hkim
ასლი: hfap
ქმარი: hgat
ექვსი: hlis
მახსოვს: twat
ეფექტი: hyaf
დაეცემა: htuk
გარდა: hsip
თმა: hpaf
გაივლის: pyas
საავტორო: pcit
არმია: cyit
პერსპექტივაში: kcak
ცხენი: kcas
მომავალი: hwic
west: pcak
გადახდა: plit
წითელი: hyun
ოქროს: tcun
სურვილი: hdan
თამაში: plin
master: mwas
ოფისი: hfus
მთავრობის: syak
ეკლესია: kyas
სიგრძე: hlen
კომპანია: ksin
ქაღალდი: kyis
ალბათობა: hbin
განსაკუთრებით: cyas
დათვი: pcas
window: cyak
შეთანხმება: hgac
სილამაზის: syac
მოვალეობა: tfac
გაუგზავნე: fyan
მანძილი: htif
დუმილი: slan
ფეხით: fyat
ველური: kyik
იღუპება: myam
გადარჩენა: pfan
მწვანე: kcin
პრობლემები: mlan
ღიმილი: myak
არასწორი: clat
სხვადასხვა: pcin
ძილის: slit
quotative-შემთხვევაში: kwik
იწყება: cwan
აქცია: kfan
ვიზიტი: fwat
დაიცვას: nlan
ცდილობენ: tcis
ყოფნა: psit
ტკბილი: tlit
მდიდარი: tcin
მტერი: tcam
გემი: hcip
მდგომარეობა: kyit
მათ-შორის: hkum
ინკლუზიური-პირი: hlon
საიდუმლო: kwit
precative-განწყობა: pwim
თავაზიანი-რეგისტრაცია: hbit
ბოროტი: pwac
მარტი: myas
რა-მნიშვნელობა-აქვს: kwac
დარჩენა: hlam
ნაცვლად: plat
ლურჯი: plan
შეუძლებელია: psap
სკოლა: hsuk
შემთხვევა: ksac
ქორწილი: nwat
საკვები: hcuk
ოცი: tsis
მშვიდი: tcit
ადვილად: hnis
პერსპექტიული-ასპექტი: hrap
ენა: lyac
გამოხატვის: syas
კვირის: hsus
დარბაზში: hcum
საფრთხე: kcic
ქონება: myit
დაიბადა: nyan
სასამართლო: kcut
ზოგადად: tyap
gnomic-ასპექტი: hmip
ღირს: tyas
მარტივი: syap
ხე: pyic
ბრძოლა: pyap
კედლის: twit
სამოთხეში: cwak
inchoative-ასპექტი: htip
jussive-განწყობა: hjin
ტონი: twun
დაკავშირებით: klan
მოსალოდნელი: pcik
თვის: hmaf
გამოცდილება: nyap
მთლიანად: nyac
ახალი: tsac
duke: hnuk
დაფარული: kwak
შეკრული: hyim
აღმოსავლეთ: tyuk
ქვის: pwan
გარკვეულწილად: kfat
მიმართულებით: tlac
სკამი: kwis
მხარდაჭერა: syut
თარიღი: tyic
სოფელ: klac
სფეროში: clit
ნებართვა: nwin
permissive-განწყობა: hmom
წარმატება: slak
სათანადო: hric
hill: clin
მუსიკა: ksik
დისტალური-საჩვენებელი: hdat
დღის-მეორე-ნახევარში: htup
ტირილი: hyuc
პატივი: hnaf
შვიდი: swit
კერძო: pfat
ახალი-ამბები: nwas
სცენა: slac
ბაღში: cyam
რასის: htus
გამანაწილებელ-შემთხვევაში: twak
ვისწავლოთ: clan
პოლიტიკური: syik
ტყუილი: kcun
მიცემული: tsak
ჭამა: kcam
სართული: hlaf
ავად: pwin
ორიგინალური: mlin
ზაფხულში: kyam
რელიგია: tlam
სურათი: ksit
გაქცევის: plap
ავტორი: hlut
brown: pyun
განისაზღვრება: htem
ტკივილი: hdon
გაზაფხულზე: psin
საუკუნის: syic
რბილი: mwan
კუთხეში: kyun
აწარმოოს: psas
სიცილი: cyaf
დაგავიწყდეთ: flat
europe: hyup
რვა: lwat
dress: lwac
საშინელი: cyap
სუნთქვა: syaf
ბრძენი: hbas
კუთვნილებითი-marker: srak
მეხსიერება: myin
თანამედროვე: fwan
ადგილზე: tcap
მოიმატებს: hyus
შესვენების: pyik
ორმოცდაათი: hfis
კუნძული: tlap
შეეხოთ: hsuc
დაპირება: pcam
commissive-განწყობა: mwin
ხარისხი: tfat
გეგმა: plac
ქცევის: nyak
სიურპრიზი: cran
წუთი: hmun
გასროლა: hwut
უარესი: pcap
მინა: klak
მაგალითად: tlin
უსაფრთხო: hsif
ექიმი: tsit
completive-ასპექტი: hmep
განმეორებითი: tyun
სამხედრო: slin
თბილი: nyam
სასმელი: pfin
კითხვები: pcaf
აღშფოთება: nran
პირდაპირ: tyik
ქუდი: hcup
ძაღლი: kwap
მსახური: hnuc
სიამაყე: hram
გულშემატკივარი: tcuc
მატარებელი: nyin
მორალური: myut
დაკავშირებული: kyim
შესვლის: fyak
წესი: nyas
ხმალი: cwat
თავდასხმა: kfak
ჯანმრთელობის: clac
პუნქტის: pyaf
სოციალური: hsum
დაბრუნების: tfit
ბოდიში: hpec
გამბედაობა: krac
მადლი: hnen
ოფიციალური: hfaf
იმ-პირობით,: tsik
მოთხოვნა: pwit
ერთი-შეხედვით: klas
მოძრაობა: hyon
ველით: cwit
პირიქით: psam
თორმეტი: tyaf
დაკავებული: nyut
ღვინო: hwun
გემო: swut
რკინის: fyac
გავრცელება: syin
სავაჭრო: myap
უპირატესობა: twac
ტანსაცმელი: kfip
მოსამართლე: fwak
განსხვავება: tfaf
შეშფოთებულია: kcis
კაპიტანი: kwin
მზა: nlat
შეწყვეტის-ასპექტი: hsep
საინტერესო: kyic
უცხოური: kwic
გამაძლიერებელი: hnif
მნიშვნელობა: myun
საბოლოოდ: hfim
კანონპროექტი: fwin
დაამტკიცოს: hpuk
თავიდან-ასაცილებლად: flan
კისრის: cyun
იურიდიული: hfik
მშრალი: swak
ემსახურება: syam
დაკარგავს: pcut
მტკიცებულება: pyut
მტკიცებულების-შემთხვევაში: hdak
პროგრესი: pyis
შენობა: klit
ძიება: syuc
სამწუხარო: hrac
ცოდვა: psip
ოცდაათი: tfis
პატიოსანი: tsin
დახურეს: kyap
საბანკო: pcun
ბედი: cyik
ტყე: hfun
გაზომვა: mlac
წინააღმდეგ-შემთხვევაში,: htoc
ნაკადი: lyam
პური: hpup
დამატებითი: tfak
აირჩიეთ: twas
ცხოველთა: nwam
zoic-გენდერული: hzin
Eventive-სისტემის-განწყობა: hwim
იგივე-ღონისძიება-marker: hcom
multiplicative-შემთხვევაში: tlak
სქელი: hmus
არსება: hyum
წვიმა: myic
ზედაპირზე: pfas
წმინდა: swis
ივლისი: clim
ანგარიში: hfut
სანაპირო: pwas
ფაილი: hfif
მხრის: cwut
მიკვირს,: kran
სამეფო: klik
სიმღერა: hkuf
კომფორტი: kfaf
არავის: nyic
ბალახის: kcap
მიაპყროს: cwik
გახსნის: cyic
ივნისი: cwun
თევზი: mlic
დედაქალაქში: klin
მკერდის: cyut
snow: hcif
განათლება: tlik
ბასრი: tcaf
სამწუხაროა,: hdam
ხარჯზე: fyas
შენია: hmuc
მილიონი: mlun
დაიღალა: tcik
კლავს: ksam
ჩრდილი: cwap
წონა: plas
მასობრივი: mlas
შეიქმნა: tlip
მამაცი: pyam
წვრილი: plic
კმაყოფილი: srat
შეამოწმეთ: kcik
ძალით: hdet
ეროვნული: nyaf
ღვთაებრივი: swin
ხეობაში: clak
ვხვდები,: kwam
სპეკულაცია-განწყობა: hken
ყვითელი: clas
ნაშთები: mwac
bent: nlac
ყუთი: pwak
სეზონი: tsim
მეცნიერება: slas
ჭაბურღილის: kcuc
ბიძა: hmuk
სია: lyit
აგვისტო: ksut
პოპულარული: hlup
უცნობი: fyit
ნაცნობი: flak
ნაცნობი-რეგისტრაცია: krit
მკითხველს: tsut
მიდგომა: pcuc
ორჯერ: tsap
ინტელექტუალური: tfik
ნამდვილად: tsam
მღვდელი: pcis
დაიჭრა: fran
მწუხარება: hpom
სასახლე: kfas
სცემეს: clap
eh?: hnec
სულელი: myuk
ზღვარზე: pfac
ცხრა: nwun
პაკეტური: psut
განიცდიან: tfas
ხმაური: hcus
ლიტერატურა: lyic
რჩევა: swas
ცარიელი: kcuk
წოდება: psik
ქარიშხალი: tcut
ჯიბეში: kyip
ფანტაზია: nlin
სასჯელი: cwas
ნოემბერი: nwap
დეკემბერი: tsip
არარსებობის: psic
მადლობა: ryak
მისამართი: tyis
ფრინველის: pyuc
მფლობელი: mlik
ქურთუკი: kwut
მომზადება: tyip
ურთიერთობა: lwan
მოწევა: htum
იანვარი: nwak
მანქანა: clic
შინაარსი: nyik
კბილი: tlis
სირცხვილი: hcet
bay: kcaf
ტვინის: pyuk
ბეჭედი: klic
ფრაზა-marker: frak
კვ: ksap
ხილი: fyut
ჩაი: tsic
აგიხსნით: slam
მისასალმებელი: cwam
პოეზია: pwis
ყიდვა: klam
ერთგული: hdic
შფოთვა: hcen
ორმოცი: klis
აპრილი: pyip
kindly: kfit
ოქტომბერი: kfap
მწარე: kyuc
მონა: tlaf
ფხვიერი: hluk
ტექსტი: tsus
საკრედიტო: cyip
თხუთმეტი: pfit
სასტიკი: kcim
შეუერთდება: cluc
პროცესი: hpif
დანაშაული: kyaf
მტვერი: tsuc
პრაქტიკული: plik
ფერი: nlak
განადგურება: nyuc
მომატება: lyas
ცხვირი: hnus
ვაღიაროთ: tyim
გუშინ: kfac
hesternal-დაძაბული: tlen
ვერ: slap
გაგრძელდება: tcim
აცვიათ: pwam
ბრმა: nlit
ათეული: tsun
ფრენა: fyap
დიდება: cwin
devil: cwaf
თანდათან: twic
მსხვერპლს: kyif
სწავლება: cyis
სინდისის: tfin
თეორია: tlic
მინისტრი: myis
სიძულვილი: hnet
ტბა: cwic
ცენტრი: syun
faint: pfic
რაციონალური-გენდერული: hron
ფრთხილად: fwac
სარგებლობენ: nlam
თაყვანისცემა: pwap
საქონელი: twap
კანი: twaf
სახურავი: tlut
გვირგვინი: gyan
ციხე: klap
ტახტზე: tcus
მიმაგრებული: nlaf
mile: mlim
ექსტრემალური: krim
ციხეში: fyis
თასი: kcip
წევრი: mlam
სამოქალაქო: syim
ყველგან: tsaf
აშკარაა,: tfic
რამდენიმე: pwaf
მოცულობა: clam
საბაჟო: ksaf
bow: ksun
სარჩელი: slut
ხორცი: mwak
რძე: hluc
მცენარეული-გენდერული: hwen
ხედვა: slic
იშვიათი: nlap
დეიდაშვილი: ksic
ხიდი: pwut
დაცვა: pfak
მარილი: swam
innocent: hwus
დედოფალი: kwim
იმედი: kcus
ცნობისმოყვარეობა: hras
ცეკვა: tyus
სასტუმრო: clut
შეავსოთ: flin
პატიმარი: psun
მაღაზია: hjan
კიბეები: sric
beg: hmen
ქვიშის: sran
ძალადობრივი: hgit
სექტემბერი: hsem
გამგზავრების: prac
ჩაშლის: crin
უნარი: krin
მსხვილფეხა-რქოსანი-პირუტყვი: hwec
ტექნიკა: hwip
სამზარეულო: hkon
გაყიდვა: hbak
სიჩქარე: hsot
დასკვნა: clon
კომპიუტერული: hkot
მარადიული: hsen
შეზღუდული: mrit
ბიბლიოთეკა: hbek
ბაზა: hbac
დაბნეულობა: hrun
დიდებული: cris
ანალოგიურად: hjic
შეშინებული: hbic
უბედური: prin
სტატია: hrek
მზარეული: kfin
band: hbat
უდაბნო: hget
კოცნა: hbun
ბურთი: hbot
ჯოხი: hpot
არგუმენტი: hrut
დაიცვან: nrak
კურთხევად-განწყობა: hbim
ნათელი: hrim
დამნაშავე: hdis
gun: hgin
პოლიციის: plis
დამალვა: hzan
ექსპედიცია: srin
ignorant: nrin
გულუხვი: drac
cloud: blan
ნარჩენების: htek
თებერვალი: frif
დაავადება: hren
დახარჯვა: bwan
წყარო: sron
ინიციატივა-შემთხვევაში: hnok
დეიდა: hbam
დაგვიანებით: dlic
გადაიდო-აუცილებელია: hlip
ცნობით-მტკიცებულების: prat
შუაღამისას: dyit
გმირი: nrac
ფილოსოფია: hfof
finger: hjit
კომფორტული: hzat
სადღაც: hmoc
პრეს-: bran
თანამშრომლები: hraf
ჯილდო: rwan
ბრალი: dlac
სიღარიბეს: krat
შუბლის: htec
რეკლამა: glan
angel: htet
სინგულარული-ნომერი: hgam
გამთენიისას: hbon
კომერციული: krak
აპატიებს: pran
ცხვარი: hcec
მოთმინება: hpen
ფერმა: crac
რეფერენტული: hrec
სიმინდის: mran
გასაღები: kcif
უმრავლესობა: hmot
სისუსტე: hdut
ატმოსფერო: traf
შვებით: tcoc
კაცობრიობის: mlis
ოპოზიციის: pric
დისკზე: hdik
lonely: hket
მხატვარი: nrat
რაინდი: cwis
ხიბლი: tran
გადაწყვეტილება: drin
გამგებელი: gran
ფილიალი: rwac
განწყობას: hsoc
ენთუზიაზმი: tsum
ინდუქციური-განწყობა: hdum
საზოგადოების: hmum
ნავთობის: hyen
მილის: hbap
ბეჭდვითი: trat
oh: dyoc
დისკურსი-კონტექსტში: hros
წოდებითი-შემთხვევაში: hwok
სალონში: ksen
სიგნალიზაცია: plam
ნერვული: hnes
მუდმივი: hset
დანა: ksuk
აბრეშუმის: slik
აბუჩად: grin
ჯოჯოხეთი: nrik
გამოყოფილი: plen
სერიოზულად: mrat
შერეული: mrik
ხის: mrak
ურჩევნია: hpet
გაფრთხილება: trin
მითითება-განწყობა: htom
იმპულსი: hmos
ამბიცია: mrac
უარყოფს: hnek
კონსტიტუცია: swic
ინსტრუმენტი: srit
უწყვეტი-ასპექტი: hnip
tide: hgas
კოლეჯი: klen
კუდი: hkek
თაობის: nric
კატა: blat
პირდაპირი-მტკიცებულების: hret
მიტოვებული: trac
თერთმეტი: hyec
ინსტიქტი: nlik
დამახასიათებელი: trit
ტომის: hgik
apprehensive-განწყობა: pcim
თავშესაფარი: crat
უხეში: hruc
riding: hris
shake: hmon
მრეწველობა: hdot
პროფესია: hres
ნათურა: hdap
ყავა: kfif
დაემორჩილოს: htot
ჩრდილოეთ: nrit
მედდა: nris
გარწმუნებთ: hjat
ჯაჭვი: ryin
სწავლების: cric
ფეხსაცმელი: hgut
ეზოში: mram
ბუნდოვანი: hmec
სხვაგან: hlet
ბინა: pret
საქმიანობის: twot
შაბათი: cram
sunshine: hduc
ქვრივი: hwuc
ელემენტი: hlem
ასახვა: hfen
ორგანიზაცია: hgis
ვარსკვლავი: tram
ინციდენტი: hgon
სტუმარი: hgip
ბარი: brap
ბოთლი: hbet
დალოცოს: blak
აჟიოტაჟი: crak
შიდა: trik
დაფიქსირება: krik
გამომდინარეობს: prit
ღრუ: hcot
პროვინცია: hpos
ცივილიზაციის: srac
hang: hgak
შოკი: crok
გამონაკლისი: swap
დაძაბულობა: tren
სტანდარტული: ryan
მართვის: dran
rid: hruk
ფიცს: kses
საგანძური: zran
თესლი: hbis
კოშკი: tras
საყვარელი: fwit
ცოტა-ხნის-წინ: hcem
ბოლო-ბოლო-დაძაბული: hrot
მეძინა: srik
ავეჯი: mrin
თოკზე: hkos
სათავგადასავლო: hdas
ჰონორარის: ryit
დღესასწაული: dyat
აღწერს: dras
სამოცი: hses
მასშტაბის: hkem
ცერემონია: srec
ნადირობა: clik
whisper: psus
დიდწილად: ryat
ქრისტიანობა: ksim
ადვოკატი: hwif
დეტალურად: drit
princess: hrus
საკურთხევლის: dlat
ვებ: hwes
purple: brin
შევიკრიბოთ: hkoc
საარჩევნო: hben
კონცეფცია: kren
მთვრალი: crik
დაასხით: brac
ლიფტით: hlif
ჟესტი: hjis
მართვა: rwin
გაცვლა: tcen
გარკვეული-სტატია: hdek
იმპერატორი: mras
დისტანციური: hroc
მახინჯი: clup
უვნებელია: cras
roll: hrof
inch: nlic
გაზეთი: grat
წვერი: dric
გაანადგურეს: srim
კომისიის: kson
მაშინ,-როდესაც: grak
გადაკვეთა: kcoc
დამოუკიდებლობის: htes
სუნი: hwon
თვრამეტი: hdec
ისტორიული: tris
მთლიანი: krut
root: hrok
ტალახში: hbik
პატარძალი: dlan
veil: pras
თეატრი: tret
შედარება: kras
კონკურენტი: rwis
ბალანსი: slen
მწვრთნელი: kron
იუმორი: hnum
რომანი: rwas
შურისძიების: hbaf
ეჭვიანი: ryut
საჭე: hlok
დაიწვა: glat
ფლეშ: flac
შექმნა: hkec
კონფლიქტის: hnot
წყევლა: hlos
imprecatory-განწყობა: pram
უმწეო: hces
დადებითი: hzit
შესვლა: klup
წყალდიდობის: nras
მარცვლეულის: gwan
გულგრილობა: hdun
ჰორიზონტზე: crim
სავარაუდო-განწყობა: hsom
ციცაბო: htop
ჰარმონია: mron
thunder: hgot
ბავშვობაში: htok
მუხლი: hgun
პროგრამული-უზრუნველყოფა: pwen
დაზიანება: kram
მიღების: ryis
მისცემს: nlim
protasis: hpoc
slip: slok
რევოლუცია: hrif
ფერმერი: hjim
ინსულტის: trak
პლატფორმა: hpof
მომხმარებლები: hmes
პრივილეგია: hpek
ორგანიზებული: hyot
სტუდენტი: clen
მღვიმე: hgec
ტრადიცია: rwat
ტრაგედია: tses
გამოსამშვიდობებელი: hjap
კრიტიკა: ryik
ბამბა: krap
საავადმყოფოში: slot
ქირავდება: kris
გაზის: hges
გარდაუვალია: pwic
სასიკვდილო: hgim
ფოთოლი: glit
გამოცემა: plun
მტრული: tsup
თარგმანი: dwan
დაკრძალვის: jran
ფქვილი: mrun
მიმოწერა: ryon
რომანტიული: hrom
ქოხი: clun
შესთავაზოს: psot
mimetic: hmet
დოლარი: dlon
დღისით: hjac
თექვსმეტი: hsos
ასამბლეის: hzac
კოლონია: klon
ფრთა: gyin
lion: hles
კულტურა: klut
სვეტი: hkom
cunning: glak
დრამა: dram
ხუმრობა: hjuc
mist: hdus
მედიცინის: dwas
თოთხმეტი: hkes
მჟავა: sram
კერძოდ,: hyet
შემოსავალი: hmok
ეპისკოპოსი: hbip
orange: tron
აბანო: byan
პრიმიტიული: rwit
კალათაში: ksek
მდივანი: sris
ჩალის: prak
მოუთმენელი: pfif
ხსნა: slon
hodiernal-დაძაბული: dlin
აპირებენ: zrin
steam: tcip
შხამი: hwoc
ნიჭი: tlon
კლიმატის: lwim
ეფექტური: fric
გარჩევა: tcif
სარეცხი: dwac
აღიარება: kfis
სისულელეა: hjas
ქვანახშირი: kyon
canoe: kwon
დროებითი: tric
delimitative-ასპექტი: hdip
ძვლის: hcos
monday: nwic
სამშაბათი: glac
ოთხშაბათი: bwac
ფედერალური: frin
სასურველია: hzic
წარმომადგენელი: ryic
თეთრეულის: lwin
რადიატორის: swuk
ძმისშვილი: bwin
სისხლიანი: kric
ალყის: cren
კუჭის: hpem
სპილენძის: pcon
სამიტზე: hzik
მეხუთე: pfik
იაფი: brat
ექსკლუზიური-პირი: kwen
წართმევას: zrat
ღობე: hzas
ძეგლი: tfam
საარტილერიო: tlep
იკისროს: mrap
მიმდებარე: sren
მკაცრად: srot
ირმის: hluf
ბუჩქი: hbuc
რკინიგზის: hrep
გამონადენი: hduk
მემკვიდრე: mris
მუხა: blun
უსიამოვნო: pren
გამოგონება: hgic
ფორტეპიანო: pyon
დაარწმუნოს: swen
უხილავი: gric
კარგად-ცნობილი: ryun
სისასტიკით: kluk
ცდუნება: hyoc
telic-ასპექტი: hlep
ეკონომიკური: kfik
საერთაშორისო: troc
ხელს-უშლის: tcek
ფილოსოფოსი: flif
ელეგანტური: gyit
კეთილდღეობა: kyen
თევზჭერის: mlak
იპარავენ: truc
ტუჩის: hloc
გადადგეს: ryac
მონაკვეთი: sras
გალერეა: glen
პარალელურად: zlan
atelic-ასპექტი: htep
კონტინენტზე: trap
prohibitive-განწყობა: nrim
ჰალსტუხი: dwat
მობილური: slep
კვერცხი: dyan
ხელოვნური: jrat
ამასობაში: nwis
კრიზისი: ksot
თავაზიანი: sloc
ლანჩი: lyon
ფიჭვის: pwon
ბიძგი: hcef
ალიანსი: lyen
წელის: hkop
სასწაული: hmek
მეზღვაური: slis
სიწმინდეს: prut
რესპუბლიკა: hguk
ტელეფონი: tfen
whip: krip
პერანგი: cyim
დანერგვა: ryas
sofa: hsof
პერსონალი-ბარათს-გაატარებს: hsup
ქურდი: ksif
შეინარჩუნებს: nrec
არხი: kcen
პიროვნება: klim
რეფორმა: kfam
საშიში: hzim
palm: plim
სპიკერი: hzak
ბარიერი: dwic
გამოიწვიოს: pris
სათადარიგო: bzak
neat: syec
სხდომაზე: cwen
წამების: crot
ნესტიან: tcum
ქედის: grit
მგზავრის: hyek
mill: mwik
რუკა: jrac
საყელო: klok
შეცვლის: klif
განზრახ: drat
ლუდი: hbif
velvet: hwem
სიმძიმის: gwit
ქადაგების: hpum
ბოროტად: glas
ფარა: hgen
ცამეტი: tres
ამართლებს: jyit
პარასკევი: crum
ფუნჯი: broc
ჩამოტვირთვა: dlas
კრემი: krem
cliff: klaf
ჟიურის: jrin
monster: ksos
გაყინული: hgoc
ბანკში: pfot
penny: psen
ამტკიცებენ,: srut
apple: hpep
განიხილავენ: drak
ფონზე: prun
ტრანსკრიფციას: trim
პერიოდული: prik
გასართობი: nren
ვირუსი: bris
ბავშვური: blit
ასახავს: flit
დააკონვერტიროთ: kcet
განტოტვილი: kluc
ოპერა: hpop
დამტკიცების: nron
ღალატი: rwak
დასჯა: hzen
elbow: kcon
დანართი: tcet
სარემონტო: hrop
საეჭვო: cyec
სამოცდაათი: swet
წმინდა-წერილი: srip
pit: grac
არეულობის: dlak
ორობითი: byin
abbey: bjan
arrow: tcec
როგორც-წესი,: trec
შეიმუშაოს: frat
ერთგულება: hlot
მონეტა: syip
კანკალს: tcem
დევნილობაში: gwin
მექანიკური: myim
ხაფანგში: crap
ტორტი: kyek
sir: cyes
მოგერიდებათ: sret
ჩვიდმეტი: syet
თაფლი: myon
აქციების: dzat
tread: hjam
აგურის: brit
ოთხმოცი: hpes
სამწუხაროდ,: pcen
კონსულტაციები: kcot
ლეგენდა: lwen
მოსავალი: hfos
ხელშეწყობა: pfon
ღუმელი: hsop
მეამბოხე: bric
მოძველებული: hnom
swell: cron
swamp: swot
გასახდელი: hdes
ასკეტური: pces
მენეჯერი: mren
გუნდი: cros
რაციონალური: tson
დამუშავება: pson
wolf: blaf
ხალიჩა: hgap
ანტიკურ: hjak
ნაყოფიერი: frut
ისთვის: slif
ყველი: twis
bite: byat
მოიწვიოს: jwan
ტაძარი: kyet
harbor: brak
wander: djan
კულტურების: tsos
მუქი-ლურჯი: nlen
ნიღაბი: mrok
ფანქარი: pses
ბოსტნეულის: sroc
გამოფენა: hzet
შარვალი: tlun
კორუფცია: hrup
კაბინეტი: nram
წვნიანი: srup
ქირურგი: syon
შემწეობა: tcot
spy: gyas
უგუნური: hlec
gossip: gyic
ნიშანი: hzon
აბსტრაქტული: srok
ხუთშაბათი: cwim
საგზაო: ryaf
არქიტექტურა: ryek
crack: rwaf
ორნამენტი: rwon
დავამარცხებთ: lwas
amuse: mwun
აღდგენა: ksus
საფარის: plut
გადამწყვეტი: dyin
უარყოფითი: nraf
ფესტივალი: hfec
ამცირებს: hrum
ღალატის: zyan
hunter: djin
snake: syen
ბატარეის: bret
ცვილის: flam
დეტექტივი: dlit
ანალიზი: nlis
ყურადღება: hzot
swim: twen
კონვერტში: lwaf
ვინც: hgek
სიგარეტის: jrit
საავტომობილო: mrot
მოხალისე: hwot
რეაქცია: ryif
ბარგის: blam
ყრუ: hboc
წვენი: hjus
humility: jlit
სამინისტროს: mret
სექსუალური: hjon
დიამეტრი: dyam
ნაჯახი: blac
diamond: dlam
ალტერნატიული: hlek
echo: hgus
თავშეკავება: swon
პირადობის: hdaf
ეკრანზე: krun
lazy: lwis
momentane-ასპექტი: hmop
კომპაქტური: kfot
drift: hdif
გაქრება: hgaf
ray: ryen
მელნის: mwic
მასიური: mraf
მარანი: dyac
სამახსოვრო: nrun
glare: klek
სენატის: slet
კუბოში: tfap
პატიება: frac
მერცხალი: nlun
indulge: nlot
swing: swun
მინდვრის: gram
კომპლექსი: klos
გადადგომის: hzis
თავმდაბალი-რეგისტრაცია: nret
შეთქმულების: swim
წიწაკა: prip
pony: pron
კანდიდატი: hzam
fox: flik
chimney: tcon
იურისდიქცია: drik
სოფლის-მეურნეობის: rwic
სიზუსტით: tcuk
ყოფილი-გარდაცვლილი: brim
დემოკრატიული: mrek
bud: hbos
საბანი: bwat
სეტყვა: hgep
ღორის: srus
shaped: krek
სპილოს: craf
კლასიკური: ksok
დამკვირვებელი: nwet
elephant: lwit
ფრჩხილების: nwus
bee: hmif
დასამარებას: dzan
მსახიობი: bzat
ოფლი: zwan
polish: ploc
ილუზია: hlus
გაურკვევლობა: pcet
საშუალო: syif
ჩამოყაროს: tsot
სოფლის: grun
groan: nyen
ჰგავს: slec
პასუხის: hzun
ტომარა: cyek
გაღიზიანებას: fren
ნემსი: hjun
კონტროლირებადი: nroc
ქათამი: truk
თანმიმდევრული: kwot
ბარელზე: bras
მუდმივი-ასპექტი: hcep
ექსპერტი: ksec
შთაბეჭდილება: blin
olive: zlin
van: myen
დაბრკოლება: bwak
nod: kcec
foster: plaf
განმარტება: fyic
დაბადების-დღე: gjin
hammer: hcof
სურნელოვანი: hfon
განმეორება: trun
ტრივიალური: twut
kick: hjik
გათხრები: kwaf
ცხოველები: plot
თავის-ქალა: hcop
საკანონმდებლო: dlik
heel: cruk
frown: crun
პატენტის: plet
მილიარდი: blim
ქიმიური: fyik
პილოტი: pyot
იმიტაცია: mlot
skirt: kwet
უჩვეულოდ: srap
ყოველკვირეული: jwik
ტექნიკური: tfip
მცენარეული: tset
crow: kraf
sunrise: sruc
სიცოცხლის-განმავლობაში: glin
ხელი-შეუწყოს: hyom
hook: hdok
tiger: blic
შეაღწიონ: crut
ყდის: slun
გზატკეცილზე: jras
მილიციის: mlip
ditch: kroc
მთლიანობის: kret
ცხრამეტი: dzin
ორგანული: rwik
თეოლოგია: flic
float: flut
witch: byac
შეწუხებული: hwuk
დიპლომატიური: dyik
სტუდია: twos
უნდა-აღემატებოდეს: kcok
შამპანური: cyen
გააჩინოს: crif
ბანერი: hbes
გაყრა: lwon
bolt: hbut
ვენაში: jyan
პასიური: psif
ქაფი: hgum
ხრეში: grik
წინსაფარი: tyen
პლანეტის: gren
თაროზე: claf
fan: flon
ტროპიკული: hjip
ფაზა: fwas
თვითნებური: rwen
შეხედულებებსა: kfun
mercury: krok
creep: hrem
თვითმკვლელობა: tcos
რეპორტიორი: prot
ართმევს: hpok
გამოცდილი: klun
აივნით: blik
ჩანგალი: fras
თანამშრომელი: mlek
დამსაქმებელი: myot
სიგანე: jrak
გაღიზიანებული: djit
ადანაშაულებენ: klot
საპენსიო: pyen
ზმნა: kres
monkey: mwon
მისაღები: hwek
ხელმოწერა: tlim
მართლმადიდებელი: rwos
ირონია: fron
სანერგე: nrap
თავშეკავებით: jlan
იმპორტი: tyot
ლამპარი: croc
გრამატიკა: gjak
ანაბარი: gyat
კოლონიური: plon
yacht: jyat
შედეგობრივ: kwec
გუმბათი: kwun
სისქე: hfot
ჯიუტი: cyon
muscle: hmup
მასშტაბები: ryam
რუბლს-შეადგენს: ryos
cowardly: rwam
აღკაზმულობა: gwac
სადღეგრძელო: tros
მაუსი: myus
syllable: slim
pat: prap
დიალოგი: dlaf
ნეიტრალური: nrot
შრომისმოყვარეობა: dwin
ეწინააღმდეგება: trot
მისაღწევად: kfic
თხა: byak
აყვავება: hfet
დააწესოს: mlon
ანონიმური: nwim
ფორმალური-რეგისტრაცია: frit
ხბო: hbof
სახელმძღვანელო: mwut
melt: hjec
წაშლა: flas
ქოლგა: gras
boot: bzut
მინერალური: mrim
ზავი: crus
duck: hbok
დაგეგმვა: pfam
საპნის: hsuf
თოჯინა: gwak
ჩონჩხი: klet
ვილა: blis
სამკერვალო: jlin
შერიგება: dyak
kettle: kset
mature: mruc
კურდღელი: kruc
დირიჟორი: nwot
დამოკიდებულება: djat
მოთამაშე: jlic
insect: pset
რესტორანი: cret
owl: lwun
რადიკალური: djik
რეზიდენტი: zwin
dragon: dron
აუდიტორია-მტკიცებულების: drot
მწყურვალი: kyos
linger: dren
გაანგარიშება: glun
რეგულირება: ryim
მერი: mlap
უმცირესობის: mric
შეძენის: dwon
ვეტერანი: bren
ორკესტრი: ryes
ბეკონი: bjin
მინუსი: zwat
ქსოვილი: frap
მუსიკოსი: gzik
გონებრივად: hnep
ერთობლიობაში: nyon
არაადეკვატური: nrip
არქიტექტორი: tsek
lemon: nyim
ხველა: kcos
თავის-ტკივილი: crek
tenant: ryet
ნაყოფიერების: srun
მოშუშებისა: hfoc
ოთხმოცდაათი: nwon
შემთხვევითი: hbec
კოვზი: kcek
balloon: blon
ცარცი: hfip
ახსნითი-მტკიცებულების: nlet
გამომცემელი: pcot
ძმარი: sruk
ნაცარი: fyec
expletive: slek
აღორძინება: nrut
მგრძნობიარე: kfim
გვირაბი: tfun
თავსატეხი: hpef
მექანიზმი: mwim
მათემატიკის: gzit
fade: frun
ღვიძლის: jwin
sublative-შემთხვევაში: bwik
dip: dris
ერთეულის: twim
მონოპოლია: hnop
სათამაშო: hgup
წყალქვეშა: bzin
მიწისძვრის: hbem
ლაბორატორიული: brot
კორპის: kruk
თვითმმართველობის-კონტროლის: syot
buddha: hbus
იქსოვებოდა: bjat
საელჩოს: blas
შორეული: sres
დეკლარაციული-განწყობა: drim
სტიმული: tyuc
შოკოლადი: clot
დამთხვევა: tyon
ხელთათმანი: gwat
დაჩოქება: hjek
გეოგრაფია: hjif
საინვესტიციო: nwes
სიტყვიერი: mrec
ანალოგია: nlip
საერო: srek
hawk: blap
ფსიქოლოგია: nloc
შეიკარი: gjan
ჯართი: krep
როლი: cyum
დოზა: hdos
ორაგული: slom
pudding: pwun
მაგნიტური: gyik
ტუმბოს: pcom
ჟანგბადის: ksip
სერტიფიკატი: tfot
მედალი: hmem
რიტორიკა: trok
scrape: rwap
oar: dyas
ტელესკოპი: trip
ყელსაბამი: clek
ორთოგრაფიული: prif
ვისკი: hwos
willow: hwof
camel: hlum
amateur: myet
გასასვლელი: crec
ბიოგრაფია: brif
ვირი: gzac
ყოველთვიური: mwis
იგნორირება: nruk
დასვენება: byit
click: lyik
ოვალური: twon
ელასტიური: lyet
ლექსიკონი: kfon
ham: gzam
ცისარტყელა: rwun
მოიხმარენ: kcum
spit: tcup
სატანკო: trek
კოლეგა: clok
პეპელა: trif
გრაფიკი: graf
ტყუპი: jwat
დამოუკიდებლად: trem
bamboo: hbum
ბანკირი: jlat
დაგროვების: kles
ინსპექტორი: nyet
ლუკმა: hyos
კოშმარი: hbom
jam: gjam
მუზეუმი: mrem
ანბანი: lwam
scatter: zras
დარბევა: crip
გამჟღავნება: clus
rot: fraf
აგრესიული: gris
ხახუნის: mroc
პიერ: gyac
spider: brik
კარტოფილის: trut
რევიზია: cwon
გაუმაძღრობით: jlac
ნაადრევი: ryot
გამრავლების: gzan
დატრიალება: pcip
სტატისტიკა: tsok
კალენდარი: klem
ნომინაციაში: nwen
ტრილიონი: tlos
სხვენით: tlok
სასარგებლოდ-განწყობა: rwim
პროგრამები: pfen
ნომინალური: nlon
უკმაყოფილება: sraf
ინფექციის: hfok
ქვევრის: krot
გაკვირვებით: cyok
pioneer: gzin
უმოქმედობის: nlif
კომბოსტო: glic
სპორტული: tlet
ლოთობა: mrut
idiophone: hdof
ბერკეტი: lwek
სენატორი: syem
iris: nrif
ant: mwam
bug: hbop
ორსული: grim
პროვოცირება: hjet
ტერფის: tcok
კლასიფიკაცია: glik
ცვლადი: prim
გადაიტანოთ: ryap
ხვეული: krec
გოგირდის: hsef
უკარნახოს: dwik
წარმოშობა: brun
frog: fram
გადაჭარბებული-შემთხვევაში: twek
sponge: hjen
შემაშფოთებელი: djon
squirrel: slip
grind: zyin
irrealis-განწყობა: flim
ვულკანის: glam
შენობაში: gron
გამოყენებისათვის: kloc
გეოლოგიური: jlik
პასპორტი: psop
ამორალური: mlet
ორცხობილა: hbuk
თანამშრომლობა: kros
ტაბლეტი: tlot
დასვენების: kces
atom: trom
შიდსის: hzip
პირამიდის: psim
ციკლი: swok
nap: hnup
უკანონო: hjaf
paw: pfap
shyness: crom
eclipse: klip
არფაზე: lwap
ცოცხი: srum
პანელი: mwen
ასტრონომიის: tcom
maze: blen
სტიპენდია: bwit
კუს: kfuc
მრჩეველი: dwak
ბოჭკოვანი: fwic
cricket: jrik
მტრედი: ksom
ადაპტაციის: dyon
სამკუთხედის: tfon
ხაზინადარი: tsen
წყალბადის: jron
მყიფე: hfuk
პრინტერი: pyet
choke: tcof
ქრონიკული: gzon
გაუმკლავდეს: slaf
დილემა: dlim
საინჟინრო: jyin
კამერა: hkef
ბოდიშს: pluc
lick: lwet
მოცეკვავე: dret
მიგრაციის: mres
ჩოგბურთის: tces
ხერხემლის: clip
fry: zrac
იკვეთება: tfuc
stab: twuc
დაგავიწყდათ: psaf
ნახევარსფეროში: praf
სტრატეგია: zrit
კვარცის: krus
მაკრატელი: jris
საპატრულო: proc
მყინვარი: lwic
შუა: dwam
მემორანდუმი: mwap
cone: kwuc
სიმეტრია: hzut
მწარმოებელი: zrak
მოპასუხე: fwik
mosque: djis
ჭადრაკი: cres
ზარი: htof
cherry: tref
გავრცელებული: kfen
stumble: tfok
სატვირთო: ryok
მდოგვი: mros
პროცენტი: pfet
აუქციონზე: jlam
sieve: srif
ცვალებადი: swoc
magnet: gjat
ლევან-გაჩეჩილაძე: syus
islam: slum
tiptoe: twip
გარსის: mlen
shave: clet
გიტარა: gjit
გამოუყენებელი: bzan
თელა: hyem
soar: kcom
ნაცვალსახელი-marker: ryec
staple: pcus
spice: zlat
გირაო: jlas
გადამზიდავი: zyac
ვიბრაცია: bron
გაღიზიანება: trus
გუთნის: hlom
ფსიქოლოგიური: zlik
წყალსაწრეტი: hgok
comet: cyet
შუა-საუკუნეების: dyic
sparrow: grec
აუნაზღაუროს: twet
პლასტიკური: psuk
სქოლიო: cyot
ორბიტაზე: rwot
frugal: twum
გოლფის: hgof
ნულოვანი: zrun
ჩიპი: tcep
ზეწოლას: prok
yawn: gjac
უთანასწორობა: gwas
mole: tloc
ჭურჭელი: frik
დიასახლისი: hgif
ჭვავის: rwem
დაემორჩილებოდა: hyes
ტოლერანტული: glon
ემბრიონის: brec
miner: jren
მივესალმებით: zlac
საფუარი: lyim
პრემია: pfim
ქლიავი: plem
გაკოტრების: byas
სარწყავი: rwif
პიტნის: nyun
კაპიტალისტურ: glis
ელასტიურობას: hlef
ზვიგენი: gyak
გაწვევის: drut
შენახვის: zren
რეალიზმი: cles
ginger: djic
სასწრაფო-დახმარების: blus
შესადარებელი: kwip
საფულე: bjap
grimace: glim
მეცნიერი: gyis
gut: grot
equanimity: hwum
რადიო: href
შეუსაბამო: zlit
bean: bwam
არაფორმალური: frim
შვილიშვილი: gyut
უთანხმოება: dloc
სტეიკი: tfek
აზოტის: zron
razor: hjut
კონტრასტული: krom
პროპაგანდა: pcoc
ფეიერვერკი: fris
პოპ: pcop
undress: crop
furrow: cruc
მავნე: hzaf
იუდაიზმი: hjum
დაკომპლექტდეს: pluk
ობიექტივი: lyes
pegative-შემთხვევაში: pwek
კიბოს: kfes
სალომბარდო: pyek
ლექტორი: zyat
გაჟონვის: hzuk
კვალიფიკაციას: krif
სიმჭიდროვე: djot
ინდუქციური: dyis
საღეჭი: htuf
talkative: bzit
lobster: hgos
ფასდაკლება: dyut
ტაქსის: tsuk
იერარქია: crem
jade: gyec
snarl: glaf
lizard: lyis
ჩანჩქერი: crof
გულდასაწყვეტია: djak
ვეტო: frot
პრეზიდენტობის: ryip
მყიდველი: mrif
gallon: jlen
mosquito: mruk
გადახრა: dwen
ჭიდაობა: lyut
მოზაიკა: myok
plug: plok
squat: pcuk
სასურსათო: ksoc
კომუნისტური: myos
amaze: mwek
prosecutive-შემთხვევაში: rwuk
constellation: nlos
დიქტატორი: dwit
გატაცებული: tyet
სატელიტური: tlec
slipper: hlop
თანხმოვანთა: fyon
სავარაუდო: tsif
უმუშევარი: byet
მხარდამჭერი: sros
lotus: lwot
სალათა: sles
ქლორიდი: lwok
ბაქტერიების: bwic
წებოვანი: pcek
კომპონენტი: bwon
kernel: klec
feign: bjak
byte: bzet
სეკრეციის: sruf
მკაფიოდ: pres
ემთხვევა: mloc
ბალეტი: blet
შარდის: mrus
ნიორი: lyun
გასული: hguc
ეკონომიკა: kcem
საშუალო-კლასი: hdom
სწრაფი: gjic
მაშები: htef
სამრეცხაო: lyoc
მარწყვის: srem
ურბანული: pcos
გართულებების: mlaf
ნოუთბუქი: tfut
ალბომი: zlam
ბეისბოლის: hbep
sniff: sluc
ბუფეტი: hbuf
მიმღეობის: rwip
ავტოფარეხით: grek
დიაგნოზი: djas
ყავარჯენი: ksuc
გამოძალვის: srom
რეგისტრაციის: psuc
ხსნადი: jlun
ფოსფორის: psof
სტრუქტურული: rwut
წებო: glum
თეზისი: twes
ხელოსანთა: clif
ბანანის: bwas
აქსიომა: kyom
ნეკნი: psos
არცერთი: nyek
pi: pyim
ავტობუსი: bwos
ცენზორი: swes
სარაკეტო: mlus
ძეხვი: slos
მანიპულირება: nlut
ტომატის: tfet
გააძლიეროს: kfut
socket: syok
კალიუმის: tsom
ვიღებ: prup
ვირტუალური: zwit
ალგებრა: gjas
სტომატოლოგი: dzit
ოპტიკური: pcok
ბიუჯეტის: bzen
ბიოლოგიის: bwim
უმუშევრობის: byim
მუხლუხა: krum
solo: slof
ბრაუზერი: bjac
დისტანციური-ბოლო-დაძაბული: nyot
ისტორიული-დაძაბული: crep
ბირთვული: nluk
სპექტრი: pyem
ნატრიუმის: syom
ისტერიის: syes
რწმუნებულის: tyos
მძევალი: byik
gourd: gluk
wrinkle: kwuk
გამჭვირვალობა: tfif
spike: swip
პრიორიტეტი: pcif
საცალფეხო: dyen
ათეიზმის: tsem
მონიტორის: mwot
ოლქში: nlec
უკონტროლო: hkof
probe: grok
პლატინის: plip
ორმაგი-ნომერი: dlun
ფილტვის: pcep
super: syup
trolley: trop
ადგილობრივად: lyot
უბიძგებს: gzat
ბენზინზე: plif
თირკმლის: grif
ნაძარცვი: bzac
შეფასების: dlen
დარიშხანის: syek
snail: nrok
grasshopper: tsec
განტოლება: fwen
სოციალისტური: swos
ფილტრი: flot
სენსორული-მტკიცებულების-განწყობა: hxin
გაფართოება: kyot
გადასცემს: mwet
leash: pwet
მანდარინი: drun
ჟოკეი: hjok
პნევმონია: hnof
სოლიდარობა: gret
hinge: cyif
გრძივი: nruc
დივიდენდი: dwun
skate: hkep
მაჩვენებლებით: slop
ინვალიდობის: dlif
შეპყრობილი: bwen
გაცემის: pfun
ფოტოგრაფი: trof
delta: dlet
ციფრული: djim
bitch: brut
ქუთუთოს: hyop
დიაგონალური: dyun
ქვეცნობიერი: byon
წარბის: bruc
sneeze: pcec
იუმორისტული: dlis
ინდუისტი: nwum
ლტოლვილთა: nyif
სამარშრუტო: cwot
ცილის: pwot
ნაგავსაყრელი: hdop
დახვეწა: flen
რევა: hwom
გენი: gyen
პირველკურსელთა: hdem
სოციოლოგიის: syoc
squash: kwoc
fisher: hfuc
რეგიონალური: jyen
მოძრაობის-აღმართზე: hvok
რეტროსპექტივა: hxik
tornado: gyon
inversion: nwos
tv: twif
cube: kfet
პროდუქტიულობის: pwuk
სტაფილოს: krop
მოლეკულური: mwuk
კონგლომერატის: glet
ბუღალტერი: ksum
კიტრი: kyok
orgy: drok
გამხსნელი: jlet
ფოსფატი: psef
პრემიერის: gwik
ტუტე: flis
ტანვარჯიში: jyas
მძიმით: kwom
მოძრაობის-downhill: hvat
miscarriage: jwac
pod: tcop
დონორი: dzon
მანგანუმის: hzem
ფსიქოლოგი: syos
ქლორის: clos
კლავიატურის: kyoc
ელიტა: zyit
ფრჩხილებში: pfaf
რაგბის: rwoc
წყლული: jlon
inflected: hxit
nibble: nres
კვანტური: fwam
სვიტრი: swek
ევოლუციური: fwis
notation: nyoc
bounce: tcuf
სასექციო: drec
cache: kcep
წრფივი: lyec
სტიბიუმი: trum
superessive-შემთხვევაში: psek
სიმსივნური: twom
ეროზია: cyos
alpha: flaf
navel: nwip
იმუნური: myip
გრიპის: flun
ლუდსახარში: bjit
გაამარტივებს: slef
ამოკლებენ: bram
dent: djen
captivate: dwim
იძულება: brok
sock: bzas
ფილმის: fyim
კოსმოსში: klom
აბინძურებს: hpuf
gregarious: gjen
პენისი: zyis
სატყეო: lyif
ალუმინის: lwum
რხევის: zlon
ჰოროსკოპის: ksop
აგდებს: dlek
ჩართვა: nluc
ბენეფიციარი: byic
dolphin: dlip
killer: cyus
ძუძუმწოვარი: myaf
მაჩვენებელი: swif
დიოქსიდი: dwis
მსხვილი-ნაწლავის: zlen
ბიუროკრატია: brus
დამახინჯება: jric
მაცივარი: frip
არქეოლოგიური: cluk
მიუღებელია: kwok
დაზუსტება: pfis
ბროშურა: pfut
ანთროპოლოგია: nlom
გემრიელი: kyec
გარდამავალი: txit
უშიშარი: kwus
მზესუმზირის: hzuc
louse: glus
ion: lyos
ტურიზმი: tyum
მოდემი: myom
აჩქარება: jrun
გააყალბოს: tsoc
ემისიის: hmef
გატაცების: drap
გადახურვა: hwep
საპარიკმახერო: pfes
ფოლკლორის: floc
კაპილარული: plek
ნაციონალიზმი: nlum
buttocks: nros
მოტივი: hmuf
სულემის: slem
იმედგაცრუება: xras
კობალტის: kwos
შვრიის: gwam
მოძრაობის-upriver: trup
ტანში: gyam
მსხვილფეხა-რქოსანი: bwun
flip: flip
redundancy: dzun
ვიდეო: hwop
ბოიკოტი: bjik
ვიქტორინა: cwif
hockey: cwok
პარტიზანული: grip
მაგნიუმის: hgem
სარადარო: drek
შიმპანზე: hzif
საიმედოობის: kwif
მართკუთხედი: tyec
კელპი: klep
განზოგადება: jlak
კომენდანტის-საათი: kfec
ჰომოსექსუალი: mlok
სცენარი: srop
ფორმულირება: flus
ჩადის: nrom
გაღვივების: zlak
ურანის: ryum
catcher: kwes
კოორდინაცია: kyop
გადასახადის-გადამხდელის: nwaf
ინტეგრირებული: trep
მიიჩნია,: hzap
გამა: hxam
safari: fwim
მოძრაობის-downriver: ht6n
კოეფიციენტი: kfus
სათაურით: zlic
ანალიტიკოსი: nles
შამათის: hzes
mall: hmof
ბისმუტის: bzim
მისალოცი: psok
დაახლოების: bros
გადაუხვიოს: djet
აქციონერი: ksem
მიკრობთა: mrip
გენიტალური: jwit
მორფოლოგიური: mluk
beta: byot
jeans: gjis
მონაცემთა-ბაზაში: tles
კალკულატორი: klus
x--ray: ksef
გარჩევის: zram
გარემოს: zyen
sigma: zyim
გათიშვის: hxon
დღის-წესრიგში: gres
სავიზო: bzis
ინფრასტრუქტურის: nyuk
firefly: gyun
detector: tyek
ადაპტური: dyip
ბიოლოგი: byis
splice: pyec
ბრომი: brom
პალადიუმი: plum
hiccup: kfok
pastel: psec
ზოოპარკში: zwac
კლინიკა: lyok
კონტექსტში: nwoc
yoga: hjoc
წიგნის-მაღაზია: byun
თერაპია: grap
ნაციონალისტური: zlis
behead: zlet
yeah: swec
პრობლემური: byam
ჯაზის: dzas
ვოლფრამი: tsof
ტერორისტული: gwis
dribble: droc
ცვლის: tlem
alimony: lyaf
შაბათ-კვირას: hfom
chrysanthemum: gzim
ვაქცინა: byap
მოტოციკლი: tyok
მანტრა: dyot
სემესტრის: myes
ჰეროინის: gwon
დირექტორია: flap
კათოდური: kfoc
იდეოლოგია: dlec
პარკირების: prek
თეტა: fret
anticlimax: hxis
სელენი: clem
cycling: blek
ქერქის: pros
ექვივალენტობის: swaf
მიმდინარე-შესაბამისობის-marker: hxak
აეროპორტში: cwoc
ამპუტაციაზე: gyet
კალათბურთი: bwet
თვითმარქვია: mwip
ტარაკანი: tlek
ქრომის: hgom
ლიტრი: hl6t
მიუხედავად-ამისა,: nwec
ჰორმონის: cwom
ყალბი: tluc
გახვრიტეთ: prec
animism: nyom
პოლიგონის: cloc
ფემინისტური: hfes
შეუღლებული: kcop
ევრო: dros
ginseng: hjes
ალგორითმი: hlof
ლაზერული: lwes
აფთიაქი: dlot
მილიმეტრიანი: mlem
flex: flek
ანოდი: nlok
ნიუანსი: hzus
ნახევარი-განაკვეთი: prem
მგრძობიარობა: nyec
აქციის: drom
ჰელიუმი: clum
ორენოვანი: dzic
აკრონიმი: hqim
initialism: nl6m
gerund: gros
პლაზმური: psem
ქრომოსომის: rwom
რიგითი: rwok
კილომეტრიანი: klum
ფაქსი: tfes
გენეტიკა: nwek
freckle: frek
screwdriver: dres
ბროკოლი: blok
preterite: xrit
ვიტამინი: tyem
კადმიუმის: kyem
ბომბდამშენი: bwoc
გრაფიკული: gjik
ტიტანის: dyim
splurge: clec
ლამბდა: lwem
მეგობარი: pcem
copulate: kyuk
hourglass: tlus
თანაგრძნობა: mlif
ბორის: bres
ვერტმფრენი: cwet
tellurium: tlum
ბოლო-ვადა: jyic
უერთდებიან: gwic
სანტიმეტრი: hfem
მოლიბდენის: mlom
lithium: tfim
მულტიმედია: myum
განახლება: dyet
calorie: clom
რობოტი: ryoc
საშინაო-დავალება: groc
ლოგარითმი: grom
mantis: gzas
instal: nwut
ამინო: myoc
glyph: glif
aorist: pyos
ეკოლოგია: plec
დახვეწა: flok
მარიხუანა: bjam
მიკრო: mrom
კილოგრამი: lwom
overeat: jrot
პროგნოზირებადი: dzik
pizza: zyas
მოსმენას: zris
ენათმეცნიერების: bwis
თმის-შეჭრა: braf
iridium: ryom
რასიზმის: gwim
ოპტიმალური: gyim
ინდუსტრიალიზაცია: drif
შტაბი: krup
ცერიუმის: zrim
შესაბამისები: nrum
partitive-შემთხვევაში: pxik
კასეტა: ksep
ნებისყოფის: blot
განზომილებიანი: dzen
პარამეტრი: rwet
სინქრონიზაციისათვის: nrop
მაქსიმალურად: dzim
სემინარი: mwec
დისკო: dyok
neon: nyok
ოსმიუმი: hzom
ნათლისღების: hp6n
პლაგიატობის: lyap
artifact: rwek
reactor: fyet
oregano: ryop
პლუტონიუმი: pwum
yttrium: tyom
augmentative: hxat
სახელი: mrum
სამაგისტრო: zrot
მარჯვენა-ფლანგიდან: dwaf
არგონი: jros
phobia: hxot
სოციალიზაციისა: sluk
გლობალიზაციის: bluc
ტალღის-სიგრძე: hnef
encode: kfom
მეორადი: psoc
რესტარტი: nrek
ჰეპატიტი: pyes
torus: fros
ქიმიოთერაპიის: myep
modulo: mwok
პროტონული: zwot
diskette: dwet
milligram: mlum
pixel: psep
ტანტალის: twem
გადაწყვიტოს: hjot
გენოციდი: nyos
predator: rwes
გალიუმის: glem
ცირკონიუმის: hzum
განმსაზღვრელი: txin
არაწრფივი: nlem
პესტიციდების: pyif
ბერილიუმის: brem
neuron: nrus
predicative: pxit
underpants: tlif
factorial: kref
ნეიტრონული: zrut
ნიობიუმის: nwom
გერმანიუმი: hjem
metalloid: tlop
ბოლო-on: dlap
prolative-შემთხვევაში: hl6k
ბიომრავალფეროვნების: jwic
ჯოისტიკი: jyok
ანტიბიოტიკი: twok
actinium: gjim
ასტრონავტ: srof
ლოგო: tyes
crackpot: hwup
მარათონი: mrof
იტერბიუმის: zwim
აუტიზმით: tyif
ionize: nlof
რადონის: cwos
Nerium: nrem
ეპიდემიოლოგია: pwip
მოხუცებულთა: lyuc
კარავში: kyep
ზოლიანი: drip
indium: nyum
veridical: hvik
ნახვა: bwes
ყურანის: kwek
ჭურჭელი-და-დანა: fwet
nth--root: tfec
lawrencium: lyem
სამოქალაქო-უფლებები: glip
მობილური-ტელეფონი: mlof
პარალიზებულია: twoc
protactinium: prum
რადიაციული: hd6n
დამოკიდებული-on: pxin
თორიუმის-atom: hxim
blue--jean: bjun
სახლი-მცენარეთა: hxas
ინდივიდუალურად: dvit
ნაკადის-მიმდინარე: lwuk
triple--პუნქტიანი: ht6t
ადამიანის-სხეულის: hn6n
ფიზიკის: bzik
საცალო-მაღაზია: hxan
ცეზიუმ: hs6m
ხანგრძლივი-წინ: hqan
ცხრილების: hxet
ერთეულის--of--მასობრივი: hn6m
შედგენა: ml6n
ორობითი---ღირებულება: vrim
ადამიანის-მიმდინარეობს: nyus
მიერ-საშუალება-საქართველოს: hvan
depan-dari: pxat
praseodymium: pyom
მუყაოს: kxat
სასრული-verb: hqik
სასამართლო-ნომერი: hr6n
პრო-წინადადება: hr6t
კრიტიკოსი: hk6k
შეფუთვა: pxas
impermanence: pxan
at-ყველაზე: txas
აღმწერი: drop
ნეოდიმი: nyem
მეგობრობისათვის: hvit
წაკითხული-მხოლოდ: xyak
ნაპოვნია: xwan
gnomic-განწყობა: kxin
ფონემა: hxom
რაციონალობა: xlit
ფონოლოგიური: xlin
სასადილო-ოთახი: hxac
ცხოვრების-ოთახი: hxic
centric-შემთხვევაში: zrik
წინასწარ-hodiernal: hx6n
პაციენტი-შემთხვევაში: hqak
oblique-შემთხვევაში: bwok
სოფლის-ტერიტორიაზე: hqat
recurse: hr6s
შუა-ხმა: dyos
meitnerium: hm6m
ფოსტალიონი: hvak
noncommittal: kxit
საფონდო-ბაზარზე: xrak
იდენტიფიცირებადი: hxap
მიზანი-გამოიწვევს: krof
ერთი-მეორე: hxen
lative-შემთხვევაში: dvak
რაციონი: hr6c
არასამთავრობო-ადამიანის: hg6n
ცხოვრების-რამ: hvic
ძალიან-პატარა: hxut
კინო---თეატრი: hvin
hassium: xyim
attenuative: ty6t
multal-ნომერი: ml6m
milky-გზა: txam
neptunium: nwem
მწერალი-მოჩვენება: txik
trans-ციფრების: ts6s
სულელი-გარშემო: hqun
americium: myem
დილით-დიდება: txan
მეხანძრე: xran
berkelium: blem
galaxy-გენდერული: kxan
nobelium: blum
ნახვამდის: hvac
ბუდიზმი: hfum
fermium: frem
ცისფერი: xyan
სოიოს: syof
დისტრიბუტორი: qrit
strikebreaker: txak
პროცესორი: ples
abessive-შემთხვევაში: bvak
adessive-შემთხვევაში: dvik
to-შემთხვევაში: kxak
agentive-შემთხვევაში: dvek
rutherfordium: hr6m
ანტისხეულების: txip
როგორც-ბევრი-როგორც: hjos
აგენტი-გამოიწვევს: hg6t
მსახიობი-როლი: xram
ethidium: txim
საერთო-გენდერული: hk6n
accompanier: kl6n
safflower: kxam
francium: fyam
ერბიუმი: ry6m
პასიური-ხმა: xyis
astatine: hqit
საღეჭი-რეზინის: hqam
ვარსკვლავი-გენდერული: hqin
ციტირების-ფორმა: ht6m
Curium: jrim
კომიკური-ზოლები: kxis
ფერი-ბრმა: hqon
euler's-ნომერი: hl6m
გამოიყურება-at: kxas
crosswalk: pwok
ბრძოლის-ველზე: txat
motorist: vrit
მოკლე-ჩართვა: txok
სიტყვიერი-არსებითი-სახელი: hvis
ტირილი-გარეთ: hk6t
სტატისტიკურად: xyit
იოგურტი: txot
ქსენონები: hs6n
Hypnotize: hxif
მიიღოს-off: hxaf
პუნქტი-კუდი: hxok
პირდაპირი-ობიექტი: dwot
სასურსათო-მაღაზია: kxun
შედგება-საქართველოს: hm6t
ერგატიული-შემთხვევაში: gvik
ამ-ენაზე: txic
პირველი-მხრივ: pxam
ლოკატიური-შემთხვევაში: hqok
საცურაო-აუზი: slup
ზმნისართულ-შემთხვევაში: vlak
დასათვალიერებლად: hqas
ტელევიზია-კომპლექტი: ht6s
საბოლოო-ნაწილაკების: xlik
evitative-შემთხვევაში: hvek
რეაბილიტაცია: xlat
რეგრესია: xris
ბლოკი-საქართველოს-ბინა: kxot
ვიღვიძებ-up: hxup
პოლიციის-ოფიცერი: ps6s
ფიცს--in: vran
ინტერვიუერი: qrat
rhenium: ryem
აეროზოლური: xres
კუთვნილებითი-შემთხვევაში: kxik
ნომინალიზაცია: mlec
გააჩნდა-შემთხვევაში: dzak
overcharge: pxak
დამხმარე-verb: xyik
პირველადი-ობიექტი: mlut
კომპიუტერული-ვირუსი: prus
ბიზნეს-პირი: hqis
ადამიანი: hqen
antessive-შემთხვევაში: ts6k
პრემიერ-მინისტრი: pxis
lutetium: lyum
ევროპიუმ: rwum
emote: xrot
ხალხური-მუსიკა: zyik
პოეტი: vwit
ფოსტა: pxot
სავარაუდოდ,: hvas
animate-გენდერული: hven
subessive-შემთხვევაში: bvik
გაზის-პედალი: glep
პოლარობის: pr6t
მანქანა-გენდერული: vlin
მინერალური-გენდერული: xrin
ზმნა--სუფიქსი: hvif
ვნებიანი: pc6n
samarium: sr6m
ხელშემწყობი: hs6t
წარმოსახვითი-ერთეული: xyin
სიჩქარე--of--light: kxac
საჰაერო-ძალა: hxes
თანამგრძნობი-სიხარული: pfec
კრიტიკული-წერტილი: qyit
სრული-დრო: hxem
hafnium: xyam
ინჰიბირება: hn6s
ცვლილება-საქართველოს-ღონისძიება: qrin
holmium: xlim
განსხვავებული-ღონისძიება: hf6t
სამყარო-გენდერული: hvip
რაიონი-გენდერული: kxen
ვირტუალური-მანქანა: hvim
კვლევა-გენდერული: txen
მხატვრული-გენდერული: ts6n
crastinal-დაძაბული: sl6t
აბსტრაქტული-გენდერული: srep
exocentric-შემთხვევაში: zrek
გარდამავალი-verb: txif
morpheme: tfom
შოვინისტური: dvis
ბოლო-სრულყოფილი: xrat
პროფესიული: hy6n
არაპირდაპირი-გამოსვლა: tyoc
მეორე-ენა: draf
to-იყოს: txis
სასაფლაოს-ცვლა: vrak
კოლექტიური-არსებითი-სახელი: hxos
absolutive-შემთხვევაში: bvuk
პაციენტი-გამოიწვევს: tr6t
თვითმმართველობის-ნდობის: hs6s
განავლის: hzos
რეფლექსურ-ხმა: hf6s
უპიროვნო-verb: hxek
seaborgium: br6m
თეთრი-სივრცე: hxep
მოდალური-შემთხვევაში: dlok
inanimate-გენდერული: hj6n
გამომწვევი: qran
propositive-განწყობა: psom
ელექტრო-მიმდინარე: tr6n
ასოციაციური-შემთხვევაში: nwok
უბადლო-შემთხვევაში: tluk
ძალიან-ბევრი: xyut
პლანეტარული-გენდერული: pxen
ანიმაციური-cartoon: nwuk
საპასუხო-ხმა: vrik
კანონმდებლობა: hqaf
at-მინიმუმ: vlas
გრამატიკული-შემთხვევაში: qrak
შესახებ: pxut
ძირითადი-benefactive: kfef
მეკარე: hgop
:-Except-for: kcef
მნიშვნელი: dvan
სხვა-თუ: lyek
sideways: hx6s
ერთმანეთი: dles
ზედიზედ-პუნქტი: lyuk
გაცვეთა: hxun
shorts: ht6k
dysprosium: prom
მალე-მომავალი-დაძაბული: rwec
si-ერთეული: vyin
კრიპტონი: kxon
mendelevium: dlem
applicative-ხმა: hp6s
antipassive-ხმა: tsef
continuative-ასპექტი: ht6p
რადიაციული-ავადმყოფობის: hr6k
necessitative-განწყობა: hn6t
მარტოხელა-აქცია-verb: hqek
railcar: xlak
უბადლო-ხარისხი: tlup
ეგზისტენციალური-პუნქტი: hs6k
californium: kf6n
იმყოფება-მიმღეობის: vrat
luminous-ინტენსივობის: hc6t
singulative-ნომერი: slus
გრამატიკული--object: hy6t
პასიური-მიმღეობის: vris
გადაჭარბებული-ხანგრძლივობა: kxic
supercritical-სითხის: sr6t
თანხა-საქართველოს-ნივთიერება: ks6t
postpositional-შემთხვევაში: pxok
არჩევითი-კვანტიფიკატორი: lwif
გადოლინიუმი: dl6n
epenthetic-morpheme: hp6m
negatory-კვანტიფიკატორი: nwif
einsteinium: ny6n
ხელოვნური-ენა: txac
შემაერთებელი-ნაწილაკების: qrik
დისტანციური-მომავალი-დაძაბული: twec
frequentative-ასპექტი: hfep
გამანაწილებელ-ნაცვალსახელი: bvin
გამოსულიყო-შეთანხმება: hk6m
მელოტი: blos
გარეუბანში: syum
უნივერსალური-კვანტიფიკატორი: vlit
კომპიუტერული-პროგრამირების: mr6m
ტელევიზია-პროგრამა: tr6m
მცურავი-პუნქტიანი-ნომერი: hvun
ეგზისტენციალური-კვანტიფიკატორი: tl6t
დღეს-მას-შემდეგ, რაც ხვალ: dwek
ალტერნატიული-კვანტიფიკატორი: lw6t
ცუდი-ხასიათზე: hdup
ბოლო-პასიური-მიმღეობის: hp6t
დღეს-ადრე-გუშინ: txet
ლოკატიური-მიმართულების-შემთხვევაში: tc6k
ჰიპოთეტური-პირობითი: ht6c
