bendratis: hnit
vardininkas-atvejis: hnak
galininko-atvejis: hkak
tema-atvejis: htak
pirminis: hmat
tėtis: hpap
mama: hmam
Labas: hnat
protėvis: htat
senelių: hyat
alkanas: hcac
kilmininko-atvejis: hnik
būdvardis: hcit
ir: hwan
man: hmic
Jūs: hnan
mums: hnam
tai: hyic
paskirties-vieta-atvejis: htas
naudininkas-atvejis: htik
interjeras-kontekstas: htis
asmuo-kontekstas: hpak
priklausomas-išlyga: htan
Tobulas-aspektas: htap
praeitis-įtempti: hkat
vyriškas-lytis: hsan
comitative-atvejis: hmik
dovana-įtempti: hyan
benefactive-atvejis: hpik
essive-atvejis: swik
ne: hnic
jos: hsis
paviršius-kontekstas: hsak
adpositional-atvejis: hpan
vieta-atvejis: hwak
erdvė-kontekstas: hnos
būdas-atvejis: hrak
instrumentinis-atvejis: hsik
kuris: hkan
klausiamasis-nuotaika: hnim
ir-arba: htam
išskirtinė---arba: hkit
šaltinis-atvejis: hsok
įnagininko-atvejis: hlak
demonstratyvus: hdit
bet: hlan
visi: hsut
moteriškas-lytis: hnin
jie: hwin
daugiskaitos-skaičius: hlun
vienas: hyik
ateitis-įtempti: hwet
socialinis-kontekstas: hson
kada: hkap
imperfective-aspektas: hmap
ten: hkac
sąlyginis-nuotaika: hcan
daugiau: hdoc
iš: htac
santykinis-atvejis: hrik
Išreiškia-išvada-atvejis: hlik
padaryti: hkas
direktyva-nuotaika: hden
deontic-nuotaika: hdim
klausimas-žodis: hwac
copula: hkok
asmuo: hpon
Vyras: hman
galėtų: kwat
kitas: hcon
skaičius: hnoc
labai: tcac
laikas: htim
laikas-kontekstas: htos
laiko-atvejis: hmak
apie: hkam
episteminis-nuotaika: hsim
tik: htun
mažai: hcak
tada: pcan
Hortative-nuotaika: hton
retrospektyvus-aspektas: hrip
puikus: hcat
Volitive-nuotaika: hlim
prieš: hsec
turi: pcic
du: htut
pamatyti: tcan
žinoti: hsat
žemyn: hcin
po: hcas
pirmas: hpas
nuosavas: hpun
nusavinamas-turėjimas: hlic
niekada: hnac
neatimamas-turėjimas: hkic
senas: hwat
svarstymo-nuotaika: hcim
diena: htin
kur: hnap
ateiti: hlat
būdas: hyas
darbas: hkaf
balsis: hwaf
eiti: hkun
perlative-atvejis: pwik
progresuojantis-aspektas: hpip
ilgai: hlac
pasakyti: hsac
kaip: hkin
net: hpit
atgal: hwap
čia: hcic
galvoti: hcik
tas-pats: hsam
paskutinis: kcac
toli: twan
pagal-kontekstas: hnas
imti: htit
rasti: hfan
ranka: cyat
jaunas: hyac
nors: hyap
duoti: hkik
dievas: hmac
delative-atvejis: lwak
niekas: hmin
teisė: hyit
kartą: hyam
semelfactive-aspektas: fwip
dalis: hpat
pjūklas: htic
namas: hfas
pasaulis: tcat
galva: hcaf
trys: tyin
Neo: hnon
fokusas: hcok
meilė: hpac
visada: hsit
naktis: hwit
kiekvienas: hmit
karalius: hyak
tarp: hsin
širdis: cyin
paucal-skaičius: plom
nes: hyok
priežastinis-atvejis: ksak
dalykas: hkis
rinkinys: swat
Pavadinimas: hnem
tinkamas-daiktavardis: hran
Hortative: hrat
šalis: hlit
paklausė: hput
matomas-pagrįstas-įrodymu: crit
geriau: pcac
pusė: psac
kursas: hkus
patelė: hfin
pakankamai: kyat
greitai: hpuc
pilnas: hcun
kambarys: hfac
beveik: hlap
negali: nyat
vanduo: hwik
desiderative-nuotaika: hdin
šviesa: lyak
nei: hnun
žodis: slat
durys: tyan
naudojimas: hpus
rytas: hsap
terminative-atvejis: twik
galia: hkuk
patys: hmis
dabartis: hyin
balsas: hwas
baltas: hpis
pinigai: tlan
Kitas: kyak
prastas: hyis
mirtis: hmut
forma: hfam
inessive-atvejis: nwik
malonus: tyac
dažnai: tsan
metai: nwan
draugas: myat
tvarka: hyut
imperatyvas-nuotaika: hpim
turas: hcut
tikėti: hban
visuomenės: hpin
valstybės-kontekstas: hsas
sūnus: psat
šimtas: hmas
vaikai: hcis
taip: tyak
tikiuosi: hcap
aukščiau: hyip
brangusis: pyin
skaityti: pyac
miestas: hsic
jau: hpic
faktas: hfat
priežastinis-pagrįstas-įrodymu: hfit
Klausyk: hsun
mažiau: hmim
gal: pyat
atviras: kcat
kūnas: tcic
oro: cwac
pobūdis: nyit
padėti: mlat
laiškas: lyat
keturi: ksat
geidžiamoji-nuosaka-nuotaika: hpam
ugnis: hfak
todėl: hyif
valanda: hcam
nemokamai: tyit
karas: syat
ar: hsaf
priežastis: kyan
vieningas: hnut
kvietimas: hkuc
kodėl: hwam
prarastas: hkut
tūkstantis: tsas
šeimos: hfic
siela: twam
klausimas: swac
priežiūra: kcan
REALIS-nuotaika: hlin
vidutinis: mwit
potencialas-nuotaika: hten
link: cyan
allative-atvejis: lwik
žmogaus-veiklos-lytis: hrin
trumpas: kyut
pajėgus: hyuk
gyventi: hkip
tema: hsek
tas-pats-tema žymeklis: hcek
kitoks-tema: hfek
atsakymas: tsat
jūra: mwat
baimė: hcoc
suprasti: pcat
sunku: kyin
sąlygos: tyut
abejonė: hdac
dubitative-nuotaika: twin
paklausti: psan
ginklai: tcas
juodas: clis
atnešti: tyat
gražus: ksis
tamsus: tcak
laikyti: psak
dešimt: htaf
Rodyti: pyan
istorija: hkif
bendras: kwan
knyga: hkup
elektroninis: lyin
kalbėti: plak
ženklas: myac
palūkanos: nyis
rašyti: kcit
lova: pwat
būtinas: syis
idėja: hwis
menas: klat
VIALIS-atvejis: hlas
brolis: pyak
kartais: ksas
linija: lyan
lentelė: tlas
upė: nwit
akis: kyac
informacija: fyin
staiga: tfan
keistas: hgan
giliai: ksan
pokytis: hrit
jausmas: nwac
susitikti: mlit
tikslas: htuc
laimingas: hcuc
atrodyti: syit
kraujas: cyac
rožė: kwas
į-pietus: swan
šaltas: tlat
Pirmyn: myik
pozicija: psis
vėlai: tyam
stovėti: syan
tarkime: nlas
dukra: pyit
mano: myan
supjaustyti: hkim
kopija: hfap
vyras: hgat
šeši: hlis
prisiminti: twat
poveikis: hyaf
kristi: htuk
išskyrus: hsip
plaukai: hpaf
pereiti: pyas
autorinės-teisės: pcit
kariuomenė: cyit
paleisti: kcak
arklys: kcas
ateitis: hwic
į-vakarus: pcak
mokėti: plit
raudonas: hyun
auksas: tcun
noras: hdan
Groti: plin
meistras: mwas
biuras: hfus
vyriausybė: syak
bažnyčia: kyas
ilgis: hlen
įmonė: ksin
popierius: kyis
tikimybė: hbin
ypač: cyas
turėti: pcas
langas: cyak
susitarimas: hgac
grožis: syac
pareiga: tfac
siųsti: fyan
atstumas: htif
tyla: slan
pėda: fyat
laukinis: kyik
mirti: myam
sutaupyti: pfan
žalias: kcin
bėda: mlan
šypsena: myak
neteisus: clat
įvairus: pcin
miegas: slit
quotative-atvejis: kwik
pradžia: cwan
veiksmas: kfan
apsilankymas: fwat
sekti: nlan
pabandyti: tcis
buvimas: psit
saldus: tlit
turtingas: tcin
priešas: tcam
laivas: hcip
būklė: kyit
įskirtinai: hkum
imtinai-asmuo: hlon
paslaptis: kwit
precative-nuotaika: pwim
mandagus-registruotis: hbit
blogis: pwac
Kovas: myas
kokia: kwac
pasilikti: hlam
užuot: plat
mėlynas: plan
neįmanomas: psap
mokykla: hsuk
proga: ksac
vedęs: nwat
maistas: hcuk
dvidešimt: tsis
ramus: tcit
lengvai: hnis
būsimas-aspektas: hrap
kalba: lyac
išraiška: syas
savaitė: hsus
salė: hcum
pavojus: kcic
turtas: myit
gimęs: nyan
teismas: kcut
paprastai: tyap
Gnomiczny-aspektas: hmip
vertas: tyas
paprastas: syap
medis: pyic
kova: pyap
sienos: twit
dangus: cwak
inchoative-aspektas: htip
Liepiamoji-nuotaika: hjin
tonas: twun
atsižvelgti: klan
laukiamas: pcik
mėnuo: hmaf
patirtis: nyap
visiškai: nyac
šviežias: tsac
kunigaikštis: hnuk
taikoma: kwak
riba: hyim
į-rytus: tyuk
akmuo: pwan
šiek-tiek: kfat
kryptis: tlac
kėdė: kwis
parama: syut
data: tyic
kaimas: klac
laukas: clit
leidimas: nwin
liberalus-nuotaika: hmom
sėkmė: slak
tinkamas: hric
kalnas: clin
muzika: ksik
distalinės-demonstratyvus: hdat
popietė: htup
šauksmas: hyuc
garbė: hnaf
septyni: swit
privatus: pfat
naujienos: nwas
scena: slac
sodas: cyam
varžybos: htus
skirstomasis-atvejis: twak
sužinoti: clan
politinis: syik
melas: kcun
mesti: tsak
valgyti: kcam
aukštas: hlaf
blogai: pwin
originalus: mlin
vasara: kyam
religija: tlam
nuotrauka: ksit
pabėgti: plap
autorius: hlut
rudas: pyun
Atkaklus: htem
skausmas: hdon
pavasaris: psin
amžius: syic
minkštas: mwan
kampas: kyun
gaminti: psas
juokas: cyaf
pamiršti: flat
Europa: hyup
aštuoni: lwat
suknelė: lwac
baisus: cyap
kvėpavimas: syaf
protingas: hbas
savininkiškas-žymeklis: srak
atmintis: myin
modernus: fwan
vieta: tcap
pakilti: hyus
pertrauka: pyik
penkiasdešimt: hfis
sala: tlap
liesti: hsuc
pažadas: pcam
commissive-nuotaika: mwin
laipsnis: tfat
planas: plac
elgesys: nyak
staigmena: cran
minutė: hmun
kadras: hwut
blogiau: pcap
stiklas: klak
instancija: tlin
saugus: hsif
gydytojas: tsit
Kompletywny-aspektas: hmep
pakartotinis: tyun
karinis: slin
šiltas: nyam
gėrimas: pfin
klausimai: pcaf
pyktis: nran
tiesiogiai: tyik
skrybėlė: hcup
šuo: kwap
tarnas: hnuc
pasididžiavimas: hram
minia: tcuc
traukinys: nyin
moralinis: myut
susijęs: kyim
įeiti: fyak
taisyklė: nyas
kardas: cwat
ataka: kfak
sveikata: clac
pastraipa: pyaf
socialinis: hsum
pinigų-grąžinimas: tfit
atsiprašau: hpec
drąsa: krac
malonė: hnen
oficialus: hfaf
jei: tsik
prašymas: pwit
pažvelgti: klas
judėjimas: hyon
tikėtis: cwit
priešais: psam
dvylika: tyaf
užsiima: nyut
vyno: hwun
skonis: swut
geležies: fyac
paskirstyti: syin
prekyba: myap
pranašumas: twac
drabužiai: kfip
teisėjas: fwak
skirtumas: tfaf
neramus: kcis
kapitonas: kwin
gatavas: nlat
nutraukimas-aspektas: hsep
smalsus: kyic
užsienio: kwic
stiprinimo: hnif
svarba: myun
pagaliau: hfim
sąskaita: fwin
įrodyti: hpuk
užkirsti-kelią: flan
kaklas: cyun
juridinis: hfik
sausas: swak
tarnauti: syam
prarasti: pcut
įrodymas: pyut
pagrįstas-įrodymu-atvejis: hdak
pažanga: pyis
pastatas: klit
Ieškoti: syuc
liūdnas: hrac
nuodėmė: psip
trisdešimt: tfis
sąžiningas: tsin
uždaryti: kyap
bankas: pcun
likimas: cyik
miškas: hfun
matuoti: mlac
kitaip: htoc
srautas: lyam
duona: hpup
papildomas: tfak
pasirinkti: twas
gyvūnas: nwam
geologinƳ-lytis: hzin
eventive-nuotaika: hwim
tas-pats-renginys žymeklis: hcom
dauginamasis-atvejis: tlak
storas: hmus
padaras: hyum
lietus: myic
paviršius: pfas
šventas: swis
liepa: clim
ataskaita: hfut
pakrantė: pwas
byla: hfif
petys: cwut
nustebino: kran
karališkas: klik
daina: hkuf
komfortas: kfaf
bet-kas: nyic
žolė: kcap
atkreipti: cwik
atidarymas: cyic
birželis: cwun
žuvis: mlic
kapitalas: klin
krūtinė: cyut
sniegas: hcif
švietimas: tlik
aštrus: tcaf
gailestis: hdam
išlaidos: fyas
tavo: hmuc
milijonas: mlun
pavargęs: tcik
nužudyti: ksam
šešėlis: cwap
svoris: plas
masė: mlas
nustatytas: tlip
drąsus: pyam
plonas: plic
patenkintas: srat
patikrinti: kcik
dorybė: hdet
nacionalinis: nyaf
dieviškas: swin
slėnis: clak
atspėti: kwam
spekuliacinis-nuotaika: hken
geltonas: clas
palaikai: mwac
smilga: nlac
dėžė: pwak
sezonas: tsim
mokslas: slas
gręžinys: kcuc
dėdė: hmuk
sąrašas: lyit
Rugpjūtis: ksut
populiarus: hlup
nežinomas: fyit
susipažinęs: flak
susipažinęs-registruotis: krit
skaitytojas: tsut
požiūris: pcuc
dvigubai: tsap
intelektinis: tfik
tikrai: tsam
kunigas: pcis
sužeistas: fran
liūdesys: hpom
rūmai: kfas
įveikti: clap
eh?: hnec
kvailas: myuk
kraštas: pfac
devyni: nwun
sprogimas: psut
kentėti: tfas
triukšmas: hcus
literatūra: lyic
patarimas: swas
tuščias: kcuk
rangas: psik
audra: tcut
kišenė: kyip
vaizduotė: nlin
sakinys: cwas
lapkritis: nwap
gruodis: tsip
nebuvimas: psic
dėkoti: ryak
adresas: tyis
paukštis: pyuc
savininkas: mlik
kailis: kwut
parengti: tyip
santykiai: lwan
dūmai: htum
sausis: nwak
mašina: clic
turinys: nyik
dantys: tlis
gėda: hcet
įlanka: kcaf
smegenys: pyuk
žiedas: klic
frazė-žymeklis: frak
aikštė: ksap
vaisiai: fyut
arbata: tsic
paaiškinti: slam
Sveiki: cwam
poezija: pwis
nupirkti: klam
ištikimas: hdic
sujaudinimas: hcen
keturiasdešimt: klis
Balandis: pyip
maloniai: kfit
spalis: kfap
kartus: kyuc
vergas: tlaf
laisvas: hluk
tekstas: tsus
kreditas: cyip
penkiolika: pfit
žiaurus: kcim
prisijungti: cluc
procesas: hpif
nusikaltimas: kyaf
dulkės: tsuc
praktinis: plik
spalva: nlak
sunaikinti: nyuc
padidinti: lyas
nosis: hnus
pripažinti: tyim
vakar: kfac
hesternal-įtempti: tlen
žlugti: slap
Tęsti: tcim
dėvėti: pwam
aklas: nlit
tuzinas: tsun
skraidyti: fyap
pagyrimas: cwin
velnias: cwaf
palaipsniui: twic
auka: kyif
pratimas: cyis
sąžinė: tfin
teorija: tlic
ministras: myis
nekęsti: hnet
ežeras: cwic
centras: syun
nualpti: pfic
racionalus-lytis: hron
atsargus: fwac
mėgautis: nlam
garbinimas: pwap
prekės: twap
oda: twaf
stogas: tlut
karūna: gyan
pilis: klap
sostas: tcus
pridedamas: nlaf
mylia: mlim
kraštutinis: krim
kalėjimas: fyis
taurė: kcip
narys: mlam
civilinis: syim
visur: tsaf
akivaizdus: tfic
pora: pwaf
apimtis: clam
paprotys: ksaf
lankas: ksun
kostiumas: slut
mėsa: mwak
pienas: hluc
augalinis-lytis: hwen
vizija: slic
retas: nlap
pusbrolis: ksic
tiltas: pwut
apsaugoti: pfak
druska: swam
nekaltas: hwus
karalienė: kwim
skaičiuoti: kcus
smalsumas: hras
šokis: tyus
viešbutis: clut
pildyti: flin
kalinys: psun
parduotuvė: hjan
laiptai: sric
elgetauti: hmen
smėlis: sran
smurtinis: hgit
rugsėjis: hsem
išvykimas: prac
griuvėsiai: crin
įgūdis: krin
galvijai: hwec
įranga: hwip
virtuvė: hkon
parduoti: hbak
greitis: hsot
išvada: clon
kompiuteris: hkot
amžinas: hsen
ribotas: mrit
biblioteka: hbek
bazė: hbac
painiava: hrun
šlovingas: cris
taip-pat: hjic
išsigandęs: hbic
nepatenkintas: prin
straipsnis: hrek
virėjas: kfin
juosta: hbat
dykuma: hget
bučinys: hbun
kamuolys: hbot
lazda: hpot
argumentas: hrut
stebėti: nrak
palaiminimas-nuotaika: hbim
ryškus: hrim
kaltas: hdis
pistoletas: hgin
policija: plis
paslėpti: hzan
ekspedicija: srin
neišmanantis: nrin
dosnus: drac
debesis: blan
atliekos: htek
vasaris: frif
liga: hren
praleisti: bwan
šaltinis: sron
iniciatyva-atvejis: hnok
teta: hbam
delsimas: dlic
atidėtas-imperatyvas: hlip
pranešė-pagrįstas-įrodymu: prat
vidurnakčio: dyit
herojus: nrac
filosofija: hfof
pirštas: hjit
patogus: hzat
kažkur: hmoc
spauda: bran
personalas: hraf
apdovanojimas: rwan
kaltė: dlac
vargas: krat
kakta: htec
skelbimas: glan
angelas: htet
vienaskaitos-skaičius: hgam
aušra: hbon
prekybos: krak
atleisti: pran
avis: hcec
kantrybė: hpen
ferma: crac
referuoto: hrec
kukurūzai: mran
raktas: kcif
dauguma: hmot
silpnumas: hdut
atmosfera: traf
atodūsis: tcoc
žmonija: mlis
opozicija: pric
diskas: hdik
vienišas: hket
menininkas: nrat
riteris: cwis
žavesys: tran
sprendimas: drin
gubernatorius: gran
filialas: rwac
dispozicija: hsoc
entuziazmas: tsum
indukcinis-nuotaika: hdum
bendruomenė: hmum
alyva: hyen
vamzdis: hbap
spausdinti: trat
oi: dyoc
diskursas-kontekstas: hros
šauksmininko-atvejis: hwok
kabina: ksen
žadintuvas: plam
nervų: hnes
nuolatinis: hset
peilis: ksuk
šilkas: slik
panieka: grin
pragaras: nrik
atskirti: plen
rimtai: mrat
mišrus: mrik
medinis: mrak
teikti-pirmenybę: hpet
įspėjimas: trin
perspėjimas-nuotaika: htom
impulsas: hmos
ambicija: mrac
neigti: hnek
konstitucija: swic
instrumentas: srit
nepertraukiamas-aspektas: hnip
banga: hgas
kolegija: klen
uodega: hkek
karta: nric
katė: blat
tiesioginis-pagrįstas-įrodymu: hret
apleistas: trac
vienuolika: hyec
instinktas: nlik
charakteristika: trit
gentis: hgik
sumanus-nuotaika: pcim
pastogė: crat
grubus: hruc
jodinėjimas: hris
purtyti: hmon
pramonė: hdot
profesija: hres
lempa: hdap
kava: kfif
paklusti: htot
šiaurinis: nrit
slaugytoja: nris
užtikrinti: hjat
grandinė: ryin
mokymas: cric
avalynė: hgut
kiemas: mram
neaiškus: hmec
kitur: hlet
butas: pret
veikla: twot
šeštadienis: cram
saulės-šviesa: hduc
našlė: hwuc
elementas: hlem
atspindys: hfen
organizacija: hgis
žvaigždė: tram
incidentas: hgon
svečias: hgip
baras: brap
butelis: hbet
palaiminti: blak
sąmyšis: crak
vidinis: trik
nustatyti: krik
gauti: prit
tuščiaviduris: hcot
provincija: hpos
civilizacija: srac
padvisinti: hgak
šokas: crok
išimtis: swap
padermė: tren
standartas: ryan
vairavimas: dran
atsikratyti: hruk
prisiekti: kses
lobis: zran
sėklos: hbis
bokštas: tras
mėgstamas: fwit
neseniai: hcem
naujas-praeitis-įtempti: hrot
budrus: srik
baldai: mrin
virvė: hkos
nuotykis: hdas
"Royalty: ryit
šventė: dyat
apibūdinti: dras
šešiasdešimt: hses
skalė: hkem
ceremonija: srec
medžioklė: clik
šnabždesys: psus
daugiausia: ryat
krikščionybė: ksim
teisininkas: hwif
detalė: drit
princesė: hrus
altorius: dlat
tinklas: hwes
purpurinis: brin
surinkti: hkoc
rinkimai: hben
samprata: kren
girtas: crik
pilti: brac
keltuvas: hlif
gestas: hjis
valdyti: rwin
mainai: tcen
neabejotinas-straipsnis: hdek
imperatorius: mras
nuotolinis: hroc
bjaurus: clup
nekenksmingas: cras
ritinys: hrof
colis: nlic
laikraštis: grat
barzda: dric
ašara: srim
komisija: kson
o: grak
sankryža: kcoc
nepriklausomumas: htes
kvapas: hwon
aštuoniolika: hdec
istorinis: tris
bruto: krut
šaknis: hrok
purvas: hbik
nuotaka: dlan
šydas: pras
teatras: tret
palyginimas: kras
varžovų: rwis
balansas: slen
treneris: kron
humoras: hnum
romanas: rwas
kerštas: hbaf
pavydus: ryut
ratas: hlok
sudegino: glat
blykstė: flac
kurti: hkec
konfliktas: hnot
prakeikimas: hlos
prakeikiantis-nuotaika: pram
bejėgis: hces
teigiamas: hzit
klubas: klup
potvynis: nras
grūdai: gwan
abejingumas: hdun
horizontas: crim
arogantiškas-nuotaika: hsom
status: htop
harmonija: mron
perkūnas: hgot
vaikystė: htok
kelis: hgun
programinė-įranga: pwen
sužalojimas: kram
gavimas: ryis
leisti: nlim
Protasis: hpoc
slydimas: slok
revoliucija: hrif
ūkininkas: hjim
insultas: trak
platforma: hpof
pasiuntinys: hmes
privilegija: hpek
organizuotas: hyot
studentas: clen
urvas: hgec
tradicija: rwat
tragedija: tses
atsisveikinimas: hjap
kritika: ryik
medvilnė: krap
ligoninė: slot
nuoma: kris
dujos: hges
neišvengiamas: pwic
mirtinas: hgim
lapas: glit
leidinys: plun
priešiškas: tsup
vertimas: dwan
laidotuvės: jran
miltai: mrun
korespondencija: ryon
romantiškas: hrom
namelis: clun
pasiūlyti: psot
mimezinis: hmet
doleris: dlon
dienos-šviesa: hjac
šešiolika: hsos
surinkimas: hzac
kolonija: klon
sparnas: gyin
liūtas: hles
kultūra: klut
kolona: hkom
gudrus: glak
drama: dram
anekdotas: hjuc
rūkas: hdus
medicina: dwas
keturiolika: hkes
rūgštis: sram
būtent: hyet
pajamos: hmok
vyskupas: hbip
oranžinis: tron
vonia: byan
primityvus: rwit
krepšys: ksek
sekretorius: sris
šiaudų: prak
nekantrus: pfif
išgelbėjimas: slon
hodiernal-įtempti: dlin
skirti: zrin
garas: tcip
nuodai: hwoc
talentas: tlon
klimatas: lwim
veiksmingas: fric
išskirti: tcif
skalbimas: dwac
išpažintis: kfis
nesąmonė: hjas
anglis: kyon
kanoja: kwon
laikinas: tric
delimitative-aspektas: hdip
kaulas: hcos
pirmadienis: nwic
antradienis: glac
trečiadienis: bwac
federalinis: frin
pageidaujamas: hzic
atstovas: ryic
linas: lwin
kriauklė: swuk
sūnėnas: bwin
kruvinas: kric
apgula: cren
skrandis: hpem
žalvaris: pcon
viršūnė: hzik
penktas: pfik
pigus: brat
išskirtinis-asmuo: kwen
pasinaudoti: zrat
tvora: hzas
statula: tfam
artilerija: tlep
apkabinti: mrap
supantis: sren
griežtai: srot
elnias: hluf
krūmas: hbuc
geležinkelis: hrep
iškrovimas: hduk
įpėdinis: mris
ąžuolas: blun
nemalonus: pren
išradimas: hgic
pianinas: pyon
įtikinti: swen
nematomas: gric
garsus: ryun
žiaurumas: kluk
pagunda: hyoc
TELIC-aspektas: hlep
ekonominis: kfik
tarptautinis: troc
trukdyti: tcek
filosofas: flif
elegantiškas: gyit
gerovė: kyen
žvejyba: mlak
pavogti: truc
lūpa: hloc
išeiti-į-pensiją: ryac
ruožas: sras
galerija: glen
lygiagretus: zlan
atelic-aspektas: htep
žemynas: trap
neįperkamas-nuotaika: nrim
kaklaraištis: dwat
ląstelė: slep
kiaušinis: dyan
dirbtinis: jrat
tuo-tarpu: nwis
krizė: ksot
mandagus: sloc
pietūs: lyon
pušis: pwon
stumti: hcef
aljansas: lyen
juosmuo: hkop
stebuklas: hmek
jūreivis: slis
grynumas: prut
respublika: hguk
telefonas: tfen
plakti: krip
marškiniai: cyim
pristatyti: ryas
sofa: hsof
valymas: hsup
vagis: ksif
išlaikyti: nrec
kanalas: kcen
asmenybė: klim
reforma: kfam
grasinantis: hzim
palmė: plim
garsiakalbis: hzak
slenkstis: dwic
sukelti: pris
ietis: bzak
tvarkingas: syec
sesija: cwen
kankinimas: crot
drėgnas: tcum
kraigas: grit
keliautojas: hyek
malūnas: mwik
žemėlapis: jrac
apykaklė: klok
pakeisti: klif
sąmoningai: drat
alus: hbif
aksomas: hwem
gravitacija: gwit
pamokslas: hpum
piktnaudžiavimas: glas
pulkas: hgen
trylika: tres
pateisinti: jyit
penktadienis: crum
šepetys: broc
parsisiųsti: dlas
kremas: krem
uola: klaf
žiuri: jrin
pabaisa: ksos
užšalęs: hgoc
puodas: pfot
centas: psen
primygtinai-reikalauti: srut
obuolys: hpep
aptarti: drak
fonas: prun
transkribuoti: trim
periodinis: prik
pramoga: nren
virusas: bris
vaikiškas: blit
atspindėti: flit
konvertuoti: kcet
kontūras: kluc
opera: hpop
pritarimas: nron
išdavinėti: rwak
nubausti: hzen
alkūnė: kcon
areštas: tcet
remontas: hrop
įtartinas: cyec
septyniasdešimt: swet
Šventasis-Raštas: srip
duobė: grac
sutrikimas: dlak
dvejetainis: byin
abatija: bjan
rodyklė: tcec
linkę: trec
detalizuoti: frat
lojalumas: hlot
moneta: syip
drebėti: tcem
tremtis: gwin
mechaninis: myim
gaudyklė: crap
tortas: kyek
seras: cyes
nesiryžti: sret
septyniolika: syet
medus: myon
kuolas: dzat
protektorius: hjam
plyta: brit
aštuoniasdešimt: hpes
deja: pcen
konsultuotis: kcot
legenda: lwen
derlius: hfos
skatinimas: pfon
viryklė: hsop
sukilėlių: bric
senamadiškas: hnom
bangavimas: cron
pelkė: swot
padažas: hdes
asketiškas: pces
vadybininkas: mren
choras: cros
racionalus: tson
apdorojimas: pson
vilkas: blaf
kilimas: hgap
senovė: hjak
derlingas: frut
švilpukas: slif
sūris: twis
įkąsti: byat
pakviesti: jwan
katedra: kyet
uostas: brak
nuklysti: djan
augalai: tsos
karinis-jūrų-laivynas: nlen
kaukė: mrok
pieštukas: pses
daržovių: sroc
eksponatas: hzet
kelnės: tlun
korupcija: hrup
kabinetas: nram
sriuba: srup
chirurgas: syon
pašalpa: tcot
šnipas: gyas
neapgalvotas: hlec
paskalos: gyic
žetonas: hzon
abstraktus: srok
ketvirtadienis: cwim
eismas: ryaf
architektūra: ryek
krekas: rwaf
ornamentas: rwon
atvirkštinis: lwas
linksmintis: mwun
atsigavimas: ksus
šaligatvis: plut
lemiamas: dyin
neigiamas: nraf
festivalis: hfec
sumažinti: hrum
išdavystė: zyan
medžiotojas: djin
gyvatė: syen
baterija: bret
vaškas: flam
detektyvas: dlit
analizė: nlis
pabrėžimas: hzot
plaukti: twen
vokas: lwaf
kas-tik: hgek
cigaretė: jrit
variklis: mrot
savanoris: hwot
reakcija: ryif
bagažas: blam
kurčias: hboc
sultys: hjus
nuolankumas: jlit
ministerija: mret
seksualinis: hjon
skersmuo: dyam
kirvis: blac
deimantas: dlam
atsarginis: hlek
aidas: hgus
apribojimas: swon
tapatybė: hdaf
ekranas: krun
tingus: lwis
momentane-aspektas: hmop
kompaktiškas: kfot
dreifas: hdif
išnykti: hgaf
spindulys: ryen
rašalas: mwic
masinis: mraf
rūsys: dyac
įsimintinas: nrun
žvilgsnis: klek
senatas: slet
karstas: tfap
atleidimas: frac
nuryti: nlun
atsiduoti: nlot
sūpynės: swun
pieva: gram
kompleksas: klos
atsistatydinimas: hzis
nuolankus-registruotis: nret
sąmokslas: swim
paprika: prip
ponis: pron
kandidatas: hzam
lapė: flik
kaminas: tcon
jurisdikcija: drik
Žemdirbystė: rwic
tikslumas: tcuk
buvęs-velionis: brim
demokratinis: mrek
pumpuras: hbos
antklodė: bwat
kruša: hgep
kiaulė: srus
formos: krek
dramblio-kaulas: craf
klasikinis: ksok
stebėtojas: nwet
dramblys: lwit
nagai: nwus
bitė: hmif
palaidoti: dzan
aktorius: bzat
prakaitas: zwan
lenkų: ploc
iliuzija: hlus
neapibrėžtumas: pcet
antrinis: syif
sulankstyti: tsot
kaimo: grun
dejavimas: nyen
priminti: slec
citata: hzun
maišas: cyek
susierzinimas: fren
adata: hjun
kontroliuojamomis: nroc
vištiena: truk
nuoseklus: kwot
statinė: bras
įprastas-aspektas: hcep
ekspertas: ksec
įteigti: blin
alyvmedis: zlin
furgonas: myen
kliūtis: bwak
kinkuoti: kcec
skatinti: plaf
apibrėžimas: fyic
gimimo-diena: gjin
plaktukas: hcof
gardus: hfon
kartojimas: trun
trivialus: twut
smūgis: hjik
kasti: kwaf
glamonėti: plot
kaukolė: hcop
teisės-aktų-leidėjas: dlik
kulnas: cruk
raukytis: crun
patentas: plet
milijardų: blim
cheminis: fyik
pilotas: pyot
imituoti: mlot
sijonas: kwet
itin: srap
kas-savaitę: jwik
techninis: tfip
augmenija: tset
varna: kraf
saulėtekis: sruc
gyvenimas: glin
prisidėti: hyom
kablys: hdok
tigras: blic
prasiskverbti: crut
įvorė: slun
greitkelis: jras
milicija: mlip
griovys: kroc
vientisumas: kret
devyniolika: dzin
organinis: rwik
teologija: flic
plūdė: flut
ragana: byac
Padovanok-dovaną-Pasiūlyk savaitės: hwuk
diplomatinis: dyik
studija: twos
viršyti: kcok
šampanas: cyen
įkvėpti: crif
vėliava: hbes
skyrybos: lwon
varžtas: hbut
vena: jyan
pasyvus: psif
puta: hgum
žvyras: grik
prijuostė: tyen
planeta: gren
lentyna: claf
ventiliatorius: flon
tropinis: hjip
fazė: fwas
savavališkas: rwen
ištarti: kfun
gyvsidabris: krok
slinkti: hrem
savižudybė: tcos
reporteris: prot
atimti: hpok
kvalifikuotas: klun
balkonas: blik
šakės: fras
darbuotojas: mlek
darbdavys: myot
plotis: jrak
suirzęs: djit
apkaltinti: klot
pensija: pyen
veiksmažodis: kres
beždžionė: mwon
priimtinas: hwek
parašas: tlim
ortodoksinis: rwos
ironija: fron
medelynas: nrap
nenoras: jlan
importas: tyot
deglas: croc
gramatika: gjak
užstatas: gyat
kolonijinis: plon
jachta: jyat
logiškai: kwec
kupolas: kwun
storis: hfot
užsispyręs: cyon
raumuo: hmup
dydis: ryam
patrinti: ryos
bailiai: rwam
reikmenys: gwac
skrebutis: tros
pelė: myus
skiemuo: slim
paglostyti: prap
dialogas: dlaf
neutralus: nrot
darbštumas: dwin
prieštaravimas: trot
pasiekti: kfic
ožka: byak
klestėti: hfet
primesti: mlon
anoniminis: nwim
formalus-registruotis: frit
veršelis: hbof
vadovas: mwut
išlydyti: hjec
panaikinti: flas
skėtis: gras
bagažinė: bzut
mineralinis: mrim
paliaubos: crus
antis: hbok
planavimas: pfam
muilas: hsuf
lėlė: gwak
skeletas: klet
vila: blis
siuvimas: jlin
suderinti: dyak
virdulys: kset
brandus: mruc
triušis: kruc
dirigentas: nwot
priklausomybė: djat
žaidėjas: jlic
vabzdys: pset
restoranas: cret
pelėda: lwun
radikalus: djik
gyventojas: zwin
drakonas: dron
girdimasis-pagrįstas-įrodymu: drot
ištroškęs: kyos
užgaišti: dren
skaičiavimas: glun
reguliavimas: ryim
meras: mlap
mažuma: mric
įsigijimas: dwon
veteranas: bren
orkestras: ryes
bekonas: bjin
nenauda: zwat
audinys: frap
muzikantas: gzik
protiškai: hnep
jungtukas: nyon
netinkamas: nrip
architektas: tsek
citrina: nyim
kosulys: kcos
galvos-skausmas: crek
nuomininkas: ryet
vaisingumas: srun
išgydyti: hfoc
devyniasdešimt: nwon
atsitiktinis: hbec
šaukštas: kcek
balionas: blon
kreida: hfip
Netiesiogiai-pagrįstas-įrodymu: nlet
leidėjas: pcot
actas: sruk
uosis: fyec
užpildantis: slek
atgaivinti: nrut
jautrus: kfim
tunelis: tfun
dėlionės: hpef
mechanizmas: mwim
matematika: gzit
blukinti: frun
kepenys: jwin
sublative-atvejis: bwik
panirti: dris
vienetas: twim
monopolija: hnop
lošimas: hgup
povandeninis-laivas: bzin
žemės-drebėjimas: hbem
laboratorija: brot
kamštis: kruk
savarankiškai-kontrolė: syot
Buda: hbus
megzti: bjat
ambasada: blas
toliausiai: sres
deklaratyvus-nuotaika: drim
stimulas: tyuc
šokoladas: clot
sutapimas: tyon
pirštinė: gwat
atsiklaupti: hjek
geografija: hjif
investicija: nwes
žodinis: mrec
analogija: nlip
pasaulietinis: srek
vanagas: blap
psichologija: nloc
įkabinti: gjan
metalo-laužas: krep
vaidmuo: cyum
dozė: hdos
lašiša: slom
pudingas: pwun
magnetinis: gyik
siurblys: pcom
deguonis: ksip
pažymėjimas: tfot
medalis: hmem
retorika: trok
džiržginti: rwap
irkluotojas: dyas
teleskopas: trip
karoliai: clek
rašyba: prif
viskis: hwos
gluosnis: hwof
kupranugaris: hlum
mėgėjas: myet
išeiti: crec
biografija: brif
asilas: gzac
kas-mėnesį: mwis
ignoruoti: nruk
atostogos: byit
spragtelėjimas: lyik
ovalus: twon
elastingas: lyet
žodynas: kfon
kumpis: gzam
vaivorykštė: rwun
vartoti: kcum
nerija: tcup
bakas: trek
kolega: clok
drugys: trif
schema: graf
dvynys: jwat
nepriklausomai: trem
bambukas: hbum
prekiautojas: jlat
kaupimas: kles
inspektorius: nyet
kąsnelis: hyos
košmaras: hbom
uogienė: gjam
muziejus: mrem
abėcėlė: lwam
sklaida: zras
reidas: crip
atskleisti: clus
puvinys: fraf
agresyvus: gris
trintis: mroc
prieplauka: gyac
voras: brik
bulvės: trut
peržiūrėjimas: cwon
godumas: jlac
pirmalaikis: ryot
daugintis: gzan
sukinys: pcip
statistika: tsok
kalendorius: klem
skyrimas: nwen
trilijonas: tlos
mansarda: tlok
teigiamas-nuotaika: rwim
programos: pfen
nominalus: nlon
nepasitenkinimas: sraf
infekcija: hfok
ąsotis: krot
trūkčioti-pečiais: cyok
pradininkas: gzin
praleidimas: nlif
kopūstai: glic
Atletiškas: tlet
girtumas: mrut
saviskambių: hdof
svirtis: lwek
senatorius: syem
rainelė: nrif
skruzdė: mwam
klaidą: hbop
nėščia: grim
nusodinti: hjet
kulkšnis: tcok
klasifikacija: glik
kintamas: prim
suvynioti: ryap
garbanotas: krec
siera: hsef
diktuoti: dwik
atsirasti: brun
varlė: fram
perdėtas-atvejis: twek
kempinė: hjen
erzina: djon
voverė: slip
šlifuoti: zyin
irrealis-nuotaika: flim
vulkanas: glam
patalpoje: gron
išnaudoti: kloc
geologinis: jlik
pasas: psop
amoralus: mlet
biskvitas: hbuk
bendradarbiavimas: kros
tabletė: tlot
poilsis: kces
atomas: trom
AIDS: hzip
piramidė: psim
ciklas: swok
plaukeliai: hnup
neteisėtas: hjaf
letena: pfap
drovumas: crom
užtemimas: klip
liutnia: lwap
šluota: srum
skydas: mwen
astronomija: tcom
labirintas: blen
stipendija: bwit
vėžlys: kfuc
patarėjas: dwak
pluoštas: fwic
Kriketas: jrik
karvelis: ksom
pritaikymas: dyon
trikampis: tfon
iždininkas: tsen
vandenilis: jron
trapus: hfuk
spausdintuvas: pyet
droselinė-sklendė: tcof
lėtinis: gzon
susidoroti: slaf
dilema: dlim
inžinerija: jyin
fotoaparatas: hkef
atsiprašyti: pluc
laižymas: lwet
šokėjas: dret
migracija: mres
tenisas: tces
stuburas: clip
mailius: zrac
staklės: tfuc
dūris: twuc
slaptažodis: psaf
pusrutulis: praf
strategija: zrit
kvarcas: krus
žirklės: jris
patrulis: proc
ledynas: lwic
pusiaukelėje: dwam
memorandumas: mwap
kūgis: kwuc
simetrija: hzut
gamintojas: zrak
atsakovas: fwik
mečetė: djis
Šachmatai: cres
rinkliava: htof
vyšnių: tref
paplitęs: kfen
suklupti: tfok
sunkvežimis: ryok
garstyčių: mros
procentų: pfet
aukcionas: jlam
sietas: srif
netvirtas: swoc
magnetas: gjat
žįsti: syus
islamas: slum
pasistiebus: twip
membrana: mlen
skustis: clet
gitara: gjit
blizgus: bzan
guoba: hyem
sklęsti: kcom
įvardis-žymeklis: ryec
pagrindinis: pcus
prieskonis: zlat
perdarynė: jlas
vežėjas: zyac
vibracija: bron
erzinti: trus
plūgas: hlom
fiziologinis: zlik
latakas: hgok
kometa: cyet
viduramžių: dyic
žvirblis: grec
kompensuoti: twet
plastmasinis: psuk
išnaša: cyot
orbita: rwot
kuklus: twum
golfas: hgof
nulis: zrun
lustas: tcep
engti: prok
žiovulys: gjac
nelygybė: gwas
molis: tloc
keramika: frik
namų-šeimininkė: hgif
rugiai: rwem
nepaklusti: hyes
tolerantiškas: glon
embrionas: brec
kalnakasys: jren
ploti: zlac
mielės: lyim
premija: pfim
slyva: plem
bankrotas: byas
drėkinimas: rwif
mėta: nyun
kapitalistas: glis
elastingumas: hlef
ryklys: gyak
naujokas: drut
saugojimas: zren
realizmas: cles
imbieras: djic
greitosios-pagalbos-automobilis: blus
panašus: kwip
piniginė: bjap
kraipytis: glim
mokslininkas: gyis
nusiaubti: grot
šaltakraujiškumas: hwum
radijo: href
nesvarbus: zlit
pupa: bwam
neoficialus: frim
dukraitė: gyut
nesutarimas: dloc
kepsnys: tfek
azotas: zron
skustuvas: hjut
kontrastingos: krom
propaganda: pcoc
fejerverkas: fris
popmuzika: pcop
nusirengti: crop
vaga: cruc
žalingas: hzaf
judaizmas: hjum
papildymas: pluk
lęšis: lyes
pegative-atvejis: pwek
Vėžys: kfes
pėstininkas: pyek
lektorius: zyat
nutekėjimas: hzuk
kvalifikuoti: krif
tankis: djot
indukcija: dyis
kramtyti: htuf
kalbus: bzit
omaras: hgos
nuolaida: dyut
taksi: tsuk
hierarchija: crem
nuvarytas: gyec
urzgimas: glaf
driežas: lyis
krioklys: crof
apviliantis: djak
veto: frot
pirmininkavimas: ryip
pirkėjas: mrif
galonas: jlen
uodas: mruk
nukrypimas: dwen
ristis: lyut
mozaika: myok
kištukas: plok
pritūpęs: pcuk
bakalėjos: ksoc
komunistas: myos
stebinti: mwek
prosecutive-atvejis: rwuk
žvaigždynas: nlos
diktatorius: dwit
susirūpinimas: tyet
palydovas: tlec
šlepetė: hlop
priebalsis: fyon
apytikslis: tsif
bedarbis: byet
rėmėjas: sros
lotosas: lwot
salotos: sles
chloridas: lwok
bakterijos: bwic
lipnus: pcek
komponentas: bwon
branduolys: klec
apsimesti: bjak
baitų: bzet
sekrecija: sruf
aiškiai: pres
sutapti: mloc
baletas: blet
šlapimas: mrus
česnakas: lyun
praėjo: hguc
ekonomika: kcem
vidurinė-klasė: hdom
judrus: gjic
žnyplės: htef
skalbiniai: lyoc
žemuogė: srem
miesto: pcos
varžyti: mlaf
užrašų-knygutė: tfut
albumas: zlam
beisbolas: hbep
šnirpštimas: sluc
bufetas: hbuf
dalyvis: rwip
garažas: grek
diagnozė: djas
ramentas: ksuc
iškvosti: srom
Registracija: psuc
tirpus: jlun
fosforas: psof
struktūrinis: rwut
klijai: glum
disertacija: twes
amatininkas: clif
bananas: bwas
aksioma: kyom
šonkaulis: psos
nikelis: nyek
Pi: pyim
autobusas: bwos
cenzūruoti: swes
raketa: mlus
dešra: slos
manipuliacijos: nlut
pomidoras: tfet
sustiprinti: kfut
lizdas: syok
kalis: tsom
atgauti: prup
virtualus: zwit
algebros: gjas
dantistas: dzit
optinis: pcok
judintis: bzen
biologija: bwim
nedarbas: byim
vikšras: krum
solo: slof
naršyklė: bjac
Nuotolinis-praeitis-įtempti: nyot
istorinis-įtempti: crep
branduolinis: nluk
spektras: pyem
natris: syom
isterija: syes
globėjas: tyos
įkaitas: byik
moliūgas: gluk
raukšlėtis: kwuk
skaidrumas: tfif
smaigalys: swip
prioritetas: pcif
pėsčiasis: dyen
ateizmas: tsem
monitorius: mwot
rinkimų-apygarda: nlec
nekontroliuojamas: hkof
zondas: grok
platina: plip
dvigubas-skaičius: dlun
plaučių: pcep
Super: syup
vežimėlis: trop
vietoje: lyot
kurstyti: gzat
benzinas: plif
inkstas: grif
plėšikauti: bzac
įvertinimas: dlen
arsenas: syek
sraigė: nrok
žiogas: tsec
lygtis: fwen
socialistinė: swos
filtras: flot
sensorinis-pagrįstas-įrodymu nuotaika: hxin
išplėsti: kyot
skleisti: mwet
pasaitėlis: pwet
mandarinas: drun
menestrelis: hjok
plaučių-uždegimas: hnof
solidarumas: gret
vyris: cyif
išilginis: nruc
dividendas: dwun
raja: hkep
eksponentė: slop
nedarbingumas: dlif
manija: bwen
paskirstymas: pfun
fotografas: trof
delta: dlet
skaitmeninis: djim
kalė: brut
akies-vokas: hyop
įstrižainė: dyun
pasąmonė: byon
antakis: bruc
čiaudėti: pcec
labai-linksmas: dlis
induizmas: nwum
pabėgėlis: nyif
Pervežimas: cwot
baltymas: pwot
sąvartynas: hdop
tobulinti: flen
vemti: hwom
genas: gyen
pirmakursis: hdem
sociologija: syoc
skvošas: kwoc
žvejys: hfuc
regioninis: jyen
judėjimas-į-kalną: hvok
retrospektyvus: hxik
tornadas: gyon
inversija: nwos
televizija: twif
kubas: kfet
produktyvumas: pwuk
morka: krop
Molekulinė: mwuk
konglomeratas: glet
buhalteris: ksum
agurkas: kyok
orgija: drok
tirpiklis: jlet
fosfatas: psef
gruntas: gwik
šarminis: flis
gimnastika: jyas
kablelis: kwom
judėjimas-žemyn: hvat
persileidimas: jwac
ankštis: tcop
donoras: dzon
manganas: hzem
psichologas: syos
chloras: clos
klaviatūra: kyoc
elitas: zyit
įterptinys: pfaf
Regbis: rwoc
opa: jlon
fleksyjnych: hxit
kandinėti: nres
Quantum: fwam
megztinis: swek
evoliucinis: fwis
užrašymas: nyoc
atšokti: tcuf
skrodimas: drec
slėptuvė: kcep
linijinis: lyec
stibis: trum
superessive-atvejis: psek
navikas: twom
erozija: cyos
alfa: flaf
bamba: nwip
imuninis: myip
gripas: flun
alaus-darykla: bjit
supaprastinti: slef
sutrumpinti: bram
apmažinti: djen
sužavėti: dwim
priversti: brok
puskojinė: bzas
filmas: fyim
kosmosas: klom
teršti: hpuf
visuomeniškas: gjen
varpa: zyis
miškininkystė: lyif
aliuminis: lwum
svyravimas: zlon
horoskopas: ksop
kraustyti: dlek
įtraukimas: nluc
gavėjas: byic
delfinas: dlip
žudikas: cyus
žinduolis: myaf
rodiklis: swif
dvideginis: dwis
dvitaškis: zlen
biurokratija: brus
iškreipti: jric
šaldytuvas: frip
archeologinis: cluk
nepriimtinas: kwok
detalizavimas: pfis
lapelis: pfut
antropologija: nlom
skanus: kyec
pereinamas: txit
susigūžti: kwus
saulėgrąža: hzuc
utėlė: glus
jonų: lyos
turizmas: tyum
modemas: myom
pagreitis: jrun
klastoti: tsoc
emisija: hmef
pagrobti: drap
iš-dalies-sutapti: hwep
kirpėjas: pfes
folkloras: floc
kapiliarinis: plek
nacionalizmas: nlum
užpakalis: nros
motyvas: hmuf
sublimuoti: slem
nusivylimas: xras
kobaltas: kwos
aviža: gwam
judėjimas-Prieš-srovę: trup
išangės: gyam
jaučio: bwun
atvirkštinė: flip
atleidimas: dzun
video: hwop
boikotas: bjik
viktorina: cwif
ledo-ritulys: cwok
partizanas: grip
magnis: hgem
radaras: drek
šimpanzė: hzif
patikimumas: kwif
stačiakampis: tyec
rusvieji-dumbliai: klep
apibendrinti: jlak
komendanto-valanda: kfec
homoseksualus: mlok
scenarijus: srop
formulavimas: flus
reinkarnacija: nrom
užsidegti: zlak
uranas: ryum
gaudytojas: kwes
koordinuoti: kyop
mokesčių-mokėtojas: nwaf
integruota: trep
išreiškė-nuomonę,: hzap
gama: hxam
Safari: fwim
judėjimas-srovę: ht6n
koeficientas: kfus
antraštė: zlic
analitikas: nles
matas: hzes
prekybos-centras: hmof
bismuto: bzim
atvirukas: psok
konvergencija: bros
nutolti: djet
akcininkas: ksem
mikrobas: mrip
lyties: jwit
morfologinis: mluk
beta: byot
džinsai: gjis
duomenų-bazė: tles
skaičiuoklė: klus
rentgeno: ksef
išnagrinėti: zram
aplinkos: zyen
Sigma: zyim
Padalijimas: hxon
darbotvarkė: gres
viza: bzis
infrastruktūra: nyuk
žibukas: gyun
detektorius: tyek
prisitaikanti: dyip
biologė: byis
sudurti: pyec
bromas: brom
paladis: plum
žagsėti: kfok
pastelė: psec
zoologijos-sodas: zwac
klinika: lyok
konotacija: nwoc
joga: hjoc
knygynas: byun
terapija: grap
nacionalistas: zlis
nukirsti-galvą: zlet
Taip: swec
problemiškas: byam
džiazas: dzas
volframas: tsof
teroristas: gwis
driblingas: droc
medžiagų-apykaita: tlem
alimentai: lyaf
savaitgalis: hfom
chrizantema: gzim
vakcina: byap
motociklas: tyok
Mantra: dyot
semestras: myes
heroinas: gwon
aplankas: flap
katodas: kfoc
ideologija: dlec
automobilių-stovėjimo-aikštelė: prek
teta: fret
atoslūgis: hxis
selenas: clem
dviračių: blek
žievė: pros
lygiavertiškumas: swaf
dabartinis-aktualumas-žymeklis: hxak
oro-uostas: cwoc
amputuoti: gyet
krepšinis: bwet
apgavikai: mwip
tarakonas: tlek
chromas: hgom
litras: hl6t
vis-dėlto: nwec
hormonas: cwom
su-trūkumais: tluc
pradurti: prec
Animizmas: nyom
poligonas: cloc
feministų: hfes
sujungtas: kcop
euras: dros
ženšenis: hjes
algoritmas: hlof
lazeris: lwes
vaistinė: dlot
milimetras: mlem
lankstytis: flek
anodas: nlok
niuansas: hzus
ne-visą-darbo laiką: prem
jautrumas: nyec
demonstruotojas: drom
helis: clum
dvikalbis: dzic
akronimas: hqim
Sukurti: nl6m
gerundijus: gros
plazma: psem
chromosoma: rwom
kelintinis: rwok
kilometras: klum
faksas: tfes
genetika: nwek
šlakelis: frek
atsuktuvas: dres
Brokoliai: blok
būtasis-laikas: xrit
vitaminas: tyem
kadmio: kyem
bombonešis: bwoc
grafinis: gjik
titanas: dyim
švaistytis: clec
Lambda: lwem
draugė: pcem
poruotis: kyuk
smėlio-laikrodis: tlus
empatija: mlif
boro: bres
sraigtasparnis: cwet
telūras: tlum
terminas: jyic
lygiuoti: gwic
centimetras: hfem
molibdeno: mlom
ličio: tfim
daugialypė-terpė: myum
atnaujinimas: dyet
kalorija: clom
robotas: ryoc
namų-darbai: groc
logaritmas: grom
Mantis: gzas
įrengti: nwut
amino: myoc
glifas: glif
aoristas: pyos
ekologija: plec
padirbinėti: flok
marihuana: bjam
mikro: mrom
kilogramas: lwom
persivalgyti: jrot
nuspėjamas: dzik
pica: zyas
nusiklausyti: zris
kalbotyra: bwis
kirpimas: braf
iridis: ryom
rasizmas: gwim
optimalus: gyim
industrializacija: drif
Buveinės: krup
cerio: zrim
kongruentinis: nrum
dalijamasis-atvejis: pxik
kasetė: ksep
valios: blot
erdvinis: dzen
parametras: rwet
sinchronizuoti: nrop
maksimizuoti: dzim
seminaras: mwec
diskoteka: dyok
neonas: nyok
osmis: hzom
Trys-karaliai: hp6n
plagijuoti: lyap
artefaktas: rwek
reaktorius: fyet
raudonėlis: ryop
plutonis: pwum
itris: tyom
patobulintus: hxat
Vartotojo-vardas: mrum
magistrantas: zrot
Dešinysis-sparnas: dwaf
argonas: jros
fobija: hxot
bendrauti: sluk
globalizacija: bluc
bangos-ilgis: hnef
koduoti: kfom
pakartotinai-panaudoti: psoc
perkrauti: nrek
hepatito: pyes
toras: fros
chemoterapija: myep
modulį: mwok
protonų: zwot
diskelyje: dwet
miligramas: mlum
pikselių: psep
tantalas: twem
tirpinys: hjot
genocidas: nyos
plėšrūnas: rwes
galio: glem
cirkonio: hzum
nulėmėjas: txin
netiesinė: nlem
pesticidas: pyif
Berilis: brem
neuronas: nrus
predikatinis: pxit
apatinės-kelnaitės: tlif
faktorialas: kref
neutronas: zrut
niobio: nwom
germanis: hjem
Nemetāls: tlop
sudėti-apie: dlap
prolative-atvejis: hl6k
biologinė-įvairovė: jwic
kreiptuką: jyok
antibiotikas: twok
Actinium: gjim
astronautas: srof
esantis-už-žemės ribų: tyes
Głupek: hwup
maratonas: mrof
iterbis: zwim
autizmas: tyif
jonizuoti: nlof
radonas: cwos
Nerium: nrem
epidemiologija: pwip
senatvė: lyuc
stovyklavietė: kyep
dryžuotas: drip
indžio: nyum
Teisingą: hvik
Interneto-svetainė: bwes
Koranas: kwek
stalo-įrankiai: fwet
n-ojo-šaknis: tfec
lawrencium: lyem
civilines---teises: glip
Mobilusis-telefonas: mlof
paralyžiuotas: twoc
Protactinium: prum
radiacija: hd6n
priklausyti-apie: pxin
toris-atomas: hxim
mėlyna--Jean: bjun
namas-augalas: hxas
atskirai: dvit
srauto-srovė: lwuk
trigubas-taškas: ht6t
Žmogaus-kūnas: hn6n
fizika: bzik
mažmeninė-prekyba-parduotuvė: hxan
cezio: hs6m
ilgai-prieš: hqan
skaičiuoklės: hxet
vienetas--of--mas: hn6m
sudaryti: ml6n
dvejetainis-vertė: vrim
žmogaus-esamas: nyus
iki-priemonė-iš: hvan
depan-dari: pxat
praseodymium: pyom
kartonas: kxat
baigtinis-veiksmažodis: hqik
bandomasis-skaičius: hr6n
už-sakinys: hr6t
kritikas: hk6k
pakavimas: pxas
nepastovumą: pxan
prie-dauguma: txas
deskriptorius: drop
neodimio: nyem
draugystė: hvit
skaityti-tik: xyak
steigia: xwan
Gnomiczny-nuotaika: kxin
fonema: hxom
racionalumas: xlit
fonologinis: xlin
valgomasis-kambarys: hxac
gyvenimas-kambarys: hxic
orientuotas-atvejis: zrik
prieš-hodiernal: hx6n
pacientas-atvejis: hqak
įstrižas-atvejis: bwok
kaimo-plotas: hqat
recurse: hr6s
vidurys-balsas: dyos
meitnerium: hm6m
pašto-vežėjas: hvak
neįpareigojanti: kxit
ištekliai-rinka: xrak
atpažįstami: hxap
tikslas-gaidukas: krof
viena-sekundė: hxen
liacinės-atvejis: dvak
racionas: hr6c
ne-žmogaus: hg6n
gyvenimas-dalykas: hvic
per-daug-mažai: hxut
kino-teatras: hvin
hasis: xyim
attenuative: ty6t
multal-skaičius: ml6m
pieniškas-būdas: txam
neptūnus: nwem
svetimų-kalboje: txik
Trans-skaitvardis: ts6s
kvailioti: hqun
americį: myem
rytas-šlovė: txan
gaisrininkas: xran
berkelium: blem
galaktika-lytis: kxan
Nobelium: blum
iki: hvac
budizmas: hfum
fermis: frem
žydra: xyan
soja: syof
skirstytuvas: qrit
streiklaužys: txak
procesorius: ples
abessive-atvejis: bvak
adessive-atvejis: dvik
į-atvejis: kxak
agentive-atvejis: dvek
Rutherfordium: hr6m
antikūno: txip
kaip-daug-kaip: hjos
agentas-gaidukas: hg6t
aktorius-vaidmuo: xram
etidžio: txim
bendras-lytis: hk6n
accompanier: kl6n
dygminų: kxam
francis: fyam
erbis: ry6m
pasyvus-balsas: xyis
astatas: hqit
kramtomas-guma: hqam
žvaigždė-lytis: hqin
citata-forma: ht6m
Curie: jrim
komiksų-juostelės: kxis
neskiriantis-spalvų: hqon
euler's-numeris: hl6m
žiūrėti-prie: kxas
Crosswalk: pwok
mūšio-laukas: txat
automobilistas: vrit
trumpas-sujungimas: txok
žodinis-daiktavardis: hvis
šauksmas-iš: hk6t
statistiškai: xyit
jogurtas: txot
xenon: hs6n
hipnotizuoti: hxif
imti-nuo: hxaf
sąlyga-uodegą: hxok
tiesioginis-objektas: dwot
bakalėjos-parduotuvė: kxun
būti-apie: hm6t
ergatyvinis-atvejis: gvik
in--kalba: txic
iš-pirmų-rankų: pxam
vietininkas-atvejis: hqok
plaukiojimo-baseinas: slup
prieveiksminis-atvejis: vlak
sightsee: hqas
televizija-rinkinys: ht6s
galutinis-dalelė: xlik
evitative-atvejis: hvek
reabilitacija: xlat
regresija: xris
blokas-apie-Butai: kxot
pažadinti-aukštyn: hxup
policija-pareigūnas: ps6s
prisiekiu--in: vran
pašnekovas: qrat
renis: ryem
aerozolio: xres
savininkiškas-atvejis: kxik
nominalization: mlec
apsėstas-atvejis: dzak
užprašyti: pxak
pagalbinis-veiksmažodis: xyik
pagrindinis-objektas: mlut
kompiuterių-virusų: prus
verslo-žmogus: hqis
žmonės: hqen
antessive-atvejis: ts6k
ministras-Pirmininkas: pxis
lutecis: lyum
Europis: rwum
įsijausti: xrot
liaudies-muzika: zyik
poetas: vwit
paštas: pxot
manoma: hvas
pagyvinti-lytis: hven
subessive-atvejis: bvik
greičio-pedalas: glep
poliškumas: pr6t
transporto-priemonė-lytis: vlin
mineralinis-lytis: xrin
veiksmažodžio-priesaga--: hvif
aistringas: pc6n
samariu: sr6m
pagalbininkas: hs6t
įsivaizduojama-vienetų: xyin
greitis-nuo-šviesos: kxac
oro-pajėgos: hxes
empatiškas-džiaugsmas: pfec
kritinis-taškas: qyit
pilnas-laikas: hxem
hafnio: xyam
slopinimas: hn6s
pokytis-iš-renginys: qrin
holmis: xlim
kitoks-renginys: hf6t
visata-lytis: hvip
vietovė-lytis: kxen
virtualus-mašina: hvim
tyrimas-lytis: txen
meninis-lytis: ts6n
crastinal-įtempti: sl6t
abstraktus-lytis: srep
exocentric-atvejis: zrek
pereinamas-veiksmažodis: txif
Morpheme: tfom
šovinistas: dvis
praeitis-Tobulas: xrat
profesinis: hy6n
netiesioginis-kalbos: tyoc
antra-kalba: draf
į-būti: txis
kapinės-perėjimas: vrak
kolektyvas-daiktavardis: hxos
absolutive-atvejis: bvuk
pacientas-gaidukas: tr6t
savarankiškai-pasitikėjimas: hs6s
išmatos: hzos
sangrąžinis-balsas: hf6s
beasmenis-veiksmažodis: hxek
seaborgium: br6m
balta-erdvė: hxep
modalinis-atvejis: dlok
negyvas-lytis: hj6n
priežastinis: qran
propositive-nuotaika: psom
elektros-dabartinis: tr6n
asociatyvus-atvejis: nwok
aukščiausias-atvejis: tluk
per-daug-daug: xyut
planetinis-lytis: pxen
animacinis-karikatūra: nwuk
abipusis-balsas: vrik
leisti-įstatymus: hqaf
prie-mažiau: vlas
gramatinė-atvejis: qrak
vartotojas: pxut
šerdis-benefactive: kfef
vartininkas: hgop
:-except-for: kcef
vardiklis: dvan
dar---jei: lyek
į-šoną: hx6s
vienas-kitą: dles
nuoseklus-išlyga: lyuk
susidėvėti: hxun
šortai: ht6k
dysprosium: prom
greitai-ateitis-įtempti: rwec
si-vienetai: vyin
kriptonas: kxon
Mendelevis: dlem
TAIKOMOSIOS-balsas: hp6s
antipassive-balsas: tsef
Continuative-aspektas: ht6p
radiacijos-ligos: hr6k
necessitative-nuotaika: hn6t
vienas-veiksmas-veiksmažodis: hqek
Torpeda: xlak
aukščiausias-laipsnis: tlup
egzistencinis-išlyga: hs6k
kalifornis: kf6n
dovana-dalyvis: vrat
šviečiantis-intensyvumas: hc6t
singulative-skaičius: slus
gramatinė-objektų: hy6t
pasyvus-dalyvis: vris
perdėtas-trukmė: kxic
superkritinis-skystis--: sr6t
suma-iš-medžiaga: ks6t
postpositional-atvejis: pxok
pasirenkamas-quantifier: lwif
gadolinio: dl6n
epentetinis-morpheme: hp6m
Neigiamai-quantifier: nwif
einšteinis: ny6n
dirbtinis-kalba: txac
jungiamasis-dalelė: qrik
Nuotolinis-ateitis-įtempti: twec
dažninis-aspektas: hfep
skirstomasis-įvardis: bvin
Kreipimasis-susitarimas: hk6m
nuplikęs: blos
priemiestis: syum
universalus-quantifier: vlit
kompiuteris-programavimas: mr6m
televizija-programa: tr6m
slankaus-kablelio-numeris: hvun
egzistencinis-quantifier: tl6t
diena-po-rytoj: dwek
alternatyva-quantifier: lw6t
Gderliwy: hdup
praeitis-pasyvus-dalyvis: hp6t
diena-prieš-vakar: txet
vietininkas-krypties-atvejis: tc6k
priešingos-sąlyginis: ht6c
