bezokolicznik: hnit
mianownikowy-sprawa: hnak
biernik-sprawa: hkak
temat-sprawa: htak
roślina-mateczna: hmat
tata: hpap
mama: hmam
Halo: hnat
przodek: htat
dziadkowie: hyat
głodny: hcac
dopełniacz-sprawa: hnik
przymiotnik: hcit
i: hwan
mnie: hmic
ty: hnan
nas: hnam
ono: hyic
cel-sprawa: htas
celownik-sprawa: htik
wnętrze-kontekst: htis
osoba-kontekst: hpak
zależny-klauzula: htan
perfektywny-aspekt: htap
przeszłość-czas: hkat
rodzaj-męski-płeć: hsan
comitative-sprawa: hmik
obecny-czas: hyan
benefactive-sprawa: hpik
essive-sprawa: swik
nie: hnic
jego: hsis
powierzchnia-kontekst: hsak
adpositional-sprawa: hpan
Lokalizacja-sprawa: hwak
przestrzeń-kontekst: hnos
droga-sprawa: hrak
instrumentalny-sprawa: hsik
który: hkan
badawczy-humor: hnim
i-lub: htam
Ekskluzywny-albo: hkit
źródło-sprawa: hsok
narzędnik-sprawa: hlak
wskazujący: hdit
ale: hlan
wszyscy: hsut
kobiecy-płeć: hnin
oni: hwin
liczba-mnoga-numer: hlun
jeden: hyik
przyszłość-czas: hwet
społeczny-kontekst: hson
gdy: hkap
niedokonany-aspekt: hmap
tam: hkac
warunkowy-humor: hcan
jeszcze: hdoc
na-zewnątrz: htac
krewny-sprawa: hrik
illative-sprawa: hlik
robić: hkas
dyrektywa-humor: hden
deontyczna-humor: hdim
pytanie-słowo: hwac
spójka: hkok
osoba: hpon
męski: hman
móc: kwat
inne: hcon
numer: hnoc
bardzo: tcac
czas: htim
czas-kontekst: htos
czasowy-sprawa: hmak
o: hkam
epistemiczna-humor: hsim
tylko: htun
mało: hcak
następnie: pcan
hortative-humor: hton
z-mocą-wsteczną aspekt: hrip
wielki: hcat
volitive-humor: hlim
przed: hsec
musi: pcic
dwa: htut
widzieć: tcan
wiedzieć: hsat
na-dół: hcin
po: hcas
pierwszy: hpas
własny: hpun
przenośny-posiadanie: hlic
nigdy: hnac
niezbywalny-posiadanie: hkic
stary: hwat
obradujący-humor: hcim
dzień: htin
gdzie: hnap
chodź: hlat
droga: hyas
praca: hkaf
samogłoska: hwaf
iść: hkun
perlative-sprawa: pwik
progresywny-aspekt: hpip
długi: hlac
powiedzieć: hsac
jak: hkin
parzyste: hpit
plecy: hwap
tutaj: hcic
myśleć: hcik
podobnie: hsam
trwać: kcac
z-dala: twan
pod-kontekst: hnas
brać: htit
uznany: hfan
dłoń: cyat
młody: hyac
chociaż: hyap
dać: hkik
Bóg: hmac
delative-sprawa: lwak
nic: hmin
dobrze: hyit
pewnego-razu: hyam
semelfactive-aspekt: fwip
część: hpat
Piła: htic
dom: hfas
świat: tcat
głowa: hcaf
trzy: tyin
neo: hnon
skupiać: hcok
miłość: hpac
zawsze: hsit
noc: hwit
każdego: hmit
król: hyak
między: hsin
serce: cyin
paucal-numer: plom
bo: hyok
przyczynowy-sprawa: ksak
rzecz: hkis
zestaw: swat
imię: hnem
właściwy-rzeczownik: hran
hortative: hrat
kraj: hlit
spytał: hput
widoczny-dowodowy: crit
lepiej: pcac
bok: psac
kurs: hkus
Płeć-żeńska: hfin
wystarczy: kyat
już-wkrótce: hpuc
pełny: hcun
pokój: hfac
prawie: hlap
nie-mogą: nyat
woda: hwik
desiderative-humor: hdin
jasny: lyak
ani: hnun
słowo: slat
drzwi: tyan
posługiwać-się: hpus
ranek: hsap
terminative-sprawa: twik
moc: hkuk
sami: hmis
obecny: hyin
głos: hwas
biały: hpis
pieniądze: tlan
Dalej: kyak
ubogi: hyis
śmierć: hmut
forma: hfam
inessive-sprawa: nwik
dobry: tyac
często: tsan
rok: nwan
przyjaciel: myat
zamówienie: hyut
tryb-rozkazujący-humor: hpim
okrągły: hcut
uwierzyć: hban
publiczny: hpin
stan-kontekst: hsas
syn: psat
sto: hmas
dzieci: hcis
a-zatem: tyak
nadzieja: hcap
nad: hyip
drogi: pyin
czytać: pyac
miasto: hsic
już: hpic
fakt: hfat
factive-dowodowy: hfit
słyszeć: hsun
najmniej: hmim
może: pyat
Otwarte: kcat
ciało: tcic
powietrze: cwac
Natura: nyit
Pomoc: mlat
list: lyat
cztery: ksat
życzący-humor: hpam
ogień: hfak
dlatego: hyif
godzina: hcam
darmowy: tyit
wojna: syat
czy: hsaf
powód: kyan
zjednoczony: hnut
połączenie: hkuc
czemu: hwam
zagubiony: hkut
tysiąc: tsas
rodzina: hfic
dusza: twam
pytanie: swac
opieka: kcan
realis-humor: hlin
oznaczać: mwit
potencjał-humor: hten
w-kierunku: cyan
Allativus-sprawa: lwik
antropiczny-płeć: hrin
krótki: kyut
w-stanie: hyuk
relacja-na-żywo: hkip
Przedmiot: hsek
takie-same-Przedmiot znacznik: hcek
inny-Przedmiot: hfek
odpowiadać: tsat
morze: mwat
strach: hcoc
rozumiesz: pcat
trudny: kyin
Warunki: tyut
wątpić: hdac
dubitative-humor: twin
pytać-się: psan
ramiona: tcas
czarny: clis
przynieść: tyat
Pięknie: ksis
ciemny: tcak
trzymać: psak
dziesięć: htaf
pokaz: pyan
fabuła: hkif
pospolity: kwan
książka: hkup
elektroniczny: lyin
gadanie: plak
ocena-w-szkole: myac
zainteresowanie: nyis
pisać: kcit
łóżko: pwat
konieczny: syis
pomysł: hwis
sztuka: klat
Vialis-sprawa: hlas
brat: pyak
czasami: ksas
linia: lyan
stół: tlas
rzeka: nwit
oko: kyac
Informacja: fyin
nagle: tfan
dziwne: hgan
głęboki: ksan
zmiana: hrit
uczucie: nwac
poznać-się: mlit
cel: htuc
szczęśliwy: hcuc
wydać-się: syit
krew: cyac
róża: kwas
południe: swan
zimno: tlat
Naprzód: myik
pozycja: psis
późno: tyam
stoisko: syan
przypuszczać: nlas
córka: pyit
kopalnia: myan
ciąć: hkim
Kopiuj: hfap
mąż: hgat
sześć: hlis
pamiętać: twat
efekt: hyaf
spadek: htuk
oprócz: hsip
włosy: hpaf
przechodzić: pyas
Prawo-autorskie: pcit
armia: cyit
bieg: kcak
koń: kcas
przyszłość: hwic
zachód: pcak
zapłacić: plit
Rudy: hyun
złoto: tcun
pragnienie: hdan
bawić-się: plin
opanować: mwas
Biuro: hfus
rząd: syak
kościół: kyas
długość: hlen
firma: ksin
papier: kyis
prawdopodobieństwo: hbin
zwłaszcza: cyas
Niedźwiedź: pcas
okno: cyak
umowa: hgac
piękno: syac
obowiązek: tfac
wysłać: fyan
dystans: htif
cisza: slan
stopa: fyat
dziki: kyik
umierać: myam
ratować: pfan
zielony: kcin
problem: mlan
uśmiech: myak
źle: clat
różnorodny: pcin
sen: slit
quotative-sprawa: kwik
początek: cwan
akcja: kfan
odwiedzić: fwat
kierować-się: nlan
próba: tcis
obecność: psit
słodki: tlit
bogaty: tcin
wróg: tcam
statek: hcip
stan: kyit
w-tym: hkum
włącznie-osoba: hlon
sekret: kwit
precative-humor: pwim
uprzejmy-zarejestrować: hbit
zło: pwac
Marsz: myas
cokolwiek: kwac
pobyt: hlam
w-zamian: plat
niebieski: plan
niemożliwy: psap
szkoła: hsuk
okazja: ksac
żonaty: nwat
jedzenie: hcuk
20: tsis
cicho: tcit
z-łatwością: hnis
spodziewany-aspekt: hrap
język: lyac
wyrażenie: syas
tydzień: hsus
sala: hcum
niebezpieczeństwo: kcic
nieruchomość: myit
urodzony: nyan
boisko: kcut
ogólnie: tyap
gnomiczny-aspekt: hmip
wartość: tyas
proste: syap
drzewo: pyic
bić-się: pyap
Ściana: twit
niebo: cwak
inchoative-aspekt: htip
jussive-humor: hjin
ton: twun
wzgląd: klan
spodziewany: pcik
miesiąc: hmaf
doświadczenie: nyap
całkowicie: nyac
świeży: tsac
książę: hnuk
pokryty: kwak
granica: hyim
Wschód: tyuk
kamień: pwan
nieco: kfat
kierunek: tlac
krzesło: kwis
wsparcie: syut
data: tyic
wieś: klac
pole: clit
pozwolenie: nwin
dozwalający-humor: hmom
sukces: slak
właściwy: hric
wzgórze: clin
muzyka: ksik
dystalnej-wskazujący: hdat
popołudnie: htup
płakać: hyuc
honor: hnaf
siedem: swit
prywatny: pfat
aktualności: nwas
scena: slac
ogród: cyam
wyścig: htus
dystrybucyjny-sprawa: twak
uczyć-się: clan
polityczny: syik
kłamstwo: kcun
odlew: tsak
jeść: kcam
piętro: hlaf
chory: pwin
oryginalny: mlin
lato: kyam
religia: tlam
obraz: ksit
ucieczka: plap
autor: hlut
brązowy: pyun
zdecydowany: htem
ból: hdon
wiosna: psin
wiek: syic
miękki: mwan
kąt: kyun
wytwarzać: psas
śmiać-się: cyaf
zapomnieć: flat
Europa: hyup
osiem: lwat
sukienka: lwac
straszny: cyap
oddech: syaf
mądry: hbas
zaborczy-znacznik: srak
pamięć: myin
nowoczesny: fwan
miejsce: tcap
powstanie: hyus
złamać: pyik
pięćdziesiąt: hfis
wyspa: tlap
dotknąć: hsuc
obietnica: pcam
commissive-humor: mwin
stopień: tfat
plan: plac
postępek: nyak
niespodzianka: cran
chwila: hmun
strzał: hwut
gorzej: pcap
szkło: klak
instancja: tlin
bezpieczne: hsif
lekarz: tsit
dopełniający-aspekt: hmep
powtarzający-się: tyun
wojskowy: slin
ciepło: nyam
drink: pfin
pytania: pcaf
gniew: nran
bezpośrednio: tyik
kapelusz: hcup
pies: kwap
sługa: hnuc
duma: hram
tłum: tcuc
pociąg: nyin
morał: myut
związane: kyim
wchodzić: fyak
reguła: nyas
miecz: cwat
atak: kfak
zdrowie: clac
ustęp: pyaf
społeczny: hsum
zwrot: tfit
Przepraszam: hpec
odwaga: krac
łaska: hnen
urzędnik: hfaf
opatrzony: tsik
prośba: pwit
spojrzenie: klas
ruch: hyon
oczekiwać: cwit
naprzeciwko: psam
dwanaście: tyaf
zajęty: nyut
wino: hwun
smak: swut
żelazo: fyac
rozprowadzać: syin
handel: myap
przewaga: twac
odzież: kfip
sędzia: fwak
różnica: tfaf
niespokojny: kcis
kapitan: kwin
gotowe: nlat
zaprzestanie-aspekt: hsep
ciekawy: kyic
obcy: kwic
wzmacniacz: hnif
znaczenie: myun
wreszcie: hfim
rachunek: fwin
okazać-się: hpuk
zapobiec: flan
szyja: cyun
prawny: hfik
suchy: swak
obsługiwać: syam
stracić: pcut
dowód: pyut
dowodowy-sprawa: hdak
postęp: pyis
budynek: klit
Wyszukaj: syuc
smutny: hrac
grzech: psip
30: tfis
szczery: tsin
zamknąć: kyap
bank: pcun
los: cyik
las: hfun
zmierzyć: mlac
inaczej: htoc
strumień: lyam
chleb: hpup
dodatkowy: tfak
wybierać: twas
zwierzę: nwam
zoic-płeć: hzin
eventive-humor: hwim
takie-same-zdarzenie znacznik: hcom
mnożny-sprawa: tlak
gruby: hmus
istota: hyum
deszcz: myic
powierzchnia: pfas
święty: swis
lipiec: clim
raport: hfut
Wybrzeże: pwas
plik: hfif
ramię: cwut
zaskoczony: kran
królewski: klik
piosenka: hkuf
komfort: kfaf
kogokolwiek: nyic
trawa: kcap
rysować: cwik
otwarcie: cyic
czerwiec: cwun
ryba: mlic
kapitał: klin
pierś: cyut
śnieg: hcif
edukacja: tlik
ostry: tcaf
litość: hdam
koszt: fyas
Twój: hmuc
milion: mlun
zmęczony: tcik
zabić: ksam
cień: cwap
waga: plas
masa: mlas
ustanowiony: tlip
odważny: pyam
chudy: plic
zadowolona: srat
czek: kcik
cnota: hdet
krajowy: nyaf
boski: swin
dolina: clak
domyśl-się: kwam
spekulacyjny-humor: hken
żółty: clas
szczątki: mwac
zgięty: nlac
pudełko: pwak
pora-roku: tsim
nauka: slas
nudziarz: kcuc
wujek: hmuk
lista: lyit
sierpień: ksut
popularny: hlup
nieznany: fyit
znajomy: flak
znajomy-zarejestrować: krit
czytelnik: tsut
podejście: pcuc
dwa-razy: tsap
intelektualny: tfik
naprawdę: tsam
kapłan: pcis
ranny: fran
smutek: hpom
pałac: kfas
pokonać: clap
co?: hnec
oszukać: myuk
krawędź: pfac
dziewięć: nwun
rozerwanie: psut
ponieść: tfas
hałas: hcus
literatura: lyic
Rada: swas
pusty: kcuk
ranga: psik
burza: tcut
kieszeń: kyip
wyobraźnia: nlin
wyrok: cwas
listopad: nwap
grudzień: tsip
brak: psic
podziękować: ryak
adres: tyis
ptak: pyuc
właściciel: mlik
płaszcz: kwut
przygotować: tyip
kontakty: lwan
palić: htum
styczeń: nwak
maszyna: clic
treść: nyik
zęby: tlis
wstyd: hcet
zatoka: kcaf
mózg: pyuk
dzwonić: klic
wyrażenie-znacznik: frak
kwadrat: ksap
owoc: fyut
herbata: tsic
wyjaśniać: slam
Witaj: cwam
poezja: pwis
kupować: klam
wierny: hdic
podniecenie: hcen
czterdzieści: klis
kwiecień: pyip
uprzejmie: kfit
październik: kfap
gorzki: kyuc
niewolnik: tlaf
luźny: hluk
tekst: tsus
kredyt: cyip
piętnaście: pfit
okrutny: kcim
dołączyć-do: cluc
proces: hpif
przestępstwo: kyaf
kurz: tsuc
praktyczny: plik
kolor: nlak
zniszczyć: nyuc
wzrost: lyas
nos: hnus
przyznać: tyim
wczoraj: kfac
hesternal-czas: tlen
zawieść: slap
kontynułuj: tcim
mieć-na-sobie: pwam
ślepy: nlit
tuzin: tsun
latać: fyap
pochwała: cwin
diabeł: cwaf
stopniowo: twic
ofiara: kyif
poćwiczyć: cyis
sumienie: tfin
teoria: tlic
minister: myis
nienawidzić: hnet
jezioro: cwic
centrum: syun
słaby: pfic
racjonalny-płeć: hron
ostrożny: fwac
cieszyć-się: nlam
kult: pwap
towary: twap
skóra: twaf
dach: tlut
korona: gyan
zamek: klap
tron: tcus
przywiązany: nlaf
mila: mlim
skrajny: krim
więzienie: fyis
filiżanka: kcip
członek: mlam
cywilny: syim
wszędzie: tsaf
oczywisty: tfic
para: pwaf
Tom: clam
zwyczaj: ksaf
kokarda: ksun
garnitur: slut
mięso: mwak
mleko: hluc
roślinny-płeć: hwen
wizja: slic
rzadki: nlap
kuzyn: ksic
most: pwut
chronić: pfak
sól: swam
niewinny: hwus
królowa: kwim
liczyć: kcus
ciekawość: hras
taniec: tyus
hotel: clut
wypełniać: flin
więzień: psun
robić-zakupy: hjan
schody: sric
błagać: hmen
piasek: sran
gwałtowny: hgit
wrzesień: hsem
wyjazd: prac
ruina: crin
umiejętność: krin
bydło: hwec
sprzęt: hwip
kuchnia: hkon
sprzedać: hbak
prędkość: hsot
wniosek: clon
komputer: hkot
wieczny: hsen
ograniczony: mrit
biblioteka: hbek
opierać: hbac
zamieszanie: hrun
wspaniały: cris
również: hjic
przestraszony: hbic
nieszczęśliwy: prin
artykuł: hrek
gotować: kfin
pasmo: hbat
pustynia: hget
pocałunek: hbun
piłka: hbot
kij: hpot
sprzeczka: hrut
przestrzegać: nrak
błogosławieństwo-humor: hbim
uderzający: hrim
winny: hdis
pistolet: hgin
policja: plis
chować: hzan
wyprawa: srin
nieświadomy: nrin
hojny: drac
chmura: blan
odpady: htek
luty: frif
choroba: hren
spędzić: bwan
źródło: sron
inicjatywa-sprawa: hnok
ciocia: hbam
opóźnienie: dlic
opóźniony-tryb-rozkazujący: hlip
Podawane-dowodowy: prat
północ: dyit
bohater: nrac
filozofia: hfof
palec: hjit
wygodna: hzat
gdzieś: hmoc
naciśnij: bran
personel: hraf
nagroda: rwan
winić: dlac
nieszczęście: krat
czoło: htec
ogłoszenie: glan
anioł: htet
pojedynczy-numer: hgam
świt: hbon
handlowy: krak
przebaczyć: pran
owca: hcec
cierpliwość: hpen
gospodarstwo: crac
referencyjny: hrec
kukurydza: mran
klawisz: kcif
większość: hmot
słaba-strona: hdut
atmosfera: traf
westchnienie: tcoc
ludzkość: mlis
sprzeciw: pric
dysk: hdik
samotny: hket
artysta: nrat
rycerz: cwis
urok: tran
decyzja: drin
gubernator: gran
gałąź: rwac
usposobienie: hsoc
entuzjazm: tsum
indukcyjny-humor: hdum
społeczność: hmum
olej: hyen
rura: hbap
wydrukować: trat
O: dyoc
rozprawiać-kontekst: hros
wołacz-sprawa: hwok
kabina: ksen
alarm: plam
nerwowy: hnes
stały: hset
nóż: ksuk
jedwab: slik
pogarda: grin
piekło: nrik
rozdzielony: plen
na-poważnie: mrat
mieszany: mrik
drewniany: mrak
woleć: hpet
ostrzeżenie: trin
napomnienie-humor: htom
impuls: hmos
ambicja: mrac
zaprzeczać: hnek
konstytucja: swic
instrument: srit
ciągły-aspekt: hnip
fala: hgas
Szkoła-Wyższa: klen
ogon: hkek
generacja: nric
kot: blat
bezpośredni-dowodowy: hret
opuszczony: trac
jedenaście: hyec
instynkt: nlik
cecha-charakterystyczna: trit
plemię: hgik
lękliwy-humor: pcim
schronisko: crat
niegrzeczny: hruc
jazda-konna: hris
potrząsnąć: hmon
przemysł: hdot
zawód: hres
lampa: hdap
kawa: kfif
słuchać: htot
północny: nrit
pielęgniarka: nris
gwarantować: hjat
łańcuch: ryin
nauczanie: cric
buty: hgut
dziedziniec: mram
niejasny: hmec
gdzie-indziej: hlet
apartament: pret
czynność: twot
sobota: cram
światło-słoneczne: hduc
wdowa: hwuc
element: hlem
odbicie: hfen
organizacja: hgis
gwiazda: tram
incydent: hgon
Gość: hgip
bar: brap
butelka: hbet
błogosławić: blak
wymieszać: crak
wewnętrzny: trik
naprawić: krik
czerpać: prit
wydrążony: hcot
województwo: hpos
cywilizacja: srac
zawiesić: hgak
zaszokować: crok
wyjątek: swap
odcedzić: tren
standard: ryan
napędowy: dran
pozbyć-się: hruk
przysięgać: kses
skarb: zran
nasienie: hbis
wieża: tras
ulubiony: fwit
ostatnimi-czasy: hcem
niedawny-przeszłość-czas: hrot
obudzić: srik
meble: mrin
lina: hkos
przygoda: hdas
rodzina-królewska: ryit
uczta: dyat
opisać: dras
sześćdziesiąt: hses
skala: hkem
ceremonia: srec
polowanie: clik
szept: psus
w-dużej-mierze: ryat
chrześcijaństwo: ksim
prawnik: hwif
szczegół: drit
księżniczka: hrus
ołtarz: dlat
sieć: hwes
fioletowy: brin
gromadzić: hkoc
wybór: hben
koncepcja: kren
pijany: crik
wlać: brac
winda: hlif
gest: hjis
kierować: rwin
wymiana: tcen
konkretny-artykuł: hdek
cesarz: mras
zdalny: hroc
brzydki: clup
nieszkodliwy: cras
bułka: hrof
cal: nlic
gazeta: grat
zarost: dric
łza: srim
komisja: kson
natomiast: grak
przejście: kcoc
niezależność: htes
zapach: hwon
osiemnaście: hdec
historyczny: tris
brutto: krut
korzeń: hrok
błoto: hbik
panna-młoda: dlan
welon: pras
teatr: tret
porównanie: kras
rywalizować: rwis
saldo: slen
trener: kron
humor: hnum
powieść: rwas
zemsta: hbaf
zazdrosny: ryut
koło: hlok
spalony: glat
migać: flac
Stwórz: hkec
konflikt: hnot
przekleństwo: hlos
imprecatory-humor: pram
bezradny: hces
pozytywny: hzit
Klub: klup
powódź: nras
ziarno: gwan
obojętność: hdun
horyzont: crim
zarozumiały-humor: hsom
stromy: htop
harmonia: mron
grzmot: hgot
dzieciństwo: htok
kolano: hgun
oprogramowanie: pwen
zranienie: kram
paragon: ryis
umożliwiać: nlim
Protasis: hpoc
poślizg: slok
rewolucja: hrif
rolnik: hjim
uderzenie: trak
peron: hpof
posłaniec: hmes
przywilej: hpek
zorganizowany: hyot
student: clen
jaskinia: hgec
tradycja: rwat
tragedia: tses
pożegnanie: hjap
krytyka: ryik
bawełna: krap
szpital: slot
wynajem: kris
gaz: hges
nieunikniony: pwic
śmiertelnie: hgim
liść: glit
publikacja: plun
wrogi: tsup
tłumaczenie: dwan
pogrzeb: jran
mąka: mrun
korespondencja: ryon
romantyczny: hrom
Chata: clun
zaproponować: psot
mimetyczny: hmet
dolar: dlon
światło-dzienne: hjac
szesnaście: hsos
montaż: hzac
kolonia: klon
skrzydło: gyin
lew: hles
kultura: klut
kolumna: hkom
przebiegły: glak
dramat: dram
żart: hjuc
mgła: hdus
lekarstwo: dwas
czternaście: hkes
kwas: sram
mianowicie: hyet
dochód: hmok
biskup: hbip
pomarańczowy: tron
łazienka: byan
prymitywny: rwit
kosz: ksek
sekretarz: sris
słoma: prak
Jestem-cierpliwy: pfif
zbawienie: slon
hodiernal-czas: dlin
zamierzać: zrin
parowy: tcip
zatruć: hwoc
talent: tlon
klimat: lwim
skuteczny: fric
rozróżniać: tcif
myć-się: dwac
wyznanie: kfis
nonsens: hjas
węgiel: kyon
kajak: kwon
chwilowy: tric
delimitative-aspekt: hdip
kość: hcos
poniedziałek: nwic
wtorek: glac
środa: bwac
federalny: frin
pożądany: hzic
przedstawiciel: ryic
bielizna: lwin
umywalka: swuk
bratanek: bwin
krwawy: kric
oblężenie: cren
brzuch: hpem
mosiądz: pcon
szczyt: hzik
piąty: pfik
tani: brat
Ekskluzywny-osoba: kwen
chwycić: zrat
płot: hzas
statua: tfam
artyleria: tlep
uścisk: mrap
otaczający: sren
rygorystycznie: srot
jeleń: hluf
krzak: hbuc
popędzać: hrep
rozładować-się: hduk
dziedzic: mris
dąb: blun
nieprzyjemny: pren
wynalazek: hgic
fortepian: pyon
namawiać: swen
niewidzialny: gric
dobrze-znane: ryun
okrucieństwo: kluk
pokusa: hyoc
TELIC-aspekt: hlep
gospodarczy: kfik
międzynarodowy: troc
kolidować: tcek
filozof: flif
elegancki: gyit
dobrobyt: kyen
Wędkarstwo: mlak
ukraść: truc
warga: hloc
iść-na-emeryturę: ryac
rozciągać: sras
Galeria: glen
równolegle: zlan
atelic-aspekt: htep
kontynent: trap
prohibicyjny-humor: nrim
krawat: dwat
komórka: slep
jajko: dyan
sztuczny: jrat
W-międzyczasie: nwis
kryzys: ksot
uprzejmy: sloc
lunch: lyon
sosna: pwon
naciskać: hcef
Sojusz: lyen
talia: hkop
cud: hmek
marynarz: slis
czystość: prut
republika: hguk
telefon: tfen
bat: krip
koszula: cyim
przedstawiać: ryas
sofa: hsof
zamiatać: hsup
złodziej: ksif
zachować: nrec
kanał: kcen
osobowość: klim
reforma: kfam
groźny: hzim
Palma: plim
głośnik: hzak
próg: dwic
spowodować: pris
włócznia: bzak
schludny: syec
sesja: cwen
torturować: crot
wilgoć: tcum
grzbiet: grit
podróżny: hyek
młyn: mwik
mapa: jrac
kołnierz: klok
zastąpić: klif
celowo: drat
piwo: hbif
aksamit: hwem
powaga: gwit
kazanie: hpum
nadużycie: glas
trzoda: hgen
trzynaście: tres
uzasadniać: jyit
piątek: crum
szczotka: broc
pobieranie: dlas
krem: krem
klif: klaf
jury: jrin
potwór: ksos
mrożony: hgoc
garnek: pfot
grosz: psen
obstawać: srut
jabłko: hpep
dyskutować: drak
tło: prun
rozpisać: trim
okresowy: prik
zabawa: nren
wirus: bris
dziecinny: blit
odzwierciedlić: flit
konwertować: kcet
zarys: kluc
opera: hpop
zatwierdzenie: nron
zdradzać: rwak
karać: hzen
łokieć: kcon
Załącznik: tcet
naprawa: hrop
podejrzany: cyec
siedemdziesiąt: swet
pismo: srip
dół: grac
nieład: dlak
dwójkowy: byin
opactwo: bjan
strzałka: tcec
zmierzać: trec
opracować: frat
lojalność: hlot
moneta: syip
drżenie: tcem
wygnanie: gwin
mechaniczny: myim
pułapka: crap
ciasto: kyek
Pan: cyes
wahać-się: sret
siedemnaście: syet
miodu: myon
stawka: dzat
stąpać: hjam
cegła: brit
osiemdziesiąt: hpes
na-nieszczęście: pcen
konsultować: kcot
legenda: lwen
żniwa: hfos
promocja: pfon
kuchenka: hsop
Buntownik: bric
staromodny: hnom
puchnąć: cron
bagno: swot
ubieranie-się: hdes
ascetyczny: pces
menedżer: mren
chór: cros
racjonalny: tson
przetwarzanie: pson
Wilk: blaf
wykładzina-podłogowa: hgap
antyk: hjak
płodny: frut
gwizdać: slif
ser: twis
gryźć: byat
Zapraszam: jwan
katedra: kyet
port: brak
zbłądzić: djan
rośliny: tsos
marynarka-wojenna: nlen
maska: mrok
ołówek: pses
warzywo: sroc
wystawa: hzet
spodnie: tlun
korupcja: hrup
gabinet: nram
zupa: srup
chirurg: syon
dodatek: tcot
szpieg: gyas
lekkomyślny: hlec
plotka: gyic
znak: hzon
abstrakcyjny: srok
czwartek: cwim
ruch-drogowy: ryaf
architektura: ryek
pęknięcie: rwaf
ornament: rwon
rewers: lwas
bawić: mwun
poprawa: ksus
bruk: plut
decydujący: dyin
negatywny: nraf
festiwal: hfec
zredukować: hrum
zdrada: zyan
Łowca: djin
wąż: syen
bateria: bret
wosk: flam
detektyw: dlit
analiza: nlis
nacisk: hzot
pływać: twen
koperta: lwaf
ktokolwiek: hgek
papieros: jrit
silnik: mrot
wolontariusz: hwot
reakcja: ryif
bagaż: blam
głuchy: hboc
sok: hjus
pokora: jlit
ministerstwo: mret
seksualny: hjon
średnica: dyam
topór: blac
diament: dlam
alternatywny: hlek
echo: hgus
powściągliwość: swon
tożsamość: hdaf
ekran: krun
leniwy: lwis
momentane-aspekt: hmop
kompaktowy: kfot
dryf: hdif
znikam: hgaf
promień: ryen
atrament: mwic
masywny: mraf
piwnica: dyac
niezapomniany: nrun
blask: klek
senat: slet
trumna: tfap
przebaczenie: frac
łyk: nlun
pobłażać: nlot
huśtawka: swun
łąka: gram
kompleks: klos
rezygnacja: hzis
pokorny-zarejestrować: nret
spisek: swim
pieprz: prip
kucyk: pron
kandydat: hzam
lis: flik
komin: tcon
jurysdykcja: drik
rolnictwo: rwic
dokładność: tcuk
były-zmarły: brim
demokratyczny: mrek
pączek: hbos
koc: bwat
grad: hgep
świnia: srus
kształcie: krek
kość-słoniowa: craf
klasyczny: ksok
obserwator: nwet
słoń: lwit
paznokcie: nwus
pszczoła: hmif
pogrzebać: dzan
aktor: bzat
pocić-się: zwan
Polskie: ploc
iluzja: hlus
niepewność: pcet
wtórny: syif
zagięcie: tsot
wiejski: grun
jęk: nyen
być-podobnym: slec
zacytować: hzun
worek: cyek
kłopot: fren
igła: hjun
kontrolowanych: nroc
kurczak: truk
zgodny: kwot
beczka: bras
zwykły-aspekt: hcep
ekspert: ksec
piętno: blin
oliwka: zlin
awangarda: myen
przeszkoda: bwak
ukłon: kcec
sprzyjać: plaf
definicja: fyic
urodziny: gjin
młot: hcof
pachnący: hfon
powtórzenie: trun
trywialny: twut
rzut: hjik
kopać: kwaf
zwierzę-domowe: plot
czaszka: hcop
legislatura: dlik
obcas: cruk
marszczyć-brwi: crun
patent: plet
miliard: blim
chemiczny: fyik
pilot: pyot
naśladować: mlot
Spódnica: kwet
niezwykle: srap
co-tydzień: jwik
techniczny: tfip
roślinność: tset
wrona: kraf
wschód-słońca: sruc
życie: glin
przyczyniać-się: hyom
hak: hdok
Tygrys: blic
przenikać: crut
rękaw: slun
Autostrada: jras
milicja: mlip
rów: kroc
integralność: kret
dziewiętnaście: dzin
organiczny: rwik
teologia: flic
pływak: flut
czarownica: byac
znudzony: hwuk
dyplomatyczny: dyik
studio: twos
przekraczać: kcok
szampan: cyen
inspirować: crif
transparent: hbes
rozwód: lwon
śruba: hbut
żyła: jyan
pasywny: psif
piana: hgum
żwir: grik
Fartuch: tyen
planeta: gren
półka: claf
wentylator: flon
tropikalny: hjip
faza: fwas
arbitralny: rwen
wymawiać: kfun
Merkury: krok
pełzanie: hrem
samobójstwo: tcos
reporter: prot
pozbawiać: hpok
wykwalifikowany: klun
balkon: blik
widelec: fras
pracownik: mlek
pracodawca: myot
szerokość: jrak
podrażniona: djit
oskarżać: klot
pensjonat: pyen
czasownik: kres
małpa: mwon
do-przyjęcia: hwek
podpis: tlim
prawosławny: rwos
ironia: fron
żłobek: nrap
niechęć: jlan
import: tyot
latarka: croc
gramatyka: gjak
zdeponować: gyat
kolonialny: plon
jacht: jyat
wynikający: kwec
kopuła: kwun
grubość: hfot
uparty: cyon
mięsień: hmup
wielkość: ryam
pocierać: ryos
tchórzliwy: rwam
uprząż: gwac
toast: tros
mysz: myus
sylaba: slim
poklepać: prap
dialog: dlaf
neutralny: nrot
pracowitość: dwin
sprzeczność: trot
osiągać: kfic
Koza: byak
zakrętas: hfet
nakładać: mlon
anonimowy: nwim
formalny-zarejestrować: frit
cielę: hbof
instrukcja-obslugi: mwut
stopić: hjec
kasować: flas
parasol: gras
but: bzut
minerał: mrim
rozejm: crus
kaczka: hbok
planowanie: pfam
mydło: hsuf
lalka: gwak
szkielet: klet
willa: blis
szycie: jlin
pogodzić: dyak
czajnik: kset
dojrzały: mruc
królik: kruc
konduktor: nwot
zależność: djat
gracz: jlic
owad: pset
restauracja: cret
sowa: lwun
rodnik: djik
rezydent: zwin
smok: dron
słuchowy-dowodowy: drot
spragniony: kyos
marudzić: dren
obliczenie: glun
regulacja: ryim
burmistrz: mlap
mniejszość: mric
nabycie: dwon
weteran: bren
orkiestra: ryes
boczek: bjin
niekorzyść: zwat
tkanina: frap
muzyk: gzik
umysłowo: hnep
spójnik: nyon
niewystarczający: nrip
architekt: tsek
cytrynowy: nyim
kaszel: kcos
bol-glowy: crek
najemca: ryet
płodność: srun
leczyć-się: hfoc
dziewięćdziesiąt: nwon
losowy: hbec
łyżka: kcek
balon: blon
kreda: hfip
inferential-dowodowy: nlet
wydawca: pcot
ocet-winny: sruk
popiół: fyec
dopełniający: slek
wskrzesić: nrut
podatny: kfim
tunel: tfun
puzzle: hpef
mechanizm: mwim
matematyka: gzit
blaknąć: frun
wątroba: jwin
sublative-sprawa: bwik
zanurzać: dris
jednostka: twim
monopol: hnop
hazard: hgup
Łódź-podwodna: bzin
trzęsienie-ziemi: hbem
laboratorium: brot
korek: kruk
samego-siebie-kontrola: syot
budda: hbus
robić-na-drutach: bjat
ambasada: blas
najdalej: sres
deklaracyjny-humor: drim
bodziec: tyuc
czekolada: clot
zbieg-okoliczności: tyon
rękawica: gwat
klęczeć: hjek
geografia: hjif
inwestycja: nwes
słowny: mrec
analogia: nlip
świecki: srek
jastrząb: blap
psychologia: nloc
przymocować: gjan
skrawek: krep
rola: cyum
dawka: hdos
łosoś: slom
pudding: pwun
magnetyczny: gyik
pompa: pcom
tlen: ksip
certyfikat: tfot
medal: hmem
retoryka: trok
zeskrobać: rwap
wiosło: dyas
teleskop: trip
naszyjnik: clek
pisownia: prif
whisky: hwos
wierzba: hwof
wielbłąd: hlum
amator: myet
wyjście: crec
biografia: brif
osioł: gzac
miesięczny: mwis
ignorować: nruk
wakacje: byit
trzask: lyik
owalny: twon
elastyczny: lyet
słownik: kfon
szynka: gzam
tęcza: rwun
konsumować: kcum
pluć: tcup
czołg: trek
kolega: clok
latające-masło: trif
wykres: graf
bliźniak: jwat
niezależnie: trem
bambus: hbum
kupiec: jlat
akumulacja: kles
inspektor: nyet
kąsek: hyos
koszmar: hbom
dżem: gjam
muzeum: mrem
alfabet: lwam
rozpraszać: zras
nalot: crip
ujawniać: clus
gnić: fraf
agresywny: gris
tarcie: mroc
molo: gyac
pająk: brik
ziemniak: trut
rewizja: cwon
chciwość: jlac
przedwczesny: ryot
zwielokrotniać: gzan
spin: pcip
Statystyka: tsok
kalendarz: klem
nominacja: nwen
trylion: tlos
poddasze: tlok
twierdzący-humor: rwim
Aplikacje: pfen
nominalny: nlon
niezadowolenie: sraf
zakażenie: hfok
dzban: krot
wzruszać-ramionami: cyok
pionier: gzin
pominięcie: nlif
kapusta: glic
atletyczny: tlet
pijaństwo: mrut
idiofony: hdof
dźwignia: lwek
senator: syem
irys: nrif
mrówka: mwam
pluskwa: hbop
w-ciąży: grim
osad: hjet
kostka: tcok
klasyfikacja: glik
zmienna: prim
owinąć: ryap
kręcone: krec
siarka: hsef
dyktować: dwik
wyłaniać-się: brun
żaba: fram
nadmierny-sprawa: twek
gąbka: hjen
irytujący: djon
wiewiórka: slip
szlifować: zyin
irrealis-humor: flim
wulkan: glam
wewnątrz: gron
wykorzystać: kloc
geologiczny: jlik
paszport: psop
niemoralny: mlet
Herbatnik: hbuk
współpraca: kros
tablet: tlot
relaks: kces
atom: trom
AIDS: hzip
piramida: psim
cykl: swok
drzemka: hnup
bezprawny: hjaf
łapa: pfap
nieśmiałość: crom
zaćmienie: klip
lutnia: lwap
miotła: srum
płyta: mwen
astronomia: tcom
labirynt: blen
stypendium: bwit
żółw: kfuc
doradca: dwak
włókno: fwic
krykiet: jrik
gołąb: ksom
dostosowanie: dyon
trójkąt: tfon
skarbnik: tsen
wodór: jron
kruchy: hfuk
drukarka: pyet
dławić-się: tcof
chroniczny: gzon
sprostać: slaf
dylemat: dlim
inżynieria: jyin
aparat-fotograficzny: hkef
przepraszać: pluc
lizać: lwet
tancerz: dret
emigracja: mres
tenis: tces
kręgosłup: clip
smażyć: zrac
warsztat-tkacki: tfuc
zasztyletować: twuc
Hasło: psaf
półkula: praf
strategia: zrit
kwarc: krus
nożyczki: jris
patrol: proc
lodowiec: lwic
wpół: dwam
memorandum: mwap
stożek: kwuc
symetria: hzut
producent: zrak
pozwany: fwik
meczet: djis
szachy: cres
myto: htof
wiśnia: tref
rozpowszechniony: kfen
potknąć-się: tfok
ciężarówka: ryok
musztarda: mros
procent: pfet
Aukcja: jlam
sito: srif
niepewny: swoc
magnes: gjat
ssać: syus
islam: slum
chodzić-na-palcach: twip
membrana: mlen
golić-się: clet
gitara: gjit
błyszczący: bzan
wiąz: hyem
szybować: kcom
zaimek-znacznik: ryec
zszywka: pcus
przyprawa: zlat
kaucja: jlas
nośnik: zyac
wibracja: bron
droczyć-się: trus
pług: hlom
fizjologiczny: zlik
rynna: hgok
kometa: cyet
średniowieczny: dyic
wróbel: grec
kompensować: twet
Plastikowy: psuk
notatka: cyot
orbita: rwot
oszczędny: twum
golf: hgof
zero: zrun
żeton: tcep
uciskać: prok
ziewać: gjac
nierówność: gwas
kret: tloc
garncarstwo: frik
gospodyni-domowa: hgif
żyto: rwem
być-nieposłusznym: hyes
tolerancyjny: glon
zarodek: brec
górnik: jren
bić-brawo: zlac
drożdże: lyim
premia: pfim
śliwka: plem
bankructwo: byas
nawadnianie: rwif
mennica: nyun
kapitalista: glis
elastyczność: hlef
rekin: gyak
rekrut: drut
przechowywanie: zren
realizm: cles
imbir: djic
ambulans: blus
porównywalny: kwip
portfel: bjap
grymas: glim
naukowiec: gyis
jelito: grot
spokój-umysłu: hwum
radio: href
nieistotny: zlit
fasola: bwam
nieformalny: frim
wnuczka: gyut
niezgoda: dloc
stek: tfek
azot: zron
brzytwa: hjut
kontrastujące: krom
propaganda: pcoc
fajerwerki: fris
muzyka-pop: pcop
rozbierać-się: crop
bruzda: cruc
szkodliwy: hzaf
judaizm: hjum
uzupełnienie: pluk
obiektyw: lyes
pegative-sprawa: pwek
nowotwór: kfes
pionek: pyek
wykładowca: zyat
nieszczelność: hzuk
zakwalifikować: krif
gęstość: djot
indukcja: dyis
żuć: htuf
gadatliwy: bzit
Homar: hgos
obniżka-cen: dyut
Taxi: tsuk
hierarchia: crem
jadeit: gyec
warczenie: glaf
jaszczurka: lyis
wodospad: crof
niezadowalający: djak
weto: frot
przewodnictwo: ryip
kupujący: mrif
galon: jlen
komar: mruk
odchylenie: dwen
zmagać-się: lyut
mozaika: myok
wtyczka: plok
kucać: pcuk
sklep-spożywczy: ksoc
komunistyczny: myos
zadziwiać: mwek
prosecutive-sprawa: rwuk
konstelacja: nlos
dyktator: dwit
zaabsorbowanie: tyet
satelita: tlec
pantofel: hlop
spółgłoska: fyon
przybliżony: tsif
bezrobotny: byet
kibic: sros
lotos: lwot
sałata: sles
chlorek: lwok
bakteria: bwic
lepki: pcek
składnik: bwon
jądro: klec
udać: bjak
bajt: bzet
wydzielanie: sruf
wyraźnie: pres
zbiec-się: mloc
balet: blet
mocz: mrus
czosnek: lyun
Kapitalna: hguc
ekonomika: kcem
klasa-średnia: hdom
zwinny: gjic
szczypce: htef
pralnia: lyoc
truskawka: srem
miejski: pcos
zawstydzić: mlaf
notatnik: tfut
album: zlam
baseball: hbep
wąchać: sluc
bufet: hbuf
imiesłów: rwip
garaż: grek
diagnoza: djas
krocze: ksuc
wymusić: srom
rejestracja: psuc
rozpuszczalny: jlun
fosfor: psof
strukturalny: rwut
klej: glum
Praca-dyplomowa: twes
rzemieślnik: clif
banan: bwas
aksjomat: kyom
żebro: psos
nikiel: nyek
liczba-pi: pyim
autobus: bwos
cenzor: swes
pocisk: mlus
kiełbasa: slos
manipulacja: nlut
pomidor: tfet
wzmacniać: kfut
gniazdo-elektryczne: syok
potas: tsom
odzyskać: prup
wirtualny: zwit
algebra: gjas
dentysta: dzit
optyczny: pcok
drgnąć: bzen
biologia: bwim
bezrobocie: byim
gąsienica: krum
solo: slof
przeglądarka: bjac
zdalny-przeszłość-czas: nyot
historyczny-czas: crep
jądrowy: nluk
widmo: pyem
sód: syom
histeria: syes
powiernik: tyos
zakładnik: byik
gurda: gluk
marszczyć: kwuk
przezroczystość: tfif
kolec: swip
priorytet: pcif
pieszy: dyen
ateizm: tsem
monitor: mwot
okręg-wyborczy: nlec
niekontrolowane: hkof
sonda: grok
platyna: plip
podwójny-numer: dlun
płuco: pcep
Wspaniały: syup
wózek-sklepowy: trop
lokalnie: lyot
nawoływać: gzat
benzyna: plif
nerka: grif
łup: bzac
ocenianie: dlen
arsen: syek
ślimak: nrok
konik-polny: tsec
równanie: fwen
socjalista: swos
filtr: flot
sensoryczny-dowodowy-humor: hxin
poszerzać: kyot
emitować: mwet
smycz: pwet
mandarynka: drun
jockey: hjok
zapalenie-płuc: hnof
solidarność: gret
zawias: cyif
wzdłużny: nruc
dywidenda: dwun
łyżwa: hkep
wykładnik-potęgowy: slop
inwalidztwo: dlif
obsesja: bwen
przydział: pfun
fotograf: trof
delta: dlet
cyfrowy: djim
suka: brut
powieka: hyop
przekątna: dyun
podświadomy: byon
brew: bruc
kichać: pcec
wesoły: dlis
hinduizm: nwum
uchodźca: nyif
czółenko: cwot
białko: pwot
wysypisko: hdop
oczyścić: flen
wymiotować: hwom
gen: gyen
student-pierwszego-roku: hdem
socjologia: syoc
zdusić: kwoc
rybak: hfuc
regionalny: jyen
ruch-pod-górkę: hvok
z-mocą-wsteczną: hxik
tornado: gyon
odwrócenie: nwos
telewizja: twif
sześcian: kfet
wydajność: pwuk
marchew: krop
molekularny: mwuk
konglomerat: glet
księgowa: ksum
ogórek: kyok
orgia: drok
rozpuszczalnik: jlet
fosforan: psef
elementarz: gwik
alkaliczny: flis
gimnastyka: jyas
przecinek: kwom
ruch-spadek: hvat
poronienie: jwac
strąk: tcop
dawca: dzon
mangan: hzem
psycholog: syos
chlor: clos
klawiatura: kyoc
elita: zyit
nawias: pfaf
rugby: rwoc
wrzód: jlon
fleksyjny: hxit
skubać: nres
kwant: fwam
sweter: swek
ewolucyjny: fwis
notacja: nyoc
odbić-się: tcuf
sekcja: drec
Pamięć-podręczna: kcep
liniowy: lyec
antymon: trum
superessive-sprawa: psek
guz: twom
erozja: cyos
alfa: flaf
pępek: nwip
odporny: myip
grypa: flun
browar: bjit
upraszczać: slef
ograniczać: bram
wygięcie: djen
urzec: dwim
przymusić: brok
skarpetka: bzas
film: fyim
kosmos: klom
zanieczyszczać: hpuf
towarzyski: gjen
penis: zyis
leśnictwo: lyif
aluminium: lwum
oscylacja: zlon
horoskop: ksop
wyrzucać: dlek
włączenie: nluc
beneficjant: byic
delfin: dlip
zabójca: cyus
ssak: myaf
wskaźnik: swif
dwutlenek: dwis
dwukropek: zlen
biurokracja: brus
zniekształcać: jric
lodówka: frip
archeologiczny: cluk
gorszący: kwok
specyfikacja: pfis
ulotka: pfut
antropologia: nlom
pyszne: kyec
przechodni: txit
czołgać-się: kwus
słonecznik: hzuc
wesz: glus
jon: lyos
turystyka: tyum
modem: myom
przyśpieszenie: jrun
fałszować: tsoc
emisja: hmef
porwać-kogoś: drap
zakładka: hwep
fryzjer: pfes
folklor: floc
kapilarny: plek
nacjonalizm: nlum
zad: nros
motyw: hmuf
sublimować: slem
udaremnienie: xras
kobalt: kwos
owies: gwam
ruch-upriver: trup
odbyt: gyam
wołowy: bwun
trzepnięcie: flip
nadmierność: dzun
wideo: hwop
bojkot: bjik
kartkówka: cwif
hokej: cwok
partyzant: grip
magnez: hgem
radar: drek
szympans: hzif
niezawodność: kwif
prostokąt: tyec
wodorosty-morskie: klep
generalizować: jlak
cisza-nocna: kfec
homoseksualista: mlok
scenariusz: srop
sformułowanie: flus
reinkarnacja: nrom
zapalać: zlak
uran: ryum
łapacz: kwes
koordynować: kyop
podatnik: nwaf
zintegrowany: trep
zawyrokował: hzap
gamma: hxam
safari: fwim
ruch-downriver: ht6n
współczynnik: kfus
nagłówek: zlic
analityk: nles
Szach-mat: hzes
centrum-handlowe: hmof
bizmut: bzim
Pocztówka: psok
konwergencja: bros
błądzić: djet
akcjonariusz: ksem
mikrob: mrip
płciowy: jwit
morfologiczne: mluk
beta: byot
dżinsy: gjis
Baza-danych: tles
kalkulator: klus
rentgenowski: ksef
analizować: zram
środowiskowy: zyen
sigma: zyim
dysjunkcja: hxon
program: gres
wiza: bzis
infrastruktura: nyuk
robaczek-świętojański: gyun
detektor: tyek
adaptacyjny: dyip
biolog: byis
splatać: pyec
brom: brom
paladium: plum
czkawka: kfok
pastel: psec
ogród-zoologiczny: zwac
klinika: lyok
konotacja: nwoc
joga: hjoc
księgarnia: byun
terapia: grap
nacjonalista: zlis
ściąć-głowę: zlet
tak: swec
problematyczny: byam
jazz: dzas
wolfram: tsof
terrorysta: gwis
dryblować: droc
metabolizm: tlem
alimenty: lyaf
weekend: hfom
chryzantema: gzim
szczepionka: byap
motocykl: tyok
mantra: dyot
semestr: myes
heroina: gwon
teczka: flap
katoda: kfoc
ideologia: dlec
parking: prek
theta: fret
rozczarowanie: hxis
selen: clem
jazda-rowerem: blek
kora: pros
równorzędność: swaf
obecny-Znaczenie,-związek z tematem znacznik: hxak
Lotnisko: cwoc
odciąć: gyet
Koszykówka: bwet
oszust: mwip
karaluch: tlek
chrom: hgom
litr: hl6t
niemniej-jednak: nwec
hormon: cwom
wadliwa: tluc
przedziurawić: prec
animizm: nyom
wielokąt: cloc
feminista: hfes
sprzężony: kcop
euro: dros
żeń-szeń: hjes
algorytm: hlof
laser: lwes
apteka: dlot
milimetr: mlem
zgiąć: flek
anoda: nlok
niuans: hzus
w-niepełnym-wymiarze godzin: prem
wrażliwość: nyec
demonstrator: drom
hel: clum
dwujęzyczny: dzic
akronim: hqim
initialism: nl6m
rzeczownik-odsłowny: gros
osocze: psem
chromosom: rwom
porządkowy: rwok
kilometr: klum
faks: tfes
genetyka: nwek
pieg: frek
śrubokręt: dres
brokuł: blok
Preterite: xrit
witamina: tyem
kadm: kyem
bombowiec: bwoc
graficzny: gjik
tytan: dyim
popisywać-się: clec
lambda: lwem
przyjaciółka: pcem
spółkować: kyuk
klepsydra: tlus
empatia: mlif
bor: bres
śmigłowiec: cwet
tellur: tlum
ostateczny-termin: jyic
wyrównać: gwic
centymetr: hfem
molibdenu: mlom
lit: tfim
multimedialny: myum
aktualizacja: dyet
kaloria: clom
robot: ryoc
Praca-domowa: groc
logarytm: grom
modliszka: gzas
zainstalować: nwut
amino: myoc
glifów: glif
aoryst: pyos
ekologia: plec
sophisticate: flok
marihuana: bjam
mikro: mrom
kilogram: lwom
przejadać-się: jrot
możliwy-do-przewidzenia: dzik
pizza: zyas
podsłuchiwać: zris
językoznawstwo: bwis
ostrzyżenie: braf
iryd: ryom
rasizm: gwim
optymalny: gyim
uprzemysłowienie: drif
centrala: krup
cer: zrim
przystający,-zgodny: nrum
cząstkowy-sprawa: pxik
kaseta: ksep
siła-woli: blot
wymiarowy: dzen
parametr: rwet
synchronizować: nrop
wyolbrzymiać: dzim
seminarium: mwec
dyskoteka: dyok
neon: nyok
osm: hzom
Święto-Trzech-Króli: hp6n
popełnić-plagiat: lyap
artefakt: rwek
reaktor: fyet
oregano: ryop
pluton: pwum
itr: tyom
augmentatywny: hxat
nazwa-użytkownika: mrum
podyplomowy: zrot
prawica: dwaf
argon: jros
fobia: hxot
uspołecznić: sluk
globalizacja: bluc
długość-fali: hnef
kodować: kfom
recykling: psoc
restart: nrek
zapalenie-wątroby: pyes
torus: fros
chemoterapia: myep
modulo: mwok
proton: zwot
dyskietka: dwet
miligram: mlum
piksel: psep
tantal: twem
substancji-rozpuszczonej: hjot
ludobójstwo: nyos
drapieżnik: rwes
gal: glem
cyrkon: hzum
determinantem: txin
nieliniowy: nlem
pestycyd: pyif
beryl: brem
neuron: nrus
predykatywny: pxit
slipy: tlif
silnia: kref
neutron: zrut
niob: nwom
german: hjem
metaloid: tlop
położyć-na: dlap
prolative-sprawa: hl6k
bioróżnorodność: jwic
drążek-sterowy: jyok
antybiotyk: twok
aktyn: gjim
astronauta: srof
pozaziemski: tyes
głupek: hwup
maraton: mrof
iterb: zwim
autyzm: tyif
zjonizować: nlof
radon: cwos
Nerium: nrem
epidemiologia: pwip
podeszły-wiek: lyuc
kemping: kyep
pasiasty: drip
ind: nyum
veridical: hvik
Strona-www: bwes
Koran: kwek
sztućce: fwet
nth--korzeniowy: tfec
lorens: lyem
prawa-obywatelskie: glip
telefon-komórkowy: mlof
sparaliżowany: twoc
protaktyn: prum
promieniowanie: hd6n
zależeć-na: pxin
tor-atom: hxim
niebiesko--Jean: bjun
roślina-domowa: hxas
indywidualnie: dvit
Przepływ-prądu: lwuk
triple--punkt: ht6t
Ludzkie-ciało: hn6n
fizyka: bzik
sprzedaż-sklep: hxan
cez: hs6m
długi-temu: hqan
arkusz: hxet
Jednostka--of--mas: hn6m
skompilować: ml6n
Wartość-binarna: vrim
człowiek-istota: nyus
przez-znaczy-z: hvan
depan-dari: pxat
prazeodym: pyom
karton: kxat
skończone-czasownik: hqik
próba-numer: hr6n
zawodowiec-zdanie: hr6t
krytyk: hk6k
Opakowania: pxas
nietrwałość: pxan
w-większość: txas
deskryptor: drop
neodym: nyem
przyjaźń: hvit
czytać-tylko: xyak
zakłada: xwan
gnomiczny-humor: kxin
fonem: hxom
racjonalność: xlit
fonologiczny: xlin
jadalnia-pokój: hxac
życie-pokój: hxic
centryczny-sprawa: zrik
pre-hodiernal: hx6n
cierpliwy-sprawa: hqak
ukośny-sprawa: bwok
wiejski-powierzchnia: hqat
-recurse: hr6s
środkowy-głos: dyos
Meitner: hm6m
poczty-przewoźnika: hvak
wymijający: kxit
Zbiory-rynek: xrak
zidentyfikowania: hxap
cel-cyngiel: krof
sekundę: hxen
lative-sprawa: dvak
racjonować: hr6c
nie-człowiek: hg6n
życie-rzecz: hvic
także-mało: hxut
film---teatr: hvin
has: xyim
odfermentowujące: ty6t
multal-numer: ml6m
mleczny-droga: txam
neptun: nwem
Autor-widmo: txik
trans-liczbowy: ts6s
wygłupiać-się: hqun
ameryk: myem
ranek-chwała: txan
strażak: xran
Berkelium: blem
galaktyka-płeć: kxan
nobel: blum
do-widzenia: hvac
buddyzm: hfum
ferm: frem
cyan: xyan
soja: syof
dystrybutor: qrit
łamistrajk: txak
edytor: ples
abessive-sprawa: bvak
adessive-sprawa: dvik
do-sprawa: kxak
agentive-sprawa: dvek
rutherfordium: hr6m
przeciwciało: txip
tak-jak-dużo tak jak: hjos
agent-cyngiel: hg6t
aktor-rola: xram
etydyny: txim
wspólny-płeć: hk6n
accompanier: kl6n
szafranowy: kxam
francium: fyam
erb: ry6m
pasywny-głos: xyis
astat: hqit
żucie-guma: hqam
gwiazda-płeć: hqin
cytat-formularz: ht6m
kiur: jrim
komiks: kxis
ślepy-na-kolory: hqon
euler's-numer: hl6m
wygląd-w: kxas
Przejściu: pwok
pole-bitwy: txat
kierowca: vrit
zwarcie: txok
werbalny-rzeczownik: hvis
płakać-na-zewnątrz: hk6t
statystycznie: xyit
jogurt: txot
ksenon: hs6n
zahipnotyzować: hxif
brać-poza: hxaf
Klauzula-ogon: hxok
bezpośredni-obiekt: dwot
sklep-spożywczy-sklep: kxun
składać-się-z: hm6t
ergative-sprawa: gvik
w---języka: txic
z-pierwszej-ręki: pxam
miejscownik-sprawa: hqok
basen: slup
przysłówkowy-sprawa: vlak
zwiedzać: hqas
telewizja-nastawić: ht6s
finał-cząstka: xlik
evitative-sprawa: hvek
rehabilitacja: xlat
regresja: xris
blok-z-mieszkania: kxot
budzić-w-górę: hxup
policja-oficer: ps6s
przysięgam-w: vran
przeprowadzający-wywiad: qrat
ren: ryem
aerosol: xres
zaborczy-sprawa: kxik
nominalization: mlec
opętany-sprawa: dzak
przeciążenie: pxak
pomocniczy-czasownik: xyik
Podstawowa-obiekt: mlut
wirus-komputerowy: prus
biznesmen: hqis
za-ludzie: hqen
antessive-sprawa: ts6k
Premier: pxis
lutet: lyum
europ: rwum
emote: xrot
muzyka-ludowa: zyik
poeta: vwit
Poczta: pxot
podobno: hvas
animować-płeć: hven
subessive-sprawa: bvik
pedał-gazu: glep
biegunowość: pr6t
pojazd-płeć: vlin
minerał-płeć: xrin
czasownik---przyrostek: hvif
namiętny: pc6n
samar: sr6m
moderator: hs6t
urojone--unit: xyin
prędkość-światła: kxac
siły-Powietrzne: hxes
empatyczny-radość: pfec
punkt-krytyczny: qyit
pełny-etat: hxem
hafn: xyam
zahamowanie: hn6s
zmiana-z-zdarzenie: qrin
holmium: xlim
różne-zdarzenie: hf6t
wszechświat-płeć: hvip
miejscowość-płeć: kxen
wirtualny-maszyna: hvim
Badania-płeć: txen
artystyczny-płeć: ts6n
crastinal-czas: sl6t
abstrakcyjny-płeć: srep
exocentric-sprawa: zrek
przechodni-czasownik: txif
morfem: tfom
szowinista: dvis
przeszłość-perfektywny: xrat
zawodowy: hy6n
pośredni-przemówienie: tyoc
Sekunda-język: draf
do-być: txis
cmentarz-zmiana: vrak
kolektyw-rzeczownik: hxos
absolutive-sprawa: bvuk
cierpliwy-cyngiel: tr6t
samego-siebie-pewność siebie: hs6s
kał: hzos
zwrotny-głos: hf6s
bezosobowy-czasownik: hxek
seaborg: br6m
spacje: hxep
modalny-sprawa: dlok
nieożywiony-płeć: hj6n
przyczynowy: qran
propositive-humor: psom
elektryczny-aktualny: tr6n
asocjacyjny-sprawa: nwok
superlatyw-sprawa: tluk
także-dużo: xyut
planetarny-płeć: pxen
ożywiony-rysunek: nwuk
odwrotność-głos: vrik
wprowadzać-ustawodawstwo: hqaf
w-najmniej: vlas
gramatyczno--case: qrak
użytkownik: pxut
rdzeń-benefactive: kfef
bramkarz: hgop
:-except-for: kcef
mianownik: dvan
else--if: lyek
bokiem: hx6s
wzajemnie: dles
kolejny-klauzula: lyuk
ścieranie-się: hxun
spodenki: ht6k
dysproz: prom
wkrótce-przyszłość-czas: rwec
si-jednostki: vyin
krypton: kxon
mendelew: dlem
aplikacyjnych-głos: hp6s
antipassive-głos: tsef
continuative-aspekt: ht6p
promieniowanie-chorobowe: hr6k
necessitative-humor: hn6t
pojedynczy-czynność-czasownik: hqek
torpeda: xlak
superlatyw-stopień: tlup
egzystencjalny-klauzula: hs6k
kaliforn: kf6n
obecny-imiesłów: vrat
świetlny-intensywność: hc6t
singulative-numer: slus
gramatyczno---obiektu: hy6t
pasywny-imiesłów: vris
nadmierny-trwanie: kxic
płynu-w-stanie nadkrytycznym: sr6t
ilość-z-substancja: ks6t
postpositional-sprawa: pxok
obieralny-kwantyfikator: lwif
gadolin: dl6n
epentetyczny-morfem: hp6m
przeczący-kwantyfikator: nwif
einstein: ny6n
sztuczny-język: txac
łączący-cząstka: qrik
zdalny-przyszłość-czas: twec
częstotliwy-aspekt: hfep
dystrybucyjny-zaimek: bvin
przemówienie-umowa: hk6m
łysy: blos
przedmieście: syum
uniwersalny-kwantyfikator: vlit
komputer-programowanie: mr6m
telewizja-program: tr6m
zmiennoprzecinkową-numer: hvun
egzystencjalny-kwantyfikator: tl6t
dzień-po-jutro: dwek
alternatywny-kwantyfikator: lw6t
gderliwy: hdup
przeszłość-pasywny-imiesłów: hp6t
dzień-przed-wczoraj: txet
miejscownik-kierunkowy-sprawa: tc6k
alternatywę-warunkowy: ht6c
