PA: do-widzenia, Halo, liczba-pi, pożegnanie
: 
z: między, o, jego
do: chodź, musi
w: 
:-first-person: 
ja: mnie
:-third-person: 
że: ono, który
jego: jego, własny
on: ono
z: 
dla: o, w-kierunku
jak: który, instancja, jak
:-second-person: 
być: 
jej: jego
na: połączenie, o
w: koń
przez: przechodzić, i, o
mają: Niedźwiedź
lub: ani
od: 
to: ono
jego: jego
ona: oni, ono
mój: kopalnia, mnie
ich: jego, oni
więc: a-zatem, już-wkrótce
na: 
im: oni, ty
my: nas, mnie
kto: ktokolwiek, który
by: myśleć, przynieść
będzie: siła-woli
Nie: nie
gdyby: czy, opatrzony
w-górę: nad, powstanie, na-zewnątrz, gorzej
w: jeden
jakikolwiek: mianowicie, który, wszyscy, każdego
Twój: Twój
co: ani, który, rzecz
orientacyjny-humor: dyrektywa-humor
człowiek: osoba, mąż, męski
niż: jeszcze, o, jak
nasz: wiosna, nas
trochę: nieco
na: po, nad, na-zewnątrz
maj: w-stanie
ale-już: obecny
lubie: jak, miłość, trzymać
mogą: w-stanie, móc, pudełko
powinien: musi
zrobił: robić, fakt
taki: a-zatem
za: jeden
te: oni, ono
koniec: nad, jeszcze
dużo: bardzo, Tom
Pan: Pan, opanować
dobry: Pięknie, wielki, dobry
większość: jeszcze, w-dużej-mierze, większość, bardzo
powinien: musi
te: oni, jego
samego-siebie: własny, podobnie, sami
życie: relacja-na-żywo, życie, samogłoska, talia
bez: 
robić: robić, Stwórz
dobrze: wygodna, dobrze
rozprawiać-znacznik: 
przez: przechodzić, przenikać
moc: moc, może, móc
zbyt: bardzo, parzyste
jeszcze-raz: następnie, plecy, pewnego-razu
wiele: większość
każdego: każdego, który
ludzie: osoba, społeczność, za-ludzie
myśl: ideologia, pomysł, myśleć
pod: na-dół
jeszcze: jeszcze
miejsce: miejsce, pozycja, gdzie
podczas: natomiast, czas, chwilowy
tylko: tylko, proste
również: parzyste, również, jeszcze
jeszcze: ale, ani, niemniej-jednak, jeszcze
przeciwko: w-kierunku, przed
dostać: poznać-się, brać, czerpać
kiedykolwiek: wieczny, nigdy, zawsze
poza: zamknąć, z-dala, na-zewnątrz, pokryty
twarz: powierzchnia, sto, osoba
inne: trwać, inne
lewo: z-dala
Nowy: neo, powieść, świeży, dziewięć, młody
Pani: 
położyć: zestaw, trwać, dać
powiedzieć: powiedzieć
umysł: intelektualny, myśleć
kilka: para, mało
kogo: który, ktokolwiek
daleko: z-dala, zdalny, bardzo
nazywa: myśleć
cały: pełny, wszyscy
obie: dwa
odnaleźć: uznany, Wyszukaj
Popatrz: widzieć, czek, spojrzenie
dać: autobus, emitować, dać, umożliwiać
lord: opanować, Pan, król
Dom: dom
coś: nic, nieco
moment: czas
ojciec: tata
wśród: między
kobiety: Płeć-żeńska
mama: mama
koniec: gotowe, trwać, późno
mały: mało, mikro
ty: ty
chcieć: musi
jednak: ale, niemniej-jednak, chociaż
całkiem: całkowicie, nieco, bardzo, wystarczy
którego: który
najlepiej: lepiej
siebie: mnie, sami
aż-do: parzyste, przed, do-widzenia
od: następnie, pierwszy, bo
używany: stary, recykling
raczej: w-zamian, nieco, jeszcze
mniej: krótki, na-dół, najmniej
w-ciągu: wewnętrzny, głęboki, wewnątrz
razem: zestaw
duże: wielki, masywny
materia: rzecz, Przedmiot, pytanie
pewien: zdecydowany, dobrze
się: sami
pół: wpół, szlifować, bok
prawdziwe: naprawdę, fakt, dobrze
byle-co: cokolwiek, nieco, nic
trzymać: trzymać, zestaw, zachować
żona: Płeć-żeńska
znaczy: droga
Blisko: przechodzić, prawie
stan: stan, wchodzić, kraj, rząd
sam: samotny, solo, jeden
walizka: spadek, instancja, garnitur, incydent, bo
ciebie: ty
wysoki: nad, piętro
dziewczyna: córka, Płeć-żeńska, przyjaciółka
pewnie: gwarantować, dobrze, naprawdę
w-rzeczy-samej: naprawdę, fakt
się: sami, własny, czy
wzdłuż: związane, długi, długość
wylądować: kraj
powrót: regresja, plecy, zwrot
opuszczać: wyjazd, wakacje, opuszczony, z-dala, pozwolenie
bądź: parzyste
prawo: dobrze, prawny, reguła
świecki: zestaw, świecki, Pomoc
punkt: miejsce, akcja, tylko, ustęp
dziecko: dzieci
chcieć: nadzieja, pragnienie
mówić: powiedzieć, gadanie
podczas: czas, natomiast
kilka: tuzin, para, jeszcze
biznes: handel, robić-zakupy, firma, praca, handlowy, ruch
sposób: droga, podejście
sekunda: inne
generał: pospolity, ogólnie, publiczny
za: plecy
stają-się: chodź
martwy: umierać, śmierć
Ziemia: kraj
chłopak: syn
czuć: uczucie, słyszeć
duch: dusza
prawda: fakt
ziemia: piętro, kraj, miejsce
naprawdę: naprawdę, bardzo, fakt
odpoczynek: inne, komfort, iść-na-emeryturę, szczątki, wakacje
inny: różnorodny, różnica, inne
możliwy: może
człowiek: osoba, ludzkość
miasto: miasto
następujący: Dalej, kierować-się, po
potrzeba: konieczny, musi
przyczyna: powód, spowodować, bo
wieczór: noc, popołudnie
pięciu: piąty, rok
silny: moc, w-stanie, gwałtowny
dama: Płeć-żeńska
na-około: otaczający, prawie, o, oko
kolej: bok, zestaw, zamówienie
poczucie: oznaczać, uczucie, konotacja
blisko: zamknąć, prawie
postać: cecha-charakterystyczna, osobowość, ocena-w-szkole, Natura
sortować: klasyfikacja, dobry
widok: wizja, Naprzód, scena, widzieć, spojrzenie
przyjęcie: uczta, przecinek, kraj
w-porządku: wielki, chudy
gotowe: przygotować, już, chodzić-na-palcach, gotowe
konto: powód, rachunek, obliczenie, liczyć
pisemny: pisać
wiek: stary, wiek
jeszcze: inne, trwać, gdzie-indziej, jeszcze
siła: moc, przymusić, nakładać
przez: nad, naprzeciwko
wcześnie: przedwczesny, początek, prymitywny, już-wkrótce
słońce: 
później: przyszłość, następnie, po, Dalej
wszystko: wszyscy
po: Kapitalna, z-mocą-wsteczną, trwać, po
akt: rachunek, czasownik, akcja, praca, ruch
dalej: Naprzód, jeszcze, dodatkowy
poza: jeszcze, na-zewnątrz
ani: ani, który
widok: zawyrokował, spojrzenie, widzieć, wizja, scena, kalendarz
dźwięk: głos
Żaden: nic, nikiel
jasny: Otwarte, oczywisty, uderzający, jasny
droga: Autostrada, droga
real: wirtualny, fakt, królewski
prawie: prawie, o
znajomość: Informacja
bliski: w-kierunku
zły: gorzej, zło, ubogi
życie: relacja-na-żywo, talia, życie
pokój: pokój
niski: krótki, tani, poronienie
północ: odpowiadać, północny, północ
naturalny: Natura
piękna: Pięknie, bardzo, wystarczy
sprawiedliwe: dobrze, raport, dziesięć
usługa: obsługiwać, opieka
poniżej: na-dół
przyjemność: szczęśliwy
historia: fabuła, data, historyczny
Uwaga: pamiętać, notacja
mimo-że: chociaż
z-przodu: naprzeciwko, Naprzód, przed
duża: wielki, masywny
na-pewno: rygorystycznie, kurs, naprawdę
wiatr: powietrze, poddasze
otrzymać: paragon, brać, czerpać
Uwaga: opieka, priorytet, skupiać, wzgląd, nacisk
wytrzymałość: moc
prawdopodobnie: może
cieszę: szczęśliwy, wesoły, zadowolona
ważny: konieczny, wynikający
siebie: własny, sami
facet: kolega, przyjaciel
opinia: zawyrokował, pomysł
wiara: uwierzyć, lojalność
temu: Wschód, następnie, przed, Naprzód, plecy
opłata: myto, koszt, brać
ramię: dłoń, ubogi, rękaw, ramiona, ramię
drugi: trwać
obiekt: cel, nic, Przedmiot
pan: męski, Pan, opanować
szczególny: zwłaszcza, mianowicie
ledwie: nie, prawie, rzadki
szef: menedżer, głowa
szansa: zbieg-okoliczności, pozycja, okazja, prawdopodobieństwo
transakcja: plan, robić-zakupy, umowa
myślący: myśleć
ciężki: powtórzenie, waga, na-poważnie, trudny
Równina: Otwarte, proste, wydrążony
natychmiast: pewnego-razu, już-wkrótce
usta: osoba
przestraszony: przestraszony, strach, niespokojny
pojedynczy: jeden, samotny
radość: szczęśliwy, podniecenie
złamany: siarka, ciąć
chyba-że: oprócz
mieć-przy-sobie: Niedźwiedź, mieć-na-sobie, przynieść, umożliwiać
wpływ: efekt, grypa
pojawić-się: wyłaniać-się, wydać-się
na-dworze: na-zewnątrz, oprócz
proszę: uprzejmie, pytać-się
wygląd: wyłaniać-się, wydać-się
powoli: stopniowo, późno
okres: faza, czas
siostra: brat
bitwa: bić-się, wojna
były: stary
młodość: młody
jedynie: tylko, proste, samotny
dosięgnąć: podejście, osiągać, chodź
system: zamówienie, hierarchia, organizacja
obiad: noc, lunch
potem: przyszłość, po
chodzić-pieszo: stąpać, iść, piętro, stopa
cud: cud, dziwne, zaskoczony
zwykły: ogólnie, pospolity, zawsze
postać: cyfrowy, Statystyka, kształcie, numer, myto, obraz
starożytny: stary, staromodny
poszanowanie: wzgląd, honor, niebezpieczeństwo, w-kierunku
trzeci: trzy, wtorek
pozostawać: pobyt
społeczeństwo: społeczny, społeczność, firma
wynik: wniosek, efekt
rozkaz: zamówienie
sam: tylko, proste
obok: przechodzić, Dalej, oprócz
cichy: cicho
doskonały: właściwy, wielki
ulica: droga
pisanie: pisać, list
drewno: drewniany, drzewo, kij
szybko: już-wkrótce
ogłoszenie: widzieć, ogłoszenie, ostrzeżenie
jasny: ostry, jasny, błyszczący, uderzający
łódź: statek, pływak, jacht
szlachetny: wielki, wspaniały
nagły: nagle
wartość: wartość, ranga, znaczenie
z-powodu: bo
czytanie: czytać, pytanie
godzić-się: umowa
czekać: oczekiwać, trzymać, pobyt
kawałek: żeton, część, rozciągać
dawny: stary
rozmowa: gadanie, dialog
okazja: okazja, pozycja
koszt: koszt, zapłacić
znaczny: wielki, wynikający, uderzający
siedzieć: pobyt
Góra: optymalny, grzbiet, nad, szczyt
małżeństwo: żonaty
krok: akcja, stąpać, faza
rozpocząć: początek
za: każdego, w-kierunku
indywidualny: osoba, indywidualnie, atom
trudny: trudny
kawałek: część, mało, wesz, kąsek
przemówienie: gadanie
władza: jurysdykcja, moc
szczęście: szczęśliwy
zapewniać: opatrzony, dać, gwarantować
badanie: uczyć-się, analiza, studio
osobisty: prywatny, indywidualnie, personel
oglądać: czek, monitor, widzieć
zadowolony: zadowolona, szczęśliwy
gorąco: ciepło, ogień
wysiłek: próba, odcedzić
przygotowany: przygotować, już
próba: próba, kartkówka, zasztyletować
szybki: już-wkrótce, zwinny
pod: na-dół, po
zamierzony: zamierzać, skupiać, cel
proste: bezpośrednio, proste
prawdopodobne: z-łatwością, prawdopodobieństwo, może, podobno
sprawiedliwość: dobrze
po-prostu: tylko, proste
zaufanie: uwierzyć, lojalność
przejście: część, przejście, kolumna, przechodzić, rozciągać
Zamknięte: zamknąć, warsztat-tkacki, pokryty
my-sami: sami
przechodzący: przechodzić, Kapitalna, przejście
średni: wtórny, oznaczać
posiadanie: nieruchomość
przyjemne: wygodna, dobry
doskonale: całkowicie, naprawdę
zazwyczaj: pospolity, ogólnie, zmierzać
grób: trudny
stały: naprawić, chociaż, standard, stały
wojsko: armia
spotkanie: sesja, montaż, poznać-się
obóz: kemping, pole
naród: kraj, krajowy
istnienie: obecność
odpowiadać: odpowiadać, zwrot
niebo: atmosfera, niebo
równać-się: podobnie, stopień
fortuna: los, stan, nieruchomość
domena: pole
sytuacja: pozycja, stan
środek: oznaczać, wpół, talia
zimowy: zimno
dopuszczać: pozwolenie, umożliwiać
blady: żółty, kolor, słaby, pastel, Otwarte, jasny
bieganie: wyścig, bieg
religijny: religia, chemoterapia
prowadzić: spowodować, przynieść
poruszać-się: stąpać, sprzeczka, drgnąć, ruch, akcja
Zatrzymaj-się: złamać, stoisko
mówiony: powiedzieć, słowny, gadanie
deska: powstanie, płyta, Rada, krawędź, komisja
próżny: darmowy, pusty
utrata: niekorzyść, zagubiony, nieszczelność
oferta: opatrzony, zaproponować, dać, wystawa, obsługiwać, przywilej
klasa: dobry, orbita, ranga
kompletny: pełny
dostęp: odwiedzić, podejście, nabycie
pasja: entuzjazm, uczucie
fizyczny: fizyka, ciało
przykład: instancja
początek: początek
złość: gniew
poważny: wielki, na-poważnie, skrajny
srebrny: pieniądze, piątek
wystarczający: wystarczy
Główny: głowa, opanować, klawisz, oryginalny, zszywka
wspaniale: dziwne, gwałtowny, wielki
ścieżka: droga
znaczenie: konotacja, oznaczać, znaczenie, Przedmiot
dopasowanie: garnitur, właściwy
los: masa, bardzo, los
siedzenie: krzesło, oblężenie, centrala
gra: hazard, bawić-się
komunikat: wyrażenie, raport
marzenie: koszmar, sen
skała: klif, Spódnica, kamień
specjalny: zwłaszcza, prywatny, ekspert
opłata: koszt, myto, zapłacić
dzielić: część, stawka, rola, rozprowadzać
rozprzestrzeniać-się: szczegół, rozpowszechniony, rozpraszać, powód
chwała: honor, pochwała
przestrzeń: pozycja, sala, pole, astronauta
zwykły: pospolity, proste
rozważać: myśleć, wzgląd
bardzo: bardzo, w-dużej-mierze
oficer: urzędnik
oceniać: standard, honor, kurs
znak: notacja, gest, ocena-w-szkole, miejsce
ojczysty: Natura, oryginalny, rezydent
pracujący: pracownik, praca
ożenić: żonaty
stopień: granica, Tom, stopień
metoda: droga, pewnego-razu, podejście
doskonały: lepiej, wielki
pewność-siebie: uwierzyć
dokładnie: naprawdę, zwłaszcza, pełny, całkowicie
ogromny: wielki
fantazyjny: wyobraźnia, Pięknie
szybki: już-wkrótce, zwinny
Tak: tak, a-zatem
wolność: darmowy, niezależność
ciekawa: rysować, ciekawy
na-bok: rozdzielony, bokiem, oprócz
czysty: świeży, veridical
o: nad, o, wzgląd
dowodowy: dowód, oczywisty
odległy: z-dala, zdalny
podobny: być-podobnym, podobnie, przystający,-zgodny, porównywalny
wąska: chudy, krótki
całkowicie: całkowicie
strona: bok, dziedziniec
szczególnie: zwłaszcza
góra: wzgórze
dumny: duma
wyraźnie: wyraźnie, Otwarte, oczywisty
cena: honor
chory: chory
wyrok: decyzja, wyrok, reguła, sędzia, jurysdykcja, kryzys
zaakceptować: do-przyjęcia, przyznać, brać
gatunki: dobry
szukać: Wyszukaj
honor: honor
ucho: pozwolenie
Dolny: na-dół, piętro, opierać
pomoc: AIDS, Pomoc, wsparcie
całkowicie: pełny, całkowicie
rozkosz: szczęśliwy, nieprzyjemny
ilość: kwant, Tom, tłum, numer
uzyskać: nabycie, czerpać, brać
podatek: wynajem, linia
krzyż: przejście, przechodzić, przekraczać
obcy: Gość, dziwne, obcy, nieznany
odważyć-się: odwaga
rosnąć: powstanie
fałszywe: kłamstwo, źle, chory, wadliwa
wysoka: długi, piętro
brama: drzwi
swobodnie: niezależność, darmowy, niezależnie, luźny
cios: zaszokować, uderzenie, strzał, rzut
moda: podejście, chodź
co-dzień: dzień
dystrybucja: rozprowadzać
bogactwo: pieniądze, nieruchomość
wolność: darmowy, niezależność
postęp: postęp
delikatny: miękki, słodki
pewno: kurs, naprawdę
bezpieczne: bezpieczne, chronić, gwarantować
zajęty: chwycić, grad, zajęty
etap: peron, akcja, faza, stan, scena
część: część, racjonować
język: język, pluć
zły: gniew
przewóz: pociąg, wózek-sklepowy, czółenko
pogoda: klimat, powietrze, czas
konieczność: znaczenie
praktyka: poćwiczyć, akcja, zwyczaj
roszczenie: prośba, garnitur
książę: książę
grupa: zestaw, konglomerat, trzoda, pasmo, płyta
poprzez: wszędzie
Dodaj: poszerzać, dodatkowy, wzrost
modlić-się: pytać-się
prowadzący: wynikający, opanować
szary: brązowy, popiół
często: często, powtarzający-się, stały
słynny: popularny, dobrze-znane, samogłoska
potężny: moc, w-stanie
żywy: relacja-na-żywo
słaby: słaby, ubogi
tworzywo: treść, Przedmiot
szczery: szczery, aksjomat
ciepło: lato, ciepło
strzec: chronić, opieka
na-równi: saldo, podobnie, również
naturalnie: Natura
znakomity: dziwne, niezwykle, wielki
księżyc: miesiąc
niewielki: mało, z-łatwością, jasny, chudy, krótki
styl: jasny
spiczasty: półkula, ostry
zasada: teoria, aksjomat, początek
natychmiastowy: już-wkrótce, bezpośrednio
skłonny: już, chodzić-na-palcach, mila
konsekwencja: wynikający, efekt, wniosek
delikatny: miękki, umowa, wyścig
zainteresowany: zamierzać, zainteresowanie
jedna-czwarta: stopa
zaawansowane: nad, Naprzód
widocznie: wyraźnie, podobno, wydać-się
aktywny: praca, akcja
świadomy: celowo, wiedzieć
niebezpieczny: niebezpieczeństwo, szkodliwy, groźny
spokojna: cicho
poświęcony: boski, święty
królestwo: królewski
Cały: całkowicie, wszyscy, pełny
miły: Pięknie
zwyczaj: cecha-charakterystyczna, droga, zwyczaj
bezpośredni: oczywisty, bezpośrednio, z-pierwszej-ręki
tak-właściwie: naprawdę, fakt
przesłuchanie: słyszeć
pieszy: stąpać, stopa, pieszy
rzucać: emitować, odlew, strzał
mądrość: intelektualny
prowadzić: napędowy, chór, wyprawa, naciskać, bieg, dysk
wina: winić, źle
romans,-sprawa: rzecz, Przedmiot, kontakty
Skontaktuj-się: korespondencja, dotknąć
stacja: stoisko, centrum, pora-roku
Posłuchaj: słyszeć, pytać-się, słuchać
ból: zranienie, ból, ranny
wyrazić: wyrażenie, wyjaśniać
sprzyjać: bok, łaska, sprzyjać
wysokość: długość
rozmiar: wymiarowy, wielkość, pełny
zadanie: akcja, praca, obowiązek
współczucie: empatia, litość
ubrany: sukienka
dalej: Naprzód
statek: instrument, statek
tkliwość: miłość
cierpienie: torturować, nieszczęście, gorzki, problem
ciało: mięso, ciało
wielki: masywny, wielki
stanowisko: ranga, Poczta, po, wysłać, pozycja
kolekcja: akumulacja, zestaw, Galeria, wniosek
wyobrażać-sobie: wyobraźnia, myśleć
przyjazd: chodź
głośno: obstawać, wielki, trudny
piękny: Pięknie, wspaniały
niezwykły: dziwne, niezwykle
zdarzyć: ani
śniadanie: ranek, lunch
populacja: tłum
seria: łańcuch, zestaw
ulga: AIDS, komfort, glifów
wrażenie: efekt, uczucie, piętno, wydrukować
zadowolenie: zadowolona
kształt: wymiarowy, forma, kształcie
narodziny: urodzony
wynagrodzenie: pomysł, wzgląd
regularny: okresowy, powtarzający-się, porządkowy
w-ruchu: drgnąć, ruch
zajęty: zajęty
jakość: masa, stopień
odkryć: uznany, Wyszukaj, ujawniać
w-środku: wewnętrzny, głęboki, wewnątrz
gleba: błoto, piętro, solo, kraj
całkowicie: całkowicie
wiadomość: Informacja, aktualności
fraza: wyrażenie, wyrok
wzmianka: męski
para: dobrze, para
tytuł: nagłówek, głowa, Przedmiot
zrozumienie: rozumiesz, empatia
niedziela: tydzień
szalony: głupek, oszukać
absolutnie: całkowicie, rygorystycznie
powolny: cicho
miłosierdzie: litość, łaska
zawierać: w-tym, treść
smutek: smutek, ból
żołnierz: armia, pionek
poprzedni: Wschód
wyjaśnienie: wyjaśniać, Informacja
modlitwa: prośba
wiara: uwierzyć, lojalność
stały: powtarzający-się, standard, naprawić, stały
finał: trwać, wreszcie
jazda: jazda-konna, safari, powstanie, napędowy
polityka: polityczny
rysunek: obraz, rysować, plan
umierający: śmierć, umierać
popyt: prośba, pytanie
górny: nad
podsumować: i, joga, numer
ruch: ruch, zaproponować
pomoc: wsparcie, Pomoc
godność: honor
złapać: trzymać, brać, koncepcja
wśród: między
aktualna: obecny, strumień
ewentualnie: prawdopodobieństwo, może, móc
oddzielny: rozdzielony, różnica, solo
najgorszy: gorzej, ubogi
terror: strach, terrorysta
kontrola: regulacja, kontrolowanych, czek, kierować
zdolny: umożliwiać, w-stanie, wykwalifikowany, umiejętność
firma: firma, chociaż
lepszy: lepiej
duchowy: umysłowo, morał, intelektualny
dowód: okazać-się, dowód
relacja: kontakty, raport, wzgląd
zaniepokojony: opieka, niespokojny, związane
głęboko: głęboki, szczegół
śpiewać: czytać
przyjazny: przystający,-zgodny, uprzejmie, przyjaźń, dobry
wejście: drzwi, paragon
Dostawa: szerokość, opatrzony
czysty: świeży, schludny
przydatny: konieczny, skuteczny
delikatny: kruchy, chudy, elegancki
usunąć: pozbyć-się, kasować, rysować
wybór: wybierać, wybór, czek
ogromny: masywny, wielki
niezdolny: nie-mogą, nie, zawieść
pokrywa: płaszcz, włączenie, koc, owinąć, bruk
podwójnie: bliźniak, dwa-razy, para
zwycięstwo: sukces
stale: często, powtarzający-się, zawsze, kontynułuj
poziom: standard, stan, powierzchnia
uwolnić-się: rozładować-się, publikacja, darmowy
szorstki: gorzej, gderliwy, niegrzeczny
przed-siebie: Naprzód, nad
połączony: granica, przywiązany, związane, sprzężony
zdobyć: nabycie, przewaga
dodanie: dodatkowy, uzupełnienie
izba: pokój, sala, aparat-fotograficzny
znajomy: znajomy, elementarz
błąd: źle
na-podstawie: opierać, Warunki
samochód: pociąg
nikt: kogokolwiek, nic
energia: moc
goły: Otwarte, bar, wstyd, wydrążony, łysy
częściowo: wpół, część, nieco
kolor: kolor
bezpieczeństwo: bezpieczne, zbawienie, opieka
opis: opisać, Informacja, deskryptor, definicja
we-śnie: sen
upuść: zanurzać, spadek, nieszczelność
znakomity: wspaniały, błyszczący, wielki
krótki: akronim, krótki
szary: brązowy, popiół
wysoko: bardzo
podekscytowany: podniecenie, podrażniona
rozpacz: udaremnienie, słaby
łatwość: komfort, zredukować
całkowity: brutto, wszyscy
życzliwość: cnota, łaska
krąg: cykl, apartament, okrągły, koło
nudny: nudziarz
zamiar: zamierzać, cel
semestr: Warunki, semestr, ostateczny-termin
dokładnie: wygodna, całkowicie
ubiegać-się: posługiwać-się
praca: praca
inteligencja: intelektualny
strajk: atak, uderzający
dość: całkowicie, wystarczy, bardzo
zastosować-się: poznać-się, słuchać, treść
zdarzenie: incydent, okazja, pokaz
delikatnie: miękki, uprzejmie
połączenie: spójnik, Załącznik, połączenie
ochrona: chronić, schronisko, opieka
przytomny: obudzić, celowo, uczucie
wydanie: koszt, wydrukować, publikacja, pozwolenie
lot: ptak, latać, szybować
różnorodność: dobry, różnorodny
niezależnie: rozdzielony, z-dala, oprócz, niezależnie
straszny: straszny, litość
wszyscy: wszyscy, kogokolwiek
praca: praca
kochanek: drogi, przyjaciółka
śpiew: piosenka
chętny: pragnienie, Jestem-cierpliwy, ciekawy, niespokojny
wymagać: pytać-się, prośba, obstawać
kiedy-tylko: gdy
udany: sukces
podnieść: poszerzać, winda, wzrost, powstanie
rozwój: postęp
chłodny: zimno, Pięknie
okres-próbny: sonda, proces, boisko
za-granicą: obcy, wygnanie
poświęcony: lojalność, wierny
literacki: literatura
pisarz: autor
Zbiory: kij, rola, akcja
rodzaj: dobry, pisać, naciśnij
mnóstwo: bogaty, nadmierność, wystarczy
uniknąć: zapobiec
sprzyjać: bok, łaska, sprzyjać
psychiczny: intelektualny, umysłowo, wewnętrzny
postawa: spojrzenie, stoisko, gest, podejście, zależność, ustęp
podziw: pochwała
niepokój: niespokojny, strach, zaabsorbowanie, podniecenie
nauczać: wiedzieć, uczyć-się
widoczny: wiedzieć
przewodnik: instrukcja-obslugi, dowód, napędowy
rzeczywisty: wirtualny, fakt, królewski
nieszczęśliwy: niewystarczający, smutny, nieszczęśliwy, nieszczęście, bezradny
szkoda: zło, szkodliwy, zranienie, litość
pardon: przebaczyć, Przepraszam, przepraszać, łaska
rzadko: czasami
nagrywanie: rejestracja, dysk, ratować
gruby: olej, gruby
mieszkanie: apartament, wymijający, plan
prezent: nagroda, obecny
świątynia: dom, katedra
licencja: pozwolenie
zgoda: zatwierdzenie, pozwolenie
dostatecznie: pełny, wystarczy
rana: zranienie, ranny, wrzód
pogrubienie: odwaga, odważny
gdziekolwiek: gdzieś, wszędzie
dowód: dowód
głupi: nieświadomy, oszukać
ktoś: kogokolwiek, ktokolwiek
samego-siebie: prywatny, sami, własny
niezwykle: bardzo, niezwykle
leczenie: terapia, opieka
gardło: szyja, szybować, ogórek
cierpliwy: chory
wzrost: wzrost
ilość: kwant, masa, tłum, dawka, numer, wielkość
silny: rygorystycznie, gwałtowny, trudny
pretekst: przebaczyć, powód, przechodni, Przepraszam
pochodzenie: oryginalny, Natura
publiczność: pasywny, publiczny
pozostały: szczątki
zdobyć: sukces
pokojówka: sługa
delikatnie: miękki, cicho
rzeczywistość: fakt
teren: scena, Strona-www, miejsce
żagiel: statek, welon
sklep: robić-zakupy, przechowywanie, ratować
uwaga: zawyrokował, wzgląd
pauza: złamać
cenny: wartość
stąd: a-zatem, dlatego
roślina: powstanie, drzewo, młyn
lód: śnieg
absolutny: pełny, całkowicie
łatwo: z-łatwością, już-wkrótce
dziki: ostry, gwałtowny, trudny, okrutny, drapieżnik, dziki
wściekłość: gniew
odkrycie: uznany, Wyszukaj, wynalazek, otwarcie
pokrewny: związane
kara: wyrok
nieco: mało, z-łatwością, nieco
tajemniczy: sekret, niejasny, niewidzialny
cień: cień, ton, niuans
morderstwo: zabić
emocja: uczucie, namiętny
zniszczenie: ruina, zniszczyć
przerażenie: strach
lokalny: lokalnie, wewnętrzny, miejsce
strzelnica: różnorodny, dystans, zestaw
gospodarz: armia, Gość, tłum
mokro: deszcz, wilgoć
tajemnica: sekret
posiadać: własny, Niedźwiedź
świadomość: racjonalność, uczucie, sumienie
dawniej: przed
produkcja: wytwarzać
pokład: most
majątek: nieruchomość
królować: król, rodzina-królewska
spełnienie: kierować-się, dostosowanie
jej: jego
niefortunny: na-nieszczęście, zbieg-okoliczności, nieszczęśliwy, litość, niewystarczający
kwiat: spędzić, zainteresowanie, błoto
dzięki: podziękować
należeć: nieruchomość, w-tym
rynek: kupować
czapka-z-daszkiem: kapelusz, korek
zachwycony: szczęśliwy
gospodarstwo-domowe: rodzina, dom
flota: statek, marynarka-wojenna, pływak
dziecko: dzieci, lalka
region: pole
dokładny: mąka, właściwy, pełny, ostrożny
obraz: obraz
podejrzenie: wątpić, podejrzany
odpadki: zaprzeczać, weto, odpady
odpowiedzialność: obowiązek, winić
zawstydzony: wstyd
posiłek: jedzenie, jeść, mąka
status: pozycja, stan
wskazać: wchodzić, pokaz
wiersz: poezja, piosenka
powstać: wyłaniać-się, powstanie
rejs: safari, wyprawa
brać-udział-w: dołączyć-do
pozwolić-sobie: kupować, dać, Niedźwiedź
podarować: przyczyniać-się, dać
praca: praca
kontynuować: kontynułuj, wzrost, postęp, przechodzić
żal: Przepraszam
ryzyko: niebezpieczeństwo
szybki: już-wkrótce, zwinny
odrębny: rozdzielony, różnica
prawidłowo: właściwy, wygodna
sława: pochwała
pojedynczy: zjednoczony, jednostka
błąd: źle
reputacja: pochwała
apel: rysować, połączenie
brak: ciąć, wadliwa, brak
przemoc: gwałtowny
renderowanie: robić, przedstawiać, dać
Kariera: zawód, praca
projekt: koncepcja, plan
sugestia: wyrok, zaproponować
zupełny: wymawiać, pełny
rozkład: decyzja, wniosek, analiza, poszerzać
zapasowy: alternatywny, dodatkowy, zastąpić, włócznia
krajowy: cywilny, wewnętrzny, rezydent, krajowy
odniesienie: referencyjny, pamięć
istnieć: obecność, obecny
problem: problematyczny, Warunki, problem, Przedmiot, pytanie, emisja
że: opatrzony, dać
płomień: ogień
ignorancja: nieświadomy, ignorować
od-czasu-do czasu: czasami, powtarzający-się
latający: latać
płótno: tkanina, odzież
zysk: przewaga
czwarty: cztery, środa, pokój
dzwon: alarm, godzina
zasiłek: przewaga
rozdział: drzwi, część, głowa, pora-roku, kapitał, sami
otwór: nudziarz, dół
rozsądny: właściwy, mądry, racjonalny
cukier: pijaństwo, droga
wymiana: zastąpić, w-zamian, dodatek, alternatywny, wymiana
pchnięcie: obstawać, robić-na-drutach, zapłacić, naciskać, impuls
rama: skala, prawny, strzał
substancja: Przedmiot
e-mail: wysłać
podział: część
niewolnictwo: niewolnik
werset: poezja, ustęp
prawdopodobny: może
bolesny: gorzki, ból
na-zawsze: zawsze, wieczny
ocean: morze
tylny: po, plecy, rewers
lider: głowa, menedżer, konduktor, instrukcja-obslugi
zapalony: zamierzać, niespokojny, ostry
szczęście: los
pozorny: oczywisty, aksjomat
pośpiech: już-wkrótce, cielę
schemat: plan, pasiasty, wykres
bezużyteczny: odpady
Niemniej-jednak: chociaż, niemniej-jednak
gładki: miękki
solidny: wskazujący, ustanowiony, chociaż, kompaktowy
koniecznie: musi, konieczny
budować: Stwórz, budynek, sformułowanie
próba: próba, zasztyletować
równowartość: podobnie
niedawny: ostatnimi-czasy, nowoczesny, trwać
podróżować: odwiedzić, turystyka
południe: popołudnie, południe
usytuowany: spadek
ogłoszenie: ogłoszenie
zaprzestać: zapobiec
okoliczność: stan, koperta
namiot: kabina, scena
częsty: powtarzający-się, często
głośno: głos
niezależny: niezależność, luźny, niezależnie
istotny: konieczny, zszywka
obserwacja: przestrzegać
wdzięczność: podziękować
zachować: zachować, przechowywanie, chronić
aspekt: element, bok
strach: strach, fobia, przestraszony
mądry: wykwalifikowany, mądry
dzielnica: relacja-na-żywo
niepowodzenie: zawieść, źle, bankructwo, poronienie
cent: grosz, procent, sto
sentyment: uczucie
agent: oznaczać
zdesperowany: słaby
unia: Sojusz, zjednoczony
dotacja: przyznać
uderzyć: zwielokrotniać, rzut, sukces
ogromny: wielki, masywny
przekonanie: wyrok
gorączka: ogień, grypa
leczyć: terapia, proces, leczyć-się
nasz: wiosna, nas
błędny: źle, nadużycie, wadliwa
ideał: lepiej
spiesz-się: tłum, uderzenie
poprawny: właściwy, dobrze, wierny, naprawić
wykonać: pokaz, robić
jakoś: nieco
pojęcie: koncepcja, konotacja, pomysł
dyskusja: dyskutować, sprzeczka
mocno: ustanowiony, chociaż
stały: standard, naprawić, zgodny, stały
imperium: królewski
długopis: ołówek, głowa
pozwolić: pozwolenie
utrzymać: trzymać, chronić, zachować
zatłoczony: tłum, gęstość
ograniczenie: granica, powściągliwość
okropny: straszny
port: port, drzwi
doświadczony: doświadczenie, wykwalifikowany, ekspert
przeciwny: sprzeciw, naprzeciwko, w-kierunku, kontrastujące
traktat: memorandum, umowa
występować: chodź
poszukiwania: błagać, Wyszukaj
praktycznie: prawie, naprawdę, praktyczny
ślad: ocena-w-szkole, weto
wesoły: szczęśliwy, wesoły
układ: zamówienie, usposobienie, zorganizowany, umowa
western: zachód
ciśnienie: nacisk, wydrukować, naciskać, waga
polityka: polityczny
naukowy: nauka, naukowiec
zasługa: pochwała, zakwalifikować, wartość
wywiad: odwiedzić, przeprowadzający-wywiad
terytorium: pole
seks: penis, seksualny, sześć
tworzenie: Stwórz, sformułowanie, ustanowiony
ślad: ocena-w-szkole, wybór, droga
perspektywa: nadzieja, prawdopodobieństwo, wizja, scena
działanie: dryf, proces, akcja, chirurg
głęboki: głęboki
mecz: hazard, zbiec-się, zbieg-okoliczności, wyścig
mundur: sukienka
dług: winić, religia, obowiązek, kredyt
przedsięwzięcie: przygoda, inwestycja, firma
wykonanie: akcja
nastrój: uczucie, humor, usposobienie
załoga: personel
dostrzec: rozumiesz, koncepcja, widzieć
ogłosić: wyjaśniać
wersja: Kopiuj, komórka
dziwny: dziwne, niezwykle
wdzięczny: podziękować
nieskończony: wieczny, bezokolicznik
bezpieczeństwo: bezpieczne, opieka
rozsądny: mądry, racjonalny, podatny
Chata: Chata, kabina
Pojemność: w-stanie, umiejętność, Tom
rozstrzygać: pobyt
zaangażowany: zajęty, dołączyć-do
rada: Rada
badanie: sonda, czek, wybierać
stal: żelazo
test: czek, próba
akcja-charytatywna: miłość
Szopa: wlać, odlew
komunikacja: korespondencja, kontakty
ktoś: ktokolwiek, osoba, kogokolwiek
rząd: linia, porządkowy, zestaw, rząd, zamówienie
ubóstwo: ubogi
intensywny: krawędź, skrajny, gwałtowny
kłótnia: bić-się
do-dyspozycji: opatrzony, obecny
odporność: sprzeciw
niezwykły: niezwykle, pospolity
opustoszały: opuszczony, pustynia
głosować: wybierać, głos
znieść: Niedźwiedź, kibic, trwać, ponieść
osiągnąć-sukces: sukces
noga: stopa, kość
oferta: zaproponować, prośba
wnętrze: wewnętrzny
lekko: z-łatwością, jasny
pokaz: pokaz, wystawa, ekran, scena, dowód
ograniczony: ograniczony, tylko
cel: cel, skupiać
krytyczny: konieczny, krytyk
plecak: kieszeń, worek, kosz
powtarzać: powtórzenie, plecy, powtarzający-się
tor: monitor, piosenka, droga, kierować-się
rezydencja: schronisko
zabawa: szczęśliwy, wesoły, zabawa
bronić: chronić
mocno: waga, na-poważnie
rzeczy: treść, towary, rzecz
sekcja: część, sekcja
osada: umowa, schronisko, regulacja
płyta: płyta, dysk, dyskoteka
przezwyciężać: sprostać, przekraczać, pokonać
fusy: powód, Warunki, motyw
marmur: kamień
zdolność: w-stanie, umiejętność, talent
fala: fala, niejasny
ludowy: za-ludzie, popularny
możliwość: prawdopodobieństwo, w-stanie
masło: olej
nienawiść: pogarda, nienawidzić
pościg: Wyszukaj
ciągnąć: rysować, nożyczki
sygnał: gest, ocena-w-szkole, Hasło
bezpiecznie: bezpieczne
palić: spalony, palić
lekcja: edukacja, Przedmiot, kurs
roczny: rok
karta: karton, mapa, krótki, papier
Aplikacja: posługiwać-się, oprogramowanie, prośba
inteligentny: intelektualny, mądry
Hrabstwo: bojkot, regionalny, miasto, kraj
format: forma, odlew
pływ: strumień
uszkodzić: ruina, zranienie, litość
co-więcej: dodatkowy, parzyste, jeszcze
handel: handel
południowy: południe
zewnętrzny: na-zewnątrz
średni: wtórny, oznaczać
nagi: wstyd
oczywisty: oczywisty, Otwarte, aksjomat
fundament: opierać, peron
dotyczyć: opieka, niespokojny, związane, zainteresowanie, zaabsorbowanie
magia: urok
kampania: ruch, wyprawa
liberał: hojny
powszechnie: pospolity, często, ogólnie
polowanie: polowanie
nauczyciel: autor
wkrótce: już-wkrótce, krótki, prawie
błogosławieństwo: błogosławić
malutki: mało, mikro
ostro: prędkość, ostry, na-poważnie
skrzynia: pierś
głębokość: głęboki
wydajność: pokaz, wydajność
dobrobyt: zakrętas, sukces, dobrobyt
urzędnik: pracownik, urzędnik
decydować-się: decyzja, zdecydowany, decydujący, substancji-rozpuszczonej
ofiara: polowanie, ofiara, myto
motyw: zamierzać, motyw, silnik, cel, bodziec
określony: zdecydowany, oczywisty
tendencja: cecha-charakterystyczna, mila, usposobienie, dryf
koniec: gotowe, kolor
flaga: transparent, wiedzieć
administracja: reguła, kierować
rzadko: rzadki
prawdziwy: wirtualny, oryginalny
szkolenie: edukacja, nauczanie
źle: źle, bardzo, gorzej, zło, chory
karmić: jeść, sprzyjać, jedzenie
centralny: centrum, federalny
kontrast: kontrastujące, sprzeciw, konflikt
struktura: budynek, strukturalny, organizacja
zapłata: zapłacić
tempo: prędkość
zapytanie-ofertowe: sonda, prośba, Wyszukaj
dokądkolwiek: gdzie
zawdzięczać: winny, obowiązek
uchwyt: proces, kierować, sprostać, manipulacja
wycieczka: odwiedzić, safari, zwiedzać, wyprawa
strzelać: strzał, wygnanie, emitować
zatrudnienie: bezrobotny, zaabsorbowanie, praca
cięcie: ciąć
opierać-się: sprzeciw
ustalać: determinantem, zdecydowany, decydujący, nakładać, naprawić
kupiecki: kupiec, biznesmen, handel
żywy: relacja-na-żywo
bryza: powietrze
krewny: kuzyn
a-tym-samym: a-zatem
zaopatrzenie: przedstawiać, opatrzony, dobrobyt, przydział, usposobienie
Jeżeli-chodzi-o: o, wzgląd
wybierać: wybierać, brać
zrujnowany: zniszczyć
dostarczyć: dać, przedstawiać
nieoczekiwany: niespodzianka
biurko: stół, Biuro
pas-ruchu: linia, pasmo
reprezentować: przedstawiciel, instancja
poważny: honor
odpowiedzialność: obowiązek, winić
rozczarowany: ambicja, niezadowalający
odpowiedni: zbiec-się, właściwy
zależeć: zależność, granica
gigant: wielki, potwór
chwycić: rozumiesz, chwycić
przyjechać: chodź, osiągać
prostota: proste, pokora
jesień: spadek
nieobecny: brak, z-dala
mrok: ciemny
posądzać: domyśl-się, wątpić, podejrzany
determinacja: zdecydowany, decyzja, raport, definicja
podstawa: opierać, Warunki
zbadać: przestrzegać, czek, analiza
nagroda: nagroda, premia
zakup: kupować
ktoś: osoba, kogokolwiek, chociaż
zdawać-sobie-sprawę: osiągać, rozumiesz
pokonać: pokonać, naszyjnik, zawieść
przestępca: krew
głupi: oszukać, nieświadomy
odwołanie: pamiętać
zawód: nalot, zawód, zawodowy, agresywny
rozprawiać: nowoczesny, gadanie
wspierać: Pomoc, wsparcie, współpraca
sprzedaż: Aukcja, sprzedać, obniżka-cen
zaproszenie: Zapraszam, połączenie
gorszy: niewystarczający, na-dół, gorzej
rozpoznać: przyznać, diagnoza
portret: obraz
sugerować: zaproponować, przypuszczać
rozczarowanie: udaremnienie, ambicja, rozczarowanie, niezadowalający, liczyć
budowa: budynek
gorliwość: entuzjazm, pracowitość
odpowiedzialny: obowiązek
leczyć: terapia, leczyć-się, opieka
zawierać: w-tym, wchodzić, włączenie, rozumiesz, treść
usatysfakcjonować: poznać-się, zadowolona, treść, pobłażać
agonia: gorzki
głupi: głupek, nieświadomy, oszukać
przyjemność: cieszyć-się
ukryć: chować
dokładnie: właściwy, pełny
przyjąć: błagać, przypuszczać, wzgląd
ocena: ocenianie, domyśl-się
trasa: droga
gość: podróżny, Gość, obserwator
nie: nie
drut: linia
głównie: zwłaszcza, w-dużej-mierze
nieprzytomny: słaby
wzajemny: wzajemnie, pospolity
zewnętrzny: na-zewnątrz, obcy
wszechświat: kosmos, świat
zegar: godzina
instrukcja: nauczanie, kierunek, instrukcja-obslugi
ból: wrzód, chory, ból
dyscyplina: Przedmiot
przedstawienie-się: przedstawiać, opatrzony, promocja, elementarz, import
pustynia: pustynia
zmieszany: nerwowy, udaremnienie
ślub: żonaty
imieniu: przedstawiciel, bok, łaska, część
liczyć-się: uwierzyć, obliczenie, liczyć
niepewny: niepewność, niepewny, niejasny
zaręczynowy: zajęty, nominacja
brudny: emisja, brutto
lekarz: lekarz
pokrycie: pokryty, włączenie, dach, owinąć
szczery: szczery, naprawdę, veridical
uczucie: uczucie
konkretny: zwłaszcza, prywatny, ekspert
Zajazd: hotel
sztywny: trudny
towarzyszyć: kierować-się
wynik: ocena-w-szkole, raport
dziewica: córka
głód: głodny
ulubiony: ulubiony
urząd-celny: tradycja, cal, obowiązek, zwyczaj
pod-wrażeniem: uczucie
zdobycz: polowanie, łup, ofiara
musical: muzyka, muzyk
zadowalający: choroba
niedorzeczny: nieświadomy, wesoły
prześcieradło: papier, liść, ulotka
hańba: wstyd
pierwotnie: oryginalny
wynagrodzenie: zapłacić
rozległy: rozpowszechniony, głęboki
wolny-czas: zabawa, pusty, iść-na-emeryturę, relaks
podbródek: zarost
poświata: blask, jasny, promieniowanie, migać
zazdrość: zazdrosny
kolej-żelazna: popędzać, pociąg
funt: książka
wschodni: Wschód
obywatel: cywilny
plaża: Wybrzeże
cecha: element, cecha-charakterystyczna, nieruchomość
rezerwa: zachować, książka
ryk: hałas
dziwnie: dziwne
szczekać: kora, skóra
recepcja: Witaj, paragon
przyjemny: nieprzyjemny, dobry
budzić: obudzić
Badania: analiza, Wyszukaj
monarcha: cesarz, król
odzież: tkanina, sukienka, odzież
choroba: choroba, chory
żart: żart, ironia, śmiać-się
komentarz: wyjaśniać
metal: żelazo, minerał
rozwiązanie: naprawić, decyzja, odpowiadać
tytoń: papieros, palić
jednostka: instrument, jednostka, obecność, organizacja, firma, osoba
odstąpić: wyjazd, błądzić, pęknięcie, iść
gorzko: gorzki
spokojna: cicho
zaniepokojony: niespokojny
sztuczka: rekrut, stąpać, oszukać, manipulacja, przebiegły
budżetowy: pieniądze, gospodarczy
przygotowanie: przygotować
muszla: strąk, kora, skóra
gniazdo: relacja-na-żywo, gniazdo-elektryczne
pojąć: koncepcja, rozumiesz, myśleć
spotkanie: nominacja, obietnica
sprowadzać: przynieść, odzyskać, brać
świeca: jasny, wosk
obrażać-się: atak, przestępstwo, masa
mieszanina: mieszany
Model: instancja
wada: winić, marszczyć, inwalidztwo
sprzeciw: niezgoda, sprzeciw, sprzeczność
rzemiosło: sztuka, zawodowy, umiejętność
zaniedbanie: ignorować, opuszczony, pominięcie, bojkot
dane: Informacja
broń: ramiona, pistolet
różowy: róża
użytkownik: o, beneficjant
Dziadek: przodek, dziadkowie
zero: zero, pusty
energiczny: gwałtowny
błyskawica: elektroniczny, śruba, migać
sport: ruch, poćwiczyć
proszek: mąka, kurz
malarstwo: obraz, płyta
krzyczeć: hałas, nóż, płakać
niedbały: lekkomyślny, obojętność
pochodna: czerpać
wejście: drzwi
wygodny: proste, praktyczny, wygodna, z-łatwością, właściwy
Poczta: Poczta, list
farba: kolor
poddanie: tradycja
ustalić: przedstawiać, ustanowiony, naprawić
łagodny: miękki, jasny
natychmiast: pewnego-razu, właściwy
departament: część
zasłużyć: wartość, zakwalifikować
porzucić: opuszczony, wyłaniać-się, pęknięcie, odlew
pewność: gwarantować, kaucja
lustro: szkło
fabuła: spisek, plan, fabuła
w-górę: jeszcze
niestety: smutny, na-nieszczęście
skromny: pospolity, proste, pokora, oszczędny
danie: boisko, jedzenie, jeść
netto: sieć, veridical, święty
ciepło: entuzjazm, ciepło
niespokojny: niespokojny
eksperyment: pilot, doświadczenie, próba
Dzisiaj: dzień
ogromny: straszny, wielki, masywny, bardzo
poprawa: reforma, naprawa, postęp, poprawa, leczyć-się
spierać-się: niezgoda, sprzeczka
propozycja: zaproponować, wyrok
być-może: może, móc
karabin: pistolet
tarcza: chronić
zatrudniać: wynajem, posługiwać-się
w-odróżnieniu: różnorodny
odnaleźć: ratować, odzyskać, poprawa
kolega: pluć, kolega, przyjaciel
zorganizować: zamówienie, wprowadzać-ustawodawstwo, zorganizowany
komisja: płyta, komisja
w-wieku: stary
duch: dusza
objawienie: wyrażenie
uznanie: przyznać, wyznanie
glina: błoto, kret
bagażnik-samochodowy: plemię, bagaż, but
zarządzanie: kierować, napędowy
przywracać: zachować, plecy, poprawa, odzyskać
protest: sprzeciw, Marsz
stos: wysypisko, stawka, tłum
umiarkowany: wtórny, oznaczać
zaklęcie: urok, pisownia
powierzchnia: pole, regionalny, powierzchnia
formalny: urzędnik
redaktor: autor, wydawca
uznać: wyznanie, przyznać
zaradzić: lekarstwo, terapia, naprawić
kontynuować: pobłażać, monitor, spędzić, kierować-się
Polak: Przepraszam, kolumna, skrajny, pępek
witalny: konieczny, decydujący, klawisz
prezydent: głowa
wychowanek: skrzydło, regionalny, część
ms: 
dopingować: serce, entuzjazm
usprawiedliwiony: racjonalny, dobrze, uzasadniać
podziwiać: pochwała
otwarcie: wyraźnie, Otwarte, otwarcie
modyfikacja: zmiana, dostosowanie
dramatyczny: dramat, wskazujący
na-górze: nad, gorzej
urozmaicony: różnorodny
zejście: Natura
zazdrość: zazdrosny
załadować: waga, odcedzić, bar, plemię
udać: udać, dramat
wewnętrzny: wewnętrzny
kurtyna: welon, ekran
zdrowy: zdrowie
niejasny: niejasny, zaćmienie
centrum: centrum
zawody: wyścig
zmieniać: konwertować, zmiana, zastąpić
dojrzeć: spojrzenie, wizja
umowa: memorandum, zamówienie, trzymać, umowa
oszczędność: ratować, przechowywanie, ekonomika
strunowy: lina, łańcuch, zestaw
połączenie: zbieg-okoliczności, mieszany, zestaw, połączenie
aresztować: przymocować, koncepcja
temperatura: ciepło
rygorystyczny: rygorystycznie, ostry, trudny
profesjonalny: zawód, zawodowy
ranny: ranny, zranienie
sąsiedztwo: otaczający, relacja-na-żywo, środowiskowy
palenie: palić, papieros
medyczny: lekarz
poinformować: gazeta
wybitny: popularny, niezapomniany, wynikający, klawisz, dobrze-znane
instytucja: zorganizowany, firma, organizacja
pakiet: owinąć, zamknąć, Opakowania
boleść: gorzki, nieszczęście, ból, smutek
oczywiście: oczywisty, Otwarte, wyraźnie
zdobyć: urzec, brać, koncepcja
obszerny: wystarczy, niewystarczający
sypialnia: pokój
czysto: tylko, całkowicie, święty
połączenie: pospolity, mieszany, połączenie
odnosić-się: referencyjny, konsultować
zidentyfikować: tożsamość, zidentyfikowania, naprawić
ławka: bank
ratować: poprawa, ratować
limit: granica, ograniczać
oczekiwanie: oczekiwać
program: plan, program
elektryczny: elektroniczny
interwał: chwilowy, złamać
pościg: polowanie
zająć: brać, chwycić
suknia: płaszcz, sukienka, garnitur
zablokować: zamek
wniosek: zaproponować, wyrok, plan, wniosek
szczęśliwie: szczęśliwy
kolejny: Dalej
niespokojny: niepewny, nieprzyjemny, niespokojny, trudny
blask: blask, migać
maszyneria: mechaniczny, maszyna, mechanizm
atrakcyjny: magnetyczny, rysować, pożądany
produkt: towary
choroba: choroba
silnik: silnik, maszyna
ich: oni
Skórzany: skóra
subtelny: mikro, chudy
nachylenie: mila, zanurzać, zgięty
martwić-się: niespokojny, zaabsorbowanie
gwałtownie: trudny
określony: zdecydowany
drzewny: drewniany, kij, drzewo
obliczać: obliczenie, liczyć
zabicie: zabić
zabawny: dziwne, wesoły
obraza: pogarda, wstyd
niezdolny: w-stanie
jeść-obiad: jeść
wrażliwy: podatny, klawisz
apetyt: pragnienie
kurtuazja: uprzejmy, honor
kula: pole, piłka, regionalny
grzecznościowy: honor
wina: winny, przestępstwo, winić, grzech
pyszne: pyszne, smak
pszenica: folklor, ziarno, kukurydza
humor: humor
spotkanie: sprostać, poznać-się, data
zmierzch: świt
park: ogród
gospodarka: gospodarczy, ekonomika
rządzić: kierować, reguła, opanować
tworzenie: edukacja, sformułowanie
pochylać-się: mila, chudy
pukanie: wahać-się, poklepać, pokonać
jedność: zjednoczony, jednostka, solidarność
główny: pionier, klawisz, roślina-mateczna, wielki, zszywka
wstępny: otwarcie, oryginalny
granica: granica, krawędź
oddychać: oddech
zwolniony: darmowy, pozbyć-się, przebaczyć
zamożny: bogaty
inspiracja: impuls, inspirować
każdy: wszyscy
obfity: bogaty
malarz: artysta
okulary: szkło
strzelanie: strzał, polowanie
wóz: pociąg, wózek-sklepowy
pożyczać: dać, kredyt, zacytować
podjąć: początek, robić
zapieczętować: dzwonić
kler: kapłan
uchwyt: zainstalować, wzrost, wzgórze
szyk: kolumna, zestaw, zamówienie
czasopismo: naciśnij
szorstki: trudny, rygorystycznie
mimo: chociaż
mocno: rygorystycznie
krajobraz: scenariusz, środowiskowy, wizja
porzucić: opuszczony
artystyczny: sztuka
głównie: zwłaszcza, w-dużej-mierze
wierny: lojalność, szczery, wierny
nadaje-się: przystający,-zgodny, zbiec-się, właściwy
doradzać: Rada, doradca
stabilny: ustanowiony, zdecydowany, standard
maksymalny: wyolbrzymiać, skrajny
popełnić: obietnica, robić
wpływać: efekt, piętno
chłop: rolnik
wydatnie: bardzo, wynikający
rozciągać-się: szczegół, poszerzać, rozciągać
osobiście: indywidualnie, prywatny, własny
moralność: morał
bunt: Buntownik, rewolucja
wątek: linia, spin
miedź: mosiądz
odpowiedź: reakcja, odpowiadać
cesarski: królewski
pusty: pusty, wydrążony, biały
mniejszy: wtórny, mało, górnik
okazja: handel, okazja
zmęczenie: zmęczony, odcedzić
antypatia: pogarda, nienawidzić, niechęć
normalna: pospolity
naszkicować: zarys, plan
cnotliwy: cnota
tak-czy-inaczej: niemniej-jednak, już
kierowca: kierowca, napędowy, konduktor
deklaracja: ogłoszenie
nadmiar: dodatkowy, nadmierność
rozdzielenie: dysjunkcja, dystans, rozdzielony
niesmak: pogarda, fobia, nienawidzić
słusznie: podobnie, właściwy
tłum: tłum, masa
niepotrzebne: odpady, musi
futro: skóra, płaszcz
zachęcać: inspirować, naciskać
hołd: wynajem
odciążyć: zredukować, pozbyć-się, przebaczyć
ustawodawstwo: wprowadzać-ustawodawstwo, reguła, legislatura
projekt: plan
wróżka: anioł, niebieski, willa
wyciągnąć-wniosek: trzymać, wniosek
szczęśliwy: szczęśliwy
podołek: kolano, Fartuch, okrągły
zepsuć: łup, ruina, sophisticate
podatny: z-łatwością, zmierzać, podatny
rozważny: ostrożny, niespokojny, mądry
korzystny: przystający,-zgodny, zgiąć, pożądany
cyna: bank
zależny: zależność, przywiązany, pracownik
nakaz: gwarantować, uzasadniać, memorandum
reklamacja: biały
konwencja: memorandum, umowa
kąt: kąt, wielokąt
szeroko: rozpowszechniony, bardzo, ogólnie, w-dużej-mierze
krowa: bydło
uprzedzenie: nienawidzić
ganek: sala, balkon
zaskakujący: dziwne, zadziwiać, niespodzianka, uderzający
fontanna: źródło
właściwy: właściwy, garnitur, zgodny
pewni: odwaga, bezpieczne, uwierzyć
organ: instrument, członek, element, ciało
wybór: wybierać, nominacja, wybór
groza: fobia, strach
porównać: porównanie
odnosić-się: przymocować, hak, kontakty, związane
przypuszczać: uwierzyć, domyśl-się, przypuszczać, wzgląd
brakujący: zagubiony
modny: nowoczesny, elegancki
pozytywnie: pozytywny
rozumowanie: pomysł, sprzeczka
przeszkadzać: nerwowy, agresywny, kolidować, irytujący
partner: przyjaciółka, pospolity, akcjonariusz
stowarzyszenie: spójnik, wzgląd
siostrzenica: bratanek, wnuczka
cieleśnie: fizjologiczny, ciało
wydział: Szkoła-Wyższa, silnia
armata: piłka, artyleria, pistolet
żeglarstwo: statek, welon
mądry: mądry
drobny: dzwonić, trywialny, mało
ostrożność: ostrzeżenie, opieka
rękopis: rachunek
wojownik: bohater
ciecz: woda
pojęcie: koncepcja, konotacja
specjalnie: zwłaszcza
skok: latać, taniec, obcas, odbić-się
niechętny: zamierzać
dodatkowy: dodatkowy
smoła: bruk, ton, nie
niezręczny: niewystarczający, dziwne
doceniać: bić-brawo, cieszyć-się
przetrwać: relacja-na-żywo, pobyt
na-krótko: akronim, krótki
ryż: mosiądz
facet: osoba
zachowanie: cecha-charakterystyczna, postępek
przyjąć: przypuszczać, brać
regularnie: często, powtarzający-się, stały, właściwy
dochodzenie: sonda, Wyszukaj
konstytucyjny: konstytucja
najnowszy: trwać
uczeń: student
całkowicie: całkowicie
skręcone: zgięty
różnić-się: rozdzielony, różnica, różnorodny
katastrofa: ruina
zakład: stawka, stan, weto
surowe: relacja-na-żywo, źródło, brutto, zielony
log: wchodzić, rejestracja, Klub
gościnność: hojny
wózek: pociąg, wózek-sklepowy
szata: sukienka
angażować: przywiązany, posługiwać-się, wynajem, zachować
stado: trzoda
zbierać: gromadzić
patelnia: garnek
atak: atak, nalot
oszukać: oszukać, zdradzać
żałoba: smutek
wycofać: pozbyć-się, rysować, iść-na-emeryturę
melodia: piosenka, harmonia
współczucie: empatia, litość
przebranie: chować
transkrypcja: Kopiuj
dokument: plik
sąsiad: otaczający
blok: zapobiec, Tom
obowiązek: obowiązek
upadek: zaprzeczać, spadek
ambitny: ambicja
wakacje: wakacje, uczta
pięść: pierwszy
orzeł: jastrząb, krawat
honorowy: honor
znaczący: konieczny, wynikający, uderzający
gęsty: kompaktowy, gruby
fikcja: powieść, wyobraźnia, fabuła
polecić: zaproponować, przedstawiać, Rada
edukacyjny: edukacja
w-górę: jeszcze, nad
róg: kukurydza
fundusz: pudełko, kapitał
wigwam: Chata, plik, kabina
kostium: sukienka, garnitur, zwyczaj
opłata-za-przejazd: wynajem, iść, mapa
oklaski: bić-brawo, zatwierdzenie
przypominać: pamiętać, być-podobnym
poduszka: rzeka
nigdzie: miejsce
zwłoki: ciało
istota: komórka, istota
podniesienie: stromy
królestwo: pole, świat
schody: schody, skala
porozumienie: memorandum, kompaktowy, garnitur, zbiec-się, umowa
koronka: kolec, dochód
uczony: student, naukowiec
linijka: książę, gubernator
pomylony: głupek, oszukać
bawić: Witaj, bawić, zabawa
Powitanie: Witaj, Pocztówka
kobiecy: Płeć-żeńska
potworny: potwór, straszny
obiekt: sprzęt
obrabować: ukraść, łup
drabina: schody, konduktor, skala, szkoła
kończący-się: trwać
podzielić: różnica, rozprowadzać
niesamowite: dziwne, niezwykle
łuk: kokarda
elekt: wybór, wybierać
nieśmiały: nieśmiałość, wstyd
mgła: mgła
kolorowy: kolor
ostrzec: ostrzeżenie, spowodować
płytki: głęboki
zachęta: bodziec, komfort
nieregularny: pospolity, niezwykle
wiernie: lojalność, wierny, właściwy
transfer: tłumaczenie
podstawowy: opierać, zszywka
pakiet: zamknąć, włókno
tragiczny: straszny
recenzja: rewizja, krytyka
niemożliwie: straszny, bardzo, gorzej
gotowanie: gotować, kuchnia
bunt: Buntownik, rewolucja
polepszyć: naprawić, leczyć-się
wrak: zniszczyć
przekonać: namawiać, gwarantować
miska: filiżanka
ilustracja: instancja, obraz
nerw: żyła, odwaga, nerwowy
gapić-się: naprawić
ustalać: wiedzieć, gwarantować, zdecydowany, czek, naprawić
zastaw: gwarantować, obietnica, zakładnik, kaucja, pionek
zarabiać: obsługiwać
wybierz: wybierać
przemysłowy: uprzemysłowienie, przemysł
interpretacja: tłumaczenie
wyzwanie: połączenie
zakazać: zapobiec, zaprzeczać
motyw: motyw, Przedmiot
wstęp: paragon
basen: basen, dół
konferencja: sesja, montaż
równość: analogia, saldo, równorzędność, równanie
nowo: neo, ostatnimi-czasy, powieść
okolica: środowiskowy, otaczający
inwazja: atak, nalot
wzór: instancja, pewnego-razu, standard, forma
odsłonić: ujawniać, zdradzać
rozwiązać: luźny, naprawić
kazanie: kazanie
babcia: panna-młoda, dziadkowie
wełna: bawełna
komunikować: dialog, uspołecznić, kontakty
esencjonalnie: Warunki
sprzeciwiać-się: sprzeciw
okaz: instancja
opór: rysować, nożyczki
przyciąć: rośliny, żniwa, ciąć
dokładny: właściwy, mąka, ostrożny
uciec: brać, schronisko, złamać
odmowa: zaprzeczać, odpady
obligacja: klawisz, kaucja, spójka
współczujący: litość
wynagrodzenie: zapłacić
ciągły: kontynułuj
podniecać: spowodować, nawoływać
wściekle: dziki, gwałtowny
smutek: smutek, tragedia
sprzymierzony: zjednoczony, związane
sufit: koc, dach
cel: skupiać, cel
gotówka: pieniądze
pusty: Otwarte, darmowy, pusty, luźny, niejasny
gardzić: pogarda
trawnik: trawa, łąka
Turcja: 
sąsiad: otaczający
najwyższy: trwać, skrajny, wreszcie, zszywka
uległość: słuchać, wysłać
wejście: wchodzić
dokładny: głęboki, pełny
ekscytujący: rysować, ciekawy
zwycięski: sukces
konserwatywny: prawosławny, gubernator
entuzjastyczny: entuzjazm, niespokojny
na-dół: na-dół
gotować: gotować, wrzód
estetycznie: piękno, Pięknie
jutro: wczoraj
niewygodny: niespokojny, nieprzyjemny
aparat: sprzęt
zapewniać: obstawać
wypowiedź: wymawiać, wyrażenie
kolej: popędzać, pociąg
niedoskonały: pełny, inwalidztwo, wadliwa
nabyć: nabycie, czerpać, kupować
ofensywa: nalot, atak, agresywny
ozięble: zimno
wykład: kurs
w-wyniku-czego: gdzie
postrzeganie: uczucie, spojrzenie, koncepcja
rozwijać: opracować
funkcjonować: ceremonia, praca, czynność
kula: tablet, strzał, piłka
wiązać: przymocować, granica
identyczny: podobnie
znaczny: wskazujący, wielki, wynikający, uderzający
objętość: masa, wielkość, Tom, guz
przedłużony: długi, marudzić
poirytowany: podrażniona, nieprzyjemny
smutny: nerwowy, smutny
wiązka: spójka, pasmo
siano: trawa, słoma
debata: niezgoda, sprzeczka
spokój: cisza
częściowy: wyjątek, część
mięso-wołowe: mięso
zjednoczyć: solidarność, uprząż, pogodzić, dołączyć-do
nóż: liść, miecz, nóż
fabryka: młyn
zero: zero, pusty
dziennik: gazeta, naciśnij
szczerze: lojalność, szczery
prawowity: prawny
akcent: wymawiać, nacisk, skupiać
Z-Poważaniem: na-poważnie
liga: Sojusz
zatwierdzać: zatwierdzenie
kończyna: członek, skrajny
steward: menedżer, sługa
ewolucja: reforma, ewolucyjny
Ankieta: czek, Wyszukaj
współczesny: nowoczesny
skandal: korupcja
obradować: celowo
symbol: notacja, gest
mycie: myć-się, pralnia
precyzyjny: właściwy, mąka, ostrożny
występowanie: incydent, okazja
wał: rów, ramię, drzewo
trzon: suchy, plemię, korzeń
korporacja: firma, organizacja
pierwszeństwo: przywilej, woleć, przewaga, wybierać
pęd: spowodować, impuls, pragnienie
usuwanie: dystans
twierdzenie: zatwierdzenie, nacisk
dostępny: odwiedzić, uznany
komedia: humor
spłukać: kolor, podniecenie
kod: dziedziniec, kodować
odpowiedni: wystarczy, właściwy
rozdzielać: rozprowadzać
historyk: historyczny
intensywność: gęstość, odcedzić
demokracja: republika
kredo: wyznanie
atrakcja: urok, powaga
koncert: festiwal
zniżkowy: na-dół
kanał: kanał, rura
skłonić: już-wkrótce, prośba, zwinny
brązowy: mosiądz, brązowy
część-garderoby: odzież
wyrzuty-sumienia: smutny, litość
Ekskluzywny: monopol, prywatny
porter: mieć-na-sobie, nośnik
dziarskość: linia
rozebrać-się: pasmo
ostatecznie: wreszcie
zespół: chór
drogi: drogi
główna-siedziba: centrala, centrum
ostry: ostry
Zakłopotany: nerwowy, wstyd
potomstwo: dzieci
sieć: sieć
samolot: ptak, powierzchnia, maszyna
częściowo: część
dumnie: duma
taras: balkon, dach
uchwyt: trzymać, pułapka
podmuch: rozerwanie
stado: armia, wojskowy
ciasno: rygorystycznie
rzut-karny: litość, wyrok
brud: wilgoć, kał, błoto
era: pora-roku
ambasador: posłaniec
rasa: zwielokrotniać, wyścig
ingerencja: kolidować, kłopot, nieład
składać-się: przechodzić, treść
przyjęcie: do-przyjęcia, zatwierdzenie, paragon
inżynier: mechaniczny
postój: stopa
alternatywny: alternatywny, zastąpić
pieczęć: dzwonić
licznik: dysk, sprzeciw, naprzeciwko
Wenus: piątek
wyimaginowany: wyobraźnia
wspinaczka: powstanie, pełzanie
pociągać: rysować, piętno
zadziwiający: niespodzianka, uderzający
konkurencja: rywalizować
kryształ: szkło
kabina-prysznicowa: łazienka, deszcz
filozoficzny: filozof, filozofia
głośny: hałas
urządzenie: sprzęt
transport: ruch-drogowy, czółenko
ostatecznie: wreszcie
strasznie: bardzo, straszny
kontemplacja: odzwierciedlić, odbicie
produkcja: przemysł, wytwarzać
wygodnie: wygodna
wystawa: wystawa, raport
rolniczy: rolnictwo, gospodarstwo
zadanie: Wyszukaj
przedłużenie: szczegół, poszerzać
spór: sprzeczność, sprzeczka
w-przybliżeniu: prawie
nad-głową: nad
powstrzymać-się: zahamowanie, zapobiec, powściągliwość, zachować
ochrona: ratować, opieka, zachować
pub: bar
basen: dolina, basen, umywalka
melodia: ton
zatrudnić: wynajem
zmartwiony: niespokojny, nerwowy
Starsi: podeszły-wiek, stary
Uniwersytet: Szkoła-Wyższa
ostrożny: ostrożny
wcześniejszy: Wschód, przed
skomplikowane: kompleks, trudny, opracować
przeprosiny: przepraszać, Przepraszam
przerażony: przestraszony, strach
zastąpić: alternatywny, dodatek, zastąpić
stosowanie: posługiwać-się
przywrócenie: naprawa, poprawa, odzyskać
żywopłot: płot
Podstawowa: opanować, opierać, oryginalny, zszywka
Belka: promień
tournee: odwiedzić, wyprawa
przesadny: sól
kompetentny: umożliwiać, w-stanie
pilny: już-wkrótce, osad
alarm: ostrzeżenie, alarm, obudzić
piekarnik: kuchenka
bułczasty: okrągły
standardowy: pospolity
błagać: błagać, uzasadniać
sznur: lina
wzdłuż: równolegle, Dalej, spójnik
wydobyć: zacytować, sok
zapalniczka: jasny
pół-kwarty: piwo
rura: rura
aleja: okazja
wydajny: wykwalifikowany, skuteczny, efekt
mieszać: mieszany, wymieszać
niepokojenie: nieład, kłopot
wykonawczy: menedżer
dziesiąty: dziesięć
porównawczy: porównanie
rano: ranek, błyszczący
klatka-szybowa: zamek, komórka
więzienie: więzienie, łańcuch
umiejętny: wykwalifikowany, przebiegły, w-stanie
krzyk: płakać
kompromis: umowa, harmonia
amunicja: strzał
asystent: kibic, Pomoc
trzcinowy: kij
kłócić-się: dyskutować, obstawać
logika: sprzeczka, racjonalny, racjonalność
panika: strach
krążenie: jazda-rowerem, cykl, ruch-drogowy, zwiedzać
stres: odcedzić
konsumpcja: posługiwać-się, konsumować, jeść
ponieść: wsparcie, zachować, trzymać, ponieść
wypadek: spadek, konflikt
brakuje: niewystarczający, ciąć, wadliwa
stopniowy: stopniowo
zmiażdżyć: zniszczyć, powaga, zdusić
zjawisko: incydent, rzecz
wykonać: bieg, akcja
powitać: zdrowie, Witaj, grad
monarchia: królewski, nieruchomość
zachować-się: relacja-na-żywo
bariera: przeszkoda, próg
krzywa: kokarda
polegać: liczyć
wygoda: z-łatwością, komfort
jagnięcina: owca, pełzanie
logiczny: racjonalny
dieta: jedzenie
sądowy: boisko, prawny
nieufność: wątpić, lojalność
pióro: wiosna, litość
dobrowolny: wolontariusz
kurtka: płaszcz, sweter
pływacki: pływać
imponujący: uderzający
pod-spodem: na-dół, po
prowincjonalny: wiejski, województwo
odszkodowanie: kompensować, dodatek
kelner: sługa
promować: przyśpieszenie, promocja, sprzyjać, naciskać, przyczyniać-się
poświęcać: zamierzać
wrogość: wrogi
plantacja: gospodarstwo, żłobek
expose: zarys, ujawniać, Otwarte
załatać: miejsce, Załącznik
przerwanie: złamać, kłopot
kciuk: cal
rewolucyjny: rewolucja
niesamowity: dziwne, zadziwiać
napiwek: półkula, kolec, skrajny, zarost, szczyt, Rada
groźba: groźny, niebezpieczeństwo
dżungla: las
typowy: pospolity, cecha-charakterystyczna
paliwo: olej
cichy: cicho
cel: powtórzenie, cel, los
kołek: sekret, igła
Mars: Marsz
współpracownik: związane, kolega, spójnik, pospolity, równolegle, przywiązany
złośliwy: niemoralny, zło
bankiet: uczta
szczegółowy: opracować, głęboki, zawias, szczegół, ostrożny
gabinet: gabinet
ustawodawczy: wprowadzać-ustawodawstwo, legislatura
margines: krawędź, pole
mistrz: bohater
puls: impuls
uciec: bieg, ucieczka
klauzula: strumień, ustęp
złożony: spójnik, kompleks
węzeł: trzymać, robić-na-drutach
związek: kontakty, raport, wzgląd
agencja: organizacja, firma, Biuro
szeroki-uśmiech: uśmiech, grymas
demonstracja: pokaz, Marsz
depresja: smutek
pojazd: maszyna
pożyczyć: kredyt, zacytować
obrzęk: puchnąć
temat: motyw, Przedmiot, nagłówek
werdykt: decyzja, reguła
sabat: sobota
identyfikacja: zidentyfikowania, tożsamość, definicja
fotografia: obraz, strzał
sprzymierzyć: przyjaciel, przyjaźń, zjednoczony
traktat: droga, rozciągać, sprzeczka
faborek: pasmo, film
plus: jeszcze
przezroczysty: przezroczystość, oczywisty
Perfumy: zapach
niepokoić: problem, kolidować, irytujący, kłopot
wykwalifikowany: w-stanie, zakwalifikować, wykwalifikowany
esej: artykuł, raport
jeździec: rycerz, jazda-konna
samotność: samotny
nadgarstek: dłoń
delikatnie: miękki, chudy, wreszcie
zero: zero, pusty
potępiać: wyrok
szczęka: sosna
jedyne-w-swoim rodzaju: zjednoczony
nieuchronnie: nieunikniony
bęben: taniec, pusty
kosz: pudełko, kosz
trwanie: chwilowy, stały, czas, długość
ważyć: zmierzyć, waga
klasztor: opactwo
publikować: publikacja, rozprowadzać, ujawniać
wgląd: wizja
Zdecydowanie: oczywisty, rygorystycznie, kurs, naprawdę, wyraźnie
przesunięcie: zmiana
dzisiaj-wieczorem: dzień
czynnik: powód, pracownik, współczynnik
bałagan: agresywny, nieład, zamieszanie
praktyka: poćwiczyć, akcja
sanktuarium: ołtarz
kurczyć: akronim, gromadzić
wydatek: koszt, posługiwać-się, spędzić
zachęcający: serce, inspirować
ekspozycja: wyrażenie, wystawa, raport, efekt
surowy: brutto, zielony
bilet: transparent, mapa
Wstecz: plecy
but: buty, but
oszustwo: iluzja
eksplozja: rozerwanie
kominek: komin
słoik: szkło, butelka, dzban, garnek
sos: ubieranie-się
zgniły: leniwy, niemoralny, ubogi
zachowanie: cecha-charakterystyczna, postępek
pożyczyć: kredyt, zacytować
nierozsądny: racjonalny, nonsens
żądza: ambicja
rocznie: rok
płyn: woda
dziecko: dzieci
szalony: głupek, oszukać
obalenie: wlać
osiągnięcie: sukces, ranga, wykorzystać
założenie: przypuszczać, wyobraźnia, podobno
humorystyczny: humor, wesoły
ekstaza: entuzjazm
przejście-na-emeryturę: iść-na-emeryturę, rezygnacja, pensjonat
parlament: legislatura, senat
nagły-wypadek: niespokojny, kryzys
paczka: owinąć, część, zamknąć
szuflada: pudełko, schody
wkład: przyczyniać-się, stawka
połączyć: Załącznik
podroby: odwaga, wymusić
druk: publikacja, wydrukować, naciśnij
rzecznik: prawnik, uzasadniać, pozwany
środowisko: atmosfera, środowiskowy
potwierdzać: okazać-się, gwarantować, wzmacniać
ogłaszać: ujawniać, publikacja
rezygnować: rezygnacja, iść-na-emeryturę
odrzucać: zaprzeczać, weto
twardy: trudny, okrutny
fragment: żeton, kąsek, skrawek, rozciągać
medytacja: opieka, odzwierciedlić
plama: miejsce
pogrzeb: pogrzeb, pogrzebać
hipoteza: przypuszczać
hipotetyczny-humor: spekulacyjny-humor, zarozumiały-humor, warunkowy-humor
transakcja: czynność, handel
skandal: gniew, pogarda, wstyd
różnią-się: zmienna, różnorodny, zastąpić
adwokat: prawnik, przedstawiciel
obrazić: winny
paczka: owinąć, kieszeń, zamknąć
klasyczny: klasyczny
ranczo: gospodarstwo
ciasto: ciasto, liczba-pi
dokładnie: dobrze, dokładność, rygorystycznie
rzucać: odlew
morski: marynarka-wojenna, morze
piosenkarz: czytelnik
Elektryczność: elektroniczny, strumień
obcy: obcy, Gość, pozaziemski
pęknięty: rozerwanie, pęknięcie
przygnębiony: smutny, smutek
mętnie: gruby
rozsądnie: powód, racjonalny
kabel: wydrążony, zgiąć
zilustrować: wyjaśniać, odzwierciedlić
przyjęcie: zatwierdzenie, paragon
notoryczny: dobrze-znane
zranić: zranienie
prawidłowo: dokładność, właściwy, dobrze
pastwisko: wierzba, łąka
robak: maska, głęboki
oszacowanie: ocenianie, domyśl-się
strój: organizacja, odzież, sprzęt, sukienka
pechowy: nieszczęśliwy, na-nieszczęście
ósma: osiem
zrelaksowany: komfort, relaks, cicho
sąsiadujący: prawie, otaczający
senior: weteran, roślina-mateczna, głowa
straszyć: alarm
nauczyciel: trener
rozbój: łup, ukraść
handlowy: handel, handlowy
wymarły: znikam
guzek: masa, torus, wygięcie
przypadkowy: losowy, chwilowy, zbieg-okoliczności, niespodzianka
lokal: dom, miejsce, budynek, wewnątrz
dostawa: przedstawiać
zakrzywiony: zgięty, zgiąć
produktywny: producent, wytwarzać
spuchnięty: puchnąć
hodować: sprzyjać, gospodarstwo
zmiana: zmiana, różnica
przeciwnik: rywalizować, sprzeciw
wnuk: wnuczka, bratanek
gwóźdź: paznokcie, kolec, śruba
życzliwość: hojny, dobrobyt, cnota, łaska
precyzja: dokładność
wskazanie: ocena-w-szkole
zmniejszenie: zredukować, ciąć
brzuch: brzuch, pępek
oburzony: nienawidzić
komponować: pisać, Stwórz
pasażer: podróżny
żądło: zasztyletować, gorzki, gryźć
równocześnie: W-międzyczasie
epizod: wynikający, część
trwały: zgodny, kontynułuj, stały
głodować: głodny
konsultacja: konsultować, Rada
kwaśny: kwas
podkreślać: obstawać, nacisk
parada: Marsz
kask: kapelusz
głosić: propaganda, publikacja
nocleg: hotel
rozpylać: lekarstwo
formalnie: urzędnik
niepokojący: nerwowy, kolidować, niespokojny, irytujący
przewidywanie: spodziewany, oczekiwać
gatunek: most, współczynnik, ranga, ocenianie, stopień
stołek: kał, krzesło
usprawiedliwienie: uzasadniać
cudzoziemiec: obcy, Gość
transport: ruch-drogowy, czółenko
zrozumienie: rozumiesz
reżyser: menedżer, głowa
czasowy: chwilowy, czas
ładnie: Pięknie
egzekwować: nakładać, przymusić, umożliwiać, policja
wszechstronny: głęboki, pełny
grozić: groźny
progresywny: postęp, rodnik
ratunek: źródło
ograniczać: ograniczony, chwycić, ograniczać, zredukować
pogratulować: pochwała
ubezpieczenie: bezpieczne
wyznaczać: oko
przerwać: przeszkoda, ciąć, kolidować, odciąć, złamać
stłumić: uciskać, zapobiec
warstwa: kolumna
trop: dowód, klawisz
ząb: zęby, dentysta, wygięcie
gwarancja: gwarantować, kaucja
procedura: proces, mechanizm, akcja, podejście
zalecenie: Rada
przepaść: złamać, otwarcie
sugerować: oznaczać
dołączać: przywiązany, splatać, przymocować
postawa: gest, wskaźnik, pozycja, stoisko
apartament: skrzydło, zestaw, apartament
klejnot: skarb, zakrętas
emocjonalny: uczucie, namiętny, podatny
beton: wskazujący, zgodny
połączyć: Sojusz, spójnik
szczyt: szczyt
waluta: pieniądze, moneta
cel: cel, skupiać
memoriał: pamięć, ostrzeżenie
osobno: rozdzielony, różnica, indywidualnie, samotny
taca: dysk
poziomy: saldo
czarter: konstytucja, papier, wynajem
pozycja: towary, artykuł, element, głos, dobry, pozycja
ekspansja: szczegół, poszerzać
skręcać: śruba, spin, ironia
tradycyjny: tradycja, klasyczny
angażować: w-tym, włączenie, treść
rutyna: pospolity, mechanizm
rozwiązać: pług, luźny, naprawić
kusić: droczyć-się, spowodować
nieudany: zawieść
polityk: polityczny
pokrywa: dach
naruszenie: zranienie
węzeł: porządkowy, przejście
szef: właściciel, menedżer, pracodawca, głowa, złodziej
sprzęt-komputerowy: sprzęt
pasmo: Wybrzeże, pasmo
skraj: krawędź, klif, warga
towar: handel, towary
z-dala: rozdzielony, z-dala, zdalny
przytułek: szpital, schronisko
potwierdzać: okazać-się, gwarantować
harmonogram: stół, kalendarz, wykres, usposobienie
rów: rów
komunalny: miasto
zamieszki: wymieszać
świadczyć: okazać-się
macierzyński: w-ciąży, mama
rzeźba: statua
smak: smak
Marka: instrukcja-obslugi, ocena-w-szkole
bagaż: bagaż
śmieci: nonsens, skrawek, wysypisko
narzędzie: instrument
chaos: nieład, zamieszanie
oskarżenie: garnitur
czas: nerwowy, czas
kura: kurczak
trym: ornament, zredukować, ciąć
dyskretny: mądry
opłakiwać: płakać
dialekt: Polskie
podstawowy: opierać
fracht: bagaż, bar, ciężarówka
wycierać: zamiatać
odmowa: zaprzeczać
Metro: sekret
pośredni: czek
formuła: równanie, naciśnij
oszukać: oszukać, manipulacja
straszyć: wahać-się, fobia
zarejestrować: lista, rejestracja
nieokreślony: niejasny, aoryst
nadwyżka: dodatkowy
dreszcz: drżenie
tkanka: organizacja, sieć, tkanina
wersja-robocza: zarys
zabawka: lalka, bawić-się, hazard
schodek: schody, skala
przejście: zakażenie, zmiana, przechodni, przejście
przycisk: klawisz
niedobry: niegrzeczny
program: plan, program
produkcja: uprzemysłowienie, młyn, wytwarzać
strefa: pole, regionalny, pasmo
dziewiąty: dziewięć
alkohol: wino
chciwy: ambicja, chciwość
sterować: kierować
wpływowy: skuteczny, przenikać
otaczać: kołnierz, oblężenie
utopić: umywalka, kąt
zjeżdżalnia: poślizg
siać: powstanie, chleb, świnia
dominujący: wielki, nalot
przywództwo: hierarchia, instrukcja-obslugi
Pamiętnik: gazeta, kalendarz
świętować: namawiać
zamieszanie: podniecenie, hałas, irytujący, zamieszanie
zastępca: przedstawiciel, alternatywny
samochód: silnik
poprawka: rewizja, zmiana
pionowy: stoisko, wzdłużny
niewystarczający: niewystarczający, wystarczy
cholerny: chudy
wnioskowanie: domyśl-się, wniosek
inferential-humor: indukcyjny-humor
ogłoszenie: ogłoszenie, handlowy, propaganda
kradzież: ukraść, popełnić-plagiat
spontaniczny: instynkt, arbitralny
użyteczność: organizacja, posługiwać-się, instrument
łączyć: przymocować, hak, splatać, dołączyć-do
ku-dołowi: na-dół
interwencja: kolidować
odrodzenie: wskrzesić, poprawa
Internet: handel
fizycznie: fizyka, ciało
kropka: miejsce
wstrząsający: zaszokować
niegrzecznie: niegrzeczny
zrównoważony: zgodny
indeks: wykładnik-potęgowy, lista, wskaźnik
przekazać: wysłać, rozprowadzać
na: nad, na-zewnątrz, Naprzód
pogawędzić: gadanie, Statystyka
bursztyn: żółty
tona: ton
płynnie: wygodna
napięcie: odcedzić, podniecenie
wieloryb: wybór
trujący: zatruć
koncesja: drgnąć, przywilej, obniżka-cen
pracownik: pracownik
skłonić: zanurzać, sprzężony
toaleta: gabinet
obrażać-się: atak, przestępstwo
uraza: nienawidzić, zemsta
hart: cierpliwość, odwaga
przewidywać: nadzieja, oczekiwać
rytm: pokonać
szczur: mysz
odpowiadać: korespondencja, garnitur, właściwy, odpowiadać
zatrzymać: zapobiec, chwycić, zachować
interpretować: wyjaśniać
salon: sala
działać: manipulacja, praca, bieg, akcja
drenaż: rynna, bieg
płaca: zapłacić
paskudny: nienawidzić, zło, nieprzyjemny, niezadowalający, brzydki
cmentarz: pogrzeb
gips: kreda
kran: rura, mleko
oddalić: worek, ignorować, zaprzeczać, weto, rozróżniać, nadmierność, przebaczyć
sprowokować: podniecenie, podrażniona
zamieszkać: pobyt, relacja-na-żywo
dekoracja: ornament
palec-u-nogi: chodzić-na-palcach, stopa, palec, łapa
niemożność: inwalidztwo, słaba-strona
wymyślać: wynalazek
określić: determinantem, opracować, opisać
ograniczony: ograniczony, granica
szafka: gabinet, półka
stojak: półka
superintendent: konduktor, inspektor
prezentacja: przedstawiać, pokaz, wystawa, promocja
gumowy: piłka, elastyczny
wykluczać: pozbawiać, kasować, rozróżniać
uprzywilejowany: przywilej
pustelnik: ascetyczny
zarysować: zeskrobać, początek
wkręt: śruba
zbadać: przestrzegać, wykorzystać
ubezpieczać: gwarantować
cylinder: dysk
Podsumowanie: zarys, abstrakcyjny
nieprawdopodobne: prawdopodobieństwo
rój: trzoda, syn
systematyczny: mechanizm
prawie: naprawdę, prawie, praktyczny
klient: zwyczaj, Gość
katalog: lista, stół
chemia: chemiczny
piec: chleb, gotować
przebić: zasztyletować, przenikać, nudziarz, przedziurawić
urywek: łza, chwycić, porwać-kogoś
uruchomić: emitować, odlew
rolnictwo: rolnictwo
aktorka: aktor
teatr: teatr, sala
narkotyk: lekarstwo
niekorzystny: gorzej, niekorzyść, rewers, negatywny, szkodliwy
słodycze: mennica, czekolada, słodki
pasta: zestaw, naszyjnik
skazać: pułapka, karać, winny
prowadzić-śledztwo: sonda, przestrzegać, czek
pakiet: owinąć, zestaw, zamknąć
czołgać-się: pełzanie, czołgać-się
kłapnięcie: muzyka-pop, trzask, obraz, fala, już-wkrótce
opona: zarodek, dzwonić
zauważalny: uderzający, oczywisty
rdzeń: opierać
poprzednik: przodek
podobnie: również, podobnie
zapora: kurz
śliski: poślizg
transformacja: zmiana
frędzle: krawędź
Lokalizacja: pozycja, miejsce
grupa: konglomerat, masa, pasmo
cytat: zacytować
opieka: pracowitość, opieka
do-przyjęcia: do-przyjęcia
podrzucenie: odlew
szczebel-drabiny: stąpać
stężenie: akumulacja, skupiać
poręczny: praktyczny, wygodna
przynęta: smak, elementarz
różnorodny: różnorodny
kawałek: żeton, dysk, kąsek
wiercić: nudziarz, kopać
odpowiadać: reakcja, zwrot, odpowiadać
śmiertelność: śmierć
chwast: trawa
stosunkowo: Tom
matematyczny: matematyka, atletyczny
moralnie: morał
łapanie-tchu: westchnienie, oddech
wyścigi: wyścig
izolacja: dysjunkcja, rozdzielony
czasami: czasami
dorosły: dojrzały
trudność: gorzki, nieszczęście, problem, kłopot
plotka: plotka, głos
wytrzymać: zachować, Niedźwiedź, trwać
junior: młody
robienie-na-drutach: robić-na-drutach
pośredni: bezpośrednio
precedens: instancja
przejście: promień, sala, przejście
zaprzeczać: sprzeczność, zaprzeczać
wykupić: ratować, kompensować
ścieżka: droga, Przejściu
bieg: sprzęt, zęby, żebro, bieg
uroczystość: uczta
przytulny: ciepło, wygodna
wydawniczy: publikacja, rozprowadzać
klient: Gość, kupujący
dywan: wykładzina-podłogowa, piętro, koc
przegroda: liczyć
perspektywy: spojrzenie, wizja
estetyczny: piękno
oburzać-się: nienawidzić
poza: zaproponować, spowodować, stoisko
zadowolenie: zadowolona
organizm: istota
niezrozumiały: rozumiesz
dobitny: nacisk
południe: popołudnie, południe
lilia: czytać
rzeczownik: nominalization, imię
składanie: zagięcie, zgięty
pomocny: Pomoc
trwać: obstawać, kontynułuj, trwać
wylot: wyjście, gniazdo-elektryczne, wyjazd
dziedziczyć: dziedzic
prędkość: prędkość, osad
obraźliwy: słowny
niedobór: niewystarczający, ciąć, pominięcie, wadliwa
zagwarantować: gwarantować
niesprawiedliwy: dobrze
zastąpić: zastąpić
wiadro: beczka, łyżka
organizacja: organizacja
głównie: zwłaszcza
rytuał: ceremonia, kult
udo: szynka, stopa
szafa: odzież, gabinet
tekstura: organizacja
burzliwy: gwałtowny
bagno: bagno
nieświadomy: nieświadomy
inicjał: otwarcie, oryginalny, początek, pierwszy, prymitywny
minimum: najmniej
korekta: reforma, rewizja, naprawa
przeoczyć: ignorować, zapomnieć
jednomyślny: zjednoczony
węgiel: węgiel
cewka: plik, bułka, kręcone
chrupiący: kruchy, ostry
słownictwo: słownik
przechadzka: zbłądzić
zdatność: poćwiczyć, gimnastyka, stan
narodowość: nacjonalizm, krajowy
smak: smak
nieważny: konieczny, trywialny, nieistotny
poncz: pokonać
krok: postęp, stąpać
oś: ramię, wydrukować
dogadzający: choroba, zadowolona
niezawodny: wierny
obrzydliwy: nienawidzić, brzydki
etyczny: morał
upadek: spadek
poduszka: rzeka
zawieść: fałszować, zniszczyć, zadziwiać, zawieść, zawstydzić
mit: fabuła, legenda
własność: nieruchomość
przestraszyć: przestraszony, straszny, strach
hamulec: złamać
orzech: fasola, nasienie
powiększać: puchnąć, wzrost
słoneczny: światło-słoneczne
dziób: warga, jednostka
wynajem: smycz, wynajem
stosunek: kontakty, porównanie, skala, raport, analogia
grzebień: szczotka, ramię, grzbiet
Tłumaczyć: tłumaczenie, trzepnięcie
rekreacja: zabawa, wakacje, relaks
kaprys: kolor
próba: instancja, próba
liczba-mnoga: masa
inicjatywa: plan, próba
galaretka: dżem, mleko
anarchia: nieład
profil: zarys, plik, Strona-www
finanse: pieniądze
podstawowy: opierać, zszywka
wygnać: wysypisko, nalot
elektryczny: elektroniczny
ziele: trawa
prosperować: zakrętas
podobieństwo: analogia, być-podobnym, solidarność
prywatność: prywatny
arena: pole
podróżny: podróżny
cząstka: atom, nasienie
wrodzony: oryginalny
mieszkaniec: rezydent
Flet: gwizdać
reprodukcja: płodność
ma-zakres: długość
sałatka: sałata, moc
barwnik: kolor
wykazać: okazać-się
etyka: morał
oficjalnie: urzędnik
drażnić: kolidować, irytujący, droczyć-się, nawoływać, nudziarz
poślizg: poślizg
cecha: cecha-charakterystyczna, nieruchomość, rozciągać
kompozytor: muzyk
piłka-nożna: rzut
Współpraca: współpraca, Sojusz, przyczyniać-się
kontynuowanie: kontynułuj
nieprawidłowy: niezwykle, głupek
sekwencja: łańcuch
ściśnięcie: naciskać
sprzęt: chwycić, sprostać, sprzęt
krawężnik: zahamowanie, bruk, powściągliwość
reklama: ogłoszenie, propaganda
wycofanie: regresja, gniazdo-elektryczne, wniosek
hipoteka: zakładnik, kredyt, pionek
wyrozumiałość: cierpliwość, Niedźwiedź
stłumić: zapobiec, uciskać
małżonka: mąż
ważny: skuteczny
zawór: awangarda
zbudować: Stwórz, budynek, sformułowanie, faza
para: parowy, para
nietoperz: kij, Klub, Naprzód
sprzeczny: sprzeczność, nieistotny, kontrastujące
automatyczny: bezpośrednio
wyraźny: Otwarte, przezroczystość, aksjomat
faktycznie: skuteczny, efekt
poleganie: zależność
sprawdzać: przestrzegać, czek, zwiedzać, analiza
dziwnie: dziwne, niezwykle
zaciąg: rysować, łup
żenujący: wstyd, zawstydzić
wyłączone: inwalidztwo, pasywny
arogancki: duma
kędzior: kręcone, dzwonić
klejnot: kamień, zakrętas
rocznica: urodziny
prestiż: kredyt
zaniedbanie: pominięcie, pogarda, obojętność
samego-siebie-: prywatny
dyskryminacja: wyjątek, rozróżniać
kontynentalny: kontynent
cel: cel
stoisko: robić-zakupy, stoisko
inwestować: inwestycja
rejs: statek
Rajd: solidarność, akcja
plotka: plotka, głos
aktywnie: na-poważnie
czek: czek
przedział: apartament
swoiście: zwłaszcza
huk: muzyka-pop, rozerwanie, strzał
agregat: brutto, pospolity
frakcja: część, stawka
nielegalny: bezprawny, dziki
rozwiązać: kasować, rozpuszczalny, rozpuszczalnik
równowaga: saldo
badanie: sonda, analiza
cebula: kokarda
powinowactwo: analogia, solidarność, zależność
nieuczciwy: wierny
kolidować: konflikt, zaszokować, kolidować
fotel: krzesło, sofa
ciasto: mąka, masa, drożdże, ciasto
rozpocząć: dołączyć-do
trans: wizja
odmowa: zaprzeczać, odpady
zmienność: różnica, właściwy, sprzeczność
wchłanianie: skóra
kolektyw: masa
aktualny: czas
najechać: atak
zwolnienie: worek, nadmierność
znacznie: w-dużej-mierze
eksperymentalny: pilot
film: film, telewizja, obraz
reklama: propaganda, promocja, ogłoszenie
rozszerzać: poszerzać, szczegół
upadek: potknąć-się, spadek, zanurzać, odzież
fałszować: Stwórz, fałszować
skamieniałość: olej, archeologiczny
przymus: przeszkoda, regulacja, powściągliwość
swada: entuzjazm, przyprawa, doświadczenie, smak, skóra
wybredny: irytujący
mała-wioska: przedmieście, wieś
Boom: zakrętas, odbić-się, rozerwanie
reprodukować: Kopiuj, naśladować
kongres: montaż
winogrono: wino
warsztat: studio, seminarium
spadek: zredukować, ciąć, spadek
wymowa: wymawiać
wyrok: decyzja, wyrok, reguła, sędzia, jurysdykcja, kryzys
koncentrować: ostrożny, skupiać
Cofnij: ujawniać, plecy
prom: jacht, statek
bezpośredni: proste, bezpośrednio, z-łatwością, przezroczystość, liniowy
wysokość: długość
oznaczać: pokaz, oznaczać
eksport: wyjście
przestępca: kometa, winny
dezaprobata: sprzeciw, weto
par: para, saldo
znieść: kasować
dostosować: rewizja, naprawić, dostosowanie
członkostwo: członek
wskaźnik: zmierzyć, skala, wielkość, chudy, wskaźnik
tolerować: przebaczyć
cześć-p: zad, talia
przylegać: kierować-się, dołączyć-do, kij, zachować
odpychać: zapobiec
niepokój: nieład
czystość: dokładność, czystość
luźny: relaks, luźny
skurcz: nieśmiałość
dziennikarz: reporter
objaw: wystawa
rower: jazda-rowerem, cykl
smoła: bruk
spirala: spin
komentarz: szczepionka, definicja
transmisja: zakażenie
balotować: głos, wybór
potencjał: w-stanie
wybieralny: w-stanie, dobrze, zakwalifikować, właściwy
pętla: jazda-rowerem, zawias, dzwonić
robotnik: pracownik
zaskarżyć: winić
licencja: pozwolenie
porzucić: rozładować-się
ego: sami, oddech
strumień: wyrzucać, ptak, strumień
naruszać: być-nieposłusznym, ciąć
uzależniony: zależność
przetrwanie: życie, samogłoska
zamrażać: mrożony
splot: robić-na-drutach
beneficjant: ustanowiony, beneficjant
apatia: obojętność
zorganizować: organizacja, przygotować, wprowadzać-ustawodawstwo, zorganizowany
prawdopodobnie: może, podobno
akord: umowa
krwawić: krew, krwawy
wykrywanie: uznany, Wyszukaj, ujawniać
rozbić: zniszczyć, złamać
ułatwiać: przyśpieszenie, sprzyjać, przyczyniać-się
częstotliwość: cykl, wahać-się
ścieg: szycie
informator: dowód
posiekać: gryźć, ciąć, stek
grzewczy: ciepło
przygnębiający: niezadowalający, smutny
wspaniały-wyczyn: rewolucja, strzał, uderzenie
współczujący: litość
myśliciel: intelektualny
budżet: saldo
obywatelski: cywilny, miejski
wstawić: wchodzić, wzrost
medytować: odzwierciedlić, myśleć
elastyczny: proste, zgiąć, elastyczny
płyta: płyta, tablet, kuchenka
kwalifikacja: talent, zakwalifikować
przełącznik: rewers, konwertować, klawisz
ręcznik: tkanina
dekada: dziesięć, trzymać
wielokrotność: różnorodny, jeszcze
bandaż: ubieranie-się, przymocować
schludny: schludny
klaskać: poklepać, bić-brawo
klon: Palma
grabie: zamiatać
pustka: pusty
szpik-kostny: olej, mózg, gurda
osłony: płaszcz, koperta, strąk
absorbować: wykorzystać, ssać, uścisk
przewidywanie: możliwy-do-przewidzenia, domyśl-się
kształcić: edukacja, pociąg, nauczanie
zapytanie-ofertowe: sonda, prośba, Wyszukaj
dominacja: reguła
rodzicielski: roślina-mateczna
brać-udział: delta, dołączyć-do, zajęty
winda: winda
boczny: bok
odraczać: opóźnienie
odraza: pogarda, nienawidzić
jądro: jądrowy, komórka, zarodek
metafora: instancja
zdrobnienie: mało, mikro
bomba: pompa
krytycznie: głęboki, krytyk
rdza: przechodzić
rezerwacja: zachować, chwycić
szyć: szycie
chemik: chemiczny
hol: złamać, sala
początek: początek, nalot, atak
nurkować: zanurzać
nieprzyjazny: wrogi
spis-ludności: obliczenie
potępiać: oskarżać, wyrok
len: bielizna
zawieszać: zapobiec
policzkować: pokonać
zrelaksować-się: relaks
zaloty: dziedziniec
towar: towary
ciągłość: spójnik
odwrotność: wymiana, odwrócenie
recepta: lekarstwo, Kopiuj
bańka: piana
łopata: szczypce, wiosło
wykorzystać: wykorzystać, posługiwać-się, spędzić, uprząż, konsumować
trwały: długi
rodowód: znajomy
cynk: umywalka
którykolwiek: cokolwiek, który
skończone: ograniczony, wreszcie, gotowe
pomocniczy: kibic, AIDS
rozchwytać: zniekształcać, bić-się, uderzenie
akademicki: edukacja
opona: zarodek, dzwonić
konsument: posługiwać-się
ważność: wartość, kredyt
w-przybliżeniu: prawie, przybliżony
trykotowy: robić-na-drutach
mikroskop: teleskop
cywil: cywilny
pasek: smycz, lina
symboliczny: gest, tożsamość
dostosować: dostosowanie, sprostać, rozpisać
prawdopodobieństwo: prawdopodobieństwo, w-stanie
subiektywny: umysłowo
zaimek: sumienie
niewłaściwie: źle, nadużycie
zniechęcać: zawstydzić, ambicja
przybysz: Gość
nieskończoność: bezokolicznik
graficzny: wykres
figa: kształcie, obraz
nisza: zgodny, klawisz
zawieść: niezadowalający, zdradzać, zawieść
występ: plan, pokaz
oswobodzenie: rozładować-się, zbawienie
przepis: bodziec
koncesja: przywilej
absurdalny: nonsens, nieistotny, niewystarczający
obrót: cykl, rewolucja, spin
pokrętło: pączek
metr: zmierzyć
ograniczenie: granica, powściągliwość, regulacja
kategoria: społeczność, ranga
rasowy: wyścig, rasizm
podstawienie: w-zamian, zastąpić, zmiana
innowacja: wynalazek
konfrontować: sprostać
zakaz: zaprzeczać
dekoracyjny: ornament
lobby: spowodować, sala
ciskać: odlew, kręcone
zwój: książka, bułka, kręcone
mechanik: mechaniczny, rzemieślnik
agresja: atak, agresywny, przekraczać
Hej: Halo, Witaj
pomiary: zmierzyć
rywalizować: zmagać-się, rywalizować
akademia: Szkoła-Wyższa
nowicjusz: rekrut, świeży
rozwiedziony: rozwód
mleczarnia: mleko
zbiornik: czołg
zakupy: robić-zakupy, handel
bezwarunkowy: zgodny
strategiczny: strategia
forma: modulo, forma, wydrukować, odlew
powtórka: poćwiczyć, powtórzenie
naleganie: obstawać
poprzedzać: przed
średni: średniowieczny, wpół, talia
turysta: podróżny, turystyka
napój: drink
pomny: ostrożny
artykułować: wyjaśniać, wyrażenie
re-: następnie, plecy
modyfikować: rewizja, zmiana, zastąpić, splatać, reforma
diagram: wykres, mapa
dedukcyjny-humor: indukcyjny-humor
zasypać: uciskać
mobilne: telefon, komórka
podnieść: promocja, winda
paradoks: sprzeczność
wyolbrzymiać: sól, wyolbrzymiać
blondynka: żółty
Wskazówka: ocena-w-szkole, Hasło, kij
biegacz: sala
pertraktować: gadanie, dyskutować
reżim: reguła
tolerancja: tolerancyjny, Niedźwiedź
opcja: alternatywny, ogórek
krucjata: ruch
epidemia: tragedia, tłumaczenie
technika: techniczny, podejście, inżynieria, sprzęt
terminal: wreszcie
ukończyć: przechodzić
wydajność: koszt, wniosek, publikacja, wyjazd, wydajność, wyjście
Lokalizować: miejsce
zaniedbanie: pominięcie, standard
kontekst: środowiskowy, scena, konotacja
koalicja: Sojusz
wada: winić, źle, inwalidztwo, niekorzyść
przyznać: przyznać
nadawanie: publikacja, wysłać
cyferblat: wybierać, dzwonić, gromadzić
rozpowszechnienie: popularny
coraz-bardziej: wszyscy
przekształcać: zmiana, konwertować
latawiec: smok
dwuznaczny: niejasny, sprzeczność
kawiarnia: kawa, bar
nagroda: nagroda, premia, przyznać
etykieta: studio, ocena-w-szkole
pochlebny: zatwierdzenie, przyznać
pokrewieństwo: analogia, socjalista
realistyczny: naprawdę
gad: wąż
na-podwórko: na-zewnątrz, Otwarte
politycznie: polityczny
pozostałość: szczątki, odpady
taśma: kaseta, pasmo, film
słodki: miękki, słodki
doustny: słowny, warga
spekulować: domyśl-się
usunąć: wyrzucać, rozładować-się
skaza: miejsce, inwalidztwo
pomijać: taniec, spędzić
kubek: filiżanka, grymas
klin: kolec, stawka, kąt
zwolnienie: obniżka-cen, wyjątek, nadmierność
przenośny: mało
zawijanie: Opakowania, owinąć
blask: talent, piękno, blask
płetwa: wiosło, balet
mruczeć: szept
jagoda: zatoka
imigracja: emigracja
motyka: pług
chirurgia: chirurg
gromadzić: akumulacja, zdeponować, gromadzić
rufa: kał, rura
brzuch: brzuch
implikacja: konotacja, włączenie, wniosek
zachęta: bodziec
klucz: śrubokręt, klawisz
Wieś: wiejski, przedmieście, pole, wieś
degradować: zniszczyć, zredukować
rodzimy: Natura, oryginalny, rezydent
stos: wysypisko, grzbiet, komin
dysk: dysk
tendencja: postępek, kierunek, zgięty, usposobienie, dryf
zbiorowy: firma, pospolity
uniewinnić: pozbyć-się
nietrwały: niepewny, nietrwałość
zgodny: zgodny, równolegle, przystający,-zgodny
telefon: telefon
odkurzać: pusty
chwycić: zasztyletować, brać, chwycić
konwulsja: trzęsienie-ziemi, rozerwanie
nudny: znudzony, nudziarz, irytujący
teczka: zestaw, portfel
szpara: pęknięcie
powikłanie: problematyczny, myto
interweniować: kolidować
polarny: biegunowość, skrajny
delegat: przedstawiciel, posłaniec
wola: siła-woli, pragnienie
przepowiadać: możliwy-do-przewidzenia, domyśl-się
optymizm: nadzieja, uwierzyć
skórka: skóra, strąk, kora
rzeźbić: gryźć
wahać-się: pływak, szybować, wahać-się
sektor: pole, przemysł, regionalny, część
nazwisko: imię, oni
instytut: zorganizowany, firma, organizacja
pilna-sprawa: niespokojny
przyjemny: dobry
powstrzymać: zapobiec
negacja: zaprzeczać
zwycięzca: sukces
złożony: mieszany
wpływ: efekt, konflikt
włókno: włókno
łyk: łyk
wizualny: optyczny, scena
pazur: łapa
powód: aktor, nośnik, powód
ubolewać: litość
wprowadzić-w-błąd: zniekształcać, zadziwiać, oszukać
zakazać: zahamowanie, zapobiec, zaprzeczać
wykonawca: aktor, artysta, gracz
Turniej: wyścig
wymaganie: prośba, stan
minus: najmniej
nieporządny: lekkomyślny
zakaźny: zakażenie
podkreślać: obstawać, nacisk
spodnie: spodnie
dezorientować: puzzle, zadziwiać, zawstydzić
poświęcać: wolontariusz, zamierzać
chirurgiczny: chirurg
prawdomówność: fakt, dokładność
setny: sto
pochyła: stromy, zanurzać, zgięty
blisko: prawie, już-wkrótce, otaczający
normalnie: pospolity, często, ogólnie, zmierzać
mylące: sprzeczność, puzzle, zamieszanie
proporcjonalny: porównywalny, saldo
nie-zgadzać-się: niezgoda
podrażnić: gniew, kolidować, droczyć-się, podrażniona
wybitny: lepiej, uderzający
inicjacja: początek
osad: osad
przerazić: alarm
hobby: zabawa
gramatyczny: gramatyka
liczbowy: numer, cyfrowy
kryterium: standard
prognoza: możliwy-do-przewidzenia, domyśl-się
potępiać: zaprzeczać
egzotyczny: obcy, dziwne
żarówka: lampa
zwiększać: poszerzać, wzrost, wyolbrzymiać, leczyć-się
połączenie: stopić, połączenie
głosowanie: wybór
utalentowany: talent, wykwalifikowany
odwilż: stopić
wyprostować: rozciągać, naprawić
udekorować: ornament
prezydencki: przewodnictwo
guz: przedwczesny, zwielokrotniać, rzut, wygięcie, guz
gratulacja: pochwała
skandować: zamiatać
upoważniać: umożliwiać, dobrze
zakłady: stan
technicznie: techniczny, inżynieria
empiryczny: doświadczenie
zdominować: opanować
ogłaszać: ogłoszenie, propaganda
dyfuzja: rozprowadzać, publikacja
wypasać: zeskrobać
zestaw: sprzęt, pudełko, zestaw
praktykujący: lekarz, trener
moczyć: ssać, zanurzać
ochrona: chronić, ratować, opieka
szlam: błoto, bruk, dryblować
wyzwanie: trudny
zanieczyszczenie: zanieczyszczać, korupcja
chemikalia: chemiczny
partia: trzoda, impuls, Tom
mama: mama
przerażający: straszny, groźny
specjalista: ekspert
tęsknić-za-kimś czymś: pragnienie
łazienka: łazienka
hazard: hazard, bawić-się, przygoda
całka: konieczny, zintegrowany
wyeliminować: pozbyć-się, kasować
groch: fasola
dodatek: Załącznik, dodatkowy, dodatek
cyrkulować: rozprowadzać
włącznie: zjednoczony
sprzedawca: kupiec
nękać: nerwowy, kolidować, obsesja
eksplodować: rozerwanie
wyważać: ciekawość, dźwignia
rozlanie: nieszczelność, wlać
gratis: darmowy
składnik: element
deficyt: Otwarte
przykre: nerwowy, irytujący, nieprzyjemny, smutny, nieład
mieszkaniowy: dom
fotograficzny: faza, obraz, fotograf
szkodnik: owad
pigułka: tablet
obecnie: obecny
głoska-bezdźwięczna: naciśnij
wrak: ruina
ciało: ciało, zestaw
menu: lista
pęknięcie: pęknięcie
forum: peron, nudziarz, boisko
pęd: prędkość, impuls
skos: lutnia, zgięty
dachówka: cegła
półka-na-książki: biblioteka, księgarnia
obliczenie: obliczenie
producent: producent
monetarny: pieniądze
przedstawiać: opisać, odzwierciedlić, przedstawiać
inflacja: puchnąć
marginalny: krawędź
kaprys: wyobraźnia
osłabiać: zniszczyć
zgodny: rygorystycznie, spójnik, zgodny
zasadniczo: Warunki
zamierzony: celowo
niedobitek: rodzina
strumień: rzeka, strumień
konkurencyjny: rywalizować
biżuteria: ornament
alkoholowy: pijany, wino
dyskryminować: rozróżniać
wojowniczy: rodnik, terrorysta, wojskowy
rozbrajać: ramiona
istotny: konieczny, decydujący
zadanie: praca, poćwiczyć, obowiązek, przydział
kontyngent: przywilej, przydział, kwant
wykop: dół, kopać
wapń: rzut
uczcić: namawiać
historycznie: historyczny
cześć: Halo, Witaj, zbawienie
eliminacja: pozbyć-się, pominięcie, kasować
napięty: schludny
odprężający: komfort, wygodna, relaks
skuteczność: skuteczny, efekt, umiejętność
wrażliwy: podatny
sportowiec: atletyczny
naszywka: pasiasty, linia, pasmo, film
fasada: maska, wizja
klips: zszywka, szczypce
prototyp: instancja, oryginalny
offsetowy: sprostać, kompensować, odchylenie
zero: zero, pusty
ograniczać: zapobiec, ograniczać, zredukować
kleszcz: ocena-w-szkole, wesz
faktura-VAT: czołg
rzepak: przekraczać
zero: zero, pusty
warunkowy: przywiązany
kulturalny: kultura
technologia: techniczny, sprzęt
marketing: handel
krawat: krawat
ekonomicznie: gospodarczy
administrator: menedżer, powiernik
przedstawiać: opisać, przedstawiać
wnuczka: wnuczka, bratanek
podwójny: dwa, para, bliźniak
synteza: oryginalny, zainstalować, zestaw
specjalność: zawodowy, cecha-charakterystyczna
dziwaczny: dziwne
petent: kandydat
lingwistyczny: język, językoznawstwo
Grzyb: korek, gąbka
dynia: zdusić, gurda
podnieść: winda, powstanie, postęp
fenomenalny: niezwykle, solo, Wspaniały
dynamiczny: moc
Poprawić: rewizja, naprawić, czek
rozkład: dysjunkcja, spadek, analiza
męczący: zmęczony
kampus: Szkoła-Wyższa, szkoła
rozprawa: Praca-dyplomowa
statystyczny: Statystyka, statystycznie
formułować: przygotować, sformułowanie
kanapka: chleb
zero: zero, pusty
stymulacja: przyśpieszenie, podniecenie, podrażniona
cenzura: cenzor, regulacja
wyposażyć: uzupełnienie
mianować: nominacja, zaproponować
Anuluj: kasować, skrawek, udaremnienie
metr: zmierzyć
deprymować: uciskać
pan: Pan, opanować
zrekonstruować: naprawa, poprawa
rozjemca: reguła, sędzia
atomowy: atom, jądrowy
kontrowersyjny: sprzeczność
wyrafinowany: kompleks, nowoczesny
skurcz: wzruszać-ramionami
niewłaściwy: nieistotny, niewystarczający
osad: osad
odkosz: pogarda, winić
wariant: różnorodny
krytykować: krytyka
nuda: znudzony, kłopot, nieszczęście
współpracować: współpraca, spójnik
analizować: analiza, analityk
opad-deszczu: deszcz
kiełkować: pączek
samolot: ptak
Pikantny: ostry
elastyczność: elastyczność
rakieta: pocisk
przysłówek: koperta
niestabilność: niepewny
pozbawienie: pozbawiać, niekorzyść
kucanie: kucać
Generować: wytwarzać, Stwórz
przybliżenie: przybliżony, podejście, konwergencja
morale: obudzić, morał, umysłowo
optymistyczny: nadzieja, uwierzyć
klasyfikować: klasyfikacja, rozprowadzać
program: kurs, program
na-dworze: na-zewnątrz
zareagować: reakcja, czasownik
scenariusz: scenariusz, linia, pismo
szantażować: wymusić
premia: nagroda, premia
kapitał: nieruchomość, obecność, przewaga, kapitał
zmienność: różnica
dwuznaczność: niejasny, sprzeczność, niepewność
zero: zero, pusty
nijaki: neutralny
upośledzenie: zawstydzić, przeszkoda, inwalidztwo, niekorzyść
fotografia: obraz
brak: ciąć, brak
przemieszczenie: zastąpić
grzyb: bakteria, gąbka, korek
sformułowanie: sformułowanie, tekst
dyplomata: dyplomatyczny, posłaniec
zainicjować: przedstawiać
łączyć: uprząż
roztrzaskać: złamać
wdychać: inspirować
krążek-linowy: rola
chudy: chudy
wyborca: okręg-wyborczy
federacja: federalny
ruchliwość: ruch
rozładować: rozładować-się
siedlisko: schronisko
przywołać: wymieszać, spowodować
rozcieńczać: chudy
do-widzenia: do-widzenia, pożegnanie
zburzyć: zniszczyć
składnia: pensjonat
podkowa: koń
zniekształcenie: odchylenie, zniekształcać
zatrzasnąć: pokonać
istotne: zgodny, właściwy, związane
funkcjonalny: praktyczny, praca
wypierać: zastąpić, wyrzucać, drgnąć
autonomia: niezależność
smród: zapach
rozróżnianie: rozróżniać
dostępność: nabycie
student: student
wykres: wykres, mapa
fascynować: urzec, droczyć-się
słodkie: Pięknie, słodki
brzuszny: brzuch
umiejętność-czytania-i pisania: edukacja
syntetyczny: sztuczny
trener: trener
chronić: przechowywanie, ratować, chronić, zachować
Śmieci: skrawek, wysypisko, odpady
zdjęcie: obraz, strzał
podręcznik: instrukcja-obslugi, książka
konsolidować: wzmacniać
wymusić: przymusić, ograniczony, wymusić
ekonomista: gospodarczy
lekkoatletyka: atletyczny, poćwiczyć
wicie-się: grymas
jod: minerał
infekować: zakażenie, zanieczyszczać
projektant: zdecydowany
wydzielać: wydzielanie, chować, wyrzucać, sekret, rozróżniać
szpinak: sprzyjać, sałata
intensywny: skrajny, gwałtowny
przekonywający: wskazujący
debiut: pierwszy, początek
tysięczny: tysiąc
wnętrz: wewnętrzny, głęboki, wewnątrz, pokryty
unieważnić: pozbawiać
amplituda: wielkość
wymiar: kierunek, po, wymiarowy, Dalej
Biblia: pismo
plakat: transparent, sieć
przyśpieszyć: osad
zintensyfikować: wzmacniać, wzmacniacz
poronienie: poronienie
zazwyczaj: ogólnie, pospolity, często, zmierzać
zaangażowanie: obietnica
kolejka: ogon, zamówienie
wspornik: zszywka, łokieć, hak, kibic, wsparcie
dawny-: stary
odwrotność: rewers, odwrócenie
odparować: stopić, ziewać
lotnictwo: atmosfera, powietrze, latać
korelacja: porównanie
etniczny: nacjonalista, krajowy
ciąć: ciąć, zredukować
zdradliwy: przebiegły, opracować, kompleks, trudny
charakteryzacja: opisać, cecha-charakterystyczna
afiks: splatać, równolegle
cząsteczka: molekularny
konfiguracja: usposobienie, strukturalny, montaż
wzajemne-oddziaływanie: gadanie, zakładka
ilościowy: Tom
introspekcja: z-mocą-wsteczną
Orient: Wschód
sperma: nasienie
podpisać-się: wsparcie, przyznać, zatwierdzenie
nie-: ani, nie
wiarygodność: lojalność, niezawodność, kredyt
obalenie: ruina
ugięcie: dryf, odchylenie
iniekcja: igła
sandał: pantofel, buty
kawałek: żeton, ustęp, rozciągać
telewizja: telewizja
zboże: ziarno, fasola
pojemnik: instrument, czołg, garnek
migrować: emigracja, zbłądzić
terminologia: Warunki
elektorat: okręg-wyborczy
wymazać: kasować, zniszczyć
pośredniczyć: pogodzić
kapitalizm: kapitalista
jeździć-na-nartach: łyżwa
luz: hazard, pozwolenie
selektywny: wybierać
statyczny: standard
skupiać: poznać-się, konwergencja, skupiać
alfabetyczny: alfabet
światowy: międzynarodowy, świat
wypadek: ofiara
ok: podobnie, naprawić, bardzo
pragmatyczny: praktyczny
Sędzia: reguła, sędzia
mechanizm-różnicowy: różnica
wydychać: emitować, oddech
dział-wodny: woda
osprzęt: dostosowanie, sprzęt
Zainstalować: zainstalować, ustanowiony, zamknąć
rezonans: wibracja
tradycyjnie: tradycja
klasa: orbita
protokół: umowa
rachunek-różniczkowy: obliczenie, rachunek
gram: ciepło, trawa
benzyna: benzyna
galaktyka: konstelacja
dorastający: młody
ugniatać: problem
rad: radio
rozrzedzone: chudy
samolot: ptak
pedał: stąpać
circa: prawie, o
Flesz: obiektyw
walizka: pudełko, bagaż
zamiana: wymiana
do-wyboru: zwyczaj
matryca: brzuch
sportretowanie: ramię, obraz
przed: Wschód, przed, łąka
ogłoszenie: ogłoszenie
oszołomić: zadziwiać
zakres: incydent, zanurzać
przewracać-się: wlać, serce
sensoryczny: uczucie, namiętny
zgoda: umowa
dozorować: kierować, monitor, policja
przeszczep: alternatywny
aluminium: aluminium
fluktuacja: oscylacja
symulować: naśladować, udać
komplikować: kompleks
mentor: doradca, trener
szczelina: otwarcie
wieża: wrona, wieża, zamek, pistolet
manipulować: manipulacja, wymieszać
wegetariański: warzywo
norma: specyfikacja, standard, reguła
metro: tunel
oddechowy: oddech
symulacja: naśladować
strzykawka: igła
mutacja: zmiana, konwertować
bielizna: slipy, bielizna
pochwa: zatoka
różnicować: rozróżniać, różnica
sezonowy: pora-roku
wieśniak: wiejski
sezam: kret
śpiączka: przecinek
odwracać: odwrócenie, rewers
kierownik: obserwator, instrukcja-obslugi
wyrugować: wyrzucać
rewizja: czek, rewizja
wycieczka: szybować, zbłądzić, winda
umiejscowienie: miejsce
recesja: ekonomika
plądrujący: łup
hasło: Hasło
płód: zarodek
integracja: współpraca, włączenie
magenta: fioletowy, cyan
zminimalizować: najmniej, zredukować
osiedle-mieszkaniowe: schronisko
liczbowy: cyfrowy, numer
słony: sól
zero: zero, pusty
teoretyk: teoria
akwarium: ryba
trakcja: weto
spadochron: parasol
najważniejsze: konieczny
ogólnie: ogólnie, wszyscy, pospolity
pogarszać-się: gnić
zero: zero, pusty
seksualność: seksualny
szpula: Tom, owinąć
przeważnie: w-dużej-mierze
lepki: lepki
jelito: jelito
archeologia: archeologiczny
arachid: fasola
dopowiedzenie: dodatek
kuchenka: kuchenka, kuchnia
spodni: spodnie
kryteria: standard, wskaźnik
Przegląd: zarys
jakościowy: cecha-charakterystyczna
okulary: szkło
genetyczny: morfologiczne, genetyka, gen
uczestnik: dołączyć-do, rola, imiesłów
repertuar: talent, oprogramowanie
obracać-się: cykl, spin
układ: organizacja, plan, usposobienie
talon: wtyczka, paragon
twierdzenie: wyrok, teoria, aksjomat
poznawczy: diagnoza
wyjaśniać: opracować, wyjaśniać
toksyczny: zatruć
akcentowany: nacisk
rysik: igła
kryzys: kryzys
zaopatrywać: obsługiwać, opatrzony, gwarantować
anty-: sprzeciw
odporny: chroniczny, sprzeciw, odporny
przekąska: toast
kino: film, film---teatr
kran: rura
znacznik: ocena-w-szkole
obwodowy: otaczający, regionalny
stanowczy: zdecydowany, predykatywny, agresywny, decydujący, uparty
węzeł: robić-na-drutach
otyły: gruby
odejmować: wyrzucać, zredukować, rysować, pozbawiać
nieprzechodni: konieczny
spirala: ślimak, kręcone
ciastko: Herbatnik, ciasto
nadmuchać: puchnąć
elektronika: elektroniczny
przepisać: rozpisać
laboratorium: laboratorium
zajęciowy: zawód, handlowy, zawodowy, praca
gradient: mila, zanurzać
kolorowy: kolor
pokrycie: pokryty, szczepionka, opieka, koc, dach, wzgląd, Tom
uwikłanie: dołączyć-do, włączenie
orientacja: kierunek
wytwarzać: Stwórz, wytwarzać
termiczny: olej
stereotyp: wyjątek
tech: techniczny
pozostały: szczątki, nadmierność
ciężarówka: ciężarówka
stadion: pole
koordynacja: koordynować
bakteryjny: bakteria
berło: podejście
krzem: liczba-pi
zapamiętać: pamięć, ratować, pamiętać
diagnostyczny: diagnoza
konspekt: abstrakcyjny
przewodzenie: linia, porwać-kogoś
milionowy: milion
detalista: kupiec
bar: bar
głównego-nurtu: klawisz, wtórny
znaczący: oznaczać, wynikający
audio: głos
konceptualistyczny: koncepcja
ruszt: sieć
przestrzenny: atmosfera, wymiarowy
egzamin: kartkówka
średni-: wtórny, talia
make-up: kompensować
oddzielny: rozdzielony, solo
hamować: zahamowanie, zapobiec
wielo: różnorodny, jeszcze, bardzo
parny: wilgoć, ciepło
morfologia: morfologiczne
rozpoznać-chorobę: diagnoza
grypa: grypa
grafika: wykres
wieńcowy: choroba
pośladek: zad, szynka
archiwum: plik
konfrontacja: bić-się, konflikt, porównanie
frachtowiec: ciężarówka
optimum: optymalny, wielki
gruntownie: Warunki
motywacja: bodziec
jądro: jajko
siarka: siarka
operacyjny: manipulacja, akcja
trajektoria: orbita, droga
stosowność: związane, znaczenie, kontakty
rower: jazda-rowerem, cykl, koło
dyrektywa: wskazujący
linia-lotnicza: ptak, powietrze
litr: litr
wpadka: udaremnienie, zaszokować, regresja, zawieść, przeszkoda
ujednolicić: uprząż, pogodzić
postawa: stoisko, pozycja, ustęp
minimalny: najmniej
cykliczny: jazda-rowerem, okresowy
podłoże: molekularny
Podwodny: Łódź-podwodna
ekspertyza: doświadczenie, umiejętność
zero: zero, pusty
elektron: elektroniczny
interaktywny: zakładka
początkowo: oryginalny
sabotaż: zniszczyć
oddziaływać: gadanie, uspołecznić
matematyka: matematyka
płodowy: zarodek
zmodernizować: nowoczesny, aktualizacja
ekstremista: rodnik, skrajny
siki: mocz
tulić-się: uścisk
w-porządku: naprawić, bardzo
trzepnąć: ukraść
służący-określonemu-celowi: celowo
pół: wpół, sprzedać, szlifować, szerokość
nerwowy: nerwowy
anty: sprzeciw
soczewica: obiektyw
bliższy: prawie
odżywka: minerał, jedzenie
niejasny: niejasny, oczywisty
uraz: zaszokować, zranienie, wrzód
zamiana: wymiana
wektor: nośnik
taktyka: podejście
oceniać: ocenianie
zero: zero, pusty
clone: Kopiuj
wykonalny: przewaga, skuteczny
replikacja: Kopiuj
reaktywny: reakcja
rozkład-jazdy: kalendarz, czas, usposobienie
syntaktyczny: los
ustabilizować: cicho
dysydent: rywalizować
informacje-zwrotne: reakcja
Ankieta: kartkówka
utleniać: połączenie
milimetr: milimetr
psychiatryczny: intelektualny
zespół: choroba
paradygmat: instancja
Aktywować: umożliwiać, robić, akcja
losowo: losowy, zbieg-okoliczności, do-sprawa
ostracyzmu: rozdzielony, bojkot
podzbiór: część
metodologia: droga, podejście, pewnego-razu
grafika: praca
ciągły: zgodny, porządkowy
zająć-własność: trzymać, chwycić, zamknąć
kilometr: kilometr
wielonarodowy: międzynarodowy
planista: najemca, pasiasty, plan
wykładniczy: wykładnik-potęgowy
zapodziać: stracić
badacz: naukowiec
supermarket: centrum-handlowe
przeznaczyć: przydział, rozróżniać, rozprowadzać, sekcja
zero: zero, pusty
piłka-nożna: rzut
prawo: dobrze, właściwy
resztki: szczątki, odpady
zrównoważony: standard
statek-kosmiczny: czółenko
empiryczny: doświadczenie
semantyczny: konotacja, Przedmiot
wtajemniczony: wewnętrzny, członek
tona: ton
moduł: modulo, jednostka, Tom
enzym: drożdże
styl-życia: życie
makaron: masa
sala-sypialna: schronisko
nastolatek: młody
atrakcja: ocena-w-szkole
negować: zaprzeczać, zniszczyć
chłopak: przyjaciółka, przyjaciel
behawioralne: postępek
Dziękuję-Ci: podziękować
mistrz-umysłu: mózg, dusza
ekologiczny: ekologia, środowiskowy
imigrant: uchodźca
wbić,-osadzać: włączenie, zanurzać, pogrzebać
fotokopia: Kopiuj, obraz
aktywista: akcja
podkoszulek: koszula
terapeuta: lekarz, terapia
potentat: król
pobudzenie: podniecenie
synchronizować: synchronizować
kwaśny: kwas
leksykalny: słownik, słowo
włamać-się: złamać
klasyfikator: klasyfikacja
awangardowy: pionier
przewodniczący: głowa
materiały-informacyjne: ulotka
charyzmatyczny: urok
skand: tellur
wytyczne: instrukcja-obslugi
hipotezę: przypuszczać, podobno
lodówka: lodówka
restart: restart
Brainstorm: potrząsnąć, pomysł
replika: Kopiuj, naśladować, powtórzenie
Angst: strach
zawieszenie-broni: rozejm
błąd: pominięcie, źle
uprzemysławiać: uprzemysłowienie, przemysł
rodzeństwo: brat
rzecznik: głośnik, przedstawiciel
uprowadzać: porwać-kogoś, pług
dla-metali: metaloid
katar: grypa, wilgoć, bieg
aspekt: kierunek, kształcie, bok
od-sprawa: 
dobroć: cnota, przewaga
luźno: luźny, darmowy
potem: przyszłość, następnie, po
trudność: problem
oddział: pasmo
rozłożysto: szerokość, poszerzać, ogólnie
korelat: związane, hak
według: plecy
zero: zero, pusty
biuletyn: ulotka, Informacja
krzywy: zatwierdzenie, gorszący
wanna: łazienka
zabawny: zabawa, bawić, wesoły
bok,-od: oprócz
powstanie: wyłaniać-się, wyjście, powstanie
zero: zero, pusty
policzek: bawić-się
mają-do: musi, obowiązek
procent: procent
spór: garnitur
zero: zero, pusty
przez: przechodzić, nad
sopran: dziecinny
zabawny: wesoły
po-południu: popołudnie, noc
białko-jajka: białko
rozlew-krwi: krwawy
tul-atom: tor-atom
zakręt: zgięty, zgiąć
łącznik: spójnik
exhortative: hortative
terb-atom: tor-atom
wynajęty: wynajem
make-up: kompensować
dowcip: żart
config: strukturalny
przeszłość: trwać
podzielić: rozróżniać, rozprowadzać
profesor: opanować
rod-atom: tor-atom
stan-znacznik: 
przestrzeń-znacznik: 
biurokratyczny: biurokracja
pas: pasmo, uprząż
zero: zero, pusty
sprzedawca: kupiec
zero: zero, pusty
lantan: tellur
Przedmiot-sprawa: temat-sprawa
konstruktywny: Stwórz, sformułowanie, producent
zero: zero, pusty
kobiecy: Płeć-żeńska
rewident-księgowy: inspektor, księgowa
mikrofon: mikro
na-zewnątrz: na-zewnątrz, oprócz
nagranie: włączenie, rejestracja
palec-wskazujący: wskaźnik
sponsoring: stypendium, opieka
nieświadomy: nieświadomy
zero: zero, pusty
ujednolicić: specyfikacja, standard
godzina: miejsce, godzina
gospodarz: właściciel
badacz: determinantem, naukowiec, detektyw
spalony: spalony
zero: zero, pusty
autoryzować: umożliwiać
obrona: opieka
korytarz: sala
negocjacja: gadanie
odświeżony: świeży, aktualizacja
meandrujące: zgięty
dalej: pierwszy, Dalej, Naprzód
oddechowy: odporny, oddech
zero: zero, pusty
postęp: postęp
nieprzechodni: konieczny
euforia: entuzjazm
szeroki: poszerzać, szerokość, rozpowszechniony
nieprzechodni: konieczny
kontrastowe: kontrastujące, sprostać
zdumiony: zaskoczony
skierowanie: przedstawiać
potomek: znajomy, wnuczka, generacja
lody: krem
promień: promień
alternatywnie: inaczej
sąsiedztwo: otaczający, relacja-na-żywo, środowiskowy
przyzwyczajony: zwyczaj
zakłopotanie: wstyd, nieład
w-zasadzie: w-dużej-mierze
świeżo: świeży, ostatnimi-czasy, korzeń
taniec: bawić-się, taniec
zero: zero, pusty
ilość-znacznik: 
społeczny-znacznik: 
krytyka: krytyka
rubid-atom: tor-atom
borykać-się: bić-się, konflikt, wojna
narzekać: o
zero: zero, pusty
wanad-atom: tor-atom
nijaki-płeć: rodzaj-męski-płeć
fluor-atom: tor-atom
podróż: odwiedzić, safari, wyprawa
rodzaj-męski: męski
zero: zero, pusty
rozwojowy: ewolucyjny, postęp
stosowany: praktyczny
zamknąć: zamknąć
przechwalać: popisywać-się
wstecz: plecy
obecny: obecny
zero: zero, pusty
losowy: losowy
spółdzielnia: kolega
na-emeryturze: iść-na-emeryturę
zero: zero, pusty
rozbawiony: szczęśliwy, wesoły, bawić
przybliżony: przybliżony
dwójkowym: dwójkowy
uzupełniający: uzupełnienie, dodatkowy
rozmowny: korespondencja, gadatliwy
zero: zero, pusty
w-sprawa: do-sprawa
polon-atom: tor-atom
rozkład: dysjunkcja, analiza
opalenizna: brązowy
problem: problematyczny, problem
Tłumaczyć: tłumaczenie, trzepnięcie
zero: zero, pusty
tal-atom: tor-atom
klika: konglomerat, trzask
łatwo: z-łatwością, proste
moderator: moderator, menedżer
społecznie: społeczny
pasujący: garnitur, zbiec-się
wypadek: incydent
ten-który: który
co-ciekawe: rysować
do-góry-nogami: rewers
herbicyd: zatruć
zero: zero, pusty
uczestnik: imiesłów
na-przykład: instancja
guz: guz
rozkład: gnić
zero: zero, pusty
Strona-www: Strona-www
ogromnie: masywny, bardzo, Wspaniały
będzie: 
krewny-sprawa: krewny-sprawa
cel-sprawa: cel-sprawa
wynagradzać: kompensować, zapłacić
znęcać-się: źle
warkocz: grzbiet, robić-na-drutach
zamiast: w-zamian
archeologia: archeologiczny
złącze: spójka, wtyczka, Załącznik, gniazdo-elektryczne
zero: zero, pusty
uogólnienie: generalizować
stront-atom: tor-atom
ruten-atom: tor-atom
nie-licząc: oprócz
zero: zero, pusty
wycofać-się: błądzić, regresja, iść-na-emeryturę
emeryt: iść-na-emeryturę
jedna-inna: wzajemnie, inne
szeroki: rozpowszechniony
computing: obliczenie, komputer, kalkulator
biznes-osoba: biznesmen
hot-dog: kiełbasa
przewaga: efekt, moc, przewaga
zamknąć-cudzysłów: zacytować
zaborczy-sprawa: dopełniacz-sprawa, zaborczy-sprawa
genetycznie: gen, genetyka
koncesyjny: drgnąć, miękki
pośredni-obiekt: bezpośredni-obiekt
prohibicyjny-humor: prohibicyjny-humor
trening: poćwiczyć, praca, opracować
rozdzielany: ograniczony, rozdzielony
przeciwnie: rewers, sprzeciw, naprzeciwko, odwrócenie, kontrastujące
wspinać-się: powstanie
niewiarygodnie: niezwykle, Wspaniały
zero: zero, pusty
zamknięcie: zamknąć, warsztat-tkacki
tanio: tani
brezentowy: tkanina, sieć
wykształcony: edukacja, uprzejmy
dzikiej-przyrody: Natura, dziki
przeciwstawiając: sprzeciw, naprzeciwko, w-kierunku
zero: zero, pusty
wykopać: kopać
zarażony: zakażenie
zero: zero, pusty
uzbrojony: ramiona
to-znaczy: mianowicie
nikt: nic
przysięga: przysięgać, dopełniający
stożkowy: chudy, stożek
komik: zabawa, artysta
itp.: 
oprócz: oprócz
kontur: zarys, środowiskowy, forma
komórka: telefon-komórkowy, komórka
chybienie: ciąć, stracić, spędzić
alarmujące: straszny, niespokojny
przyszłość: przyszłość
subjunctive-humor: warunkowy-humor, życzący-humor
powinien: musi
motocykl: motocykl, silnik
karta-kredytowa: kredyt
zero: zero, pusty
publiczny: publiczny
komórka: telefon-komórkowy, komórka
zero: zero, pusty
jelita: jelito
rozwijać: rozprowadzać, rozpraszać, konsumować
deportować: wyrzucać
proporcja: stawka, część, kwant
kompetencja: umiejętność, jurysdykcja
właściciel-ziemski: anioł
przyimkowy-sprawa: 
przydział: przydział, dywidenda, dodatek
frasobliwy: niespokojny
w-porządku: podobnie, bardzo
egzekwowanie: przymusić
zawodowiec-wyrażenie: zawodowiec-zdanie
chwytnik: łapacz
wstrzykiwać: przedstawiać
oszałamiający: zadziwiać, uderzający
kaszel: kaszel
obok: Dalej
