tchau: tchau, Olá, pi, despedida
a: 
de: entre, cerca-de, As-suas
para: vir, devo
dentro: 
:-first-person: 
Eu: a-mim
:-third-person: 
aquele: isto, qual
seu: As-suas, próprio
ele: isto
com: 
para: cerca-de, em-direção
Como: qual, exemplo, como
:-second-person: 
estar: 
dela: As-suas
ligar: ligar, cerca-de
em: cavalo
de: passar, e, cerca-de
ter: Urso
ou: nem
a-partir-da: 
esta: isto
ele: As-suas
ela: elas, isto
meu: meu, a-mim
deles: As-suas, elas
assim: assim, em-breve
a: 
eles: elas, vocês
nós: nos, a-mim
quem: quem-quer-que, qual
seria: acho, trazer
irá: força-de-vontade
não: não
E-se: se, forneceram
acima: acima, ascensão, Fora, pior
para-dentro: um
algum: nomeadamente, qual, todos, cada
seu: Sua
qual: nem, qual, coisa
indicativo-humor: directiva-humor
cara: pessoa, marido, macho
do-que: Mais, cerca-de, como
nosso: Primavera, nos
alguns: um-pouco
sobre: após, acima, Fora
maio: capaz
agora: presente
Como: como, AME, aguarde
podem: capaz, poderia, caixa
devemos: devo
fez: Faz, fato
tal: assim
uma: um
estes: elas, isto
sobre: acima, Mais
muito: muito, volume
Sr: senhor, dominar
bem: bela, ótimo, tipo
mais: Mais, largamente, maioria, muito
deve: devo
Essa: elas, As-suas
ele-mesmo: próprio, mesmo, si-mesmos
vida: ao-vivo, tempo-de-vida, vogal, cintura
sem: 
faço: Faz, crio
bem: confortável, certo
discurso-marcador: 
através: passar, penetrar
poder: poder, possivelmente, poderia
demais: muito, até
mais-uma-vez: então, costas, uma-vez
muitos: maioria
cada: cada, qual
pessoas: pessoa, comunidade, uma-pessoas
pensamento: ideologia, idéia, acho
debaixo: baixa
ainda: Mais
lugar: local, posição, Onde
enquanto: enquanto-que, Tempo, temporário
somente: só, simples
também: até, Da-mesma-forma, Mais
ainda: mas, nem, no-entanto,, Mais
contra: em-direção, antes
conseguir: Conheçer, leva, derivar
sempre: eterno, Nunca, sempre
desligado: fechar, ausente, Fora, coberto
cara: superfície, cem, pessoa
outro: mais-recente, de-outros
deixou: ausente
novo: neo, romance, fresco, nove, jovem
Senhora: 
colocar: conjunto, mais-recente, dar
contar: dizer
mente: intelectual, acho
poucos: casal, pequena
quem: qual, quem-quer-que
longe: ausente, controlo-remoto, muito
chamado: acho
todo: cheio, todos
ambos: dois
encontrar: encontrado, pesquisa
Veja: Vejo, Verifica, relance
deixei: autocarro, emitir, dar, habilitar
senhor: dominar, senhor, rei
casa: casa
algo: nenhuma-coisa, um-pouco
momento: Tempo
pai: pai
dentre: entre
mulheres: fêmea
mãe: mamãe
fim: acabado, mais-recente, atrasado
pequena: pequena, micro
tu: vocês
quer: devo
Contudo: mas, no-entanto,, embora
bastante: inteiramente, um-pouco, muito, o-suficiente
de-quem: qual
melhor: melhor
eu-mesmo: a-mim, si-mesmos
até: até, antes, tchau
desde: então, primeiro, Porque
usava: velho, reciclar
em-vez: ao-invés, um-pouco, Mais
Menos: baixo, baixa, mínimo
dentro: interior, profundo, dentro-de-casa
junto: conjunto
grande: ótimo, maciço
assunto: coisa, assunto, questão
certo: determinado, certo
ela-mesma: si-mesmos
metade: a-meio-caminho, moer, lado
verdade: verdadeiramente, fato, certo
qualquer-coisa: tanto-faz, um-pouco, nenhuma-coisa
guarda: aguarde, conjunto, reter
esposa: fêmea
meios: caminho
perto: passar, quase
Estado: condição, entrar, país, governo
sozinho: solitário, solo, um
caso: cair, exemplo, terno, incidente, Porque
te: vocês
alto: acima, andar
menina: filha, fêmea, namorada
certo: assegurar, certo, verdadeiramente
de-fato: verdadeiramente, fato
se: si-mesmos, próprio, se
ao-longo: associado, grandes, comprimento
terra: país
Retorna: regressão, costas, restituição
deixar: saída, férias, abandonado, ausente, permissão
ou: até
lei: certo, legal, regra
deitar: conjunto, secular, Socorro
ponto: local, açao, só, parágrafo
criança: crianças
desejo: esperança, desejo
falar: dizer, conversa
durante: Tempo, enquanto-que
de-várias: dúzia, casal, Mais
negócio: comércio, loja, companhia, trabalho, comercial, movimento
maneira: caminho, abordagem
segundo: de-outros
geral: comum, geralmente, público
atrás: costas
tornar-se: vir
morto: morrer, morte
terra: país
Garoto: filho
sentir: sentindo-me, ouvir
espírito: alma
verdade: fato
chão: andar, país, local
realmente: verdadeiramente, muito, fato
descansar: de-outros, conforto, aposentar, permanece, férias
diferente: vários, diferença, de-outros
possível: possivelmente
humano: pessoa, humanidade
Cidade: cidade
Segue: Próximo, Segue, após
necessidade: necessário, devo
causa: razão, induzir, Porque
fim-de-tarde: noite, tarde
cinco: quinto, ano
Forte: poder, capaz, violento
senhora: fêmea
por-aí: em-torno-da, quase, cerca-de, olho
vez: lado, conjunto, ordem
sentido: significar, sentindo-me, conotação
Fechar: fechar, quase
personagem: característica, personalidade, marca, natureza
ordenar: classificação, tipo
vista: visão, para-a-frente, cena, Vejo, relance
festa: festa, vírgula, país
bem: ótimo, fino
pronto: preparar, já, na-ponta-dos pés, acabado
conta: razão, conta, cálculo, contagem
escrito: Escreva
idade: velho, século
outro: de-outros, mais-recente, em-outro-lugar, Mais
força: poder, coagir, impor
através: acima, oposto
cedo: prematuro, começo, primitivo, em-breve
sol: 
mais-tarde: futuro, então, após, Próximo
tudo: todos
passado: decorrido, retrospectivo, mais-recente, após
Aja: conta, verbo, açao, trabalho, movimento
mais: para-a-frente, Mais, adicional
além: Mais, Fora
nem: nem, qual
Visão: opinou, relance, Vejo, visão, cena, calendário
som: voz
nenhum: nenhuma-coisa, níquel
Claro: aberto, evidente, impressionante, claro
estrada: auto-estrada, caminho
real: virtual, fato, real
quase: quase, cerca-de
conhecimento: informação
em-direção-a: em-direção
mau: pior, mal, pobre
vivo: ao-vivo, cintura, tempo-de-vida
Paz: quarto
baixo: baixo, barato, aborto-espontâneo
norte: responda, norte, meia-noite
natural: natureza
bonita: bela, muito, o-suficiente
feira: certo, relatório, dez
serviço: servir, cuidado
abaixo: baixa
prazer: feliz
história: história, encontro, histórico
Nota: lembrar, notação
embora: embora
frente: oposto, para-a-frente, antes
grande: ótimo, maciço
Certamente: estritamente, curso, verdadeiramente
vento: ar, sótão
receber: recibo, leva, derivar
atenção: cuidado, prioridade, foco, consideração, ênfase
força: poder
provavelmente: possivelmente
feliz: feliz, divertido, satisfeito
importante: necessário, conseqüente
você-mesmo: próprio, si-mesmos
companheiro: colega, amigos
opinião: opinou, idéia
fé: acreditar, fidelidade
atrás: leste, então, antes, para-a-frente, costas
carga: Pedágio, despesa, leva
braço: mão, pobre, manga, braços, ombro
último: mais-recente
objeto: propósito, nenhuma-coisa, assunto
cavalheiro: macho, senhor, dominar
especial: especialmente, nomeadamente
dificilmente: não, quase, raro
chefe: Gerente, cabeça
chance: coincidência, posição, ocasião, probabilidade
acordo: plano, loja, acordo
pensando: acho
pesado: repetição, peso, a-sério, difícil
avião: aberto, simples, oco
imediatamente: uma-vez, em-breve
boca: pessoa
receoso: amedrontado, medo, ansioso
solteira: um, solitário
alegria: feliz, excitação
quebrado: enxofre, cortar
a-menos-que: exceto
transportar: Urso, usar, trazer, habilitar
influência: efeito, gripe
aparecer: emergir, parecer
lado-de-fora: Fora, exceto
por-favor: amavelmente, perguntar
aparência: emergir, parecer
devagar: gradualmente, atrasado
período: fase, Tempo
irmã: irmão
batalha: luta, guerra
antigo: velho
juventude: jovem
apenas: só, simples, solitário
alcance: abordagem, alcançar, vir
sistema: ordem, hierarquia, organização
jantar: noite, almoço
depois: futuro, após
andar: piso, ir, andar, pé
maravilha: milagre, estranho, surpreso
usual: geralmente, comum, sempre
figura: digital, estatística, em-forma-de, número, Pedágio, fotografia
antigo: velho, antiquado
respeito: consideração, honra, perigo, em-direção
terceiro: três, terça-feira
permanecer: fique
sociedade: social, comunidade, companhia
resultado: conclusão, efeito
comando: ordem
simples: só, simples
ao-lado-de: passar, Próximo, exceto
silencioso: quieto
perfeito: adequado, ótimo
rua: caminho
escrevendo: Escreva, carta
madeira: de-madeira, árvore, bastão
rapidamente: em-breve
aviso-prévio: Vejo, de-Anúncios, aviso
brilhante: afiado, claro, brilhante, impressionante
barco: navio, flutuador, iate
nobre: ótimo, glorioso
repentino: de-repente
valor: que-vale-a pena, categoria, importância
devido: Porque
leitura: ler, questão
concordar: acordo
aguarde: esperar, aguarde, fique
pedaço: lasca, parte, alongamento
ex: velho
conversa: conversa, diálogo
oportunidade: ocasião, posição
custo: despesa, pagamento
considerável: ótimo, conseqüente, impressionante
sentar: fique
topo: optimal, cume, acima, cimeira
casamento: casado
passo: açao, piso, fase
início: começo
por: cada, em-direção
individual: pessoa, individualmente, átomo
difícil: difícil
bocado: parte, pequena, piolho, bocado
discurso: conversa
autoridade: jurisdição, poder
felicidade: feliz
fornecer: forneceram, dar, assegurar
estude: aprender, análise, estúdio
pessoal: particular, individualmente, funcionários
Assistir: Verifica, monitor, Vejo
satisfeito: satisfeito, feliz
quente: caloroso, fogo
esforço: experimentar, cepa
preparado: preparar, já
tentativa: experimentar, questionário, facada
velozes: em-breve, ágil
abaixo: baixa, após
pretendido: pretender, foco, propósito
direto: diretamente, simples
provável: facilmente, probabilidade, possivelmente, supostamente
justiça: certo
simplesmente: só, simples
Confiar-em: acreditar, fidelidade
passagem: parte, cruzamento, coluna, passar, alongamento
fechadas: fechar, tear, coberto
nós-mesmos: si-mesmos
passagem: passar, decorrido, cruzamento
médio: secundário, significar
posse: propriedade
agradável: confortável, tipo
perfeitamente: inteiramente, verdadeiramente
geralmente: comum, geralmente, tender
grave: difícil
fixo: consertar, embora, padrão, permanente
tropas: exército
reunião: sessão, montagem, Conheçer
acampar: acampamento, campo
nação: país, nacional
existência: presença
responder: responda, restituição
céu: atmosfera, céu
igual: mesmo, grau
fortuna: destino, condição, propriedade
domínio: campo
situação: posição, condição
meio: significar, a-meio-caminho, cintura
inverno: frio
permitir: permissão, habilitar
pálido: amarelo, cor, desmaiar, pastel, aberto, claro
correndo: corrida, corre
religioso: religião, quimioterapia
conduzir: induzir, trazer
jogada: piso, argumento, mover, movimento, açao
parar: parar, ficar-de-pé
falada: dizer, verbal, conversa
borda: ascensão, painel, conselho, borda, comissão
vão: livre, vazio
perda: desvantagem, perdido, vazamento
oferta: forneceram, propor, dar, exposição, servir, privilégio
aula: tipo, órbita, categoria
completo: cheio
Acesso: visita, abordagem, aquisição
paixão: entusiasmo, sentindo-me
físico: física, corpo
exemplo: exemplo
começar: começo
despeito: raiva
grave: ótimo, a-sério, extremo
prata: dinheiro, Sexta-feira
suficiente: o-suficiente
a-Principal: cabeça, dominar, chave, original, grampo
Maravilhoso: estranho, violento, ótimo
caminho: caminho
significado: conotação, significar, importância, assunto
caber: terno, adequado
muito: massa, muito, destino
assento: cadeira, cerco, sede
jogo: jogos-de-azar, Toque
afirmação: expressão, relatório
sonho: pesadelo, dorme
Rocha: penhasco, saia, pedra
especial: especialmente, particular, especialista
taxa: despesa, Pedágio, pagamento
compartilhado: parte, estaca, Função, distribuir
espalhar: detalhe, muito-difundido, espalhar, razão
glória: honra, louvor
espaço: posição, corredor, campo, astronauta
comum: comum, simples
considerar: acho, consideração
muito: muito, largamente
oficial: oficial
taxa: padrão, honra, curso
placa: notação, gesto, marca, local
nativo: natureza, original, residente
trabalhando: empregado, trabalho
casar: casado
extensão: limite, volume, grau
método: caminho, uma-vez, abordagem
excelente: melhor, ótimo
confiança: acreditar
exatamente: verdadeiramente, especialmente, cheio, inteiramente
grande: ótimo
chique: imaginação, bela
rápido: em-breve, ágil
sim: sim, assim
liberdade: livre, independência
interessante: desenhar, curioso
de-lado: separado, lateralmente, exceto
puro: fresco, verídico
relativo: acima, cerca-de, consideração
comprobatório: evidência, evidente
distante: ausente, controlo-remoto
semelhante: assemelhar, mesmo, congruente, comparável
limitar: fino, baixo
completamente: inteiramente
página: lado, jarda
particularmente: especialmente
montanha: monte
orgulho: orgulho
claramente: explicitamente, aberto, evidente
preço: honra
doente: doente
julgamento: decisão, frase, regra, juiz, jurisdição, crise
aceitar: aceitável, Admitem, leva
espécies: tipo
procurar: pesquisa
honra: honra
orelha: permissão
inferior: baixa, andar, base
ajudar: Auxilia, Socorro, apoio
totalmente: cheio, inteiramente
prazer: feliz, desagradável
quantidade: quantidade, volume, multidão, número
obtem: aquisição, derivar, leva
imposto: arrendar, linha
atravessar: cruzamento, passar, ultrapassarem
estrangeiro: hóspede, estranho, estrangeiro, desconhecido
ousar: coragem
crescer: ascensão
falso: mentira, errado, doente, falho
alto: grandes, andar
Portão: porta
livremente: independência, livre, independentemente, solto
golpe: choque, golpe, tiro, pontapé
moda: abordagem, vir
diariamente: dia
distribuição: distribuir
riqueza: dinheiro, propriedade
liberdade: livre, independência
avançar: progresso
suave: suave, doce
certamente: curso, verdadeiramente
seguro: seguro, proteger, assegurar
ocupado: apreender, saudar, contratado
etapa: plataforma, açao, fase, condição, cena
parte: parte, ração
língua: idioma, cuspir
irritado: raiva
transporte: trem, carrinho, transporte
clima: clima, ar, Tempo
necessidade: importância
prática: exercício, açao, personalizadas
reivindicação: pedido, terno
príncipe: duque
grupo: conjunto, conglomerado, rebanho, banda, painel
ao-longo: em-toda-parte
adicionar: ampliar, adicional, aumentar
orar: perguntar
conduzindo: conseqüente, dominar
cinzento: Castanho, cinza
freqüentemente: frequentemente, repetiu, permanente
famoso: popular, bem-conhecido, vogal
poderoso: poder, capaz
vivo: ao-vivo
fraco: desmaiar, pobre
material: conteúdo, assunto
franco: honesto, axioma
calor: verão, caloroso
guarda: proteger, cuidado
igualmente: equilibrar, mesmo, Da-mesma-forma
naturalmente: natureza
notável: estranho, incomumente, ótimo
lua: mês
leve: pequena, facilmente, claro, fino, baixo
estilo: claro
pontiagudo: hemisfério, afiado
princípio: teoria, axioma, começo
imediato: em-breve, diretamente
disposto: já, na-ponta-dos pés, milha
consequência: conseqüente, efeito, conclusão
ternura: suave, acordo, corrida
interessado: pretender, interesse
trimestre: pé
avançado: acima, para-a-frente
aparentemente: explicitamente, supostamente, parecer
ativo: trabalho, açao
consciente: deliberadamente, conhecer
perigoso: perigo, prejudicial, ameaçador
calma: quieto
sagrado: divino, piedosos
reino: real
todo: inteiramente, todos, cheio
bem: bela
hábito: característica, caminho, personalizadas
direto: evidente, diretamente, em-primeira-mão
na-realidade: verdadeiramente, fato
audiência: ouvir
caminhada: piso, pé, pedestre
jogar: emitir, elenco, tiro
sabedoria: intelectual
conduzir: dirigindo, coro, expedição, empurrar, corre, disco
falha: culpa, errado
assunto: coisa, assunto, relações
contato: correspondência, tocar
estação: ficar-de-pé, centro, estação
ouço: ouvir, perguntar, obedecer
ferido: ferimento, dor, feridos
expressar: expressão, explicar
favor: lado, graça, adotivo
altura: comprimento
tamanho: dimensional, magnitude, cheio
tarefa: açao, trabalho, dever
simpatia: empatia, pena
vestido: vestido
mais: para-a-frente
embarcação: instrumento, navio
afeição: AME
sofrimento: tortura, miséria, amargo, problema
carne: eu-no, corpo
grande: maciço, ótimo
postar: categoria, Agência-dos-Correios, após, mandar, posição
coleção: acumulação, conjunto, galeria, conclusão
imaginar: imaginação, acho
chegada: vir
alto: insistir, ótimo, difícil
adorável: bela, glorioso
extraordinário: estranho, incomumente
acontecer: nem
café-da-manhã: manhã, almoço
população: multidão
série: cadeia, conjunto
alívio: Auxilia, conforto, glifo
impressão: efeito, sentindo-me, impressionar, imprimir
satisfação: satisfeito
forma: dimensional, Formato, em-forma-de
nascimento: nascermos
consideração: idéia, consideração
regular: periódico, repetiu, ordinal
em-movimento: mover, movimento
ocupado: contratado
qualidade: massa, grau
descobrir: encontrado, pesquisa, divulgar
dentro: interior, profundo, dentro-de-casa
solo: lama, andar, solo, país
completamente: inteiramente
mensagem: informação, notícia
frase: expressão, frase
menção: macho
par: certo, casal
título: título, cabeça, assunto
compreensão: compreender, empatia
domingo: semana
louco: crackpot, enganar
absolutamente: inteiramente, estritamente
lento: quieto
misericórdia: pena, graça
conter: Incluindo, conteúdo
aflição: tristeza, dor
soldado: exército, penhor
anterior: leste
explicação: explicar, informação
oração: pedido
crença: acreditar, fidelidade
constante: repetiu, padrão, consertar, permanente
final: mais-recente, finalmente
passeio: equitação, safári, ascensão, dirigindo
política: político
desenho: fotografia, desenhar, plano
moribundo: morte, morrer
exigem: pedido, questão
superior: acima
soma: e, ioga, número
movimento: movimento, propor
assistência: apoio, Socorro
dignidade: honra
apanhar: aguarde, leva, concepção
entre: entre
atual: presente, corrente
possivelmente: probabilidade, possivelmente, poderia
separar: separado, diferença, solo
o-pior: pior, pobre
terror: medo, terrorista
ao-controle: regulamento, controlada, Verifica, gerir
capaz: habilitar, capaz, hábil, habilidade
empresa: companhia, embora
superior: melhor
espiritual: mentalmente, moral, intelectual
prova: provar, evidência
relação: relações, relatório, consideração
preocupado: cuidado, ansioso, associado
profundamente: profundo, detalhe
cantar: ler
amigáveis: congruente, amavelmente, amizade, tipo
Entrada: porta, recibo
fornecem: largura, forneceram
limpar: fresco, arrumado
útil: necessário, eficaz
delicado: frágil, fino, elegante
remover: livrar, excluir, desenhar
escolha: escolher, eleição, Verifica
enorme: maciço, ótimo
incapaz: não-podes, não, falhou
cobrir: casaco, inclusão, cobertor, embrulho, calçada
duplo: gêmeo, duas-vezes, casal
vitória: sucesso
constantemente: frequentemente, repetiu, sempre, continuar
nível: padrão, condição, superfície
lançamento: descarga, publicação, livre
áspero: pior, mal-humorado, grosseiro
adiante: para-a-frente, acima
conectado: limite, anexado, associado, conjugado
ganho: aquisição, vantagem
adição: adicional, complemento
câmara: quarto, corredor, Câmera
conhecimento: familiar, cartilha
erro: errado
baseada: base, condições
carro: trem
ninguém: alguém, nenhuma-coisa
energia: poder
nu: aberto, Barra, vergonha, oco, calvo
parcialmente: a-meio-caminho, parte, um-pouco
cor: cor
segurança: seguro, salvação, cuidado
descrição: descrever, informação, descritor, definição
adormecido: dorme
solta: mergulho, cair, vazamento
brilhante: glorioso, brilhante, ótimo
breve: acrônimo, baixo
cinzento: Castanho, cinza
altamente: muito
animado: excitação, irritada
desespero: frustração, desmaiar
facilidade: conforto, reduzir
total: bruto, todos
bondade: virtude, graça
círculo: ciclo, apartamento, volta, roda
aborrecido: perfuração
intenção: pretender, propósito
prazo: condições, semestre, data-limite
completamente: confortável, inteiramente
aplicar: uso
trabalho: trabalho
inteligência: intelectual
ataque: ataque, impressionante
bastante: inteiramente, o-suficiente, muito
obedecer: Conheçer, obedecer, conteúdo
evento: incidente, ocasião, mostra
suavemente: suave, amavelmente
conexão: conjunção, acessório, ligar
proteção: proteger, abrigo, cuidado
consciente: acordado, deliberadamente, sentindo-me
edição: despesa, imprimir, publicação, permissão
vôo: pássaro, mosca, planar
variedade: tipo, vários
à-parte: separado, ausente, exceto, independentemente
ruim: terrível, pena
todo-mundo: todos, alguém
trabalho: trabalho
amante: Prezada, namorada
cantando: canção
ansioso: desejo, impaciente, curioso, ansioso
exigir: perguntar, pedido, insistir
sempre-que: quando
bem-sucedido: sucesso
aumentar: ampliar, elevador, aumentar, ascensão
desenvolvimento: progresso
frio: frio, bela
tentativas: sonda, processo, quadra
no-exterior: estrangeiro, exílio
devotado: fidelidade, fiel
literário: literatura
escritor: autor
ações: bastão, Função, açao
tipo: tipo, Escreva, pressione
abundância: rico, redundância, o-suficiente
evitar: evita
favor: lado, graça, adotivo
mental: intelectual, mentalmente, interior
atitude: relance, ficar-de-pé, gesto, abordagem, dependência, parágrafo
admiração: louvor
ansiedade: ansioso, medo, preocupação, excitação
Ensinar: conhecer, aprender
visível: conhecer
guia: manual, evidência, dirigindo
real: virtual, fato, real
miserável: insuficiente, triste, infeliz, miséria, desamparado
prejudicar: mal, prejudicial, ferimento, pena
perdão: perdoar, desculpa, pedir-desculpas, graça
raramente: às-vezes
registro: inscrição, disco, Guardar
gorda: óleo, espesso
plano: apartamento, noncommittal, plano
Dom: recompensa, presente
templo: casa, catedral
licença: permissão
consentimento: aprovação, permissão
suficientemente: cheio, o-suficiente
ferida: ferimento, feridos, úlcera
corajoso: coragem, bravo
em-qualquer-lugar: em-algum-lugar, em-toda-parte
testemunha: evidência
tolo: ignorante, enganar
alguém: alguém, quem-quer-que
auto: particular, si-mesmos, próprio
extremamente: muito, incomumente
tratamento: terapia, cuidado
garganta: pescoço, planar, pepino
paciente: doente
crescimento: aumentar
quantidade: quantidade, massa, multidão, dose, número, magnitude
grave: estritamente, violento, difícil
desculpa: perdoar, razão, transitivo, desculpa
origem: original, natureza
público: passiva, público
remanescente: permanece
ganhar: sucesso
empregada: servo
suavemente: suave, quieto
realidade: fato
local: cena, site, local
vela: navio, véu
armazenar: loja, armazenamento, Guardar
observação: opinou, consideração
pausa: parar
valioso: que-vale-a pena
conseqüentemente: assim, portanto
plantar: ascensão, árvore, moinho
gelo: neve
absoluto: cheio, inteiramente
prontamente: facilmente, em-breve
feroz: afiado, violento, difícil, cruel, predador, selvagem
raiva: raiva
descoberta: encontrado, pesquisa, invenção, abertura
relacionado: associado
punição: frase
levemente: pequena, facilmente, um-pouco
misterioso: segredo, vago, invisível
sombra: sombra, tom, nuança
assassinato: matar
emoção: sentindo-me, apaixonado
destruição: ruína, destruir
horror: medo
local: localmente, interior, local
alcance: vários, distância, conjunto
anfitrião: exército, hóspede, multidão
molhado: chuva, úmido
mistério: segredo
possuir: próprio, Urso
consciência: racionalidade, sentindo-me, consciência
antigamente: antes
Produção: produzir
convés: ponte
propriedade: propriedade
reinado: rei, realeza
conformidade: Segue, adaptação
dela: As-suas
infeliz: infelizmente, coincidência, infeliz, pena, insuficiente
flor: gastar, interesse, lama
obrigado: obrigado
pertencer: propriedade, Incluindo
mercado: comprar
boné: chapéu, cortiça
Encantado: feliz
casa: família, casa
frota: navio, marinha, flutuador
bebê: crianças, boneca
região: campo
exato: farinha, adequado, cheio, cuidadoso
imagem: fotografia
suspeita: dúvida, suspeito
recusar: negar, veto, desperdício
responsabilidade: dever, culpa
envergonhado: vergonha
refeição: Comida, comer, farinha
estado: posição, condição
indicar: entrar, mostra
poema: poesia, canção
surgir: emergir, ascensão
viagem: safári, expedição
comparecer: Junte-se
permitir: comprar, dar, Urso
doar: contribuir, dar
emprego: trabalho
prosseguir: continuar, aumentar, progresso, passar
arrepender: desculpa
risco: perigo
rápido: em-breve, ágil
distinto: separado, diferença
corretamente: adequado, confortável
fama: louvor
singular: unido, unidade
erro: errado
reputação: louvor
recurso: desenhar, ligar
falta: cortar, falho, ausência
violência: violento
render: Faz, introduzir, dar
carreira: profissão, trabalho
projeto: concepção, plano
sugestão: frase, propor
total: pronunciar, cheio
resolução: decisão, conclusão, análise, ampliar
poupar: alternar, adicional, substituir, lança
doméstico: civil, interior, residente, nacional
referência: referencial, memória
existir: presença, presente
questão: problemático, condições, problema, assunto, questão, emissão
fornecendo: forneceram, dar
chama: fogo
ignorância: ignorante, ignorar
ocasionalmente: às-vezes, repetiu
vôo: mosca
pano: tecido, roupas
lucro: vantagem
quarto: quatro, quarta-feira, quarto
Sino: alarme, hora
beneficiar: vantagem
capítulo: porta, parte, cabeça, estação, capital, si-mesmos
buraco: perfuração, cova
razoável: adequado, sábio, racional
açúcar: embriaguez, caminho
substituição: substituir, ao-invés, abono, alternar, intercâmbio
impulso: insistir, tricotar, pagamento, empurrar, impulso
quadro: escala, legal, tiro
substância: assunto
o-email: mandar
divisão: parte
escravidão: escravo
verso: poesia, parágrafo
provável: possivelmente
doloroso: amargo, dor
para-sempre: sempre, eterno
oceano: mar
traseiro: após, costas, reverso
líder: cabeça, Gerente, condutor, manual
afiado: pretender, ansioso, afiado
sorte: destino
aparente: evidente, axioma
pressa: em-breve, bezerro
esquema: plano, listrado, gráfico
inútil: desperdício
mesmo-assim: embora, no-entanto,
suave: suave
sólido: demonstrativo, estabelecido, embora, compactar
necessariamente: devo, necessário
construir: crio, construção, formulação
tentada: experimentar, facada
equivalente: mesmo
recente: recentemente, moderno, mais-recente
viagem: visita, turismo
meio-dia: tarde, sul
localizado: cair
anúncio: de-Anúncios
cessar: evita
circunstância: condição, envelope
barraca: cabine, cena
freqüente: repetiu, frequentemente
alto: voz
independente: independência, solto, independentemente
essencial: necessário, grampo
observação: observar
gratidão: obrigado
preservar: reter, armazenamento, proteger
aspecto: elemento, lado
pavor: medo, fobia, amedrontado
esperto: hábil, sábio
distrito: ao-vivo
falha: falhou, errado, falência, aborto-espontâneo
centavo: centavo, por-cento, cem
sentimento: sentindo-me
agente: significar
desesperado: desmaiar
união: aliança, unido
conceder: Admitem
acertar: multiplicar, pontapé, sucesso
enorme: ótimo, maciço
convicção: frase
febre: fogo, gripe
tratar: terapia, processo, curar
nosso: Primavera, nos
enganado: errado, Abuso, falho
ideal: melhor
pressa: multidão, golpe
corrigir: adequado, certo, fiel, consertar
realizar: mostra, Faz
de-alguma-maneira: um-pouco
noção: concepção, conotação, idéia
discussão: discutir, argumento
firmemente: estabelecido, embora
estável: padrão, consertar, consistente, permanente
império: real
caneta: lápis, cabeça
permitir: permissão
manter: aguarde, proteger, reter
lotado: multidão, densidade
limitação: limite, limitação
horrível: terrível
porta: porto, porta
experiente: experiência, hábil, especialista
contrário: oposição, oposto, em-direção, contrastando
tratado: memorando, acordo
ocorrer: vir
buscando: implorar, pesquisa
praticamente: quase, verdadeiramente, prático
traço: marca, veto
alegre: feliz, divertido
arranjo: ordem, disposição, organizado, acordo
ocidental: oeste
pressão: ênfase, imprimir, empurrar, peso
política: político
científico: ciência, cientista
mérito: louvor, qualificar, que-vale-a pena
entrevista: visita, entrevistador
território: campo
sexo: pênis, sexual, seis
criação: crio, formulação, estabelecido
trilha: marca, eleição, caminho
prospecto: esperança, probabilidade, visão, cena
operação: deriva, processo, açao, cirurgião
profundo: profundo
jogo: jogos-de-azar, coincidir, coincidência, corrida
uniforme: vestido
dívida: culpa, religião, dever, crédito
risco: aventura, investimento, companhia
execução: açao
humor: sentindo-me, humor, disposição
equipe-técnica: funcionários
perceber: compreender, concepção, Vejo
declarar: explicar
versão: cópia, célula
ímpar: estranho, incomumente
grato: obrigado
infinito: eterno, infinitivo
segurança: seguro, cuidado
sensato: sábio, racional, suscetível
chalé: cabana, cabine
capacidade: capaz, habilidade, volume
resolver: fique
envolvido: contratado, Junte-se
conselho: conselho
exame: sonda, Verifica, escolher
aço: ferro
teste: Verifica, experimentar
caridade: AME
verter: derramar, elenco
comunicação: correspondência, relações
alguém: quem-quer-que, pessoa, alguém
fila: linha, ordinal, conjunto, governo, ordem
pobreza: pobre
intenso: borda, extremo, violento
disputa: luta
disponível: forneceram, presente
resistência: oposição
incomum: incomumente, comum
deserto: abandonado, deserto
voto: escolher, voz
suportar: Urso, suporte, mais-recente, sofrer
suceder: sucesso
perna: pé, osso
oferta: propor, pedido
interior: interior
levemente: facilmente, claro
display: mostra, exposição, tela, cena, evidência
confinado: limitado, só
alvo: propósito, foco
crítico: necessário, crítico
Bolsa: bolso, saco, cesta
repetir: repetição, costas, repetiu
pista: monitor, canção, caminho, Segue
residência: abrigo
Diversão: feliz, divertido, diversão
defender: proteger
pesadamente: peso, a-sério
material: conteúdo, bens, coisa
seção: parte, dissecação
assentamento: acordo, abrigo, regulamento
prato: painel, disco, discoteca
superar: lidar, ultrapassarem, batida
terreno: razão, condições, motivo
mármore: pedra
capacidade: capaz, habilidade, talento
onda: maré, vago
povo: uma-pessoas, popular
possibilidade: probabilidade, capaz
manteiga: óleo
ódio: desprezo, ódio
perseguição: pesquisa
Puxe: desenhar, tesoura
sinal: gesto, marca, senha
seguramente: seguro
queimar: queimado, fumaça
lição: educação, assunto, curso
anual: ano
cartão: cartão, mapa, baixo, papel
aplicação: uso, Programas, pedido
inteligente: intelectual, sábio
município: boicote, regional, cidade, país
formato: Formato, elenco
fluxo: corrente
danificar: ruína, ferimento, pena
além-disso: adicional, até, Mais
comércio: comércio
do-sul: sul
exterior: Fora
média: secundário, significar
nu: vergonha
óbvio: evidente, aberto, axioma
fundação: base, plataforma
interesse: cuidado, ansioso, associado, interesse, preocupação
magia: charme
campanha: movimento, expedição
liberal: generoso
geralmente: comum, frequentemente, geralmente
caçar: caça
professor: autor
em-breve: em-breve, baixo, quase
bênção: abençoar
minúsculo: pequena, micro
bruscamente: velocidade, afiado, a-sério
peito: mama
profundidade: profundo
desempenho: mostra, produtividade
prosperidade: florescer, sucesso, bem-estar
escriturário: empregado, oficial
decidir: decisão, determinado, decisivo, soluto
vítima: caça, sacrifício, Pedágio
motivo: pretender, motivo, motor, propósito, estímulo
definitivo: determinado, evidente
tendência: característica, milha, disposição, deriva
terminar: acabado, cor
bandeira: bandeira, conhecer
administração: regra, gerir
raramente: raro
genuíno: virtual, original
Treinamento: educação, ensino
mal: errado, muito, pior, mal, doente
alimentar: comer, adotivo, Comida
central: centro, federal
contraste: contrastando, oposição, conflito
estrutura: construção, estrutural, organização
pagamento: pagamento
ritmo: velocidade
inquérito: sonda, pedido, pesquisa
onde-quer-que: Onde
dever: culpado, dever
manusear: processo, gerir, lidar, manipulação
viagem: visita, safári, passear, expedição
atirar: tiro, exílio, emitir
emprego: desempregado, preocupação, trabalho
corte: cortar
resistir: oposição
determinar: determinador, determinado, decisivo, impor, consertar
comerciante: negociante, pessoa-de-negócios, comércio
animado: ao-vivo
brisa: ar
parente: prima
assim: assim
provisão: introduzir, forneceram, bem-estar, atribuição, disposição
em-relação-a: cerca-de, consideração
escolher: escolher, leva
arruinado: destruir
entregar: dar, introduzir
inesperado: surpresa
escrivaninha: mesa, escritório
faixa: linha, banda
representar: representante, exemplo
respeitável: honra
responsabilidade: dever, culpa
desapontado: ambição, decepcionante
adequado: coincidir, adequado
depender: dependência, limite
gigante: ótimo, monstro
aperto: compreender, apreender
chegar: vir, alcançar
simplicidade: simples, humildade
outono: cair
ausente: ausência, ausente
melancolia: escuro
suspeito: adivinhar, dúvida, suspeito
determinação: determinado, decisão, relatório, definição
base: base, condições
examinar: observar, Verifica, análise
prêmio: recompensa, prêmio
compra: comprar
alguém: pessoa, alguém, embora
perceber: alcançar, compreender
derrota: batida, colar, falhou
criminal: sangue
bobo: enganar, ignorante
recordação: lembrar
ocupação: incursão, profissão, profissional, agressivo
discurso: moderno, conversa
auxiliar: Socorro, apoio, cooperação
venda: leilão, vender, desconto
convite: convite, ligar
inferior: insuficiente, baixa, pior
reconhecer: Admitem, diagnóstico
retrato: fotografia
sugerir: propor, supor
desapontamento: frustração, ambição, anticlímax, decepcionante, contagem
construção: construção
zelo: entusiasmo, diligência
responsável: dever
cura: terapia, curar, cuidado
incluir: Incluindo, entrar, inclusão, compreender, conteúdo
satisfazer: Conheçer, satisfeito, conteúdo, saciar
agonia: amargo
estúpido: crackpot, ignorante, enganar
gozo: apreciar
esconder: esconder
justamente: adequado, cheio
assumir: implorar, supor, consideração
estimativa: avaliação, adivinhar
rota: caminho
visitante: viajante, hóspede, observador
não: não
arame: linha
principalmente: especialmente, largamente
inconsciente: desmaiar
mútuo: entre-si, comum
externo: Fora, estrangeiro
universo: cosmos, mundo
relógio: hora
instrução: ensino, direção, manual
dolorido: úlcera, doente, dor
disciplina: assunto
introdução: introduzir, forneceram, promoção, cartilha, importar
deserto: deserto
confuso: nervoso, frustração
Casamento: casado
favor: representante, lado, graça, parte
contar: acreditar, cálculo, contagem
incerto: incerteza, instável, vago
noivado: contratado, nomeação
sujo: emissão, bruto
médico: médico
cobertura: coberto, inclusão, cobertura, embrulho
sincero: honesto, verdadeiramente, verídico
sensação: sentindo-me
específico: especialmente, particular, especialista
Pousada: hotel
rígido: difícil
acompanhar: Segue
Ponto: marca, relatório
virgem: filha
fome: faminto
favorito: favorito
Alfândega: tradição, polegada, dever, personalizadas
impressionado: sentindo-me
presa: caça, pilhagem, sacrifício
musical: música, músico
satisfatório: doença
ridículo: ignorante, divertido
folha: papel, folha, folheto
desgraça: vergonha
originalmente: original
salário: pagamento
extenso: muito-difundido, profundo
lazer: diversão, vazio, aposentar, relaxamento
queixo: barba
brilho: brilho-intenso, claro, radiação, Flash
ciúmes: ciumento
estrada-de-ferro: estrada-de-ferro, trem
libra: reservar
oriental: leste
cidadão: civil
praia: costa
característica: elemento, característica, propriedade
reserva: reter, reservar
rugido: barulho
estranhamente: estranho
latido: córtex, pele
recepção: bem-vindo, recibo
agradável: desagradável, tipo
vigília: acordado
pesquisa: análise, pesquisa
monarca: imperador, rei
vestuário: tecido, vestido, roupas
doença: doença, doente
brincadeira: gracejo, ironia, rir
comente: explicar
metal: ferro, mineral
solução: consertar, decisão, responda
tabaco: cigarro, fumaça
entidade: instrumento, unidade, presença, organização, companhia, pessoa
afastar: saída, divagar, fenda, ir
amargamente: amargo
pacífico: quieto
alarmado: ansioso
truque: recrutar, piso, enganar, manipulação, destreza
financeiro: dinheiro, econômico
preparação: preparar
Concha: vagem, córtex, pele
ninho: ao-vivo, soquete
conceber: concepção, compreender, acho
compromisso: nomeação, promessa
buscar: trazer, recuperar, leva
vela: claro, cera
ofensa: ataque, crime, massa
mistura: misturado
modelo: exemplo
defeito: culpa, ruga, inabilidade
objeção: desacordo, oposição, contradição
artesanato: arte, profissional, habilidade
negligência: ignorar, abandonado, omissão, boicote
dados: informação
arma: braços, pistola
Rosa: rosa
do-utilizador: cerca-de, beneficiário
avô: antepassado, avó
nulo: zero, vazio
vigoroso: violento
relâmpago: eletrônico, parafuso, Flash
esporte: movimento, exercício
pó: farinha, poeira
pintura: fotografia, painel
gritar: barulho, faca, chora
descuidado: imprudente, indiferença
derivado: derivar
porta: porta
conveniente: simples, prático, confortável, facilmente, adequado
enviar: Agência-dos-Correios, carta
pintura: cor
entrega: tradição
estabelecer: introduzir, estabelecido, consertar
suave: suave, claro
prontamente: uma-vez, adequado
departamento: parte
merecer: que-vale-a pena, qualificar
desistir: abandonado, emergir, fenda, elenco
garantia: assegurar, fiança
espelho: vidro
enredo: conspiração, plano, história
para-cima: Mais
tristemente: triste, infelizmente
modesto: comum, simples, humildade, frugal
prato: quadra, Comida, comer
líquido: rede, verídico, piedosos
calor: entusiasmo, caloroso
inquieto: ansioso
experimentar: piloto, experiência, experimentar
hoje: dia
tremendo: terrível, ótimo, maciço, muito
melhoria: reforma, reparar, progresso, recuperação, curar
disputa: desacordo, argumento
proposição: propor, frase
talvez: possivelmente, poderia
rifle: pistola
proteger: proteger
empregar: arrendar, uso
ao-contrário: vários
recuperar: Guardar, recuperar, recuperação
companheiro: cuspir, colega, amigos
organizar: ordem, legislar, organizado
comissão: painel, comissão
idoso: velho
fantasma: alma
revelação: expressão
reconhecimento: Admitem, confissão
argila: lama, toupeira
porta-malas: tribo, Bagagem, bota
gestão: gerir, dirigindo
restaurar: reter, costas, recuperação, recuperar
protesto: oposição, Março
pilha: lixeira, estaca, multidão
moderado: secundário, significar
feitiço: charme, soletração
área: campo, regional, superfície
formal: oficial
editor: autor, editor
reconhecer: confissão, Admitem
remédio: medicamento, terapia, consertar
perseguir: saciar, monitor, gastar, Segue
pólo: desculpa, coluna, extremo, umbigo
vital: necessário, decisivo, chave
presidente: cabeça
enfermaria: asa, regional, parte
Senhora: 
ânimo: coração, entusiasmo
justificado: racional, certo, justificar
admirar: louvor
abertamente: explicitamente, aberto, abertura
modificação: alterar, adaptação
dramático: drama, demonstrativo
em-cima: acima, pior
variado: vários
descida: natureza
inveja: ciumento
carregar: peso, cepa, Barra, tribo
fingir: fingir, drama
interno: interior
cortina: véu, tela
saudável: saúde
obscurecer: vago, eclipse
centro: centro
contestar: corrida
alterar: converter, alterar, substituir
vislumbre: relance, visão
contrato: memorando, ordem, aguarde, acordo
economia: Guardar, armazenamento, economia
corda: corda, cadeia, conjunto
combinação: coincidência, misturado, conjunto, ligar
prender: prender, concepção
temperatura: caloroso
estrito: estritamente, afiado, difícil
profissional: profissão, profissional
ferido: feridos, ferimento
Vizinhança: em-torno-da, ao-vivo, de-Meio-Ambiente
fumador: fumaça, cigarro
médico: médico
informar: jornal
proeminente: popular, memorável, conseqüente, chave, bem-conhecido
instituição: organizado, companhia, organização
pacote: embrulho, fechar, embalagem
angústia: amargo, miséria, dor, tristeza
obviamente: evidente, aberto, explicitamente
capturar: cativar, leva, concepção
amplo: o-suficiente, insuficiente
quarto: quarto
puramente: só, inteiramente, piedosos
articulação: comum, misturado, ligar
referir: referencial, consultar
identificar: identidade, identificável, consertar
banco: banco
resgatar: recuperação, Guardar
limite: limite, abreviar
expectativa: esperar
programa: plano, agenda
elétrico: eletrônico
intervalo: temporário, parar
perseguição: caça
ocupar: leva, apreender
vestido: casaco, vestido, terno
trancar: castelo
proposta: propor, frase, plano, conclusão
felizmente: feliz
subseqüente: Próximo
inquieto: instável, desagradável, ansioso, difícil
brilho: brilho-intenso, Flash
maquinaria: mecânico, máquina, mecanismo
atraente: magnético, desenhar, desejável
produto: bens
doença: doença
motor: motor, máquina
seus: elas
couro: pele
sutil: micro, fino
declive: milha, mergulho, dobrado
preocupação: ansioso, preocupação
violentamente: difícil
Especificadas: determinado
madeira: de-madeira, bastão, árvore
calcular: cálculo, contagem
matança: matar
engraçado: estranho, divertido
insulto: desprezo, vergonha
incapaz: capaz
jantar: comer
sensível: suscetível, chave
apetite: desejo
cortesia: educado, honra
esfera: campo, bola, regional
honorífico: honra
culpa: culpado, crime, culpa, pecado
delicioso: saboroso, gosto
trigo: folclore, grão, milho
humor: humor
encontro: lidar, Conheçer, encontro
crepúsculo: alvorecer
parque: jardim
economia: econômico, economia
governar: gerir, regra, dominar
formação: educação, formulação
magro: milha, fino
batida: hesitar, pancadinha, batida
unidade: unido, unidade, solidariedade
principal: pioneiro, chave, principal, ótimo, grampo
preliminares: abertura, original
fronteira: limite, borda
respirar: respiração
isentar: livre, livrar, perdoar
rico: rico
inspiração: impulso, inspirar
todo-o-mundo: todos
abundante: rico
pintor: artista
óculos: vidro
tiroteio: tiro, caça
vagão: trem, carrinho
emprestar: dar, crédito, citar
empreender: começo, Faz
foca: anel
clero: sacerdote
monte: instalar, aumentar, monte
ordem: coluna, conjunto, ordem
revista: pressione
áspero: difícil, estritamente
apesar-de: embora
justa: estritamente
paisagem: cenário, de-Meio-Ambiente, visão
abandonar: abandonado
artístico: arte
principalmente: especialmente, largamente
leal: fidelidade, honesto, fiel
adequado: congruente, coincidir, adequado
aconselhar: conselho, conselheiro
estável: estabelecido, determinado, padrão
máximo: maximizar, extremo
cometer: promessa, Faz
afetar: efeito, impressionar
camponês: agricultor
consideravelmente: muito, conseqüente
ampliar: detalhe, ampliar, alongamento
pessoalmente: individualmente, particular, próprio
moralidade: moral
rebelião: rebelde, revolução
fio: linha, girar
cobre: bronze
resposta: reação, responda
imperial: real
em-branco: vazio, oco, branco
menor: secundário, pequena, mineiro
barganha: comércio, ocasião
fadiga: cansado, cepa
antipatia: desprezo, ódio, relutância
normal: comum
esboço: esboço, plano
virtuoso: virtude
de-qualquer-maneira: no-entanto,, já
condutor: motorista, dirigindo, condutor
declaração: de-Anúncios
excesso: adicional, redundância
separação: disjunção, distância, separado
desgosto: desprezo, fobia, ódio
corretamente: mesmo, adequado
máfia: multidão, massa
desnecessário: desperdício, devo
pele: pele, casaco
encorajar: inspirar, empurrar
tributo: arrendar
aliviar: reduzir, livrar, perdoar
legislação: legislar, regra, legislatura
projeto: plano
fada: anjo, azul, vila
concluir: aguarde, conclusão
por-sorte: feliz
colo: joelho, avental, volta
estragar: pilhagem, ruína, sofisticar
passível: facilmente, tender, suscetível
pensativo: cuidadoso, ansioso, sábio
favorável: congruente, flexionar, desejável
lata: banco
dependente: dependência, anexado, empregado
garantia: assegurar, justificar, memorando
queixa: branco
convenção: memorando, acordo
ângulo: canto, polígono
largamente: muito-difundido, muito, geralmente, largamente
vaca: gado
preconceito: ódio
varanda: corredor, varanda
surpreendente: estranho, surpreender, surpresa, impressionante
fonte: fonte
apropriado: adequado, terno, consistente
confiante: coragem, seguro, acreditar
órgão: instrumento, membro, elemento, corpo
seleção: escolher, nomeação, eleição
temor: fobia, medo
comparar: comparação
relacionar-se: prender, gancho, relações, associado
presumir: acreditar, adivinhar, supor, consideração
ausência-de: perdido
elegante: moderno, elegante
positivamente: positivo
raciocínio: idéia, argumento
perturbar: nervoso, agressivo, interferir, chato
parceiro: namorada, comum, acionista
associação: conjunção, consideração
sobrinha: sobrinho, neta
corpóreo: fisiológica, corpo
Faculdade: escola-Superior, fatorial
canhão: bola, artilharia, pistola
navegação: navio, véu
inteligente: sábio
pequeno: anel, trivial, pequena
cuidado: aviso, cuidado
manuscrito: conta
Guerreiro: herói
líquido: água
conceito: concepção, conotação
especialmente: especialmente
salto: mosca, dança, salto, ressalto
relutante: pretender
extra: adicional
breu: calçada, tom, não
desajeitado: insuficiente, estranho
apreciar: aplaudir, apreciar
sobreviver: ao-vivo, fique
brevemente: acrônimo, baixo
arroz: bronze
cara: pessoa
comportamento: característica, conduta
adotar: supor, leva
regularmente: frequentemente, repetiu, permanente, adequado
investigação: sonda, pesquisa
constitucional: constituição
Mais-recentes: mais-recente
aluno: aluna
totalmente: inteiramente
retorcido: dobrado
diferir: separado, diferença, vários
desastre: ruína
aposta: estaca, condição, veto
cru: ao-vivo, fonte, bruto, verde
registro: entrar, inscrição, clube
hospitalidade: generoso
carrinho: trem, carrinho
robe: vestido
engajar: anexado, uso, arrendar, reter
rebanho: rebanho
coletar: reunir
panela: pote
assalto: ataque, incursão
enganar: enganar, trair
luto: tristeza
retirar: livrar, desenhar, aposentar
afinação: canção, harmonia
compaixão: empatia, pena
disfarce: esconder
transcrição: cópia
documento: arquivo
vizinho: em-torno-da
bloquear: evita, volume
obrigação: dever
declínio: negar, cair
ambicioso: ambição
feriado: férias, festa
punho: primeiro
águia: falcão, gravata
honroso: honra
significativo: necessário, conseqüente, impressionante
denso: compactar, espesso
ficção: romance, imaginação, história
recomendar: propor, introduzir, conselho
educacional: educação
para-cima: Mais, acima
buzina: milho
fundo: caixa, capital
apresentar: cabana, arquivo, cabine
traje: vestido, terno, personalizadas
tarifa: arrendar, ir, mapa
aplauso: aplaudir, aprovação
lembrar: lembrar, assemelhar
almofada: rio
lugar-nenhum: local
cadáver: corpo
essência: célula, criatura
elevação: íngreme
reino: campo, mundo
escadaria: escada, escala
acordo: memorando, compactar, terno, coincidir, acordo
renda: espigão, renda
estudioso: aluna, cientista
régua: duque, governador
louco: crackpot, enganar
entreter: bem-vindo, divertir, diversão
cumprimento: bem-vindo, cartão-postal
feminino: fêmea
monstruoso: monstro, terrível
instalação: equipamento
roubar: roubar, pilhagem
escada: escada, condutor, escala, escola
final: mais-recente
dividir: diferença, distribuir
incrível: estranho, incomumente
arco: curva
eleger: eleição, escolher
tímido: acanhamento, vergonha
névoa: névoa
colori: cor
advertir: aviso, induzir
raso: profundo
encorajamento: estímulo, conforto
irregular: comum, incomumente
fielmente: fidelidade, fiel, adequado
transferir: tradução
fundamental: base, grampo
pacote: fechar, fibra
trágico: terrível
revisão: revisão, crítica
terrivelmente: terrível, muito, pior
cozinhando: cozinhar, cozinha
revolta: rebelde, revolução
melhorar: consertar, curar
destruir: destruir
convencer: persuadir, assegurar
tigela: copo
ilustração: exemplo, fotografia
nervo: veia, coragem, nervoso
encarar: consertar
verificar: conhecer, assegurar, determinado, Verifica, consertar
penhor: assegurar, promessa, refém, fiança, penhor
ganhar: servir
selecionar: escolher
industrial: industrialização, indústria
interpretação: tradução
desafio: ligar
proibir: evita, negar
tema: motivo, assunto
admissão: recibo
piscina: piscina, cova
conferência: sessão, montagem
igualdade: analogia, equilibrar, equivalência, equação
recentemente: neo, recentemente, romance
arredores: de-Meio-Ambiente, em-torno-da
invasão: ataque, incursão
padrão: exemplo, uma-vez, padrão, Formato
revelar: divulgar, trair
resolver: solto, consertar
pregar: sermão
avó: noiva, avó
lã: algodão
comunicar: diálogo, socializar, relações
essencialmente: condições
opor: oposição
espécime: exemplo
arrastar: desenhar, tesoura
cortar: cultivo, colheita, cortar
preciso: adequado, farinha, cuidadoso
recorrer: leva, abrigo, parar
recusa: negar, desperdício
ligação: chave, fiança, cópula
compreensivo: pena
salário: pagamento
contínuo: continuar
excitar: induzir, incitar
descontroladamente: selvagem, violento
tristeza: tristeza, tragédia
aliado: unido, associado
teto: cobertor, cobertura
objetivo: foco, propósito
dinheiro: dinheiro
vago: aberto, livre, vazio, solto, vago
desprezar: desprezo
gramado: grama, prado
Peru: 
vizinho: em-torno-da
final: mais-recente, extremo, finalmente, grampo
submissão: obedecer, mandar
entrada: entrar
completo: profundo, cheio
emocionante: desenhar, curioso
vencedor: sucesso
conservador: ortodoxo, governador
entusiasmado: entusiasmo, ansioso
no-térreo: baixa
ferver: cozinhar, úlcera
lindamente: beleza, bela
amanhã: ontem
desconfortável: ansioso, desagradável
aparelho: equipamento
afirmar: insistir
elocução: pronunciar, expressão
trilho: estrada-de-ferro, trem
imperfeito: cheio, inabilidade, falho
adquirir: aquisição, derivar, comprar
ofensiva: incursão, ataque, agressivo
friamente: frio
palestra: curso
pelo-que: Onde
percepção: sentindo-me, relance, concepção
desenvolver: elaborar
função: cerimônia, trabalho, atividade
bala: comprimido, tiro, bola
vincular: prender, limite
idêntico: mesmo
substancial: demonstrativo, ótimo, conseqüente, impressionante
massa: massa, magnitude, volume, tumor
prolongado: grandes, demorar
aborrecido: irritada, desagradável
chateado: nervoso, triste
grupo: cópula, banda
feno: grama, palha
debate: desacordo, argumento
quietude: silêncio
parcial: exceção, parte
carne: eu-no
unir: solidariedade, arreios, conciliar, Junte-se
lâmina: folha, espada, faca
fábrica: moinho
nulo: zero, vazio
jornal: jornal, pressione
honestamente: fidelidade, honesto
legítimo: legal
acentuar: pronunciar, ênfase, foco
sinceramente: a-sério
liga: aliança
aprovar: aprovação
membro: membro, extremo
mordomo: Gerente, servo
evolução: reforma, evolutivo
pesquisa: Verifica, pesquisa
contemporâneo: moderno
escândalo: corrupção
deliberar: deliberadamente
símbolo: notação, gesto
lavando: lavagem, lavanderia
preciso: adequado, farinha, cuidadoso
ocorrência: incidente, ocasião
eixo: vala, ombro, árvore
haste: seco, tribo, raiz
corporação: companhia, organização
preferência: privilégio, preferir, vantagem, escolher
instar: induzir, impulso, desejo
remoção: distância
afirmação: aprovação, ênfase
acessível: visita, encontrado
comédia: humor
rubor: cor, excitação
código: jarda, codificar
adequado: o-suficiente, adequado
Dividido: distribuir
historiador: histórico
intensidade: densidade, cepa
democracia: república
credo: confissão
atração: charme, gravidade
concerto: festival
para-baixo: baixa
canal: canal, cachimbo
pronto: em-breve, pedido, ágil
bronze: bronze, Castanho
vestuário: roupas
remorso: triste, pena
exclusivo: monopólio, particular
porteiro: usar, portador
traço: linha
faixa: banda
em-última-análise: finalmente
equipe: coro
caro: Prezada
sede: sede, centro
agudo: afiado
envergonhado: nervoso, vergonha
prole: crianças
rede: rede
avião: pássaro, superfície, máquina
parcialmente: parte
orgulhosamente: orgulho
terraço: varanda, cobertura
aperto: aguarde, armadilha
explosão: explosão
tropa: exército, militares
hermeticamente: estritamente
pena: pena, frase
sujeira: úmido, fezes, lama
era: estação
embaixador: mensageiro
raça: multiplicar, corrida
interferência: interferir, aborrecimento, desordem
consistir: passar, conteúdo
aceitação: aceitável, aprovação, recibo
engenheiro: mecânico
parada: pé
alternativa: alternar, substituir
carimbo: anel
balcão: disco, oposição, oposto
Vênus: Sexta-feira
imaginário: imaginação
escalada: ascensão, rastejar
atrai: desenhar, impressionar
surpreendente: surpresa, impressionante
concorrência: rival
cristal: vidro
banho: banho, chuva
filosófico: filósofo, filosofia
barulhento: barulho
dispositivo: equipamento
transporte: tráfego, transporte
afinal: finalmente
muito: muito, terrível
contemplação: refletir, reflexão
fabricação: indústria, produzir
confortavelmente: confortável
exposição: exposição, relatório
agrícola: agricultura, Fazenda
busca: pesquisa
extensão: detalhe, ampliar
controvérsia: contradição, argumento
grosseiramente: quase
despesas-gerais: acima
conter: inibição, evita, limitação, reter
preservação: Guardar, cuidado, reter
bar: Barra
bacia: vale, piscina, lavatório
melodia: tom
contratar: arrendar
preocupado: ansioso, nervoso
idoso: de-velhice, velho
universidade: escola-Superior
cauteloso: cuidadoso
anterior: leste, antes
complicado: complexo, difícil, elaborar
desculpa: pedir-desculpas, desculpa
assustado: amedrontado, medo
substituir: alternar, abono, substituir
uso: uso
restauração: reparar, recuperação, recuperar
cerca-viva: cerca
primário: dominar, base, original, grampo
viga: raio
passeio: visita, expedição
exagerado: sal
competente: habilitar, capaz
urgente: em-breve, precipitado
alerta: aviso, alarme, acordado
forno: fogão
arredondado: volta
convencional: comum
pleitear: implorar, justificar
cordão: corda
ao-lado-de: paralelo, Próximo, conjunção
extrair: citar, suco
isqueiro: claro
cerveja: cerveja
tubo: cachimbo
avenida: ocasião
eficiente: hábil, eficaz, efeito
misturar: misturado, mexer
perturbação: desordem, aborrecimento
executivo: Gerente
décimo: dez
comparativo: comparação
sou.: manhã, brilhante
gaiola: castelo, célula
cadeia: prisão, cadeia
hábil: hábil, destreza, capaz
gritar: chora
compromisso: acordo, harmonia
munição: tiro
assistente: suporte, Socorro
cana: bastão
argumentar: discutir, insistir
lógica: argumento, racional, racionalidade
pânico: medo
circulação: andar-de-bicicleta, ciclo, tráfego, passear
estresse: cepa
consumo: uso, consumir, comer
sustentar: apoio, reter, aguarde, sofrer
colisão: cair, conflito
sem: insuficiente, cortar, falho
gradual: gradualmente
esmagamento: destruir, gravidade, abóbora
fenômeno: incidente, coisa
executar: corre, açao
cumprimentar: saúde, bem-vindo, saudar
monarquia: real, propriedade
comportar-se: ao-vivo
barreira: obstáculo, limiar
curva: curva
depender: contagem
conveniência: facilmente, conforto
Cordeiro: ovelha, rastejar
lógico: racional
dieta: Comida
judicial: quadra, legal
desconfiança: dúvida, fidelidade
pena: Primavera, pena
voluntário: voluntário
revestimento: casaco, suéter
natação: nadar
impressionante: impressionante
por-baixo: baixa, após
provincial: rural, província
compensação: compensar, abono
garçom: servo
promover: aceleração, promoção, adotivo, empurrar, contribuir
dedicar: pretender
hostilidade: hostil
plantação: Fazenda, berçário
expor: esboço, divulgar, aberto
remendo: local, acessório
interrupção: parar, aborrecimento
polegar: polegada
revolucionário: revolução
incrível: estranho, surpreender
dica: hemisfério, espigão, extremo, barba, cimeira, conselho
ameaça: ameaçador, perigo
selva: floresta
típica: comum, característica
combustível: óleo
tranquilo: quieto
destino: repetição, propósito, destino
pino: segredo, agulha
marte: Março
associado: associado, colega, conjunção, comum, paralelo, anexado
vicioso: imoral, mal
banquete: festa
detalhado: elaborar, profundo, dobradiça, detalhe, cuidadoso
armário: armário
legislativo: legislar, legislatura
margem: borda, campo
campeão: herói
pulso: impulso
fugir: corre, escapar
cláusula: corrente, parágrafo
composto: conjunção, complexo
nó: aguarde, tricotar
relação: relações, relatório, consideração
agência: organização, companhia, escritório
sorriso-largo: sorrir, careta
demonstração: mostra, Março
depressão: tristeza
veículo: máquina
emprestar: crédito, citar
inchaço: inchar
tópico: motivo, assunto, título
veredito: decisão, regra
Sábado: sábado
identificação: identificável, identidade, definição
fotografia: fotografia, tiro
aliado: amigos, amizade, unido
trato: caminho, alongamento, argumento
fita: banda, filme
mais: Mais
transparente: transparência, evidente
perfume: cheiro
incomodar: problema, interferir, chato, aborrecimento
qualificado: capaz, qualificar, hábil
ensaio: artigo, relatório
cavaleiro: cavaleiro, equitação
solidão: solitário
pulso: mão
finamente: suave, fino, finalmente
nulo: zero, vazio
condenar: frase
mandíbula: pinho
único: unido
inevitavelmente: inevitável
tambor: dança, vazio
caixa: caixa, cesta
duração: temporário, permanente, Tempo, comprimento
pesar: medida, peso
mosteiro: abadia
publicar: publicação, distribuir, divulgar
introspecção: visão
definitivamente: evidente, estritamente, curso, verdadeiramente, explicitamente
mudança: alterar
hoje-à-noite: dia
fator: razão, empregado, coeficiente
bagunça: agressivo, desordem, confusão
prática: exercício, açao
santuário: altar
encolher: acrônimo, reunir
despesa: despesa, uso, gastar
encorajando: coração, inspirar
exposição: expressão, exposição, relatório, efeito
bruto: bruto, verde
bilhete: bandeira, mapa
para-trás: costas
sapato: sapatos, bota
fraude: ilusão
explosão: explosão
lareira: chaminé
jarra: vidro, garrafa, jarro, pote
molho: curativo
podre: preguiçoso, imoral, pobre
comportamento: característica, conduta
empréstimo: crédito, citar
irracional: racional, absurdo
luxúria: ambição
anualmente: ano
fluido: água
criança: crianças
insano: crackpot, enganar
derrubar: derramar
conquista: sucesso, categoria, explorar
suposição: supor, imaginação, supostamente
engraçado: humor, divertido
êxtase: entusiasmo
aposentadoria: aposentar, renúncia, pensão
parlamento: legislatura, senado
emergência: ansioso, crise
parcela: embrulho, parte, fechar
gaveta: caixa, escada
contribuição: contribuir, estaca
ligação: acessório
coragem: coragem, extorquir
impressão: publicação, imprimir, pressione
advogado: advogado, justificar, réu
ambiente: atmosfera, de-Meio-Ambiente
confirmar: provar, assegurar, reforçar
anunciar: divulgar, publicação
renunciar: renúncia, aposentar
rejeitar: negar, veto
resistente: difícil, cruel
fragmento: lasca, bocado, fragmento, alongamento
meditação: cuidado, refletir
mancha: local
enterro: funeral, enterrar
hipótese: supor
hipotético-humor: especulativo-humor, pretensioso-humor, condicional-humor
transação: atividade, comércio
ultraje: raiva, desprezo, vergonha
variar: variável, vários, substituir
advogado: advogado, representante
ofender: culpado
pacote: embrulho, bolso, fechar
clássico: clássico
rancho: Fazenda
torta: bolo, pi
precisamente: certo, precisão, estritamente
coice: elenco
marinho: marinha, mar
cantor: leitor
eletricidade: eletrônico, corrente
estrangeiro: estrangeiro, hóspede, extraterrestre
rachado: explosão, fenda
deprimido: triste, tristeza
densamente: espesso
razoavelmente: razão, racional
cabo: oco, flexionar
ilustrar: explicar, refletir
adoção: aprovação, recibo
notório: bem-conhecido
ferir: ferimento
corretamente: precisão, adequado, certo
pasto: salgueiro, prado
Minhoca: máscara, profundo
estimativa: avaliação, adivinhar
equipamento: organização, roupas, equipamento, vestido
azarado: infeliz, infelizmente
oitavo: oito
descontraído: conforto, relaxamento, quieto
adjacente: quase, em-torno-da
senior: veterano, principal, cabeça
amedrontar: alarme
tutor: treinador
roubo: pilhagem, roubar
comércio: comércio, comercial
extinto: desaparecer
protuberância: massa, toro, dente
acidental: acaso, temporário, coincidência, surpresa
local: casa, local, construção, dentro-de-casa
entrega: introduzir
curvado: dobrado, flexionar
produtivo: fabricante, produzir
inchado: inchar
cultivar: adotivo, Fazenda
variação: alterar, diferença
oponente: rival, oposição
neto: neta, sobrinho
unha: unhas, espigão, parafuso
benevolência: generoso, bem-estar, virtude, graça
precisão: precisão
indicação: marca
redução: reduzir, cortar
barriga: estômago, umbigo
aborrecido: ódio
compor: Escreva, crio
passageiro: viajante
picada: facada, amargo, mordida
simultaneamente: Enquanto-isso
episódio: conseqüente, parte
persistente: consistente, continuar, permanente
morrer-de-fome: faminto
consulta: consultar, conselho
azedar: ácido
sublinhado: insistir, ênfase
parada: Março
capacete: chapéu
proclamar: propaganda, publicação
alojamento: hotel
spray: medicamento
formalmente: oficial
perturbador: nervoso, interferir, ansioso, chato
antecipação: esperado, esperar
grau: ponte, coeficiente, categoria, avaliação, grau
tamborete: fezes, cadeira
justificação: justificar
estrangeiro: estrangeiro, hóspede
transporte: tráfego, transporte
compreensão: compreender
diretor: Gerente, cabeça
temporal: temporário, Tempo
agradável: bela
fazer-cumprir: impor, coagir, habilitar, polícia
abrangente: profundo, cheio
ameaçar: ameaçador
progressivo: progresso, radical
recurso: fonte
limitar: limitado, apreender, abreviar, reduzir
felicitar: louvor
seguro: seguro
nomear: olho
interromper: obstáculo, cortar, interferir, amputar, parar
suprimir: oprimir, evita
camada: coluna
pista: evidência, chave
dente: dentes, dentista, dente
garantia: assegurar, fiança
procedimento: processo, mecanismo, açao, abordagem
recomendação: conselho
lacuna: parar, abertura
implicar: significar
anexar: anexado, emendar, prender
postura: gesto, indicador, posição, ficar-de-pé
suíte: asa, conjunto, apartamento
jóia: tesouro, florescer
emocional: sentindo-me, apaixonado, suscetível
concreto: demonstrativo, consistente
combinar: aliança, conjunção
pico: cimeira
moeda: dinheiro, moeda
objetivo: propósito, foco
memorial: memória, aviso
separadamente: separado, diferença, individualmente, solitário
bandeja: disco
horizontal: equilibrar
fretar: constituição, papel, arrendar
item: bens, artigo, elemento, voz, tipo, posição
expansão: detalhe, ampliar
torção: parafuso, girar, ironia
tradicional: tradição, clássico
envolver: Incluindo, inclusão, conteúdo
rotina: comum, mecanismo
resolver: arado, solto, consertar
seduzir: provocação, induzir
sem-êxito: falhou
político: político
tampa: cobertura
violação: ferimento
junção: ordinal, cruzamento
chefe: proprietário, Gerente, empregador, cabeça, ladrao
ferragens: equipamento
costa: costa, banda
beira: borda, penhasco, lábio
mercadoria: comércio, bens
indiferente: separado, ausente, controlo-remoto
asilo: hospital, abrigo
afirmar: provar, assegurar
cronograma: mesa, calendário, gráfico, disposição
trincheira: vala
municipal: cidade
revolta: mexer
testemunhar: provar
materno: grávida, mamãe
escultura: estátua
sabor: gosto
marca: manual, marca
bagagem: Bagagem
lixo: absurdo, fragmento, lixeira
ferramenta: instrumento
caos: desordem, confusão
acusação: terno
tenso: nervoso, Tempo
galinha: frango
aparar: ornamento, reduzir, cortar
discreto: sábio
lamentar: chora
dialeto: polonês
elementar: base
frete: Bagagem, Barra, caminhão
limpar: varrer
negação: negar
subterrâneo: segredo
intermediário: Verifica
fórmula: equação, pressione
enganação: enganar, manipulação
assombro: hesitar, fobia
registrar: Lista, inscrição
indeterminado: vago, aorista
excedente: adicional
arrepio: tremer
tecido: organização, rede, tecido
esboço: esboço
brinquedo: boneca, Toque, jogos-de-azar
escada: escada, escala
transição: infecção, alterar, transitivo, cruzamento
botão: chave
grosseiro: grosseiro
programa: plano, agenda
fabrico: industrialização, moinho, produzir
zona: campo, regional, banda
nono: nove
álcool: vinho
ávido: ambição, ganância
dirigir: gerir
influente: eficaz, penetrar
cercar: colarinho, cerco
afogar: lavatório, canto
deslizar: deslize
semear: ascensão, pão, porco
dominante: ótimo, incursão
Liderança: hierarquia, manual
diário: jornal, calendário
comemoro: persuadir
espalhafato: excitação, barulho, chato, confusão
deputado: representante, alternar
automóvel: motor
emenda: revisão, alterar
vertical: ficar-de-pé, longitudinal
insuficiente: insuficiente, o-suficiente
Droga: fino
inferência: adivinhar, conclusão
inferencial-humor: indutivo-humor
anúncio: de-Anúncios, comercial, propaganda
roubo: roubar, plagiar
espontâneo: instinto, arbitrário
utilidade: organização, uso, instrumento
conectar: prender, gancho, emendar, Junte-se
em-baixo: baixa
intervenção: interferir
renascimento: reviver, recuperação
Internet: comércio
fisicamente: física, corpo
ponto: local
chocante: choque
rudemente: grosseiro
equilibrado: consistente
índice: expoente, Lista, indicador
transmite: mandar, distribuir
para: acima, Fora, para-a-frente
conversar: conversa, estatística
âmbar: amarelo
tonelada: tom
suavemente: confortável
tensão: cepa, excitação
baleia: eleição
venenoso: veneno
concessão: mover, privilégio, desconto
trabalhador: empregado
inclinação: mergulho, conjugado
banheiro: armário
ofensa: ataque, crime
rancor: ódio, vingança
fortitude: paciência, coragem
antecipar: esperança, esperar
ritmo: batida
rato: rato
corresponder: correspondência, terno, adequado, responda
deter: evita, apreender, reter
interpretar: explicar
salão: corredor
operar: manipulação, trabalho, corre, açao
drenar: calha, corre
salário: pagamento
desagradável: ódio, mal, desagradável, decepcionante, feio
cemitério: funeral
gesso: giz
toque: cachimbo, leite
demitir: saco, ignorar, negar, veto, distinguir, redundância, perdoar
provocar: excitação, irritada
residir: fique, ao-vivo
decoração: ornamento
dedo-do-pé: na-ponta-dos pés, pé, dedo, pata
incapacidade: inabilidade, fraqueza
inventar: invenção
definir: determinador, elaborar, descrever
restringido: limitado, limite
armário: armário, prateleira
cremalheira: prateleira
superintendente: condutor, inspetor
apresentação: introduzir, mostra, exposição, promoção
borracha: bola, elástico
excluir: privar, excluir, distinguir
privilegiado: privilégio
eremita: ascético
arranhar: raspar, começo
parafuso: parafuso
explorar: observar, explorar
segurar: assegurar
cilindro: disco
resumo: esboço, abstrato
improvável: probabilidade
enxame: rebanho, filho
sistemático: mecanismo
praticamente: verdadeiramente, quase, prático
cliente: personalizadas, hóspede
catálogo: Lista, mesa
química: químico
assar: pão, cozinhar
perfurar: facada, penetrar, perfuração, perfurar
arrebatar: lágrima, apreender, seqüestrar
lançamento: emitir, elenco
agricultura: agricultura
atriz: ator
teatro: teatro, corredor
droga: medicamento
desfavoraveis: pior, desvantagem, reverso, negativo, prejudicial
doce: hortelã, chocolate, doce
colar: conjunto, colar
condenar: armadilha, punir, culpado
investigar: sonda, observar, Verifica
pacote: embrulho, conjunto, fechar
rastejar: rastejar, encolher-se
estalo: estouro, clique, fotografia, maré, em-breve
pneu: embrião, anel
perceptível: impressionante, evidente
testemunho: base
antecessor: antepassado
similarmente: Da-mesma-forma, mesmo
barragem: poeira
escorregadio: deslize
transformação: alterar
franja: borda
localização: posição, local
grupo: conglomerado, massa, banda
cotação: citar
custódia: diligência, cuidado
plausível: aceitável
lançar: elenco
degrau: piso
concentração: acumulação, foco
conveniente: prático, confortável
isca: gosto, cartilha
diverso: vários
fatia: lasca, disco, bocado
broca: perfuração, escavação
responder: reação, restituição, responda
mortalidade: morte
erva-daninha: grama
relativamente: volume
matemático: matemática, atlético
moralmente: moral
suspiro: suspiro, respiração
corrida: corrida
isolamento: disjunção, separado
às-vezes: às-vezes
adulto: maduro
dificuldade: amargo, miséria, problema, aborrecimento
rumor: bisbilhotice, voz
resistir: reter, Urso, mais-recente
júnior: jovem
tricotar: tricotar
indireto: diretamente
precedente: exemplo
corredor: raio, corredor, cruzamento
contradizer: contradição, negar
resgatar: Guardar, compensar
caminho: caminho, passadeira
engrenagem: equipamento, dentes, costela, corre
celebração: festa
confortável: caloroso, confortável
publicação: publicação, distribuir
cliente: hóspede, comprador
tapete: tapete, andar, cobertor
divisória: contagem
perspectiva: relance, visão
estético: beleza
ressentir: ódio
pose: propor, induzir, ficar-de-pé
contentamento: satisfeito
organismo: criatura
ininteligível: compreender
enfático: ênfase
meio-dia: tarde, sul
lírio: ler
substantivo: nominalization, nome
dobrável: dobra, dobrado
útil: Socorro
persistir: insistir, continuar, mais-recente
saída: Saída, soquete, saída
herdar: herdeiro
velocidade: velocidade, precipitado
insultante: verbal
deficiência: insuficiente, cortar, omissão, falho
garantir: assegurar
Injusto: certo
sub: substituir
balde: barril, colher
organização: organização
principalmente: especialmente
ritual: cerimônia, adoração
coxa: presunto, pé
guarda-roupa: roupas, armário
textura: organização
turbulento: violento
pântano: pântano
inconsciente: ignorante
inicial: abertura, original, começo, primeiro, primitivo
mínimo: mínimo
correção: reforma, revisão, reparar
negligenciar: ignorar, esqueço
unânime: unido
carbono: carvão
bobina: arquivo, rolo, encaracolado
quebradiço: frágil, afiado
vocabulário: dicionário
passeio: vaguear
ginástica: exercício, ginástica, condição
nacionalidade: nacionalismo, nacional
sabor: gosto
sem-importância: necessário, trivial, irrelevante
soco: batida
caminhar: progresso, piso
eixo: ombro, imprimir
gratificante: doença, satisfeito
confiável: fiel
nojento: ódio, feio
ético: moral
colapso: cair
almofada: rio
confundir: falsificar, destruir, surpreender, falhou, embaraçar
mito: história, lenda
propriedade: propriedade
susto: amedrontado, terrível, medo
freio: parar
noz: feijão, semente
prolongar: inchar, aumentar
solar: luz-do-sol
bico: lábio, unidade
de-concessão: trela, arrendar
relação: relações, comparação, escala, relatório, analogia
pente: escova, ombro, cume
traduzir: tradução, giro
recreação: diversão, férias, relaxamento
capricho: cor
amostra: exemplo, experimentar
plural: massa
iniciativa: plano, experimentar
geléia: geléia, leite
anarquia: desordem
perfil: esboço, arquivo, site
financiar: dinheiro
básico: base, grampo
banir: lixeira, incursão
elétrico: eletrônico
erva: grama
prosperar: florescer
semelhança: analogia, assemelhar, solidariedade
privacidade: particular
arena: campo
viajante: viajante
partícula: átomo, semente
inato: original
habitante: residente
flauta: apito
reprodução: fertilidade
palmo: comprimento
salada: alface, poder
corante: cor
demonstrar: provar
ética: moral
oficialmente: oficial
irritar: interferir, chato, provocação, incitar, perfuração
deslizar: deslize
traço: característica, propriedade, alongamento
compositor: músico
futebol: pontapé
parceria: cooperação, aliança, contribuir
continuação: continuar
anormal: incomumente, crackpot
seqüência: cadeia
aperto: empurrar
equipamento: apreender, lidar, equipamento
freio: inibição, calçada, limitação
publicidade: de-Anúncios, propaganda
retirada: regressão, soquete, conclusão
hipoteca: refém, crédito, penhor
paciência: paciência, Urso
reprimir: evita, oprimir
cônjuge: marido
válido: eficaz
válvula: van
construir: crio, construção, formulação, fase
vapor: vapor, casal
bastão: bastão, clube, para-a-frente
contraditório: contradição, irrelevante, contrastando
automático: diretamente
explícito: aberto, transparência, axioma
eficazmente: eficaz, efeito
confiança: dependência
inspecionar: observar, Verifica, passear, análise
estranhamente: estranho, incomumente
arrastamento: desenhar, pilhagem
embaraçoso: vergonha, embaraçar
desabilitado: inabilidade, passiva
arrogante: orgulho
ondulação: encaracolado, anel
jóia: pedra, florescer
aniversário: aniversário
prestígio: crédito
negligência: omissão, desprezo, indiferença
auto-: particular
discriminação: exceção, distinguir
continental: continente
alvo: propósito
tenda: loja, ficar-de-pé
investir: investimento
cruzeiro: navio
comício: solidariedade, açao
rumor: bisbilhotice, voz
ativamente: a-sério
Verifica: Verifica
compartimento: apartamento
especificamente: especialmente
estrondo: estouro, explosão, tiro
agregar: bruto, comum
fração: parte, estaca
ilegal: ilegal, selvagem
dissolver: excluir, solúvel, solvente
equilíbrio: equilibrar
exploração: sonda, análise
cebola: curva
afinidade: analogia, solidariedade, dependência
desonesto: fiel
choque: conflito, choque, interferir
poltrona: cadeira, sofá
massa: farinha, massa, fermento, bolo
embarcar: Junte-se
transe: visão
rejeição: negar, desperdício
variação: diferença, adequado, contradição
absorção: pele
coletivo: massa
oportuno: Tempo
invadir: ataque
demissão: saco, redundância
significativamente: largamente
experimental: piloto
filme: filme, TV, fotografia
publicidade: propaganda, promoção, de-Anúncios
expandir: ampliar, detalhe
cambalhota: tropeçar, cair, mergulho, roupas
forja: crio, falsificar
fóssil: óleo, arqueológico
limitação: obstáculo, regulamento, limitação
entusiasmo: entusiasmo, especiaria, experiência, gosto, pele
fastidioso: chato
aldeia: subúrbio, aldeia
estrondo: florescer, ressalto, explosão
reproduzir: cópia, imitar
congresso: montagem
uva: vinho
oficina: estúdio, seminário
diminuir: reduzir, cortar, cair
pronúncia: pronunciar
julgamento: decisão, frase, regra, juiz, jurisdição, crise
concentrado: cuidadoso, foco
desfazer: divulgar, costas
balsa: iate, navio
direto: simples, diretamente, facilmente, transparência, linear
altitude: comprimento
denotar: mostra, significar
exportar: Saída
ofensor: cometa, culpado
desaprovação: oposição, veto
par: casal, equilibrar
abolir: excluir
ajustar: revisão, consertar, adaptação
filiação: membro
bitola: medida, escala, magnitude, fino, indicador
tolerar: perdoar
quadril: nádegas, cintura
aderir: Segue, Junte-se, bastão, reter
repelir: evita
agitação: desordem
castidade: precisão, pureza
negligente: relaxamento, solto
contração: acanhamento
jornalista: repórter
sintoma: exposição
bicicleta: andar-de-bicicleta, ciclo
alcatrão: calçada
espiral: girar
comentário: vacina, definição
transmissão: infecção
cédula: voz, eleição
potencial: capaz
elegível: capaz, certo, qualificar, adequado
laço: andar-de-bicicleta, dobradiça, anel
trabalhador: empregado
processar: culpa
licença: permissão
abandonar: descarga
eu: si-mesmos, respiração
jato: ejetar, pássaro, corrente
violar: desobedecer, cortar
viciado: dependência
sobrevivência: tempo-de-vida, vogal
congelar: congeladas
tecer: tricotar
incumbente: estabelecido, beneficiário
apatia: indiferença
organizar: organização, preparar, legislar, organizado
presumivelmente: possivelmente, supostamente
acorde: acordo
sangrar: sangue, sangrento
detecção: encontrado, pesquisa, divulgar
esmagar: destruir, parar
facilitar: aceleração, adotivo, contribuir
freqüência: ciclo, hesitar
ponto: de-costura
diretório: evidência
picar: mordida, cortar, bife
aquecimento: caloroso
deprimente: decepcionante, triste
golpe: revolução, tiro, golpe
compassivo: pena
pensador: intelectual
orçamento: equilibrar
cívico: civil, urbano
inserir: entrar, aumentar
meditar: refletir, acho
flexível: simples, flexionar, elástico
laje: painel, comprimido, fogão
qualificação: talento, qualificar
interruptor: reverso, converter, chave
toalha: tecido
década: dez, aguarde
múltiplo: vários, Mais
bandagem: curativo, prender
arrumado: arrumado
aplaudir: pancadinha, aplaudir
bordo: palma
ancinho: varrer
vazio: vazio
medula: óleo, cérebro, cabaça
bainha: casaco, envelope, vagem
absorver: explorar, chupar, abraço
predição: previsível, adivinhar
educar: educação, trem, ensino
inquérito: sonda, pedido, pesquisa
dominação: regra
parental: principal
participar: delta, Junte-se, contratado
elevador: elevador
lateral: lado
adiar: demora
repugnância: desprezo, ódio
núcleo: nuclear, célula, embrião
metáfora: exemplo
diminutivo: pequena, micro
bomba: bomba
criticamente: profundo, crítico
ferrugem: passar
reserva: reter, apreender
costurar: de-costura
químico: químico
salão: parar, corredor
começo: começo, incursão, ataque
mergulhar: mergulho
hostil: hostil
censo: cálculo
denunciar: acusar, frase
linho: linho
suspender: evita
tapa: batida
Relaxe: relaxamento
namoro: jarda
mercadoria: bens
continuidade: conjunção
recíproca: intercâmbio, inversão
prescrição: medicamento, cópia
bolha: espuma
pá: tenaz, remo
utilizar: explorar, uso, gastar, arreios, consumir
durável: grandes
linhagem: familiar
zinco: lavatório
seja-qual-for: tanto-faz, qual
finito: limitado, finalmente, acabado
auxiliar: suporte, Auxilia
passeio: distorcer, luta, golpe
acadêmico: educação
pneu: embrião, anel
consumidor: uso
validade: que-vale-a pena, crédito
aproximadamente: quase, aproximado
tricotado: tricotar
microscópio: telescópio
civil: civil
cinta: trela, corda
simbólico: gesto, identidade
adaptar: adaptação, lidar, transcrever
probabilidade: probabilidade, capaz
subjetivo: mentalmente
pronome: consciência
erradamente: errado, Abuso
desencorajar: embaraçar, ambição
recém-chegado: hóspede
infinidade: infinitivo
gráfico: gráfico
Figura: em-forma-de, fotografia
nicho: consistente, chave
desiludir: decepcionante, trair, falhou
projeção: plano, mostra
libertação: descarga, salvação
receita: estímulo
franquia: privilégio
incongruente: absurdo, irrelevante, insuficiente
rotação: ciclo, revolução, girar
botão: broto
metro: medida
restrição: limite, limitação, regulamento
categoria: comunidade, categoria
racial: corrida, racismo
substituição: ao-invés, substituir, alterar
inovação: invenção
enfrentar: lidar
banimento: negar
decorativo: ornamento
entrada: induzir, corredor
arremessar: elenco, encaracolado
rolagem: reservar, rolo, encaracolado
mecânico: mecânico, artesão
agressão: ataque, agressivo, ultrapassarem
Ei: Olá, bem-vindo
medição: medida
competir: lutar, rival
academia: escola-Superior
novato: recrutar, fresco
divorciado: divórcio
laticínios: leite
reservatório: tanque
compras: loja, comércio
implícito: consistente
estratégico: estratégia
mofo: modulo, Formato, imprimir, elenco
ensaio: exercício, repetição
insistência: insistir
preceder: antes
médio: medieval, a-meio-caminho, cintura
turista: viajante, turismo
bebida: bebe
atento: cuidadoso
articular: explicar, expressão
ré-: então, costas
emendar: revisão, alterar, substituir, emendar, reforma
diagrama: gráfico, mapa
dedutivo-humor: indutivo-humor
oprimir: oprimir
móvel: telefone, célula
elevar: promoção, elevador
paradoxo: contradição
exagerar: sal, maximizar
loiro: amarelo
deixa: marca, senha, bastão
corredor: corredor
negociar: conversa, discutir
regime: regra
tolerância: tolerante, Urso
opção: alternar, pepino
cruzada: movimento
epidemia: tragédia, tradução
técnica: técnico, abordagem, engenharia, equipamento
terminal: finalmente
graduado: passar
saída: despesa, conclusão, publicação, saída, produtividade, Saída
localizar: local
padrão: omissão, padrão
contexto: de-Meio-Ambiente, cena, conotação
aliança: aliança
falha: culpa, errado, inabilidade, desvantagem
conceder: Admitem
transmissão: publicação, mandar
discar: escolher, anel, reunir
predomínio: popular
cada-vez-mais: todos
transformar: alterar, converter
pipa: Dragão
ambíguo: vago, contradição
café: café, Barra
prêmio: recompensa, prêmio, Admitem
etiqueta: estúdio, marca
aprovação: aprovação, Admitem
parentesco: analogia, socialista
realista: verdadeiramente
réptil: serpente
ao-ar-livre: Fora, aberto
politicamente: político
resíduo: permanece, desperdício
fita: cassete, banda, filme
brando: suave, doce
oral: verbal, lábio
especular: adivinhar
expulsar: ejetar, descarga
defeito: local, inabilidade
pular: dança, gastar
caneca: copo, careta
cunha: espigão, estaca, canto
isenção: desconto, exceção, redundância
portátil: pequena
invólucro: embalagem, embrulho
brilho: talento, beleza, brilho-intenso
barbatana: remo, balé
murmurar: sussurro
baga: baía
imigração: migração
enxada: arado
cirurgia: cirurgião
acumular: acumulação, depósito, reunir
cocô: fezes, cachimbo
abdômen: estômago
implicação: conotação, inclusão, conclusão
incentivo: estímulo
chave: chave-de-fenda, chave
campo: rural, subúrbio, campo, aldeia
degradar: destruir, reduzir
indígena: natureza, original, residente
pilha: lixeira, cume, chaminé
disco: disco
tendência: conduta, direção, dobrado, disposição, deriva
corporativo: companhia, comum
absolver: livrar
instável: instável, impermanência
compatível: consistente, paralelo, congruente
telefone: telefone
vácuo: vazio
agarrar: facada, leva, apreender
convulsão: terremoto, explosão
chato: furado, perfuração, chato
pasta: conjunto, carteira
fenda: fenda
complicação: problemático, Pedágio
intervir: interferir
polar: polaridade, extremo
delegar: representante, mensageiro
vontade: força-de-vontade, desejo
prever: previsível, adivinhar
otimismo: esperança, acreditar
casca: pele, vagem, córtex
esculpir: mordida
flutuar: flutuador, planar, hesitar
setor: campo, indústria, regional, parte
sobrenome: nome, elas
instituto: organizado, companhia, organização
urgência: ansioso
agradável: tipo
dissuadir: evita
negação: negar
vencedora: sucesso
composto: misturado
impacto: efeito, conflito
fibra: fibra
sorvo: andorinha
visual: ótico, cena
garra: pata
queixoso: ator, portador, razão
deplorar: pena
enganar: distorcer, surpreender, enganar
proibir: inibição, evita, negar
executante: ator, artista, jogador
torneio: corrida
exigência: pedido, condição
menos: mínimo
desordenado: imprudente
infeccioso: infecção
enfatizar: insistir, ênfase
calças: calças
confundir: quebra-cabeça, surpreender, embaraçar
dedicar: voluntário, pretender
cirúrgico: cirurgião
veracidade: fato, precisão
centésimo: cem
inclinado: íngreme, mergulho, dobrado
nas-proximidades: quase, em-breve, em-torno-da
normalmente: comum, frequentemente, geralmente, tender
confuso: contradição, quebra-cabeça, confusão
proporcional: comparável, equilibrar
discordar: desacordo
irritar: raiva, interferir, provocação, irritada
excelente: melhor, impressionante
iniciação: começo
precipitação: precipitado
aterrorizar: alarme
passatempo: diversão
gramatical: gramática
numérico: número, digital
critério: padrão
previsão: previsível, adivinhar
desaprovar: negar
exótico: estrangeiro, estranho
bulbo: lâmpada
aumentar: ampliar, aumentar, maximizar, curar
fusão: fundição, ligar
votação: eleição
talentoso: talento, hábil
descongelamento: fundição
endireitar: alongamento, consertar
decorar: ornamento
presidencial: presidência
colisão: prematuro, multiplicar, pontapé, dente, tumor
parabéns: louvor
digitalização: varrer
intitular: habilitar, certo
aposta: condição
tecnicamente: técnico, engenharia
empírico: experiência
dominar: dominar
anunciar: de-Anúncios, propaganda
difusão: distribuir, publicação
pastar: raspar
estojo: equipamento, caixa, conjunto
médico: médico, treinador
embeber: chupar, mergulho
conservação: proteger, Guardar, cuidado
lodo: lama, calçada, driblar
desafiador: difícil
poluição: poluir, corrupção
produtos-químicos: químico
fornada: rebanho, impulso, volume
mamãe: mamãe
assustador: terrível, ameaçador
especialista: especialista
ansiar: desejo
banheiro: banho
jogar: jogos-de-azar, Toque, aventura
integrante: necessário, integrado
eliminar: livrar, excluir
ervilha: feijão
apêndice: acessório, adicional, abono
circular: distribuir
inclusivo: unido
vendedor: negociante
molestar: nervoso, interferir, obsessão
explodir: explosão
alavanca: curiosidade, alavanca
derramar: vazamento, derramar
grátis: livre
ingrediente: elemento
déficit: aberto
perturbador: nervoso, chato, desagradável, triste, desordem
habitação: casa
fotográfico: fase, fotografia, fotógrafo
praga: inseto
pílula: comprimido
atualmente: presente
mídia: pressione
destroços: ruína
corpus: corpo, conjunto
cardápio: Lista
fratura: fenda
fórum: plataforma, perfuração, quadra
ímpeto: velocidade, impulso
inclinação: alaúde, dobrado
telha: tijolo
estante-de-livro: biblioteca, livraria
computação: cálculo
produtor: fabricante
monetário: dinheiro
descrever: descrever, refletir, introduzir
inflação: inchar
marginal: borda
fantasia: imaginação
minar: destruir
coerente: estritamente, conjunção, consistente
fundamentalmente: condições
intencional: deliberadamente
sobrevivente: família
fluxo: rio, corrente
competitivo: rival
jóias: ornamento
alcoólico: bêbado, vinho
discriminar: distinguir
militante: radical, terrorista, militares
desarmar: braços
crucial: necessário, decisivo
tarefa: trabalho, exercício, dever, atribuição
contingente: privilégio, atribuição, quantidade
escavação: cova, escavação
cálcio: pontapé
comemorar: persuadir
historicamente: histórico
Oi: Olá, bem-vindo, salvação
eliminação: livrar, omissão, excluir
tenso: arrumado
relaxante: conforto, confortável, relaxamento
eficácia: eficaz, efeito, habilidade
vulnerável: suscetível
atleta: atlético
listra: listrado, linha, banda, filme
fachada: máscara, visão
grampo: grampo, tenaz
protótipo: exemplo, original
compensar: lidar, compensar, desvio
nulo: zero, vazio
restringir: evita, abreviar, reduzir
carrapato: marca, piolho
cuba: tanque
estupro: ultrapassarem
nulo: zero, vazio
condicional: anexado
cultural: cultura
tecnologia: técnico, equipamento
marketing: comércio
gravata: gravata
economicamente: econômico
administrador: Gerente, administrador
retratar: descrever, introduzir
neto: neta, sobrinho
dual: dois, casal, gêmeo
síntese: original, instalar, conjunto
especialidade: profissional, característica
bizarro: estranho
candidato: candidato
linguístico: idioma, linguística
cogumelo: cortiça, esponja
abóbora: abóbora, cabaça
elevar: elevador, ascensão, progresso
fenomenal: incomumente, solo, super
dinâmico: poder
rever: revisão, consertar, Verifica
demolir: disjunção, cair, análise
cansativo: cansado
escola: escola-Superior, escola
dissertação: tese
estatístico: estatística, estatisticamente
formular: preparar, formulação
sanduíche: pão
nulo: zero, vazio
estimulação: aceleração, excitação, irritada
censura: censurar, regulamento
equipar: complemento
nomear: nomeação, propor
cancelar: excluir, fragmento, frustração
metro: medida
deprimir: oprimir
senhor: senhor, dominar
reconstruir: reparar, recuperação
árbitro: regra, juiz
atômico: átomo, nuclear
controverso: contradição
sofisticado: complexo, moderno
contração-muscular: encolher-de-ombros
inapropriado: irrelevante, insuficiente
sedimento: precipitado
arrebitado: desprezo, culpa
variante: vários
criticar: crítica
tédio: furado, aborrecimento, miséria
colaborar: cooperação, conjunção
analisar: análise, analista
chuva: chuva
broto: broto
aeronave: pássaro
picante: afiado
flexibilidade: elasticidade
foguete: míssil
advérbio: envelope
instabilidade: instável
privação: privar, desvantagem
agachar-se: agachamento
gerar: produzir, crio
aproximação: aproximado, abordagem, convergência
moral: acordado, moral, mentalmente
otimista: esperança, acreditar
classificar: classificação, distribuir
currículo: curso, agenda
ao-ar-livre: Fora
reagir: reação, verbo
escrita: cenário, linha, Bíblia
chantagem: extorquir
bônus: recompensa, prêmio
de-ativos: propriedade, presença, vantagem, capital
variabilidade: diferença
ambiguidade: vago, contradição, incerteza
nulo: zero, vazio
neutro: neutro
desvantagem: embaraçar, obstáculo, inabilidade, desvantagem
fotografia: fotografia
escassez: cortar, ausência
deslocamento: substituir
fungo: bactérias, esponja, cortiça
redação: formulação, texto
diplomata: diplomático, mensageiro
iniciar: introduzir
fundir: arreios
despedaçar: parar
inalar: inspirar
polia: Função
magro: fino
eleitor: eleitorado
federação: federal
mobilidade: movimento
descarregar: descarga
habitat: abrigo
evocar: mexer, induzir
diluir: fino
Tchau: tchau, despedida
demolir: destruir
sintaxe: pensão
ferradura: cavalo
distorção: desvio, distorcer
batida: batida
relevante: consistente, adequado, associado
funcional: prático, trabalho
deslocar: substituir, ejetar, mover
autonomia: independência
fedor: cheiro
diferenciação: distinguir
disponibilidade: aquisição
estudante: aluna
gráfico: gráfico, mapa
fascinar: cativar, provocação
fofa: bela, doce
abdominal: estômago
alfabetização: educação
sintético: artificial
treinador: treinador
conservar: armazenamento, Guardar, proteger, reter
lixo: fragmento, lixeira, desperdício
foto: fotografia, tiro
livro-didático: manual, reservar
consolidar: reforçar
constranger: coagir, limitado, extorquir
economista: econômico
atletismo: atlético, exercício
meneio: careta
iodo: mineral
infectar: infecção, poluir
desenhista: determinado
esconder: secreção, esconder, ejetar, segredo, distinguir
espinafre: adotivo, alface
intensivo: extremo, violento
convincente: demonstrativo
estréia: primeiro, começo
milésimo: mil
interior: interior, profundo, dentro-de-casa, coberto
revogar: privar
amplitude: magnitude
dimensão: direção, após, dimensional, Próximo
Bíblia: Bíblia
poster: bandeira, rede
acelerar: precipitado
intensificar: reforçar, intensificador
aborto: aborto-espontâneo
tipicamente: geralmente, comum, frequentemente, tender
compromisso: promessa
fila: cauda, ordem
suporte: grampo, cotovelo, gancho, suporte, apoio
ex-: velho
inverso: reverso, inversão
evaporar: fundição, bocejar
aviação: atmosfera, ar, mosca
correlação: comparação
étnico: nacionalista, nacional
reduzir: cortar, reduzir
complicado: destreza, elaborar, complexo, difícil
caracterização: descrever, característica
afixo: emendar, paralelo
molécula: molecular
configuração: disposição, estrutural, montagem
interação: conversa, sobreposição
quantitativo: volume
introspecção: retrospectivo
orientar: leste
esperma: semente
endossar: apoio, Admitem, aprovação
não-: nem, não
credibilidade: fidelidade, confiabilidade, crédito
subversão: ruína
deflexão: deriva, desvio
injeção: agulha
sandália: chinelo, sapatos
naco: lasca, parágrafo, alongamento
televisão: TV
cereal: grão, feijão
recipiente: instrumento, tanque, pote
migrar: migração, vaguear
terminologia: condições
eleitorado: eleitorado
apagar: excluir, destruir
mediar: conciliar
capitalismo: capitalista
esqui: patim
liberação: jogos-de-azar, permissão
seletivo: escolher
estático: padrão
convergir: Conheçer, convergência, foco
alfabético: alfabeto
global: internacional, mundo
acidente: sacrifício
Está-bem: mesmo, consertar, muito
pragmático: prático
árbitro: regra, juiz
diferencial: diferença
exalar: emitir, respiração
bacia-hidrográfica: água
fixação: adaptação, equipamento
instalar: instalar, estabelecido, fechar
ressonância: vibração
tradicionalmente: tradição
sala-de-aula: órbita
protocolo: acordo
cálculo: cálculo, conta
grama: caloroso, grama
gasolina: gasolina
galáxia: constelação
adolescente: jovem
amassar: problema
rádio: rádio
rarefeito: fino
avião: pássaro
pedal: piso
cerca-de: quase, cerca-de
lanterna: lente
mala: caixa, Bagagem
troca: intercâmbio
opcional: personalizadas
matriz: estômago
retrato: ombro, fotografia
pré: leste, antes, prado
anúncio: de-Anúncios
atordoar: surpreender
incidência: incidente, mergulho
tombar: derramar, coração
sensorial: sentindo-me, apaixonado
consenso: acordo
supervisionar: gerir, monitor, polícia
transplante: alternar
alumínio: alumínio
flutuação: oscilação
simular: imitar, fingir
complicar: complexo
mentor: conselheiro, treinador
ranhura: abertura
torre: Corvo, torre, castelo, pistola
manipular: manipulação, mexer
vegetariano: vegetal
norma: especificação, padrão, regra
metrô: túnel
respiratório: respiração
simulação: imitar
seringa: agulha
mutação: alterar, converter
cueca: cuecas, linho
vagina: baía
diferenciar: distinguir, diferença
sazonal: estação
aldeão: rural
sésamo: toupeira
coma: vírgula
invertido: inversão, reverso
supervisor: observador, manual
expulsar: ejetar
auditar: Verifica, revisão
marcha: planar, vaguear, elevador
local: local
recessão: economia
saques: pilhagem
slogan: senha
feto: embrião
integração: cooperação, inclusão
magenta: roxo, ciano
minimizar: mínimo, reduzir
residencial: abrigo
numeral: digital, número
salgado: sal
nulo: zero, vazio
teórico: teoria
aquário: peixe
tração: veto
pára-quedas: guarda-chuva
importante: necessário
No-geral: geralmente, todos, comum
deteriorar: podridão
nulo: zero, vazio
sexualidade: sexual
carretel: volume, embrulho
predominantemente: largamente
viscoso: pegajoso
intestino: intestino
arqueologia: arqueológico
amendoim: feijão
aposição: abono
fogão: fogão, cozinha
calças: calças
critérios: padrão, indicador
Visão-geral: esboço
qualitativo: característica
Óculos: vidro
genético: morfológica, genética, gene
participante: Junte-se, Função, particípio
repertório: talento, Programas
rodar: ciclo, girar
traçado: organização, plano, disposição
comprovante: plugue, recibo
teorema: frase, teoria, axioma
cognitivo: diagnóstico
esclarecer: elaborar, explicar
tóxico: veneno
estressado: ênfase
estilete: agulha
crise: crise
fornecer: servir, forneceram, assegurar
anti-: oposição
resistente: crônico, oposição, imune
lanche: torrada
cinema: filme, cinema
torneira: cachimbo
marcador: marca
periférico: em-torno-da, regional
assertivo: determinado, predicativo, agressivo, decisivo, teimoso
nó: tricotar
obeso: espesso
subtrair: ejetar, reduzir, desenhar, privar
intransitivo: necessário
hélice: caracol, encaracolado
bolacha: bolacha, bolo
inflar: inchar
eletrônicos: eletrônico
reescrever: transcrever
laboratório: laboratório
profissional: profissão, comercial, profissional, trabalho
gradiente: milha, mergulho
colorido: cor
cobertura: coberto, vacina, cuidado, cobertor, cobertura, consideração, volume
envolvimento: Junte-se, inclusão
orientação: direção
fabricar: crio, produzir
térmico: óleo
estereótipo: exceção
tecnologia: técnico
residual: permanece, redundância
caminhão: caminhão
estádio: campo
coordenação: coordenada
bacteriano: bactérias
interface: abordagem
silício: pi
memorizar: memória, Guardar, lembrar
diagnóstico: diagnóstico
programa-de-Estudos: abstrato
condução: linha, seqüestrar
milionésimo: milhão
varejista: negociante
bário: Barra
corrente-principal: chave, secundário
significativo: significar, conseqüente
auditivo: voz
conceptual: concepção
grade: rede
espacial: atmosfera, dimensional
exame: questionário
meio-: secundário, cintura
Compensar: compensar
discreto: separado, solo
inibir: inibição, evita
Multi: vários, Mais, muito
mormacento: úmido, caloroso
morfologia: morfológica
diagnosticar: diagnóstico
gripe: gripe
gráficos: gráfico
coronário: doença
nádega: nádegas, presunto
arquivo: arquivo
confronto: luta, conflito, comparação
cargueiro: caminhão
ótimo: optimal, ótimo
basicamente: condições
motivação: estímulo
testículo: ovo
enxofre: enxofre
operacional: manipulação, açao
trajetória: órbita, caminho
relevância: associado, importância, relações
bicicleta: andar-de-bicicleta, ciclo, roda
directiva: demonstrativo
companhia-aérea: pássaro, ar
litro: litro
revés: frustração, choque, regressão, falhou, obstáculo
unificar: arreios, conciliar
posição: ficar-de-pé, posição, parágrafo
mínimo: mínimo
cíclico: andar-de-bicicleta, periódico
substrato: molecular
subaquático: submarino
perícia: experiência, habilidade
nulo: zero, vazio
elétron: eletrônico
interativo: sobreposição
inicialmente: original
sabotar: destruir
interagir: conversa, socializar
matemática: matemática
fetal: embrião
modernizar: moderno, atualizar
extremista: radical, extremo
mijo: urina
aconchegar: abraço
OK: consertar, muito
pancada-forte: roubar
intencional: deliberadamente
semi: a-meio-caminho, vender, moer, largura
neural: nervoso
anti: oposição
lentilha: lente
proximal: quase
nutriente: mineral, Comida
obscuro: vago, evidente
trauma: choque, ferimento, úlcera
trocar: intercâmbio
vetor: portador
tática: abordagem
avalie: avaliação
nulo: zero, vazio
clone: cópia
viável: vantagem, eficaz
replicação: cópia
reativo: reação
horário: calendário, Tempo, disposição
sintático: destino
estabilizar: quieto
dissidente: rival
comentários: reação
questionário: questionário
oxidar: ligar
milímetro: milímetro
psiquiátrico: intelectual
síndrome: doença
paradigma: exemplo
ativar: habilitar, Faz, açao
aleatoriamente: acaso, coincidência, para-caso
ostracismo: separado, boicote
subconjunto: parte
metodologia: caminho, abordagem, uma-vez
artwork: trabalho
seqüente: consistente, ordinal
represar: aguarde, apreender, fechar
quilômetro: quilômetro
multinacional: internacional
planejador: inquilino, listrado, plano
exponencial: expoente
misplace: perder
investigador: cientista
supermercado: shopping
distribuir: atribuição, distinguir, distribuir, dissecação
nulo: zero, vazio
futebol: pontapé
direito: certo, adequado
sobras: permanece, desperdício
sustentável: padrão
nave-espacial: transporte
empírico: experiência
semântico: conotação, assunto
informante: interior, membro
tonelada: tom
módulo: modulo, unidade, volume
enzima: fermento
estilo-de-vida: tempo-de-vida
massa: massa
dormitório: abrigo
adolescente: jovem
realçar: marca
negar: negar, destruir
menino-amigo: namorada, amigos
comportamental: conduta
obrigado: obrigado
mentor: cérebro, alma
ecológico: ecologia, de-Meio-Ambiente
imigrante: refugiado
embutir: inclusão, mergulho, enterrar
fotocópia: cópia, fotografia
ativista: açao
camisa: camisa
terapeuta: médico, terapia
magnata: rei
excitação: excitação
sincronizar: sincronizar
ácida: ácido
lexical: dicionário, palavra
amansar: parar
classificador: classificação
vanguarda: pioneiro
presidente: cabeça
folheto: folheto
carismático: charme
escândio: telúrio
diretriz: manual
admitir-a-hipótese de: supor, supostamente
frigorífico: frigorífico
reinicialização: reiniciar
idéia-genial: agitar, idéia
repetir: cópia, imitar, repetição
angústia: medo
cessar-fogo: trégua
gafe: omissão, errado
industrializar: industrialização, indústria
irmão: irmão
porta-voz: alto-falante, representante
sequestro: seqüestrar, arado
metalóide: metalóide
corrimento: gripe, úmido, corre
faceta: direção, em-forma-de, lado
a-partir-de caso: 
bondade: virtude, vantagem
folgadamente: solto, livre
depois: futuro, então, após
dificuldade: problema
pelotão: banda
amplamente: largura, ampliar, geralmente
correlacionar: associado, gancho
de-acordo-com: costas
nulo: zero, vazio
boletim: folheto, informação
desaprovação: aprovação, inaceitável
banheira: banho
divertido: diversão, divertir, divertido
lado---a partir: exceto
emergência: emergir, Saída, ascensão
nulo: zero, vazio
bochecha: Toque
tem-que: devo, dever
por-cento: por-cento
litígio: terno
nulo: zero, vazio
via: passar, acima
soprano: infantil
divertido: divertido
da-tarde: tarde, noite
clara-de-ovo: proteína
derramamento-de-sangue: sangrento
túlio-átomo: tório-átomo
dobrar: dobrado, flexionar
vinculador: conjunção
exortativo: exortativo
térbio-átomo: tório-átomo
alugado: arrendar
Compensar: compensar
contar-piadas: gracejo
configuração: estrutural
a-passado: mais-recente
dividir: distinguir, distribuir
professor: dominar
ródio-átomo: tório-átomo
Estado-marcador: 
espaço-marcador: 
burocrático: burocracia
cinto: banda, arreios
nulo: zero, vazio
vendedor: negociante
nulo: zero, vazio
lantânio: telúrio
sujeito-caso: tema-caso
construtivo: crio, formulação, fabricante
nulo: zero, vazio
feminino: fêmea
auditor: inspetor, contador
microfone: micro
fora-de: Fora, exceto
gravação: inclusão, inscrição
dedo-indicador: indicador
patrocínio: bolsa-de-estudo, cuidado
ignorante: ignorante
nulo: zero, vazio
estandardizar: especificação, padrão
hora: local, hora
senhorio: proprietário
investigador: determinador, cientista, detetive
deflagrou: queimado
nulo: zero, vazio
autorizar: habilitar
defesa: cuidado
entrada: corredor
negociação: conversa
refrescado: fresco, atualizar
Meandros: dobrado
avante: primeiro, Próximo, para-a-frente
respiração: imune, respiração
nulo: zero, vazio
progressão: progresso
intransitivo: necessário
euforia: entusiasmo
Largo: ampliar, largura, muito-difundido
intransitivo: necessário
contrastive: contrastando, lidar
maravilhado: surpreso
referência: introduzir
descendente: familiar, neta, geração
sorvete: creme
raio: raio
alternativamente: caso-contrário
Vizinhança: em-torno-da, ao-vivo, de-Meio-Ambiente
costumava: personalizadas
embaraço: vergonha, desordem
substancialmente: largamente
recentemente: fresco, recentemente, raiz
dançando: Toque, dança
nulo: zero, vazio
quantidade-marcador: 
social-marcador: 
crítica: crítica
rubídio-átomo: tório-átomo
luta: luta, conflito, guerra
queixar-se: cerca-de
nulo: zero, vazio
vanádio-átomo: tório-átomo
neutro-gênero: masculino-gênero
flúor-átomo: tório-átomo
viagem: visita, safári, expedição
masculino: macho
nulo: zero, vazio
desenvolvimento: evolutivo, progresso
aplicado: prático
fechar: fechar
fanfarronice: fazer-alarde
para-trás: costas
a-presente: presente
nulo: zero, vazio
Aleatória: acaso
cooperativo: colega
aposentado: aposentar
nulo: zero, vazio
divertido: feliz, divertido, divertir
aproximado: aproximado
dyadic: binário
suplementar: complemento, adicional
comunicativo: correspondência, falador
nulo: zero, vazio
em-caso: para-caso
polônio-átomo: tório-átomo
demolir: disjunção, análise
bronzeado: Castanho
problema: problemático, problema
traduzir: tradução, giro
nulo: zero, vazio
tálio-átomo: tório-átomo
panelinha: conglomerado, clique
fácil: facilmente, simples
mediador: facilitador, Gerente
socialmente: social
correspondente: terno, coincidir
acidente: incidente
que---que: qual
Curiosamente: desenhar
de-cabeça-para baixo: reverso
herbicida: veneno
nulo: zero, vazio
estreante: particípio
por-exemplo: exemplo
tumor: tumor
decadência: podridão
nulo: zero, vazio
site: site
enormemente: maciço, muito, super
será: 
relativo-caso: relativo-caso
objetivo-caso: destino-caso
remunerar: compensar, pagamento
maltratar: errado
trança: cume, tricotar
ao-invés-de: ao-invés
arqueologia: arqueológico
conector: cópula, plugue, acessório, soquete
nulo: zero, vazio
generalização: generalizar
estrôncio-átomo: tório-átomo
rutênio-átomo: tório-átomo
Excluindo: exceto
nulo: zero, vazio
retiro: divagar, regressão, aposentar
aposentado: aposentar
outro: entre-si, de-outros
amplo: muito-difundido
Informática: cálculo, computador, calculadora
o-negócio-pessoa: pessoa-de-negócios
cachorro-quente: linguiça
domínio: efeito, poder, vantagem
fechar-parêntesis: citar
possessivo-caso: genitivo-caso, possessivo-caso
geneticamente: gene, genética
concessivo: mover, suave
indireto-objeto: direto-objeto
proibitivo-humor: proibitivo-humor
exercite-se: exercício, trabalho, elaborar
delimitado: limitado, separado
contrário: reverso, oposição, oposto, inversão, contrastando
escalada: ascensão
incrivelmente: incomumente, super
nulo: zero, vazio
encerramento: fechar, tear
barato: barato
lona: tecido, rede
educado: educação, educado
animais-selvagens: natureza, selvagem
opondo: oposição, oposto, em-direção
nulo: zero, vazio
escavar: escavação
infectado: infecção
nulo: zero, vazio
armado: braços
isto-é,: nomeadamente
ninguém: nenhuma-coisa
juramento: jurar, expletivo
cônico: fino, cone
entertainer: diversão, artista
etc.: 
além-de: exceto
contorno: esboço, de-Meio-Ambiente, Formato
celular: celular, célula
perde: cortar, perder, gastar
alarmante: terrível, ansioso
a-futuro: futuro
subjuntivo-humor: condicional-humor, optativo-humor
deveria: devo
motocicleta: motocicleta, motor
cartão-de-crédito: crédito
nulo: zero, vazio
a-público: público
celular: celular, célula
nulo: zero, vazio
intestinos: intestino
implantar: distribuir, espalhar, consumir
deportar: ejetar
proporção: estaca, parte, quantidade
competência: habilidade, jurisdição
proprietário-de-terras: anjo
preposicional-caso: 
alocação: atribuição, dividendo, abono
preocupante: ansioso
Tudo-certo: mesmo, muito
execução: coagir
pró-frase: pró-frase
receptor: Apanhador
injetar: introduzir
impressionante: surpreender, impressionante
tosse: tosse
--Ao-lado: Próximo
