пока: пока-пока, Здравствуйте, Пи, прощальный-привет
: 
из: между, около, его
для: приехать, должен
в: 
:-Firstov-people: 
я: меня
:-third-people: 
что: Это, который
его: его, своя
он: Это
с: 
для: около, в-направлении
в-виде: который, пример, как
:-second-people: 
быть: 
ее: его
на: вызов, около
в: лошадь
от: проходить, а-также, около
иметь: медведь
или: ни
из: 
это: Это
его: его
она: Oни, Это
мой: мой, меня
их: его, Oни
так: таким-образом, скоро
: 
их: Oни, вы
мы: нас, меня
кто: кто-бы-ни, который
бы: думать, приносить
будем: сила-воли
нет: не
если: будь-то, предоставлена
вверх: выше, подъем, вне, хуже
в: один
Любые: а-именно, который, все, каждый
ваш: ваш
какие: ни, который, вещь
ориентировочный-настроение: директива-настроение
человек: человек, муж, мужской
чем: Больше, около, как
наш: весна, нас
некоторые: в-некотором-роде
на: после, выше, вне
май: в-состоянии
Теперь: настоящее-время
как: как, люблю, держать
Можно: в-состоянии, мог, коробка
должен: должен
сделал: делать, факт
такие: таким-образом
: один
эти: Oни, Это
над: выше, Больше
гораздо: очень, объем
Мистер: сэр, мастер
хорошо: красивая, Великий, своего-рода
большинство: Больше, во-многом, большинство, очень
должен: должен
те: Oни, его
сам: своя, одна-и-та же, самих-себя
жизнь: жить, продолжительность-жизни, гласная-буква, Талия
без: 
делать: делать, Создайте
Что-ж: удобный, правильно
речь-маркер: 
через: проходить, проникать
мог-бы: мощность, возможно, мог
слишком: очень, даже
еще-раз: тогда, назад, один-раз
многие: большинство
каждый: каждый, который
люди: человек, сообщество, люди
думал: идеология, идея, думать
под: вниз
все-еще: Больше
место: место, должность, где
в-то-время как: в-то-время как, время, временный
просто: только, просто
также: даже, также, Больше
все-же: но, ни, тем-не-менее, Больше
против: в-направлении, до
получить: встретить, взять, выводить
Когда-либо: вечный, никогда, всегда
от: закрыть, далеко, вне, покрытый
лицо: поверхность, сто, человек
другой: последний, Другие
оставил: далеко
новый: нео, роман, свежий, 9, молодой
Г-жа: 
положил: задавать, последний, дайте
рассказать: сказать
разум: интеллектуальной, думать
мало: пара, немного
кого: который, кто-бы-ни
далеко: далеко, дистанционный-пульт, очень
называется: думать
все: полный, все
и-то-и другое: два
найти: найденный, поиск
смотреть: видеть, проверить, взгляд
позволять: автобус, испускают, дайте, включить
господин: мастер, сэр, король
Главная: дом
что-нибудь: ничего, в-некотором-роде
момент: время
отец: папа
среди: между
женщины: женский-пол
мама: Мама
конец: законченный, последний, поздно
маленький: немного, микро
ты: вы
хотеть: должен
Однако: но, тем-не-менее, хоть
довольно: полностью, в-некотором-роде, очень, достаточно
чья: который
Лучший: лучше
себя: меня, самих-себя
до: даже, до, пока-пока
поскольку: тогда, первый, потому-как
используемый: старый, перерабатывать
скорее: вместо, в-некотором-роде, Больше
Меньше: короткая, вниз, наименее
в: внутренний, глубоко, в-помещении
вместе: задавать
большой: Великий, массивный
дело: вещь, предмет, вопрос
определенный: определенный, правильно
сама: самих-себя
половина: наполовину, молоть, боковая-сторона
правда: действительно, факт, правильно
что-нибудь: без-разницы, в-некотором-роде, ничего
держать: держать, задавать, сохранить
жена: женский-пол
означает: путь
возле: проходить, почти
государство: состояние, войти, страна, правительство
в-одиночестве: Одинокий, соло, один
дело: падать, пример, костюм, инцидент, потому-как
тебя: вы
высокая: выше, пол
девушка: дочь, женский-пол, Подруга
конечно: гарантировать, правильно, действительно
в-самом-деле: действительно, факт
сам: самих-себя, своя, будь-то
вдоль: связано, длинный, длина
земельные-участки: страна
вернуть: регрессия, назад, возврат
оставлять: Вылет-из, отпуск, заброшенный, далеко, разрешение
или: даже
закон: правильно, правовой, правило
лежать: задавать, светский, Помогите
точка: место, действие, только, параграф
ребенок: дети
хочу: надеяться, желание
говорить: сказать, говорить
в-течение: время, в-то-время как
несколько: дюжина, пара, Больше
бизнес: сделка, магазин, Компания, Работа, коммерческая, движение
манера: путь, подход
второй: Другие
Генеральная: общий, в-общем, общественного
за: назад
стали: приехать
мертвый: умереть, смерть
Земля: страна
мальчик: сын
Чувствовать: чувство, слышать
дух: душа
правда: факт
земля: пол, страна, место
действительно: действительно, очень, факт
отдых: Другие, комфорт, выходить-на-пенсию, остатки, отпуск
другой: различный, разница, Другие
возможное: возможно
человек: человек, человечество
город: город
следующий: следующий, следовать, после
необходимость: необходимо, должен
причина: причина, индуцировать, потому-как
вечер: ночь, после-полудня
5: пятый, год
сильный: мощность, в-состоянии, сильный
леди: женский-пол
вокруг: окружающих, почти, около, глаз
очередь: боковая-сторона, задавать, заказ
смысл: имею-в-виду, чувство, коннотация
Закрыть: закрыть, почти
персонаж: характеристика, личность, отметка, природа
Сортировать: классификация, своего-рода
взгляд: видение, вперед, место-действия, видеть, взгляд
вечеринка: праздник, запятая, страна
штраф: Великий, тонкий
готов: подготовить, уже, на-цыпочках, законченный
Счет: причина, законопроект, расчет, подсчет
написано: записывать
возраст: старый, век
еще: Другие, последний, в-другом-месте, Больше
сила: мощность, принудить, наложить
через: выше, напротив
рано: преждевременный, начало, примитивный, скоро
солнце: 
позже: будущее, тогда, после, следующий
все: все
мимо: прошедшее, ретроспективный, последний, после
акт: законопроект, глагол, действие, Работа, движение
в-дальнейшем: вперед, Больше, дополнительный
за: Больше, вне
ни: ни, который
Посмотреть: высказал-мнение,, взгляд, видеть, видение, место-действия, календарь
звук: голос
никто: ничего, никель
Чисто: открытый, очевидный, поразительный, легкий
Дорога: шоссе, путь
реальный: виртуальный, факт, королевский
около: почти, около
знание: Информация
к: в-направлении
Плохо: хуже, зло, бедные
живой: жить, Талия, продолжительность-жизни
мир: комната
низкий: короткая, дешево, выкидыш
север: ответ, северный, полночь
природный: природа
Симпатичная: красивая, очень, достаточно
Справедливая: правильно, отчет, 10
оказание-услуг: обслуживать, забота
ниже: вниз
удовольствие: счастливый
история: история, Дата, исторический
заметка: запомнить, обозначение
несмотря-на-то что: хоть
фронт: напротив, вперед, до
большой: Великий, массивный
безусловно: строго, курс, действительно
ветер: воздух, чердак
Получать: квитанция, взять, выводить
внимание: забота, приоритет, фокус, учитывая, акцент
прочность: мощность
вероятно: возможно
довольный: счастливый, веселый, доволен
важный: необходимо, логически-вытекающий
сам: своя, самих-себя
малый: коллега, друг
мнение: высказал-мнение,, идея
вера: считают,, верность
тому-назад: восток, тогда, до, вперед, назад
заряд: Потери, расходы, взять
рука: рука, бедные, рукав, оружие, плечо
последний: последний
объект: цель, ничего, предмет
джентльмен: мужской, сэр, мастер
конкретный: особенно, а-именно
едва: не, почти, редкий
главный: менеджер, глава
шанс: совпадение, должность, повод, вероятность
по-рукам: план, магазин, соглашение
мышление: думать
тяжелый: повторение, вес, шутки-в-сторону, жесткий
одноцветный: открытый, просто, полый
немедленно: один-раз, скоро
рот: человек
боюсь: испуганный, страх, тревожный
Один: один, Одинокий
радость: счастливый, волнение
сломанный: сера, порез
если: Кроме
нести: медведь, носить, приносить, включить
влияние: эффект, грипп
появляться: появляться, кажется
за-пределами: вне, Кроме
пожалуйста: любезно, просить
появление: появляться, кажется
медленно: постепенно, поздно
период: фаза, время
сестра: брат
боевой: борьба, война
бывший: старый
молодежь: молодой
просто: только, просто, Одинокий
достичь: подход, достигать, приехать
система: заказ, иерархия, организация
ужин: ночь, обед
впоследствии: будущее, после
ходить: протектор, идти, пол, фут
задаваться-вопросом: чудо, странный, удивленный
обычный: в-общем, общий, всегда
фигура: цифровой, статистика, профилированный, номер, Потери, картина
древний: старый, старомодный
уважение: учитывая, честь, Опасность, в-направлении
в-третьих: три, вторник
оставаться: оставаться
общество: Социальное, сообщество, Компания
результат: вывод, эффект
команда: заказ
всего-лишь: только, просто
рядом: проходить, следующий, Кроме
тихий: тихо
идеально: надлежащий, Великий
улица: путь
письмо: записывать, письмо
дерево: деревянный, дерево, придерживаться
быстро: скоро
уведомление: видеть, объявление, предупреждение
яркий: резкое, легкий, блестящий, поразительный
лодка: корабль, поплавок, яхта
благородный: Великий, славный
внезапно: вдруг,-внезапно
стоимость: стоимость, ранг, важность
в-связи: потому-как
чтение: читать, вопрос
дать-согласие: соглашение
Подождите: ожидать, держать, оставаться
кусок: чип, часть, протяжение
бывший: старый
разговор: говорить, диалог
возможность: повод, должность
Стоимость: расходы, платить
значительный: Великий, логически-вытекающий, поразительный
сидеть: оставаться
Вверх: оптимальный, хребет, выше, саммит
Брак,-создание-семьи: в-браке
шаг: действие, протектор, фаза
начать: начало
за: каждый, в-направлении
индивидуальный: человек, в-отдельности, атом
сложно: жесткий
немного: часть, немного, вошь, кусочек
речь: говорить
власть: юрисдикция, мощность
счастье: счастливый
предоставлять: предоставлена, дайте, гарантировать
изучение: учить, анализ, студия
персональный: частный, в-отдельности, сотрудники
смотреть: проверить, монитор, видеть
довольный: доволен, счастливый
горячий: тепло, Огонь
усилие: пытаться, напряжение
подготовленный: подготовить, уже
попытка: пытаться, викторина, попытка
быстро: скоро, проворный
под: вниз, после
предназначена: намереваться, фокус, цель
Прямо: непосредственно, просто
вероятно: без-труда, вероятность, возможно, предположительно
справедливость: правильно
просто: только, просто
доверять: считают,, верность
прохождение: часть, пересечение, колонка, проходить, протяжение
закрыто: закрыть, ткацкий-станок, покрытый
сами: самих-себя
прохождение: проходить, прошедшее, пересечение
средний: вторичный, имею-в-виду
владение: имущество
приятный: удобный, своего-рода
в-совершенстве: полностью, действительно
как-правило: общий, в-общем, тенденцию
могила: жесткий
исправлено: фиксировать, хоть, стандарт, постоянный
войска: армия
встреча: сессия, сборка, встретить
лагерь: кемпинг, поле
народ: страна, национальный
существование: присутствие
Ответить: ответ, возврат
небо: атмосфера, небо
равным: одна-и-та же, степень
состояние: судьба, состояние, имущество
домен: поле
ситуация: должность, состояние
средний: имею-в-виду, наполовину, Талия
зима: холодно
позволять: разрешение, включить
бледный: желтый, цвет, слабый, пастельный, открытый, легкий
Бег: раса, бег
религиозная: религия, химиотерапия
вести: индуцировать, приносить
переехать: протектор, аргумент, сдвинуть-с-места, движение, действие
стоп: ломать, стоять
разговорный: сказать, словесный, говорить
доска: подъем, панель, совет, край, комиссия
тщеславный: свободно, пустой
потеря: недостаток, потерял, утечка
предлагает: предоставлена, предложить, дайте, экспонат, обслуживать, привилегия
класс: своего-рода, орбита, ранг
полный: полный
доступ: посещение, подход, получение
страсть: энтузиазм, чувство
физическая: физика, тело
пример: пример
Начало: начало
злость: гнев
серьезный: Великий, шутки-в-сторону, крайняя
Серебряный: Деньги, пятница
достаточно: достаточно
главный: глава, мастер, ключ, оригинальный, основной
замечательно: странный, сильный, Великий
дорожка: путь
имея-в-виду: коннотация, имею-в-виду, важность, предмет
поместиться: костюм, надлежащий
много: масса, очень, судьба
сиденье: стул, осада, штаб-квартира
игра: игорный, играть
заявление: выражение, отчет
мечта: кошмар, спать
камень: утес, юбка, камень
особый: особенно, частный, эксперт
плата: расходы, Потери, платить
доля: часть, доля, роль, распространять
распространение: деталь, широко-распространен, разброс, причина
слава: честь, хвалить
пространство: должность, зал, поле, астронавт
обычный: общий, просто
рассматривать: думать, учитывая
значительно: очень, во-многом
сотрудник: официальный
ставка: стандарт, честь, курс
знак: обозначение, жест, отметка, место
родной: природа, оригинальный, резидент
за-работой: наемный-рабочий, Работа
выйти-замуж: в-браке
степень: граница, объем, степень
метод: путь, один-раз, подход
отлично: лучше, Великий
уверенность: считают,
в-точку: действительно, особенно, полный, полностью
обширный: Великий
причудливый: воображение, красивая
быстро: скоро, проворный
да: Да, таким-образом
свобода: свободно, независимость
интересно: привлечь, любопытный
в-стороне: раздельный, боком, Кроме
чистый: свежий, правдивый
относительно: выше, около, учитывая
доказательный: доказательства, очевидный
отдаленный: далеко, дистанционный-пульт
аналогичный: походить, одна-и-та же, конгруэнтный, сравнимый
узкий: тонкий, короткая
совсем: полностью
страница: боковая-сторона, двор
особенно: особенно
гора: холм
гордый: гордость
явно: недвусмысленно, открытый, очевидный
цена: честь
больной: больной
суждение: решение, предложение, правило, судья, юрисдикция, кризис
принимать: приемлемо, признавать, взять
вид: своего-рода
искать: поиск
честь: честь
ухо: разрешение
дно: вниз, пол, база
помощь: СПИД, Помогите, поддержка
в-полной-мере: полный, полностью
восторг: счастливый, неприятный
количество: квантовая, объем, толпа, номер
получать: получение, выводить, взять
налог: аренда, линия
пересекать: пересечение, проходить, превышать
незнакомец: гость, странный, иностранный, неизвестный
сметь: мужество
расти: подъем
ложный: ложь, неправильно, больной, недостатки
высокий: длинный, пол
Ворота: дверь
свободно: независимость, свободно, независимо, свободный
дуть: шок, Инсульт, выстрел, удар
мода: подход, приехать
ежедневно: день
распределение: распространять
богатство: Деньги, имущество
свобода: свободно, независимость
продвигать: прогресс
нежный: мягкий, милая
конечно: курс, действительно
обезопасить: безопасно, защищать, гарантировать
занимал: воспользоваться, град, занято
сцена: Платформа, действие, фаза, состояние, место-действия
часть: часть, рацион
язык: язык, плевать
сердитый: гнев
каретка: поезд, тележка, челнок
Погода: климат, воздух, время
необходимость: важность
практика: упражнение, действие, обычай
Запрос: запрос, костюм
князь: герцог
группа: задавать, конгломерат, стадо, группа, панель
на-протяжении: везде
Добавить: расширять, дополнительный, увеличение
молиться: просить
ведущий: логически-вытекающий, мастер
серый: коричневый, пепел
часто: довольно-часто, повторный, постоянный
известный: популярный, общеизвестный, гласная-буква
мощный: мощность, в-состоянии
в-живых: жить
слабый: слабый, бедные
материал: содержание, предмет
откровенный: честный, аксиома
высокая-температура: лето, тепло
охрана: защищать, забота
в-равной-степени: баланс, одна-и-та же, также
естественно: природа
замечательный: странный, необычно, Великий
Луна: месяц
незначительный: немного, без-труда, легкий, тонкий, короткая
стиль: легкий
заостренный: полушарие, резкое
принцип: теория, аксиома, начало
немедленная: скоро, непосредственно
готов: уже, на-цыпочках, мили
следствие: логически-вытекающий, эффект, вывод
нежная: мягкий, соглашение, раса
заинтересованный: намереваться, интерес
четверть: фут
продвинутый: выше, вперед
по-всей-видимости: недвусмысленно, предположительно, кажется
активный: Работа, действие
известно: умышленно, знать
опасно: Опасность, вредный, угрожающий
спокойствие: тихо
священный: божественный, святой
Королевство: королевский
весь: полностью, все, полный
хороший: красивая
привычка: характеристика, путь, обычай
непосредственный: очевидный, непосредственно, из-первых-рук
на-самом-деле: действительно, факт
слух: слышать
гулять-пешком: протектор, фут, пешеход
бросать: испускают, бросать, выстрел
мудрость: интеллектуальной
водить-машину: вождение, хор, экспедиция, От-себя, бег, диск
неисправность: вина, неправильно
дело: вещь, предмет, связи
контакт: переписка, коснуться
станция: стоять, центр, время-года
Слушать: слышать, просить, подчиниться
причинить-боль: травма, боль, ранен
выразить: выражение, объяснять
благоприятствовать: боковая-сторона, Грейс, способствовать
высота: длина
размер: мерное, величина, полный
задача: действие, Работа, долг
симпатия: сопереживание, жалость
одетый: платье
дальше: вперед
судно: инструмент, корабль
привязанность: люблю
страдающий: пытки, нищета, горький, беда
плоть: мясо, тело
большой: массивный, Великий
после: ранг, Почта, после, Отправить, должность
коллекция: накопление, задавать, галерея, вывод
представить: воображение, думать
прибытие: приехать
громкий: настаивать, Великий, жесткий
прекрасный: красивая, славный
чрезвычайный: странный, необычно
происходить: ни
завтрак: утро, обед
Население: толпа
серии: цепи, задавать
облегчение: СПИД, комфорт, глиф
впечатление: эффект, чувство, впечатление, Распечатать
удовлетворение: доволен
форма: мерное, форма, профилированный
рождение: Родился
рассмотрение: идея, учитывая
регулярный: периодический, повторный, порядковый
перемещение: сдвинуть-с-места, движение
занятый: занято
качественный: масса, степень
обнаружить: найденный, поиск, раскрывать
внутри: внутренний, глубоко, в-помещении
почва: грязь, пол, соло, страна
полностью: полностью
сообщение: Информация, Новости
фраза: выражение, предложение
упомянуть: мужской
пара: правильно, пара
заглавие: Заголовок, глава, предмет
понимание: Понимаю, сопереживание
Воскресенье: неделю
Сумасшедший: ненормальный, дурак
абсолютно: полностью, строго
медленный: тихо
милость: жалость, Грейс
содержать: в-том-числе, содержание
горе: печаль, боль
солдат: армия, пешка
предыдущий: восток
объяснение: объяснять, Информация
молитва: запрос
вера: считают,, верность
постоянная: повторный, стандарт, фиксировать, постоянный
окончательный: последний, в-конце-концов
поездка: верховой, сафари, подъем, вождение
политика: политическое
Рисование: картина, привлечь, план
умирающий: смерть, умереть
спрос: запрос, вопрос
верхний: выше
сумма: а-также, йога, номер
движение: движение, предложить
помощь: поддержка, Помогите
достоинство: честь
поймать: держать, взять, концепция
среди: между
текущий: настоящее-время, поток
возможно: вероятность, возможно, мог
отдельный: раздельный, разница, соло
наихудший: хуже, бедные
террор: страх, террорист
контроль: регулирование, контролируемый, проверить, управлять
способный: включить, в-состоянии, опытный, умение
фирма: Компания, хоть
превосходный: лучше
духовный: умственно, моральный, интеллектуальной
доказательство: доказывать, доказательства
связь: связи, отчет, учитывая
обеспокоенный: забота, тревожный, связано
глубоко: глубоко, деталь
петь: читать
дружелюбный: конгруэнтный, любезно, дружба, своего-рода
Вход: дверь, квитанция
поставка: ширина, предоставлена
чистый: свежий, аккуратный
полезным: необходимо, эффективный
нежный: хрупкий, тонкий, элегантный
Удалить: избавиться, Удалить, привлечь
выбор: выберите, выборы, проверить
огромный: массивный, Великий
не-в-состоянии: не-могу, не, потерпеть-неудачу
обложка: Пальто, включение, одеяло, заворачивать, тротуар
двойной: близнец, дважды, пара
победа: успех
постоянно: довольно-часто, повторный, всегда, Продолжать
уровень: стандарт, состояние, поверхность
выпуск: разряд, публикация, свободно
грубый: хуже, раздражительный, грубый
впереди: вперед, выше
связанный: граница, прикрепленный, связано, сопряженный
усиление: получение, преимущество
добавление: дополнительный, дополнение
камера: комната, зал, камера
знакомство: знакомые, грунтовка
ошибка: неправильно
исходя-из: база, сроки
автомобиль: поезд
никто: кто-угодно, ничего
энергия: мощность
голый: открытый, бар, позор, полый, лысый
частично: наполовину, часть, в-некотором-роде
цвет: цвет
безопасность: безопасно, спасение, забота
описание: описывать, Информация, дескриптор, определение
спящий: спать
падение: падение, падать, утечка
блестящий: славный, блестящий, Великий
краткое: акроним, короткая
серый: коричневый, пепел
высоко: очень
в-восторге: волнение, раздраженный
отчаяние: разочарование, слабый
легкость: комфорт, уменьшить
Всего: валовой, все
доброта: добродетель, Грейс
круг: цикл, квартира, круглый, колесо
скучный: отверстие
намерение: намереваться, цель
срок: сроки, семестр, крайний-срок
тщательно: удобный, полностью
подать-заявление: использование
труда: Работа
интеллект: интеллектуальной
забастовка: атака, поразительный
довольно: полностью, достаточно, очень
соблюдать: встретить, подчиниться, содержание
мероприятие: инцидент, повод, показать
мягко: мягкий, любезно
подключение: соединение, прикрепление, вызов
защита: защищать, кров, забота
сознательный: проснулся, умышленно, чувство
издание: расходы, Распечатать, публикация, разрешение
рейс: птица, летать, витать
разнообразие: своего-рода, различный
Кроме: раздельный, далеко, Кроме, независимо
ужасный: ужасный, жалость
все: все, кто-угодно
труд,-работа: Работа
любовник: Уважаемые, Подруга
пение: песня
нетерпеливый: желание, нетерпеливый, любопытный, тревожный
требовать: просить, запрос, настаивать
всякий-раз,-когда: когда
успешный: успех
поднимать: расширять, лифт, увеличение, подъем
разработка: прогресс
круто: холодно, красивая
испытание: зонд, обработать, суд
за-границу: иностранный, изгнание
преданный: верность, верный
литературный: литература
автор: автор
акции: придерживаться, роль, действие
тип: своего-рода, записывать, Нажмите
много: богатые, избыточность, достаточно
избежать: не-допустить
благоприятствовать: боковая-сторона, Грейс, способствовать
психическое: интеллектуальной, умственно, внутренний
отношение: взгляд, стоять, жест, подход, зависимость, параграф
восхищение: хвалить
тревога: тревожный, страх, озабоченность, волнение
учат: знать, учить
видимый: знать
руководство: руководство, доказательства, вождение
фактический: виртуальный, факт, королевский
несчастный: недостаточный, грустный, несчастный, нищета, беспомощный
вред: зло, вредный, травма, жалость
помилование: прощать, Прости, принести-извинения, Грейс
редко: иногда
запись: постановка-на-учет, диск, спасти
жир: масло, толстый
квартира: квартира, уклончивый, план
подарок: награда, настоящее-время
храм: дом, кафедральный-собор
лицензия: разрешение
согласие: утверждение, разрешение
достаточно: полный, достаточно
рана: травма, ранен, язва
жирный: мужество, Храбрый
в-любом-месте: где-то, везде
свидетель: доказательства
глупый: невежественный, дурак
никто: кто-угодно, кто-бы-ни
само: частный, самих-себя, своя
чрезвычайно: очень, необычно
лечение: терапия, забота
горло: шея, витать, огурец
пациент: больной
рост: увеличение
количество: квантовая, масса, толпа, дозировать, номер, величина
серьезный: строго, сильный, жесткий
оправдание: прощать, причина, переходный, Прости
происхождение: оригинальный, природа
аудитория: пассивный, общественного
осталось: остатки
выиграть: успех
горничная: служащий
мягко: мягкий, тихо
реальность: факт
сайт: место-действия, Веб-сайт, место
паруса: корабль, вуаль
магазин: магазин, место-хранения, спасти
замечание: высказал-мнение,, учитывая
Пауза: ломать
ценный: стоимость
следовательно: таким-образом, следовательно
растение: подъем, дерево, мельница
лед: снег
абсолютная: полный, полностью
легко: без-труда, скоро
жестокий: резкое, сильный, жесткий, жестокий, хищник, дикий
гнев: гнев
открытие: найденный, поиск, изобретение, открытие
Связанный: связано
наказание: предложение
слегка: немного, без-труда, в-некотором-роде
загадочный: секрет, неопределенный, невидимый
оттенок: тень, тон, нюанс
убийство: убийство
эмоция: чувство, страстный
разрушение: разорение, уничтожить
ужастик: страх
местный: в-местном-масштабе, внутренний, место
ассортимент: различный, расстояние, задавать
хозяин: армия, гость, толпа
влажный: дождь, влажный
тайна: секрет
обладать: своя, медведь
сознание: рациональность, чувство, совесть
прежде: до
производство: производить
палуба: мост
имущество: имущество
царствовать: король, роялти
соблюдение: следовать, приспособление
ее: его
несчастный: К-сожалению, совпадение, несчастный, жалость, недостаточный
цветок: проводить, интерес, грязь
благодарю: спасибо
принадлежать: имущество, в-том-числе
рынок: купить
кепка: шапка, пробка
Обрадованный: счастливый
домашнее-хозяйство: семья, дом
флот: корабль, флот, поплавок
детка: дети, кукла
область: поле
точная: мука, надлежащий, полный, осторожный
образ: картина
подозрение: сомнение, подозрительный
отказаться: Отрицать, вето, отходы
ответственность: долг, вина
совестно: позор
еда: еда, есть, мука
положение-дел: должность, состояние
указывать: войти, показать
стих: поэзия, песня
возникать: появляться, подъем
путешествие: сафари, экспедиция
посещать: присоединиться
позволить-себе: купить, дайте, медведь
жертвовать: делать-вклад, дайте
работа: Работа
продолжить: Продолжать, увеличение, прогресс, проходить
жалею: Прости
риск: Опасность
быстрое: скоро, проворный
отчетливый: раздельный, разница
должным-образом: надлежащий, удобный
слава: хвалить
единственное-число: единый, Ед.-изм
ошибка: неправильно
репутации: хвалить
обращение: привлечь, вызов
отсутствие: порез, недостатки, отсутствие
насилие: сильный
оказывать: делать, вводить, дайте
карьера: профессия, Работа
дизайн: концепция, план
предложение: предложение, предложить
полный: произносить, полный
разрешающая-способность: решение, вывод, анализ, расширять
запасной: заместитель, дополнительный, заменять, копье
внутренний: гражданского, внутренний, резидент, национальный
Справка: справочный, Память
существовать: присутствие, настоящее-время
вопрос: проблематичный, сроки, беда, предмет, вопрос, эмиссия
предоставление: предоставлена, дайте
пламя: Огонь
невежество: невежественный, игнорировать
время-от-времени: иногда, повторный
полет: летать
ткань: ткань, одежда
прибыль: преимущество
четвертый: 4, среда, комната
колокол: аварийная-сигнализация, час
выгода: преимущество
глава: дверь, часть, глава, время-года, столица, самих-себя
дыра: отверстие, яма
разумный: надлежащий, мудрый, рациональный
сахар: пьянство, путь
замена: заменять, вместо, пособие, заместитель, обмен
упор: настаивать, вязать, платить, От-себя, импульс
Рамка: масштаб, правовой, выстрел
вещество: предмет
Эл.-адрес: Отправить
разделение: часть
рабство: раб
стих: поэзия, параграф
вероятный: возможно
болезненный: горький, боль
навсегда: всегда, вечный
океан: море
задний: после, назад, задний-ход
лидер: глава, менеджер, проводник, руководство
острый: намереваться, тревожный, резкое
удача: судьба
очевидный: очевидный, аксиома
торопиться: скоро, теленок
схема: план, в-полоску, диаграмма
бесполезный: отходы
тем-не-менее: хоть, тем-не-менее
гладкий;-плавный: мягкий
твердый: демонстративный, установленный, хоть, компактный
обязательно: должен, необходимо
строить: Создайте, здание, формулировка
попытка: пытаться, попытка
эквивалент: одна-и-та же
недавний: в-последнее-время, современное, последний
путешествовать: посещение, туризм
полдень: после-полудня, на-юг
располагается: падать
объявление: объявление
прекращение: не-допустить
обстоятельство: состояние, конверт
палатка: кабина, место-действия
частый: повторный, довольно-часто
вслух: голос
независимый: независимость, свободный, независимо
существенный: необходимо, основной
наблюдение: наблюдать
благодарность: спасибо
сохранять: сохранить, место-хранения, защищать
аспект: элемент, боковая-сторона
страх: страх, фобия, испуганный
умная: опытный, мудрый
район: жить
отказ: потерпеть-неудачу, неправильно, банкротство, выкидыш
цент: пенни, процент, сто
чувство: чувство
агент: имею-в-виду
отчаянный: слабый
союз: альянс, единый
предоставлять: признавать
удар: умножить, удар, успех
огромный: Великий, массивный
убеждение: предложение
лихорадка: Огонь, грипп
рассматривать: терапия, обработать, заживать
наш: весна, нас
ошибочный: неправильно, злоупотребление, недостатки
идеальный: лучше
порыв: толпа, Инсульт
верный: надлежащий, правильно, верный, фиксировать
выполнять: показать, делать
как-то: в-некотором-роде
понятие: концепция, коннотация, идея
обсуждение: обсуждать, аргумент
твердо: установленный, хоть
устойчивый: стандарт, фиксировать, последовательный, постоянный
империя: королевский
ручка: карандаш, глава
разрешать: разрешение
поддерживать: держать, защищать, сохранить
переполненный: толпа, плотность
ограничение: граница, сдержанность
какой-ужас: ужасный
порт: гавань, дверь
опытный: опыт, опытный, эксперт
противоположность: оппозиция, напротив, в-направлении, контрастные
договор: меморандум, соглашение
происходить: приехать
Ищу: очень-прошу, поиск
практически: почти, действительно, практическое
след: отметка, вето
веселая: счастливый, веселый
договоренность: заказ, расположение, организованный, соглашение
западный: запад
давление: акцент, Распечатать, От-себя, вес
политика: политическое
научный: наука, ученый
заслуга: хвалить, квалифицировать, стоимость
интервью: посещение, интервьюер
территория: поле
секс: пенис, сексуальное, шесть
создание: Создайте, формулировка, установленный
след: отметка, выборы, путь
перспектива: надеяться, вероятность, видение, место-действия
операция: дрейф, обработать, действие, врач-хирург
глубокий: глубоко
совпадение: игорный, совпадать, совпадение, раса
единая: платье
долг: вина, религия, долг, кредит
предприятие: приключение, инвестиции, Компания
выполнение: действие
настроение: чувство, юмор, расположение
экипаж: сотрудники
воспринимать: Понимаю, концепция, видеть
объявлять: объяснять
версия: копия, клетка
странный: странный, необычно
благодарный: спасибо
бесконечный: вечный, инфинитив
безопасность: безопасно, забота
разумный: мудрый, рациональный, восприимчивый
коттедж: хижина, кабина
вместимость: в-состоянии, умение, объем
селиться: оставаться
участвует: занято, присоединиться
совет: совет
экспертиза: зонд, проверить, выберите
стали: железо
контрольная-работа: проверить, пытаться
благотворительная-деятельность: люблю
сарай: залить, бросать
коммуникация: переписка, связи
кто-то: кто-бы-ни, человек, кто-угодно
ряд: линия, порядковый, задавать, правительство, заказ
бедность: бедные
интенсивный: край, крайняя, сильный
ссора: борьба
доступный: предоставлена, настоящее-время
сопротивление: оппозиция
необычный: необычно, общий
пустынный: заброшенный, пустыня
голос: выберите, голос
терпеть: медведь, сторонник, последний, страдать
добиться-успеха: успех
нога: фут, кость
торги: предложить, запрос
интерьер: внутренний
слегка: без-труда, легкий
дисплей: показать, экспонат, экран, место-действия, доказательства
ограниченный: ограниченное, только
цель: цель, фокус
критическое: необходимо, критик
мешок: карман, мешок, корзина
повторение: повторение, назад, повторный
трек: монитор, песня, путь, следовать
резиденция: кров
весело: счастливый, веселый, развлекательная-программа
защищать: защищать
сильно: вес, шутки-в-сторону
материал: содержание, товар, вещь
раздел: часть, рассечение
поселок: соглашение, кров, регулирование
пластина: панель, диск, дискотека
преодолеть: справиться, превышать, бить
основания: причина, сроки, лейтмотив
мрамор: камень
способность: в-состоянии, умение, талант
волна: волна, неопределенный
народный: люди, популярный
возможность: вероятность, в-состоянии
масло: масло
ненависть: презрение, ненавидеть
стремление: поиск
вытащить: привлечь, ножницы
сигнал: жест, отметка, пароль
безопасно: безопасно
сжигать: сожжен, дым
урок: образование, предмет, курс
годовой: год
карта: картон, карта, короткая, бумага
заявление: использование, программного-обеспечения, запрос
умный: интеллектуальной, мудрый
округ: бойкотировать, региональный, город, страна
формат: форма, бросать
течь: поток
наносить-ущерб: разорение, травма, жалость
более-того: дополнительный, даже, Больше
коммерция: сделка
южный: на-юг
внешний: вне
в-среднем: вторичный, имею-в-виду
голый: позор
очевидно,: очевидный, открытый, аксиома
Фонд: база, Платформа
беспокойство: забота, тревожный, связано, интерес, озабоченность
магия: очарование
кампания: движение, экспедиция
либеральная: щедрый
обычно: общий, довольно-часто, в-общем
охота: охота
учитель: автор
вскоре: скоро, короткая, почти
благословение: благословить
крошечный: немного, микро
резко: скорость, резкое, шутки-в-сторону
грудь: грудь
глубина: глубоко
представление: показать, производительность
процветание: процветать, успех, обеспечение
клерк: наемный-рабочий, официальный
принимать-решение: решение, определенный, решающий, растворенное-вещество
жертва: охота, жертва, Потери
мотив: намереваться, лейтмотив, двигатель, цель, стимул
определенный: определенный, очевидный
тенденция: характеристика, мили, расположение, дрейф
Конец: законченный, цвет
флаг: баннер, знать
администрация: правило, управлять
редко: редкий
подлинный: виртуальный, оригинальный
обучение: образование, учение
плохо: неправильно, очень, хуже, зло, больной
корм: есть, способствовать, еда
центральный: центр, федеральный
контрастировать: контрастные, оппозиция, конфликт
состав: здание, структурный, организация
оплата: платить
темп: скорость
запрос: зонд, запрос, поиск
где-бы: где
задолжать: виновный, долг
ручка: обработать, управлять, справиться, манипуляция
поездка: посещение, сафари, осмотреть, экспедиция
стрелять: выстрел, изгнание, испускают
занятость: безработные, озабоченность, Работа
резка: порез
оказывать-сопротивление: оппозиция
определить: детерминанта, определенный, решающий, наложить, фиксировать
торговец: дилер, деловой-человек, сделка
оживленный: жить
ветер: воздух
относительный: двоюродная-сестра
тем-самым: таким-образом
обеспечение: вводить, предоставлена, обеспечение, выделение, расположение
относительно: около, учитывая
выбирать: выберите, взять
разрушенный: уничтожить
доставить: дайте, вводить
неожиданный: сюрприз
стол-письменный: Таблица, офис
полоса-дороги: линия, группа
представлять: представитель, пример
респектабельный: честь
обязанность: долг, вина
разочарованный: амбиция, неутешительный
подходящее: совпадать, надлежащий
зависеть: зависимость, граница
гигант: Великий, монстр
схватывание: Понимаю, воспользоваться
прибыть: приехать, достигать
простота: просто, смирение
осень: падать
нет-на-месте: отсутствие, далеко
мрак: темно
подозреваемый: Угадай, сомнение, подозрительный
определение: определенный, решение, отчет, определение
основа: база, сроки
исследовать: наблюдать, проверить, анализ
приз: награда, премия
покупка: купить
кто-то: человек, кто-угодно, хоть
понимать: достигать, Понимаю
поражение: бить, ожерелье, потерпеть-неудачу
преступник: кровь
глупый: дурак, невежественный
отзыв: запомнить
занятие: рейд, профессия, профессиональное, агрессивный
речь: современное, говорить
помощь: Помогите, поддержка, сотрудничество
продажа: аукцион, продавать, скидка
приглашение: приглашать, вызов
низший: недостаточный, вниз, хуже
признать: признавать, диагноз
портрет: картина
предлагать: предложить, предположим,
разочарование: разочарование, амбиция, антиклимакс, неутешительный, подсчет
строительство: здание
рвение: энтузиазм, усердие
ответственность: долг
лечение: терапия, заживать, забота
включают: в-том-числе, войти, включение, Понимаю, содержание
удовлетворять: встретить, доволен, содержание, баловать
агония: горький
глупый: ненормальный, невежественный, дурак
наслаждение: наслаждаться
скрывать: скрывать
точно: надлежащий, полный
предполагать: очень-прошу, предположим,, учитывая
оценить: оценка, Угадай
маршрут: путь
посетитель: путешественник, гость, наблюдатель
не: не
провод: линия
в-основном: особенно, во-многом
без-сознания: слабый
взаимное: друг-друга, общий
внешний: вне, иностранный
вселенная: космос, Мир
Часы: час
инструкция: учение, направление, руководство
больной: язва, больной, боль
дисциплина: предмет
введение: вводить, предоставлена, продвижение, грунтовка, Импортировать
пустыня: пустыня
смущенный: нервный, разочарование
свадьба: в-браке
от-имени: представитель, боковая-сторона, Грейс, часть
рассчитывать: считают,, расчет, подсчет
неопределенный: неопределенность, неустойчивый, неопределенный
помолвка: занято, выдвижение
грязный: эмиссия, валовой
врач: врач
покрытие: покрытый, включение, крыша, заворачивать
искренний: честный, действительно, правдивый
ощущение: чувство
конкретный: особенно, частный, эксперт
гостиница: Гостиница
жесткий: жесткий
сопровождать: следовать
Гол: отметка, отчет
девственница: дочь
голод: голодный
любимый: любимый
обычаи: традиция, дюйм, долг, обычай
впечатленный: чувство
добыча: охота, добыча, жертва
музыкальный: Музыка, музыкант
удовлетворительное: болезнь
смешной: невежественный, веселый
лист: бумага, лист, листовка
позор: позор
первоначально: оригинальный
заработная-плата: платить
обширный: широко-распространен, глубоко
досуг: развлекательная-программа, пустой, выходить-на-пенсию, релаксация
подбородок: борода
светиться: яркий-свет, легкий, излучение, вспышка
ревность: ревнивый
Железнодорожный: железная-дорога, поезд
фунт: книга
восточный: восток
гражданин: гражданского
пляж: берег
особенность: элемент, характеристика, имущество
резерв: сохранить, книга
рев: шум
странно: странный
лай: кора, кожа
прием: Добро-пожаловат, квитанция
приятный: неприятный, своего-рода
разбудить: проснулся
исследование: анализ, поиск
монарх: император, король
одежда: ткань, платье, одежда
болезнь: болезнь, больной
шутить: шутка, Ирония, смех
комментарий: объяснять
металл: железо, минеральная
решение: фиксировать, решение, ответ
табак: сигарета, дым
организация: инструмент, Ед.-изм, присутствие, организация, Компания, человек
отходить: Вылет-из, отвлекаться, трещина, идти
горько: горький
мирное: тихо
встревоженный: тревожный
трюк: нанимать-на-работу, протектор, дурак, манипуляция, хитрость
финансовый: Деньги, экономический
подготовка: подготовить
оболочка: стручок, кора, кожа
гнездо: жить, разъем
зачать: концепция, Понимаю, думать
деловое-свидание,-встреча: выдвижение, обещание
получать: приносить, извлекать, взять
свеча: легкий, воск
преступление: атака, преступление, масса
смесь: смешанный
модель: пример
дефект: вина, морщина, инвалидность
возражение: разногласие, оппозиция, противоречие
ремесло: Изобразительное-искусство, профессиональное, умение
пренебрежение: игнорировать, заброшенный, упущение, бойкотировать
данные: Информация
оружие: оружие, пистолет
розовый: Роза
пользователь: около, бенефициар
Дед: предок, бабушка-или-дедушка
ноль: нуль, пустой
энергичный: сильный
молния: электронный, болт, вспышка
спорт: движение, упражнение
порошок: мука, пыли
картина: картина, панель
крик: шум, нож, плакать
неосторожный: безрассудный, равнодушие
производная: выводить
дверной-проем: дверь
удобный: просто, практическое, удобный, без-труда, надлежащий
почта: Почта, письмо
покрасить: цвет
сдача: традиция
установить: вводить, установленный, фиксировать
мягкий: мягкий, легкий
быстро: один-раз, надлежащий
отдел: часть
заслуживают: стоимость, квалифицировать
уволиться: заброшенный, появляться, трещина, бросать
уверенность: гарантировать, залог
зеркало: стакан
сюжет: заговор, план, история
вверх: Больше
грустно: грустный, К-сожалению
скромный: общий, просто, смирение, скромный
блюдо: суд, еда, есть
сеть: Web, правдивый, святой
тепло: энтузиазм, тепло
беспокойный: тревожный
эксперимент: пилот, опыт, пытаться
Cегодня: день
огромный: ужасный, Великий, массивный, очень
улучшение: реформа, ремонт, прогресс, восстановление, заживать
спор: разногласие, аргумент
предложение: предложить, предложение
может-быть: возможно, мог
винтовка: пистолет
щит: защищать
использовать: аренда, использование
В-отличие-от: различный
восстанавливать: спасти, извлекать, восстановление
приятель: плевать, коллега, друг
организовать: заказ, законодательствовать, организованный
комитет: панель, комиссия
пожилой: старый
призрак: душа
откровение: выражение
признание: признавать, признание
глина: грязь, моль
хобот: племя, Багаж, ботинок
управление: управлять, вождение
восстановить: сохранить, назад, восстановление, извлекать
акция-протеста: оппозиция, Март
куча: свалка, доля, толпа
умеренный: вторичный, имею-в-виду
орфографии: очарование, написание
площадка: поле, региональный, поверхность
формальный: официальный
редактор: автор, издатель
признавать: признание, признавать
средство: лекарственное-средство, терапия, фиксировать
проводить: баловать, монитор, проводить, следовать
столб: Прости, колонка, крайняя, пупок
жизненно-важно: необходимо, решающий, ключ
президент: глава
подопечный: крыло, региональный, часть
Миз: 
ура: сердце, энтузиазм
оправданный: рациональный, правильно, оправдывать
восхищаться: хвалить
открыто: недвусмысленно, открытый, открытие
модификация: изменение, приспособление
драматический: драма, демонстративный
вверх-по-лестнице: выше, хуже
разнообразный: различный
спуск: природа
зависть: ревнивый
нагрузка: вес, напряжение, бар, племя
делать-вид: симулировать, драма
внутренний: внутренний
занавес: вуаль, экран
здоровый: здоровье
безвестный: неопределенный, затмение
центр: центр
конкурс: раса
изменять: конвертировать, изменение, заменять
проблеск: взгляд, видение
контракт: меморандум, заказ, держать, соглашение
экономия: спасти, место-хранения, экономика
строка: веревка, цепи, задавать
сочетание: совпадение, смешанный, задавать, вызов
арестовать: скрепить, концепция
температура: тепло
строгий: строго, резкое, жесткий
профессиональный: профессия, профессиональное
пострадавший: ранен, травма
окрестности: окружающих, жить, экологическая
курение: дым, сигарета
медицинская: врач
поставить-в-известность: газета
видный: популярный, памятный, логически-вытекающий, ключ, общеизвестный
учреждение: организованный, Компания, организация
пакет: заворачивать, закрыть, упаковка
боль: горький, нищета, боль, печаль
очевидно: очевидный, открытый, недвусмысленно
захватить: пленять, взять, концепция
обильный: достаточно, недостаточный
Спальня: комната
чисто: только, полностью, святой
совместная: общий, смешанный, вызов
сослаться: справочный, консультироваться
идентифицировать: идентичность, опознаваемый, фиксировать
скамейка: банка
спасательный: восстановление, спасти
предел: граница, сокращать
ожидание: ожидать
программа: план, повестка-дня
электрический: электронный
интервал: временный, ломать
гнаться: охота
занимать: взять, воспользоваться
платье: Пальто, платье, костюм
замок: замок
предложение: предложить, предложение, план, вывод
счастливо: счастливый
последующее: следующий
беспокойный: неустойчивый, неприятный, тревожный, жесткий
блеск: яркий-свет, вспышка
машины: механический, машина, механизм
привлекательный: магнитный, привлечь, желательный
продукт: товар
болезнь: болезнь
двигатель: двигатель, машина
их: Oни
кожа: кожа
тонкий: микро, тонкий
наклон: мили, падение, изогнутый
беспокоиться: тревожный, озабоченность
яростно: жесткий
указанный: определенный
лесоматериалы: деревянный, придерживаться, дерево
вычислять: расчет, подсчет
убийство: убийство
веселая: странный, веселый
оскорбление: презрение, позор
неспособный: в-состоянии
пообедать: есть
чувствительный: восприимчивый, ключ
аппетит: желание
вежливость: вежливый, честь
сфера: поле, мяч, региональный
почетный: честь
вина: виновный, преступление, вина, грех
вкусно: вкусно, вкус
пшеница: фольклор, зерна, кукуруза
юмор: юмор
столкновение: справиться, встретить, Дата
сумерки: рассвет
парк: сад
экономика: экономический, экономика
управлять: управлять, правило, мастер
формирование: образование, формулировка
опираться: мили, тонкий
стучать: колебаться, похлопывание, бить
единство: единый, Ед.-изм, солидарность
главный: пионер, ключ, родитель, Великий, основной
предварительный: открытие, оригинальный
граница: граница, край
дышать: дыхание
освобожденный: свободно, избавиться, прощать
богатый: богатые
вдохновение: импульс, вдохновлять
все: все
обильный: богатые
художник: художник
очки: стакан
стрельба: выстрел, охота
вагон: поезд, тележка
давать-в-долг: дайте, кредит, цитата
предпринимать: начало, делать
печать: кольцо
духовенство: священник
крепление: устанавливать, увеличение, холм
массив: колонка, задавать, заказ
журнал: Нажмите
суровый: жесткий, строго
несмотря: хоть
в-обтяжку: строго
пейзаж: сценарий, экологическая, видение
отказаться-от: заброшенный
художественный: Изобразительное-искусство
в-основном: особенно, во-многом
верный: верность, честный, верный
подходящий: конгруэнтный, совпадать, надлежащий
консультировать: совет, консультант
стабильный: установленный, определенный, стандарт
максимальная: максимизировать, крайняя
совершить: обещание, делать
влиять: эффект, впечатление
крестьянин: фермер
значительно: очень, логически-вытекающий
продлить: деталь, расширять, протяжение
лично: в-отдельности, частный, своя
мораль: моральный
бунт: бунтарь, революция
нить: линия, вращение
медь: латунь
ответ: реакция, ответ
имперский: королевский
пустой: пустой, полый, белый
незначительный: вторичный, немного, шахтер
сделка: сделка, повод
усталость: устала, напряжение
нелюбовь: презрение, ненавидеть, нежелание
нормальный: общий
эскиз: контур, план
добродетельный: добродетель
так-или-иначе: тем-не-менее, уже
Водитель: автомобилист, вождение, проводник
декларация: объявление
избыток: дополнительный, избыточность
разделение: дизъюнкция, расстояние, раздельный
отвращение: презрение, фобия, ненавидеть
справедливо: одна-и-та же, надлежащий
толпа: толпа, масса
ненужный: отходы, должен
мех: кожа, Пальто
поощрять: вдохновлять, От-себя
дань: аренда
облегчать: уменьшить, избавиться, прощать
законодательство: законодательствовать, правило, законодательная-власть
проект: план
фея: ангел, синий, вилла
заключать: держать, вывод
везучий: счастливый
круг: колено, фартук, круглый
портить: добыча, разорение, подделывать
подлежащий: без-труда, тенденцию, восприимчивый
Вдумчивый: осторожный, тревожный, мудрый
благоприятный: конгруэнтный, сгибать, желательный
банка: банка
зависимый: зависимость, прикрепленный, наемный-рабочий
ордер: гарантировать, оправдывать, меморандум
жалоба: белый
конвенция: меморандум, соглашение
угол: угол, многоугольник
широко: широко-распространен, очень, в-общем, во-многом
корова: крупный-рогатый-скот
предубеждение: ненавидеть
крыльцо: зал, балкон
удивительный: странный, поражать, сюрприз, поразительный
фонтан: источник
подходящее: надлежащий, костюм, последовательный
уверенная-в-себе: мужество, безопасно, считают,
орган: инструмент, член, элемент, тело
выбор: выберите, выдвижение, выборы
трепет: фобия, страх
сравнить: сравнение
иметь-отношение: скрепить, крюк, связи, связано
предполагать: считают,, Угадай, предположим,, учитывая
отсутствует: потерял
модный: современное, элегантный
положительно: положительный
рассуждения: идея, аргумент
беспокоить: нервный, агрессивный, вмешиваться, раздражающий
партнер: Подруга, общий, акционер
ассоциация: соединение, учитывая
племянница: племянник, внучка
телесный: физиологический, тело
факультет: колледж, факториал
пушка: мяч, артиллерия, пистолет
парусный: корабль, вуаль
умная: мудрый
мелкий: кольцо, тривиальный, немного
осторожность: предупреждение, забота
рукопись: законопроект
воин: герой
жидкость: воды
концепция: концепция, коннотация
специально: особенно
Прыгать: летать, танец, каблук, отскок
желают: намереваться
дополнительный: дополнительный
подача: тротуар, тон, не
неловко: недостаточный, странный
ценить: аплодировать, наслаждаться
выживать: жить, оставаться
кратко: акроним, короткая
рис: латунь
парень: человек
поведение: характеристика, поведение
принять: предположим,, взять
регулярно: довольно-часто, повторный, постоянный, надлежащий
расследование: зонд, поиск
конституционная: конституция
последний: последний
ученик: студент
полностью: полностью
витой: изогнутый
отличаться: раздельный, разница, различный
катастрофа: разорение
делать-ставку: доля, состояние, вето
сырье: жить, источник, валовой, зеленый
журнал: войти, постановка-на-учет, клуб
гостеприимство: щедрый
тележка: поезд, тележка
халат: платье
заниматься: прикрепленный, использование, аренда, сохранить
пасти: стадо
собирать: собирать
кастрюля: горшок
нападение: атака, рейд
обманывать: дурак, предавать
траур: печаль
изымать: избавиться, привлечь, выходить-на-пенсию
мелодия: песня, гармония
сострадание: сопереживание, жалость
маскировать: скрывать
транскрипция: копия
документ: файл
сосед: окружающих
блок: не-допустить, объем
обязательство: долг
снижение: Отрицать, падать
амбициозный: амбиция
день-отдыха: отпуск, праздник
кулак: первый
орел: ястреб, галстук
почетный: честь
значительное: необходимо, логически-вытекающий, поразительный
плотный: компактный, толстый
фантастика: роман, воображение, история
рекомендовать: предложить, вводить, совет
образовательный: образование
вверх: Больше, выше
рог: кукуруза
фонд: коробка, столица
домик: хижина, файл, кабина
костюм: платье, костюм, обычай
плата-за-проезд: аренда, идти, карта
аплодисменты: аплодировать, утверждение
напоминать: запомнить, походить
подушка: река
нигде: место
труп: тело
сущность: клетка, существо
высота: крутой
область: поле, Мир
лестница: лестница, масштаб
соглашение: меморандум, компактный, костюм, совпадать, соглашение
шнурок: шип, доход
ученый: студент, ученый
линейка: герцог, губернатор
псих: ненормальный, дурак
развлекать: Добро-пожаловат, забавлять, развлекательная-программа
приветствие: Добро-пожаловат, открытка
женский: женский-пол
чудовищный: монстр, ужасный
объект: оборудование
грабить: украсть, добыча
лестница: лестница, проводник, масштаб, школа
окончание: последний
делить: разница, распространять
невероятный: странный, необычно
арка: лук
избранный: выборы, выберите
застенчивый: застенчивость, позор
туман: туман
цветной: цвет
предупреждать: предупреждение, индуцировать
мелкий: глубоко
поощрение: стимул, комфорт
нерегулярный: общий, необычно
верно: верность, верный, надлежащий
перевод: перевод
фундаментальный: база, основной
пачка: закрыть, волокно
трагический: ужасный
обзор: пересмотр, критика
ужасно: ужасный, очень, хуже
Готовка: готовить, кухня
восстание: бунтарь, революция
улучшать: фиксировать, заживать
крушение: уничтожить
убеждать: убеждать, гарантировать
миска: кружка
иллюстрация: пример, картина
нерв: вена, мужество, нервный
глазеть: фиксировать
выяснять: знать, гарантировать, определенный, проверить, фиксировать
залог: гарантировать, обещание, заложник, залог, пешка
зарабатывать: обслуживать
Выбрать: выберите
промышленное: индустриализация, промышленность
интерпретация: перевод
вызов: вызов
запретить: не-допустить, Отрицать
тема: лейтмотив, предмет
прием: квитанция
бассейн: бассейн, яма
конференция: сессия, сборка
равенство: аналогия, баланс, эквивалентность, уравнение
вновь: нео, в-последнее-время, роман
окружение: экологическая, окружающих
вторжение: атака, рейд
шаблон: пример, один-раз, стандарт, форма
выявить: раскрывать, предавать
разрешить: свободный, фиксировать
проповедовать: проповедь
бабушка: невеста, бабушка-или-дедушка
шерсть: хлопок
общаться: диалог, общаться, связи
по-существу: сроки
противодействовать: оппозиция
образец: пример
бремя: привлечь, ножницы
урожай: культуры, уборка-урожая, порез
точный: надлежащий, мука, осторожный
курорт: взять, кров, ломать
отказ: Отрицать, отходы
связь: ключ, залог, связка
симпатичный: жалость
зарплата: платить
непрерывный: Продолжать
возбуждать: индуцировать, подстрекать
дико: дикий, сильный
печаль: печаль, трагедия
союзный: единый, связано
потолок: одеяло, крыша
Цель: фокус, цель
денежные-средства: Деньги
свободный: открытый, свободно, пустой, свободный, неопределенный
презирать: презрение
газон: трава, луг
Турция: 
сосед: окружающих
окончательный: последний, крайняя, в-конце-концов, основной
представление: подчиниться, Отправить
запись: войти
тщательный: глубоко, полный
захватывающе: привлечь, любопытный
выигрыш: успех
консервативный: ортодоксальный, губернатор
восторженный: энтузиазм, тревожный
вниз-по-лестнице: вниз
кипятить: готовить, язва
красиво: красота, красивая
завтра: вчера
неудобный: тревожный, неприятный
устройство: оборудование
утверждать: настаивать
высказывание: произносить, выражение
рельс: железная-дорога, поезд
несовершенный: полный, инвалидность, недостатки
приобретать: получение, выводить, купить
наступление: рейд, атака, агрессивный
холодно: холодно
лекция: курс
Посредством-чего: где
восприятие: чувство, взгляд, концепция
развивать: разрабатывать
функция: церемония, Работа, Мероприятия
пуля: таблетка, выстрел, мяч
связывать: скрепить, граница
идентичный: одна-и-та же
существенный: демонстративный, Великий, логически-вытекающий, поразительный
масса: масса, величина, объем, опухоль
длительный: длинный, задерживаться
раздраженный: раздраженный, неприятный
рассториться: нервный, грустный
связка: связка, группа
сено: трава, солома
дебаты: разногласие, аргумент
неподвижность: тишина
частичное: исключение, часть
говядина: мясо
объединяться: солидарность, упряжь, примириться, присоединиться
лезвие: лист, меч, нож
завод: мельница
ноль: нуль, пустой
журнал: газета, Нажмите
честно-говоря: верность, честный
законный: правовой
акцент: произносить, акцент, фокус
С-уважением: шутки-в-сторону
лига: альянс
одобрить: утверждение
конечность: член, крайняя
стюард: менеджер, служащий
эволюция: реформа, эволюционный
опрос: проверить, поиск
современный: современное
скандал: коррупция
умышленное: умышленно
символ: обозначение, жест
мойка: мыть, прачечная
точный: надлежащий, мука, осторожный
вхождение: инцидент, повод
вал: ров, плечо, дерево
стебель: сухой, племя, корень
корпорация: Компания, организация
предпочтение: привилегия, предпочитать, преимущество, выберите
побуждать: индуцировать, импульс, желание
удаление: расстояние
утверждение: утверждение, акцент
доступной: посещение, найденный
комедия: юмор
промывать: цвет, волнение
код: двор, кодировать
адекватный: достаточно, надлежащий
Трещина: распространять
историк: исторический
интенсивность: плотность, напряжение
демократия: республика
кредо: признание
Привлечение: очарование, сила-тяжести
концерт: фестиваль
вниз: вниз
канал: канал, труба
незамедлительный: скоро, запрос, проворный
бронза: латунь, коричневый
одежда: одежда
раскаяние: грустный, жалость
эксклюзивный: монополия, частный
портье: носить, перевозчик
тире: линия
полоса: группа
в-конечном-счете: в-конце-концов
команда: хор
дорогая: Уважаемые
главное-управление: штаб-квартира, центр
острый: резкое
смущенный: нервный, позор
отпрыск: дети
сеть: Web
самолет: птица, поверхность, машина
частично: часть
гордо: гордость
терраса: балкон, крыша
рукоятка: держать, ловушка
взрыв: взрыв
отряд: армия, военный
плотно: строго
штраф: жалость, предложение
грязь: влажный, фекалии, грязь
эпоха: время-года
посол: вестник
разводить: умножить, раса
вмешательство: вмешиваться, раздражение, расстройство
состоять: проходить, содержание
принятие: приемлемо, утверждение, квитанция
инженер: механический
остановка: фут
альтернатива: заместитель, заменять
печать: кольцо
счетчик: диск, оппозиция, напротив
Венера: пятница
воображаемый: воображение
альпинизм: подъем, ползать
привлекать: привлечь, впечатление
удивительный: сюрприз, поразительный
соревнование: соперник
кристалл: стакан
душ: ванна, дождь
философский: философ, философия
шумный: шум
устройство: оборудование
транспорт: трафик, челнок
в-итоге: в-конце-концов
ужасно: очень, ужасный
созерцание: отражать, отражение
производство: промышленность, производить
удобно: удобный
выставка: экспонат, отчет
сельскохозяйственное: сельское-хозяйство, ферма
поиски: поиск
расширение: деталь, расширять
полемика: противоречие, аргумент
грубо: почти
накладные-расходы: выше
сдерживать: ингибирование, не-допустить, сдержанность, сохранить
сохранение: спасти, забота, сохранить
паб: бар
бассейн: долина, бассейн, раковина
мелодия: тон
Наем: аренда
волновался: тревожный, нервный
пожилой: старость, старый
Университет: колледж
осторожный: осторожный
предшествующий: восток, до
сложно: сложный, жесткий, разрабатывать
извинение: принести-извинения, Прости
испуганный: испуганный, страх
замена: заместитель, пособие, заменять
Применение: использование
восстановление: ремонт, восстановление, извлекать
живая-изгородь: забор
первичная: мастер, база, оригинальный, основной
луч: луч
тур: посещение, экспедиция
преувеличенный: поваренная-соль
компетентный: включить, в-состоянии
срочный: скоро, осадок
тревога: предупреждение, аварийная-сигнализация, проснулся
духовой-шкаф: плита
закругленный: круглый
обычный: общий
умолять: очень-прошу, оправдывать
шнур: веревка
рядом: параллельно, следующий, соединение
экстракт: цитата, сок
более-легкий: легкий
пинта: пиво
трубка: труба
проспект: повод
эффективным: опытный, эффективный, эффект
смешивание: смешанный, размешать
нарушение: расстройство, раздражение
должностное-лицо: менеджер
десятый: 10
Сравнительная-степень: сравнение
утра: утро, блестящий
клетка: замок, клетка
тюрьма: тюрьма, цепи
искусный: опытный, хитрость, в-состоянии
вопить: плакать
компромисс: соглашение, гармония
боеприпасы: выстрел
помощник: сторонник, Помогите
тростник: придерживаться
утверждать: обсуждать, настаивать
логика: аргумент, рациональный, рациональность
паника: страх
циркуляция: езда-на-велосипеде, цикл, трафик, осмотреть
стресс: напряжение
потребление: использование, потреблять, есть
поддерживать: поддержка, сохранить, держать, страдать
авария: падать, конфликт
не-хватает: недостаточный, порез, недостатки
постепенное: постепенно
раздавить: уничтожить, сила-тяжести, сквош
явление: инцидент, вещь
выполнять: бег, действие
приветствовать: здоровье, Добро-пожаловат, град
монархия: королевский, имущество
вести-себя: жить
барьер: препятствие, порог
кривая: лук
полагаться: подсчет
удобство: без-труда, комфорт
ягненок: овца, ползать
логическое: рациональный
диета: еда
судебная: суд, правовой
недоверие: сомнение, верность
перо: весна, жалость
добровольное: доброволец
куртка: Пальто, свитер
плавание: плавать
впечатляющий: поразительный
под: вниз, после
провинциальный: сельский, провинция
компенсация: компенсировать, пособие
Официант: служащий
содействовать: ускорение, продвижение, способствовать, От-себя, делать-вклад
посвятить: намереваться
враждебность: враждебный
плантация: ферма, питомник
подвергать: контур, раскрывать, открытый
пластырь: место, прикрепление
прерывание: ломать, раздражение
большой-палец: дюйм
революционный: революция
удивительно: странный, поражать
наконечник: полушарие, шип, крайняя, борода, саммит, совет
угроза: угрожающий, Опасность
джунгли: лес
типичный: общий, характеристика
топливо: масло
спокойный: тихо
место-назначения: повторение, цель, судьба
штырь: секрет, игла
Марс: Март
ассоциировать: связано, коллега, соединение, общий, параллельно, прикрепленный
порочный: аморальный, зло
банкет: праздник
подробная: разрабатывать, глубоко, петля, деталь, осторожный
стенной-шкаф: шкаф
законодательная: законодательствовать, законодательная-власть
поле: край, поле
чемпион: герой
пульс: импульс
бежать: бег, побег
пункт: поток, параграф
соединение: соединение, сложный
морской-узел: держать, вязать
отношения: связи, отчет, учитывая
агентство: организация, Компания, офис
усмешка: улыбка, гримаса
демонстрация: показать, Март
депрессия: печаль
средство-передвижения: машина
заимствовать: кредит, цитата
припухлость: зыбь
тема: лейтмотив, предмет, Заголовок
вердикт: решение, правило
суббота: суббота
идентификация: опознаваемый, идентичность, определение
фотография: картина, выстрел
союзник: друг, дружба, единый
тракт: путь, протяжение, аргумент
лента: группа, кино
плюс: Больше
прозрачный: прозрачность, очевидный
духи: запах
беспокоить: беда, вмешиваться, раздражающий, раздражение
квалифицированный: в-состоянии, квалифицировать, опытный
сочинение: статья, отчет
всадник: рыцарь, верховой
одиночество: Одинокий
запястье: рука
мелко: мягкий, тонкий, в-конце-концов
ноль: нуль, пустой
осуждать: предложение
челюсть: сосна
уникальный: единый
неизбежно: неизбежный
барабан: танец, пустой
бункер: коробка, корзина
продолжительность: временный, постоянный, время, длина
весить: измерять, вес
монастырь: аббатство
публиковать: публикация, распространять, раскрывать
в-поле-зрения: видение
определенно: очевидный, строго, курс, действительно, недвусмысленно
сдвиг: изменение
сегодня-ночью: день
фактор: причина, наемный-рабочий, коэффициент
беспорядок: агрессивный, расстройство, путаница
практика: упражнение, действие
святилище: алтарь
сокращаться: акроним, собирать
расход: расходы, использование, проводить
поощрение: сердце, вдохновлять
воздействие: выражение, экспонат, отчет, эффект
сырой: валовой, зеленый
билет: баннер, карта
назад: назад
обувной: обувь, ботинок
мошенничество: иллюзия
взрыв: взрыв
камин: дымовая-труба
сосуд: стакан, бутылка, кувшин, горшок
соус: повязка
гнилой: ленивый, аморальный, бедные
поведение: характеристика, поведение
заем: кредит, цитата
необоснованный: рациональный, бред-какой-то
похоть: амбиция
ежегодно: год
жидкость: воды
дитя: дети
безумный: ненормальный, дурак
свержение: залить
достижение: успех, ранг, эксплуатировать
предположение: предположим,, воображение, предположительно
юмористический: юмор, веселый
экстаз: энтузиазм
выход-на-пенсию: выходить-на-пенсию, отставка, пенсия
парламент: законодательная-власть, сенат
крайняя-необходимость: тревожный, кризис
пакет: заворачивать, часть, закрыть
выдвижной-ящик: коробка, лестница
вклад: делать-вклад, доля
ссылка: прикрепление
срывать: мужество, вымогать
печать: публикация, Распечатать, Нажмите
адвокат: адвокат, оправдывать, ответчик
Окружающая-среда: атмосфера, экологическая
подтвердить: доказывать, гарантировать, усиливать
объявлять: раскрывать, публикация
в-отставку: отставка, выходить-на-пенсию
отклонить: Отрицать, вето
жестко: жесткий, жестокий
фрагмент: чип, кусочек, лом, протяжение
медитация: забота, отражать
пятно: место
захоронение: похороны, похоронить
гипотеза: предположим,
гипотетический-настроение: спекулятивный-настроение, предположительный-настроение, условный-настроение
сделка: Мероприятия, сделка
безобразие: гнев, презрение, позор
варьировать: переменная, различный, заменять
адвокат: адвокат, представитель
оскорблять: виновный
пакет: заворачивать, карман, закрыть
классический: классическая
ранчо: ферма
пирог: кекс, Пи
точно: правильно, точность, строго
бросать: бросать
морской: флот, море
певец: читатель
электричество: электронный, поток
инопланетянин: иностранный, гость, внеземной
треснувший: взрыв, трещина
подавленный: грустный, печаль
густо: толстый
разумно: причина, рациональный
кабель: полый, сгибать
иллюстрировать: объяснять, отражать
принятие: утверждение, квитанция
печально-известный: общеизвестный
ранить: травма
правильно: точность, надлежащий, правильно
пастбище: ива, луг
червь: маска, глубоко
оценка: оценка, Угадай
снаряжение: организация, одежда, оборудование, платье
несчастливый: несчастный, К-сожалению
восьмой: 8
расслабленный: комфорт, релаксация, тихо
смежный: почти, окружающих
старшая: ветеран, родитель, глава
пугать: аварийная-сигнализация
репетитор: тренер
ограбление: добыча, украсть
торговый: сделка, коммерческая
потухший: исчезать
кусковой: масса, торус, вмятина
случайный: случайный, временный, совпадение, сюрприз
предпосылки: дом, место, здание, в-помещении
Доставка: вводить
изогнутый: изогнутый, сгибать
продуктивный: производитель, производить
набухший: зыбь
культивировать: способствовать, ферма
вариация: изменение, разница
противник: соперник, оппозиция
внук: внучка, племянник
гвоздь: ногти, шип, болт
благожелательность: щедрый, обеспечение, добродетель, Грейс
точность: точность
индикация: отметка
снижение: уменьшить, порез
живот: желудок, пупок
чувствующий-отвращение: ненавидеть
сочинять: записывать, Создайте
пассажир: путешественник
жало: попытка, горький, укусить
одновременно: между-тем
эпизод: логически-вытекающий, часть
стойкий: последовательный, Продолжать, постоянный
голодать: голодный
консультация: консультироваться, совет
кислый: кислота
подчеркивание: настаивать, акцент
парад: Март
шлем: шапка
провозглашать: пропаганда, публикация
жилье: Гостиница
спрей: лекарственное-средство
формально: официальный
тревожный: нервный, вмешиваться, тревожный, раздражающий
ожидание: ожидаемый, ожидать
оценка: мост, коэффициент, ранг, оценка, степень
стул: фекалии, стул
обоснование: оправдывать
иностранец: иностранный, гость
транспорт: трафик, челнок
понимание: Понимаю
директор: менеджер, глава
временной: временный, время
мило: красивая
обеспечивать-соблюдение: наложить, принудить, включить, полиция
комплексный: глубоко, полный
угрожать: угрожающий
прогрессивный: прогресс, радикал
ресурс: источник
ограничивать: ограниченное, воспользоваться, сокращать, уменьшить
поздравлять: хвалить
страхование: безопасно
назначать: глаз
прерывать: препятствие, порез, вмешиваться, ампутировать, ломать
подавлять: угнетать, не-допустить
слой: колонка
ключ-к-разгадке: доказательства, ключ
зуб: зубы, Дантист, вмятина
гарантия: гарантировать, залог
процедура: обработать, механизм, действие, подход
рекомендация: совет
разрыв: ломать, открытие
подразумевать: имею-в-виду
прикреплять: прикрепленный, сращивание, скрепить
поза: жест, индикатор, должность, стоять
набор: крыло, задавать, квартира
драгоценный-камень: сокровище, процветать
эмоциональное: чувство, страстный, восприимчивый
бетон: демонстративный, последовательный
комбинировать: альянс, соединение
вершина-горы: саммит
валюта: Деньги, монета
задача: цель, фокус
мемориал: Память, предупреждение
в-отдельности: раздельный, разница, в-отдельности, Одинокий
лоток: диск
горизонтальный: баланс
чартер: конституция, бумага, аренда
пункт: товар, статья, элемент, голос, своего-рода, должность
расширение: деталь, расширять
твист: болт, вращение, Ирония
традиционный: традиция, классическая
вовлекать: в-том-числе, включение, содержание
рутина: общий, механизм
решать: плуг, свободный, фиксировать
искушать: дразнить, индуцировать
неудачный: потерпеть-неудачу
политик: политическое
крышка: крыша
нарушение: травма
узел: порядковый, пересечение
босс: владелец, менеджер, работодатель, глава, вор
аппаратный: оборудование
прядь: берег, группа
Brink: край, утес, губа
товар: сделка, товар
в-стороне: раздельный, далеко, дистанционный-пульт
убежище: больница, кров
утверждать: доказывать, гарантировать
график: Таблица, календарь, диаграмма, расположение
траншея: ров
муниципальный: город
бунт: размешать
свидетельствовать: доказывать
материнский: беременна, Мама
скульптура: статуя
аромат: вкус
марка: руководство, отметка
багаж: Багаж
мусор: бред-какой-то, лом, свалка
инструмент: инструмент
хаос: расстройство, путаница
обвинение: костюм
напряженный: нервный, время
курица: курица
отделка: орнамент, уменьшить, порез
сдержанный: мудрый
оплакивать: плакать
диалект: полировка
элементарный: база
грузовой: Багаж, бар, грузовая-машина
протирать: подметать
отказ: Отрицать
метро: секрет
промежуточный: проверить
формула: уравнение, Нажмите
обманывать: дурак, манипуляция
преследовать: колебаться, фобия
регистр: список, постановка-на-учет
неопределенный: неопределенный, аорист
избыток: дополнительный
дрожь: дрожать
ткань: организация, Web, ткань
проект: контур
игрушка: кукла, играть, игорный
лестница: лестница, масштаб
переход: инфекционное-заболевание, изменение, переходный, пересечение
кнопка: ключ
недобрый: грубый
программа: план, повестка-дня
производство: индустриализация, мельница, производить
зона: поле, региональный, группа
девятая: 9
алкоголь: вино
жадный: амбиция, жадность
управлять: управлять
влиятельный: эффективный, проникать
окружать: воротник, осада
тонуть: раковина, угол
горка: скольжение
свинья: подъем, хлеб, свинья
доминирующий: Великий, рейд
руководство: иерархия, руководство
дневник: газета, календарь
праздновать: убеждать
суетиться: волнение, шум, раздражающий, путаница
заместитель: представитель, заместитель
автомобиль: двигатель
поправка: пересмотр, изменение
вертикальный: стоять, продольная
недостаточное: недостаточный, достаточно
черт: тонкий
вывод: Угадай, вывод
выведенный-настроение: индуктивный-настроение
Реклама: объявление, коммерческая, пропаганда
кража: украсть, заниматься-плагиатом
спонтанный: инстинкт, произвольный
утилита: организация, использование, инструмент
подключения: скрепить, крюк, сращивание, присоединиться
вниз: вниз
вмешательство: вмешиваться
возрождение: возрождать, восстановление
интернет: сделка
физически: физика, тело
точка: место
отвратительный: шок
грубо: грубый
сбалансированный: последовательный
индекс: экспонента, список, индикатор
передавать: Отправить, распространять
на: выше, вне, вперед
чат: говорить, статистика
янтарный: желтый
тонна: тон
плавно: удобный
напряженность: напряжение, волнение
кит: выборы
ядовитый: яд
концессия: сдвинуть-с-места, привилегия, скидка
работник: наемный-рабочий
наклон: падение, сопряженный
туалет: шкаф
преступление: атака, преступление
недовольство: ненавидеть, жажда-мести
стойкость: терпение, мужество
предвидеть: надеяться, ожидать
ритм: бить
крыса: мышь
вести-переписку: переписка, костюм, надлежащий, ответ
задерживать: не-допустить, воспользоваться, сохранить
интерпретировать: объяснять
салон: зал
работать: манипуляция, Работа, бег, действие
истощать: желоб, бег
заработная-плата: платить
неприятный: ненавидеть, зло, неприятный, неутешительный, уродливый
кладбище: похороны
штукатурка: мел
нажмите: труба, молоко
увольнять: мешок, игнорировать, Отрицать, вето, выделить, избыточность, прощать
провоцировать: волнение, раздраженный
проживать: оставаться, жить
украшение: орнамент
палец: на-цыпочках, фут, Палец, лапа
неспособность: инвалидность, слабое-место
изобретать: изобретение
определять: детерминанта, разрабатывать, описывать
ограниченный: ограниченное, граница
шкаф: шкаф, полка
подставка: полка
руководитель: проводник, инспектор
презентация: вводить, показать, экспонат, продвижение
ластик: мяч, эластичный
исключать: лишать, Удалить, выделить
привилегированный: привилегия
отшельник: аскет
царапина: скрип, начало
винт: болт
исследовать: наблюдать, эксплуатировать
застраховать: гарантировать
цилиндр: диск
резюме: контур, Абстрактные
вряд-ли: вероятность
рой: стадо, сын
систематическое: механизм
фактически: действительно, почти, практическое
клиент: обычай, гость
каталог: список, Таблица
химия: химическая
выпекать: хлеб, готовить
проколоть: попытка, проникать, отверстие, перфорировать
урвать: слеза, воспользоваться, похищать
запуск: испускают, бросать
сельское-хозяйство: сельское-хозяйство
актриса: актер
театр: театр, зал
лекарство: лекарственное-средство
неблагоприятный: хуже, недостаток, задний-ход, отрицательный, вредный
конфеты: мята, шоколад, милая
вставить: задавать, ожерелье
осужденный: ловушка, наказать, виновный
исследовать: зонд, наблюдать, проверить
пакет: заворачивать, задавать, закрыть
ползать: ползать, приседать
щелчок: поп, щелчок, картина, волна, скоро
шина: эмбрион, кольцо
заметный: поразительный, очевидный
ядро: база
предшественник: предок
по-аналогии: также, одна-и-та же
плотина: пыли
скользкий: скольжение
преобразование: изменение
бахрома: край
место-нахождения: должность, место
кластер: конгломерат, масса, группа
цитата: цитата
опека: усердие, забота
вероятный: приемлемо
бросать: бросать
ступенька: протектор
концентрация: накопление, фокус
удобный: практическое, удобный
приманка: вкус, грунтовка
разнообразный: различный
кусочек: чип, диск, кусочек
дрель: отверстие, копать
отвечать: реакция, возврат, ответ
смертность: смерть
сорняк: трава
относительно: объем
математическая: математика, Спортивное
морально: моральный
удушье: вздох, дыхание
гоночный: раса
изоляция: дизъюнкция, раздельный
когда-то: иногда
для-взрослых: зрелый
затруднение: горький, нищета, беда, раздражение
слух: слухи, голос
выдерживать: сохранить, медведь, последний
младший: молодой
Вязание: вязать
непрямой: непосредственно
прецедент: пример
проход: луч, зал, пересечение
противоречить: противоречие, Отрицать
выкупать: спасти, компенсировать
путь: путь, пешеходный-переход
шестерня: оборудование, зубы, ребро, бег
праздник: праздник
уютно: тепло, удобный
издательский: публикация, распространять
клиент: гость, покупатель
ковер: ковер, пол, одеяло
раздел: подсчет
прогноз: взгляд, видение
эстетический: красота
возмущаться: ненавидеть
поза: предложить, индуцировать, стоять
удовлетворенность: доволен
организм: существо
невразумительный: Понимаю
выразительный: акцент
полдень: после-полудня, на-юг
Лили: читать
имя-существительное: номинализация, имя
складной: сложить, изогнутый
полезный: Помогите
сохраняться: настаивать, Продолжать, последний
выход: Выход, разъем, Вылет-из
наследовать: наследник
скорость: скорость, осадок
оскорбительный: словесный
дефицит: недостаточный, порез, упущение, недостатки
обеспечивать: гарантировать
недобросовестный: правильно
суб: заменять
ведро: баррель, ложка
организация: организация
в-первую-очередь: особенно
ритуал: церемония, поклонение
бедро: ветчина, фут
гардероб: одежда, шкаф
текстура: организация
турбулентный: сильный
болото: болото
знают: невежественный
начальная: открытие, оригинальный, начало, первый, примитивный
минимальный: наименее
коррекция: реформа, пересмотр, ремонт
игнорировать: игнорировать, забывать
единодушное: единый
углерод: каменный-уголь
катушка: файл, рулон, кудрявый
хрустящий: хрупкий, резкое
запас-слов: Словарь
прогулка: бродить
фитнес: упражнение, гимнастика, состояние
Национальность: национализм, национальный
аромат: вкус
неважный: необходимо, тривиальный, значения
перфоратор: бить
шагать: прогресс, протектор
ось: плечо, Распечатать
удовлетворительный: болезнь, доволен
надежный: верный
отвратительно: ненавидеть, уродливый
этический: моральный
крах: падать
диванная-подушка: река
смешивать: фальсифицировать, уничтожить, поражать, потерпеть-неудачу, смущать
миф: история, легенда
владение: имущество
паника: испуганный, ужасный, страх
тормоз: ломать
орех: фасоль, семена
увеличить: зыбь, увеличение
солнечная: Солнечный-свет
клюв: губа, Ед.-изм
аренда: привязь, аренда
отношение: связи, сравнение, масштаб, отчет, аналогия
гребень: щетка, плечо, хребет
переведите: перевод, кувырок
отдых: развлекательная-программа, отпуск, релаксация
прихоть: цвет
образец: пример, пытаться
множественное-число: масса
инициатива: план, пытаться
желе: варенье, молоко
анархия: расстройство
профиль: контур, файл, Веб-сайт
финансы: Деньги
основной: база, основной
изгонять: свалка, рейд
электрический: электронный
трава: трава
процветать: процветать
сходство: аналогия, походить, солидарность
Конфиденциальность: частный
арена: поле
путешественник: путешественник
частица: атом, семена
врожденный: оригинальный
житель: резидент
флейта: свисток
воспроизведение: плодородие
пролет: длина
салат: салат, мощность
краситель: цвет
демонстрировать: доказывать
этика: моральный
официально: официальный
раздражать: вмешиваться, раздражающий, дразнить, подстрекать, отверстие
скольжение: скольжение
черта: характеристика, имущество, протяжение
композитор: музыкант
футбол: удар
партнерство: сотрудничество, альянс, делать-вклад
продолжение: Продолжать
ненормальный: необычно, ненормальный
последовательность: цепи
сжатие: От-себя
снасти: воспользоваться, справиться, оборудование
бордюрный-камень: ингибирование, тротуар, сдержанность
реклама: объявление, пропаганда
вывод: регрессия, разъем, вывод
ипотека: заложник, кредит, пешка
воздержанность: терпение, медведь
репрессировать: не-допустить, угнетать
супруга: муж
действительный: эффективный
клапан: фургон
строить: Создайте, здание, формулировка, фаза
пар: Стим, пара
летучая-мышь: придерживаться, клуб, вперед
противоречивый: противоречие, значения, контрастные
автоматическая: непосредственно
явный: открытый, прозрачность, аксиома
фактически: эффективный, эффект
опора: зависимость
осмотреть: наблюдать, проверить, осмотреть, анализ
странно: странный, необычно
улов: привлечь, добыча
смущающий: позор, смущать
отключен: инвалидность, пассивный
высокомерный: гордость
локон: кудрявый, кольцо
драгоценный-камень: камень, процветать
Годовщина: день-рождения
престиж: кредит
небрежность: упущение, презрение, равнодушие
само-: частный
дискриминация: исключение, выделить
континентальный: континент
мишень: цель
стойло: магазин, стоять
вкладывать-деньги: инвестиции
круиз: корабль
ралли: солидарность, действие
слух: слухи, голос
активно: шутки-в-сторону
проверить: проверить
отсек: квартира
конкретно: особенно
взрыв: поп, взрыв, выстрел
совокупный: валовой, общий
доля: часть, доля
незаконный: незаконное, дикий
растворить: Удалить, растворимый, растворитель
равновесие: баланс
исследование: зонд, анализ
лук: лук
сродство: аналогия, солидарность, зависимость
нечестный: верный
столкновение: конфликт, шок, вмешиваться
кресло: стул, диван
тесто: мука, масса, дрожжи, кекс
начинать: присоединиться
транс: видение
отказ: Отрицать, отходы
дисперсия: разница, надлежащий, противоречие
поглощение: кожа
коллектив: масса
своевременно: время
вторгаться: атака
увольнение: мешок, избыточность
существенно: во-многом
экспериментальный: пилот
фильм: кино, ТВ, картина
публичность: пропаганда, продвижение, объявление
расширять: расширять, деталь
падение: спотыкаться, падать, падение, одежда
ковать: Создайте, фальсифицировать
ископаемое: масло, археологический
ограничение: препятствие, регулирование, сдержанность
цедра: энтузиазм, специи, опыт, вкус, кожа
привередливый: раздражающий
Гамлет: пригород, деревня
бум: процветать, отскок, взрыв
воспроизводить: копия, подражать
конгресс: сборка
виноград: вино
мастерская: студия, семинар
уменьшить: уменьшить, порез, падать
произношение: произносить
суждение: решение, предложение, правило, судья, юрисдикция, кризис
сконцентрировать: осторожный, фокус
расстегивать: раскрывать, назад
паром: яхта, корабль
простой: просто, непосредственно, без-труда, прозрачность, линейный
высота: длина
обозначать: показать, имею-в-виду
экспорт: Выход
преступник: комета, виновный
неодобрение: оппозиция, вето
номинал: пара, баланс
отменять: Удалить
регулировать: пересмотр, фиксировать, приспособление
членство: член
калибр: измерять, масштаб, величина, тонкий, индикатор
терпеть: прощать
бедро: ягодицы, Талия
придерживаться: следовать, присоединиться, придерживаться, сохранить
отталкивать: не-допустить
беспорядки: расстройство
целомудрие: точность, чистота
слабина: релаксация, свободный
сокращение: застенчивость
журналист: репортер
симптом: экспонат
велосипед: езда-на-велосипеде, цикл
деготь: тротуар
спираль: вращение
комментарий: вакцина, определение
коробка-передач: инфекционное-заболевание
бюллетень: голос, выборы
потенциал: в-состоянии
право: в-состоянии, правильно, квалифицировать, надлежащий
петля: езда-на-велосипеде, петля, кольцо
рабочий: наемный-рабочий
преследовать: вина
лицензия: разрешение
отказываться: разряд
эго: самих-себя, дыхание
реактивный: выталкивать, птица, поток
нарушать: не-подчиняться, порез
склонный: зависимость
выживание: продолжительность-жизни, гласная-буква
замораживать: замороженные
ткать: вязать
возложенный: установленный, бенефициар
апатия: равнодушие
организовать: организация, подготовить, законодательствовать, организованный
предположительно: возможно, предположительно
аккорд: соглашение
кровоточить: кровь, кровавый
обнаружение: найденный, поиск, раскрывать
громить: уничтожить, ломать
способствовать: ускорение, способствовать, делать-вклад
частота: цикл, колебаться
стежка: шитье
каталог: доказательства
рубить: укусить, порез, стейк
обогрев: тепло
унылый: неутешительный, грустный
переворот: революция, выстрел, Инсульт
сострадательный: жалость
мыслитель: интеллектуальной
бюджет: баланс
гражданский: гражданского, городской
вставить: войти, увеличение
размышлять: отражать, думать
гибкая: просто, сгибать, эластичный
плита: панель, таблетка, плита
квалификация: талант, квалифицировать
переключатель: задний-ход, конвертировать, ключ
полотенце: ткань
десятилетие: 10, держать
множественный: различный, Больше
повязка: повязка, скрепить
аккуратный: аккуратный
хлопать-в-ладоши: похлопывание, аплодировать
клен: Пальма
грабли: подметать
пустота: пустой
мозг: масло, головной-мозг, тыква
оболочка: Пальто, конверт, стручок
поглощать: эксплуатировать, сосать, охватывать
прогнозирование: предсказуемый, Угадай
воспитывать: образование, поезд, учение
запрос: зонд, запрос, поиск
доминирование: правило
родительский: родитель
принимать-участие: дельта, присоединиться, занято
лифт: лифт
боковая: боковая-сторона
откладывать: задержка
ненависть: презрение, ненавидеть
ядро: ядерного, клетка, эмбрион
метафора: пример
миниатюрный: немного, микро
бомбить: насос
критически: глубоко, критик
ржавчина: проходить
резервирование: сохранить, воспользоваться
шить: шитье
химик: химическая
гостиная: ломать, зал
начало: начало, рейд, атака
погружение: падение
недружественный: враждебный
перепись: расчет
денонсировать: обвинить, предложение
лен: белье
приостановить: не-допустить
пощечина: бить
расслабиться: релаксация
ухаживание: двор
товар: товар
непрерывность: соединение
взаимная: обмен, инверсия
рецепт: лекарственное-средство, копия
пузырь: пена
лопата: щипцы, весло
использовать: эксплуатировать, использование, проводить, упряжь, потреблять
прочный: длинный
родословная: знакомые
цинк: раковина
какой-бы-ни: без-разницы, который
конечный: ограниченное, в-конце-концов, законченный
вспомогательный: сторонник, СПИД
борьба: искажать, борьба, Инсульт
академический: образование
шина: эмбрион, кольцо
потребитель: использование
период-действия: стоимость, кредит
примерно: почти, приблизительный
вязаный: вязать
микроскоп: телескоп
гражданский: гражданского
ремень: привязь, веревка
символический: жест, идентичность
адаптировать: приспособление, справиться, транскрибировать
вероятность: вероятность, в-состоянии
субъективное: умственно
местоимение: совесть
превратно: неправильно, злоупотребление
отговаривать: смущать, амбиция
новичок: гость
бесконечность: инфинитив
графический: диаграмма
инжир: профилированный, картина
ниша: последовательный, ключ
разочаровывать: неутешительный, предавать, потерпеть-неудачу
проекция: план, показать
освобождение: разряд, спасение
рецепт: стимул
франшиза: привилегия
несоответственный: бред-какой-то, значения, недостаточный
вращение: цикл, революция, вращение
ручка: бутон
метр: измерять
ограничение: граница, сдержанность, регулирование
категория: сообщество, ранг
расовой: раса, расизм
замена: вместо, заменять, изменение
инновация: изобретение
противостоять: справиться
запрет: Отрицать
декоративный: орнамент
лобби: индуцировать, зал
метать: бросать, кудрявый
свиток: книга, рулон, кудрявый
механик: механический, ремесленник
агрессия: атака, агрессивный, превышать
Привет: Здравствуйте, Добро-пожаловат
измерение: измерять
конкурировать: бороться, соперник
академия: колледж
начинающий: нанимать-на-работу, свежий
разведенный: развод
молочные-продукты: молоко
резервуар: бак
поход-по-магазинам: магазин, сделка
неявный: последовательный
стратегическое: стратегия
плесень: по-модулю, форма, Распечатать, бросать
репетиция: упражнение, повторение
настойчивость: настаивать
предшествовать: до
середине: средневековый, наполовину, Талия
туристический: путешественник, туризм
напиток: напиток
внимательный,-помнящий: осторожный
артикулировать: объяснять, выражение
заново: тогда, назад
изменить: пересмотр, изменение, заменять, сращивание, реформа
схема: диаграмма, карта
дедуктивный-настроение: индуктивный-настроение
подавлять: угнетать
мобильный: телефон, клетка
возвысить: продвижение, лифт
парадокс: противоречие
преувеличивать: поваренная-соль, максимизировать
блондинка: желтый
кий: отметка, пароль, придерживаться
бегун: зал
вести-переговоры: говорить, обсуждать
режим: правило
толерантность: толерантный, медведь
вариант: заместитель, огурец
поход: движение
эпидемия: трагедия, перевод
техника: технический, подход, инжиниринг, оборудование
Терминал: в-конце-концов
выпускник: проходить
вывод: расходы, вывод, публикация, Вылет-из, производительность, Выход
разместить: место
по-умолчанию: упущение, стандарт
контекст: экологическая, место-действия, коннотация
коалиция: альянс
недостаток: вина, неправильно, инвалидность, недостаток
уступать: признавать
трансляции: публикация, Отправить
набирать-номер: выберите, кольцо, собирать
распространенность: популярный
все-больше-и больше: все
трансформировать: изменение, конвертировать
воздушный-змей: Дракон
двусмысленный: неопределенный, противоречие
кафе: кофе, бар
награда: награда, премия, признавать
метка: студия, отметка
утверждении: утверждение, признавать
родство: аналогия, социалист
реалистичный: действительно
рептилия: змея
на-открытом-воздухе: вне, открытый
политически: политическое
остаток: остатки, отходы
лента: кассета, группа, кино
мягкий: мягкий, милая
оральный: словесный, губа
спекулировать: Угадай
высылать: выталкивать, разряд
порок: место, инвалидность
пропускать: танец, проводить
кружка: кружка, гримаса
клин: шип, доля, угол
освобождение: скидка, исключение, избыточность
портативный: немного
оберточная-бумага: упаковка, заворачивать
блеск: талант, красота, яркий-свет
плавник: весло, балет
бормотание: шепот
ягода: бухта
иммиграция: миграция
мотыга: плуг
хирургия: врач-хирург
накапливать: накопление, депозит, собирать
корма: фекалии, труба
брюшная-полость: желудок
вывод: коннотация, включение, вывод
стимул: стимул
гаечный-ключ: отвертка, ключ
сельская-местность: сельский, пригород, поле, деревня
деградировать: уничтожить, уменьшить
местный: природа, оригинальный, резидент
стек: свалка, хребет, дымовая-труба
диск: диск
тенденция: поведение, направление, изогнутый, расположение, дрейф
корпоративная: Компания, общий
оправдать: избавиться
неустойчивый: неустойчивый, непостоянство
совместимый: последовательный, параллельно, конгруэнтный
Телефон: телефон
вакуум: пустой
захват: попытка, взять, воспользоваться
судорога: землетрясение, взрыв
скучный: скучающий, отверстие, раздражающий
портфолио: задавать, бумажник
щель: трещина
осложнение: проблематичный, Потери
вмешиваться: вмешиваться
полярный: полярность, крайняя
делегат: представитель, вестник
воля: сила-воли, желание
прогнозировать: предсказуемый, Угадай
оптимизм: надеяться, считают,
кожура: кожа, стручок, кора
разделывать: укусить
зависать: поплавок, витать, колебаться
сектор: поле, промышленность, региональный, часть
фамилия: имя, Oни
институт: организованный, Компания, организация
острая-необходимость: тревожный
приятный: своего-рода
удерживать: не-допустить
отрицание: Отрицать
победитель: успех
композитный: смешанный
влияние: эффект, конфликт
волокно: волокно
глоток: глотать
визуальный: оптический, место-действия
коготь: лапа
истец: актер, перевозчик, причина
сожалеть: жалость
ввести-в-заблуждение: искажать, поражать, дурак
запрещать: ингибирование, не-допустить, Отрицать
исполнитель: актер, художник, игрок
турнир: раса
требование: запрос, состояние
минус: наименее
неопрятный: безрассудный
инфекционный: инфекционное-заболевание
подчеркивать: настаивать, акцент
брюки: брюки
спутать: головоломка, поражать, смущать
посвятить: доброволец, намереваться
хирургический: врач-хирург
правдивость: факт, точность
сотый: сто
наклонный: крутой, падение, изогнутый
рядом,-поблизости: почти, скоро, окружающих
как-обычно: общий, довольно-часто, в-общем, тенденцию
запутанной: противоречие, головоломка, путаница
пропорциональный: сравнимый, баланс
не-соглашаться: разногласие
раздражать: гнев, вмешиваться, дразнить, раздраженный
выдающийся: лучше, поразительный
инициирование: начало
атмосферные-осадки: осадок
устрашать: аварийная-сигнализация
хобби: развлекательная-программа
грамматический: грамматика
численный: номер, цифровой
критерий: стандарт
прогноз: предсказуемый, Угадай
не-одобрять: Отрицать
экзотический: иностранный, странный
колба: лампа
усилить: расширять, увеличение, максимизировать, заживать
слияние: плавиться, вызов
голосование: выборы
талантливый: талант, опытный
оттепель: плавиться
выпрямлять: протяжение, фиксировать
декорировать: орнамент
президентский: президентство
удар: преждевременный, умножить, удар, вмятина, опухоль
поздравление: хвалить
сканирование: подметать
давать-право: включить, правильно
делать-ставки: состояние
технически: технический, инжиниринг
эмпирический: опыт
доминировать: мастер
рекламировать: объявление, пропаганда
диффузия: распространять, публикация
царапина: скрип
Комплект: оборудование, коробка, задавать
практикующий-врач: врач, тренер
впитывать: сосать, падение
сохранение: защищать, спасти, забота
слизь: грязь, тротуар, капать
испытывающий: жесткий
загрязнение: загрязнять, коррупция
химикалии: химическая
партия: стадо, импульс, объем
Мама: Мама
пугающий: ужасный, угрожающий
специалист: эксперт
тосковать: желание
ванная: ванна
авантюра: игорный, играть, приключение
интеграл: необходимо, интегрированный
Устранить: избавиться, Удалить
горох: фасоль
приложение: прикрепление, дополнительный, пособие
циркулировать: распространять
включительно: единый
продавец: дилер
беспокоить: нервный, вмешиваться, навязчивая-идея
взорваться: взрыв
подглядывать: любопытство, рычаг
проливать: утечка, залить
бесплатно: свободно
ингредиент: элемент
дефицит: открытый
расстройство: нервный, раздражающий, неприятный, грустный, расстройство
Корпус: дом
фотографический: фаза, картина, фотограф
вредитель: насекомое
пилюля: таблетка
В-данный-момент: настоящее-время
СМИ: Нажмите
крушение: разорение
свод: тело, задавать
меню: список
перелом: трещина
Форум: Платформа, отверстие, суд
импульс: скорость, импульс
уклон: лютня, изогнутый
кафельная-плитка: кирпич
книжный-шкаф: библиотека, книжный-магазин
вычисление: расчет
режиссер: производитель
денежный: Деньги
изображать: описывать, отражать, вводить
инфляция: зыбь
маргинальный: край
фантазия: воображение
подрывать: уничтожить
последовательный: строго, соединение, последовательный
в-корне: сроки
намеренный: умышленно
оставшийся-в-живых: семья
флюс: река, поток
конкурентоспособный: соперник
ювелирные-изделия: орнамент
алкогольный: пьяный, вино
дискриминировать: выделить
воинствующий: радикал, террорист, военный
разоружаться: оружие
ключевой: необходимо, решающий
назначение: Работа, упражнение, долг, выделение
квота: привилегия, выделение, квантовая
земляные-работы: яма, копать
кальций: удар
почтить-память: убеждать
исторически: исторический
Здравствуй: Здравствуйте, Добро-пожаловат, спасение
устранение: избавиться, упущение, Удалить
тугой: аккуратный
расслабляющий: комфорт, удобный, релаксация
эффективность: эффективный, эффект, умение
уязвимый: восприимчивый
спортсмен: Спортивное
полоса: в-полоску, линия, группа, кино
фасад: маска, видение
клип: основной, щипцы
опытный-образец: пример, оригинальный
смещение: справиться, компенсировать, отклонение
ноль: нуль, пустой
ограничивать: не-допустить, сокращать, уменьшить
поставить-галочку: отметка, вошь
НДС: бак
изнасилование: превышать
ноль: нуль, пустой
условный: прикрепленный
культурный: культура
технологии: технический, оборудование
маркетинг: сделка
галстук: галстук
экономически: экономический
администратор: менеджер, доверенное-лицо
изобразить: описывать, вводить
внук: внучка, племянник
двойной: два, пара, близнец
синтез: оригинальный, устанавливать, задавать
специальность: профессиональное, характеристика
причудливый: странный
заявитель: кандидат
лингвистический: язык, лингвистика
гриб: пробка, губка
тыква: сквош, тыква
подъем: лифт, подъем, прогресс
феноменальный: необычно, соло, супер
динамическая: мощность
пересматривать: пересмотр, фиксировать, проверить
сломать: дизъюнкция, падать, анализ
утомительный: устала
кампус: колледж, школа
диссертация: Тезис
статистическая: статистика, статистически
сформулировать: подготовить, формулировка
сэндвич: хлеб
ноль: нуль, пустой
стимуляция: ускорение, волнение, раздраженный
цензура: цензор, регулирование
оборудовать: дополнение
назначать: выдвижение, предложить
Отмена: Удалить, лом, разочарование
метр: измерять
угнетать: угнетать
Господин: сэр, мастер
реконструировать: ремонт, восстановление
судья: правило, судья
атомный: атом, ядерного
спорный: противоречие
сложный: сложный, современное
дергаться: пожимание-плечами
несоответствующий: значения, недостаточный
осадок: осадок
курносый: презрение, вина
вариант: различный
критиковать: критика
скука: скучающий, раздражение, нищета
сотрудничать: сотрудничество, соединение
анализировать: анализ, аналитик
ливень: дождь
росток: бутон
самолет: птица
острый: резкое
гибкость: эластичность
ракета: ракета
наречие: конверт
нестабильность: неустойчивый
лишение: лишать, недостаток
пресмыкаться: приземистый
генерировать: производить, Создайте
приближение: приблизительный, подход, сходимость
боевой-дух: проснулся, моральный, умственно
оптимистичный: надеяться, считают,
классифицировать: классификация, распространять
учебный-план: курс, повестка-дня
на-открытом-воздухе: вне
реагировать: реакция, глагол
скрипт: сценарий, линия, священное-писание
шантажировать: вымогать
бонус: награда, премия
актив: имущество, присутствие, преимущество, столица
изменчивость: разница
неоднозначность: неопределенный, противоречие, неопределенность
ноль: нуль, пустой
среднего-рода: нейтральный
помеха: смущать, препятствие, инвалидность, недостаток
фотография: картина
нехватка: порез, отсутствие
смещение: заменять
грибок: бактерии, губка, пробка
формулировка: формулировка, текст
дипломат: дипломатический, вестник
инициировать: вводить
слить: упряжь
раздробить: ломать
вдыхать: вдохновлять
шкив: роль
тощий: тонкий
избиратель: избирательный-округ
федерация: федеральный
мобильность: движение
разгружать: разряд
естественная-среда: кров
вызывать: размешать, индуцировать
разбавлять: тонкий
Прощай: пока-пока, прощальный-привет
сносить: уничтожить
синтаксис: пенсия
подкова: лошадь
искажение: отклонение, искажать
шлем: бить
Соответствующий: последовательный, надлежащий, связано
функциональная: практическое, Работа
вытеснять: заменять, выталкивать, сдвинуть-с-места
автономия: независимость
вонь: запах
дифференциация: выделить
доступность: получение
студент: студент
график: диаграмма, карта
очаровывать: пленять, дразнить
милый: красивая, милая
брюшной: желудок
грамотность: образование
синтетический: искусственный
тренер: тренер
сохранять: место-хранения, спасти, защищать, сохранить
мусор: лом, свалка, отходы
Фото: картина, выстрел
учебник: руководство, книга
консолидировать: усиливать
сдерживать: принудить, ограниченное, вымогать
экономист: экономический
легкая-атлетика: Спортивное, упражнение
извиваться: гримаса
йод: минеральная
заражать: инфекционное-заболевание, загрязнять
дизайнер: определенный
выделять: секреция, скрывать, выталкивать, секрет, выделить
шпинат: способствовать, салат
интенсивное: крайняя, сильный
убедительный: демонстративный
дебют: первый, начало
тысячный: тысяча
в-помещении: внутренний, глубоко, в-помещении, покрытый
аннулировать: лишать
амплитуда: величина
измерение: направление, после, мерное, следующий
библия: священное-писание
плакат: баннер, Web
ускорять: осадок
активизировать: усиливать, усилитель
аборт: выкидыш
типично: в-общем, общий, довольно-часто, тенденцию
обязательство: обещание
очередь: хвост, заказ
скобка: основной, локоть, крюк, сторонник, поддержка
бывший: старый
обратный: задний-ход, инверсия
испаряться: плавиться, зевать
авиация: атмосфера, воздух, летать
корреляция: сравнение
этнической: националист, национальный
слэш: порез, уменьшить
сложный: хитрость, разрабатывать, сложный, жесткий
характеристика: описывать, характеристика
прикреплять: сращивание, параллельно
молекула: молекулярная
конфигурация: расположение, структурный, сборка
взаимодействие: говорить, перекрытие
количественный: объем
самоанализ: ретроспективный
ориентировать: восток
сперма: семена
одобрять: поддержка, признавать, утверждение
не-: ни, не
достоверность: верность, надежность, кредит
подрывная-деятельность: разорение
прогиб: дрейф, отклонение
впрыск: игла
сандал: тапочка, обувь
кусок: чип, параграф, протяжение
телевидение: ТВ
зерновой: зерна, фасоль
контейнер: инструмент, бак, горшок
мигрировать: миграция, бродить
терминология: сроки
электорат: избирательный-округ
стирать: Удалить, уничтожить
посредничать: примириться
капитализм: капиталист
лыжа: кататься-на-коньках
зазор: игорный, разрешение
селективный: выберите
статический: стандарт
сходиться: встретить, сходимость, фокус
алфавитный: алфавит
Глобальный: Международный, Мир
несчастный-случай: жертва
ОК: одна-и-та же, фиксировать, очень
прагматический: практическое
арбитр: правило, судья
дифференциальный: разница
выдыхать: испускают, дыхание
водораздел: воды
приспособление: приспособление, оборудование
устанавливать: устанавливать, установленный, закрыть
резонанс: вибрация
по-традиции: традиция
класс: орбита
протокол: соглашение
исчисление: расчет, законопроект
грамм: тепло, трава
бензин: бензин
галактика: созвездие
подросток: молодой
месить: беда
радий: радио
разреженный: тонкий
самолет: птица
педаль: протектор
около: почти, около
фонарик: объектив
чемодан: коробка, Багаж
замена: обмен
необязательный: обычай
матрица: желудок
изображение: плечо, картина
заранее: восток, до, луг
объявление: объявление
оглушать: поражать
падение: инцидент, падение
опрокидывать: залить, сердце
сенсорный: чувство, страстный
консенсус: соглашение
контролировать: управлять, монитор, полиция
пересадка: заместитель
алюминий: алюминий
флуктуация: колебание
имитировать: подражать, симулировать
усложнять: сложный
наставник: консультант, тренер
слот: открытие
ладья: ворона, башня, замок, пистолет
манипулировать: манипуляция, размешать
вегетарианский: овощной
норма: Спецификация, стандарт, правило
метро: тоннель
респираторный: дыхание
моделирование: подражать
шприц: игла
мутация: изменение, конвертировать
нижнее-белье: Трусы, белье
влагалище: бухта
дифференцировать: выделить, разница
сезонный: время-года
сельский-житель: сельский
кунжут: моль
кома: запятая
инвертировать: инверсия, задний-ход
руководитель: наблюдатель, руководство
вытеснять: выталкивать
аудит: проверить, пересмотр
поход: витать, бродить, лифт
местоположение: место
спад: экономика
мародерство: добыча
лозунг: пароль
плод: эмбрион
интеграция: сотрудничество, включение
пурпурный: пурпурный, голубой
минимизировать: наименее, уменьшить
Жилой: кров
цифра: цифровой, номер
соленый: поваренная-соль
ноль: нуль, пустой
теоретик: теория
аквариум: рыба
тяга: вето
парашют: зонтик
важно: необходимо
в-общем-и целом: в-общем, все, общий
ухудшаться: гниль
ноль: нуль, пустой
сексуальность: сексуальное
шпуля: объем, заворачивать
преимущественно: во-многом
вязкий: липкий
кишечник: потрошить
археология: археологический
арахис: фасоль
прикладывание: пособие
плита: плита, кухня
брюк: брюки
критерии: стандарт, индикатор
обзор: контур
качественный: характеристика
очки: стакан
генетический: морфологический, генетика, ген
участник: присоединиться, роль, причастие
репертуар: талант, программного-обеспечения
вращать: цикл, вращение
макет: организация, план, расположение
ваучер: штекер, квитанция
теорема: предложение, теория, аксиома
познавательный: диагноз
прояснить: разрабатывать, объяснять
токсический: яд
подчеркнул: акцент
стилус: игла
спад: кризис
обслуживать: обслуживать, предоставлена, гарантировать
анти-: оппозиция
стойкий: хронический, оппозиция, иммунный
закуска: тост
кино: кино, кинотеатр
кран: труба
маркер: отметка
периферийный: окружающих, региональный
напористый: определенный, предикативный, агрессивный, решающий, упертый
узел: вязать
тучный: толстый
вычитать: выталкивать, уменьшить, привлечь, лишать
непереходный: необходимо
спираль: улитка, кудрявый
печенье: бисквит, кекс
раздувать: зыбь
электроника: электронный
перезапись: транскрибировать
лаборатория: лаборатория
профессиональный: профессия, коммерческая, профессиональное, Работа
градиент: мили, падение
красочный: цвет
охват: покрытый, вакцина, забота, одеяло, крыша, учитывая, объем
вовлечение: присоединиться, включение
ориентация: направление
фабриковать: Создайте, производить
тепловой: масло
стереотип: исключение
тек: технический
остаточная: остатки, избыточность
грузовик: грузовая-машина
стадион: поле
координация: координировать
бактериальный: бактерии
интерфейс: подход
кремний: Пи
выучить-наизусть: Память, спасти, запомнить
диагностический: диагноз
учебный-план: Абстрактные
проводимость: линия, похищать
миллионный: миллиона
розничный-торговец: дилер
барий: бар
Основной-поток: ключ, вторичный
смысл: имею-в-виду, логически-вытекающий
аудио: голос
концептуальный: концепция
сетка: Web
пространственная: атмосфера, мерное
экзамен: викторина
в-середине: вторичный, Талия
составить: компенсировать
дискретный: раздельный, соло
препятствовать: ингибирование, не-допустить
много: различный, Больше, очень
влажный: влажный, тепло
морфология: морфологический
диагностировать: диагноз
грипп: грипп
графика: диаграмма
коронарный: болезнь
ягодица: ягодицы, ветчина
архив: файл
конфронтация: борьба, конфликт, сравнение
грузовое-судно: грузовая-машина
оптимальный: оптимальный, Великий
в-основном: сроки
мотивация: стимул
яичко: яйцо
сера: сера
оперативный: манипуляция, действие
траектория: орбита, путь
актуальность: связано, важность, связи
велосипед: езда-на-велосипеде, цикл, колесо
директива: демонстративный
авиакомпания: птица, воздух
литр: литр
неудача: разочарование, шок, регрессия, потерпеть-неудачу, препятствие
унифицировать: упряжь, примириться
позиция: стоять, должность, параграф
минимальная: наименее
циклический: езда-на-велосипеде, периодический
подложка: молекулярная
подводный: подводная-лодка
экспертиза: опыт, умение
ноль: нуль, пустой
электрон: электронный
интерактивный: перекрытие
первоначально: оригинальный
саботаж: уничтожить
взаимодействовать: говорить, общаться
математический: математика
эмбриональный: эмбрион
модернизировать: современное, Обновить
экстремист: радикал, крайняя
моча: моча
прильнуть: охватывать
Хорошо: фиксировать, очень
красть: украсть
намеренный: умышленно
полу: наполовину, продавать, молоть, ширина
нервный: нервный
анти: оппозиция
чечевица: объектив
проксимальный: почти
питательный: минеральная, еда
не-понятно: неопределенный, очевидный
травма: шок, травма, язва
перекачка: обмен
вектор: перевозчик
тактика: подход
оценивать: оценка
ноль: нуль, пустой
клон: копия
жизнеспособный: преимущество, эффективный
копирование: копия
реактивный: реакция
Расписание: календарь, время, расположение
синтаксический: судьба
стабилизировать: тихо
диссидент: соперник
Обратная-связь: реакция
анкета: викторина
окислять: вызов
миллиметр: миллиметр
психиатрический: интеллектуальной
синдром: болезнь
парадигма: пример
активировать: включить, делать, действие
случайно: случайный, совпадение, к-дело
остракизму: раздельный, бойкотировать
подмножество: часть
методология: путь, подход, один-раз
произведение-искусства: Работа
последовательный: последовательный, порядковый
изымать: держать, воспользоваться, закрыть
километр: километр
многонациональный: Международный
планировщик: арендатор, в-полоску, план
экспоненциальный: экспонента
класть-не-на место: потерять
Исследователь: ученый
супермаркет: торговый-центр
выделять: выделение, выделить, распространять, рассечение
ноль: нуль, пустой
футбольный: удар
право: правильно, надлежащий
остатки: остатки, отходы
устойчивый: стандарт
космический-корабль: челнок
эмпирический: опыт
семантический: коннотация, предмет
инсайдер: внутренний, член
тонну: тон
модуль: по-модулю, Ед.-изм, объем
фермент: дрожжи
Стиль-жизни: продолжительность-жизни
макаронные-изделия: масса
спальня: кров
подросток: молодой
основной-момент: отметка
отрицать: Отрицать, уничтожить
дружок: Подруга, друг
поведенческий: поведение
Спасибо: спасибо
вдохновитель: головной-мозг, душа
экологическая: экология, экологическая
иммигрант: беженец
вставлять: включение, падение, похоронить
ксерокопия: копия, картина
активист: действие
Футболка: Рубашка
Терапевт: врач, терапия
магнат: король
пробуждение: волнение
синхронизировать: синхронизировать
кислый: кислота
лексический: Словарь, слово
взломать: ломать
классификатор: классификация
авангард: пионер
председатель: глава
Рекламный-проспект: листовка
харизматический: очарование
скандий: теллур
директива: руководство
строить-гипотезу: предположим,, предположительно
холодильник: холодильник
перезагружать: перезапуск
мозговой-штурм: трясти, идея
копировать: копия, подражать, повторение
тоска: страх
о-прекращении-огня: перемирие
оплошность: упущение, неправильно
индустриализировать: индустриализация, промышленность
родной-брат: брат
докладчик: оратор, представитель
налет: похищать, плуг
не-металл: металлоид
жидкий: грипп, влажный, бег
грань: направление, профилированный, боковая-сторона
из-дело: 
доброкачественность: добродетель, преимущество
свободно: свободный, свободно
позже: будущее, тогда, после
трудность: беда
отряд: группа
широко: ширина, расширять, в-общем
коррелировать: связано, крюк
в-соответствии-с: назад
ноль: нуль, пустой
бюллетень: листовка, Информация
неодобрительно: утверждение, неприемлемо
ванна: ванна
развлекательный: развлекательная-программа, забавлять, веселый
Помимо: Кроме
появление: появляться, Выход, подъем
ноль: нуль, пустой
щека: играть
должен: должен, долг
процент: процент
судебные-разбирательства: костюм
ноль: нуль, пустой
с-помощью: проходить, выше
сопрано: детский
забавный: веселый
вечера.: после-полудня, ночь
Яичный-белок: белок
кровопролитие: кровавый
тулий-атом: торий-атом
изгиб: изогнутый, сгибать
линкер: соединение
увещевательный: наставительный
тербий-атом: торий-атом
арендованный: аренда
составить: компенсировать
острить: шутка
конфиг: структурный
мимо: последний
разделить: выделить, распространять
профессор: мастер
родий-атом: торий-атом
государство-маркер: 
пространство-маркер: 
бюрократический: бюрократия
ремень: группа, упряжь
ноль: нуль, пустой
продавец: дилер
ноль: нуль, пустой
лантан: теллур
предмет-дело: тема-дело
конструктивный: Создайте, формулировка, производитель
ноль: нуль, пустой
женский: женский-пол
аудитор: инспектор, бухгалтер
микрофон: микро
вне: вне, Кроме
запись: включение, постановка-на-учет
указательный-палец: индикатор
спонсорство: стипендия, забота
невежественный: невежественный
ноль: нуль, пустой
стандартизировать: Спецификация, стандарт
час: место, час
хозяин: владелец
следователь: детерминанта, ученый, детектив
клеш: сожжен
ноль: нуль, пустой
санкционировать: включить
защита: забота
коридор: зал
Переговоры: говорить
обновилась: свежий, Обновить
извилистый: изогнутый
далее: первый, следующий, вперед
дыхание: иммунный, дыхание
ноль: нуль, пустой
прогрессия: прогресс
непереходный: необходимо
эйфория: энтузиазм
широкий: расширять, ширина, широко-распространен
непереходный: необходимо
контрастивный: контрастные, справиться
пораженный: удивленный
направления: вводить
потомок: знакомые, внучка, поколение
мороженное: крем
радиус: луч
альтернативно: в-противном-случае
окрестности: окружающих, жить, экологическая
использовал-к: обычай
смущение: позор, расстройство
по-существу: во-многом
недавно: свежий, в-последнее-время, корень
танцы: играть, танец
ноль: нуль, пустой
количество-маркер: 
Социальное-маркер: 
критика: критика
рубидий-атом: торий-атом
борьба: борьба, конфликт, война
жаловаться: около
ноль: нуль, пустой
ванадий-атом: торий-атом
средний-Пол: мужской-Пол
фтор-атом: торий-атом
поездка: посещение, сафари, экспедиция
мужской: мужской
ноль: нуль, пустой
развивающий: эволюционный, прогресс
прикладная: практическое
закрывать: закрыть
похвастать: бахвальство
назад: назад
настоящее-время: настоящее-время
ноль: нуль, пустой
случайный: случайный
кооператив: коллега
в-отставке: выходить-на-пенсию
ноль: нуль, пустой
довольный: счастливый, веселый, забавлять
аппроксимативная: приблизительный
диадическим: двоичный
дополнительный: дополнение, дополнительный
коммуникативный: переписка, разговорчивый
ноль: нуль, пустой
в-дело: к-дело
полоний-атом: торий-атом
сломать: дизъюнкция, анализ
загар: коричневый
проблема: проблематичный, беда
переведите: перевод, кувырок
ноль: нуль, пустой
таллий-атом: торий-атом
клика: конгломерат, щелчок
легко: без-труда, просто
Модератор: посредник, менеджер
социально: Социальное
согласование: костюм, совпадать
авария: инцидент
то,-что: который
интересно: привлечь
вверх-ногами: задний-ход
гербицид: яд
ноль: нуль, пустой
участник: причастие
например: пример
опухоль: опухоль
распад: гниль
ноль: нуль, пустой
Веб-сайт: Веб-сайт
чрезвычайно: массивный, очень, супер
будет: 
относительный-дело: относительный-дело
задача-дело: место-назначения-дело
вознаграждать: компенсировать, платить
дурно-обращаться: неправильно
оплетка: хребет, вязать
вместо: вместо
археология: археологический
соединитель: связка, штекер, прикрепление, разъем
ноль: нуль, пустой
обобщение: обобщать
стронций-атом: торий-атом
рутений-атом: торий-атом
без-учета: Кроме
ноль: нуль, пустой
отступление: отвлекаться, регрессия, выходить-на-пенсию
пенсионер: выходить-на-пенсию
друг-друга: друг-друга, Другие
широкая: широко-распространен
вычисления: расчет, компьютер, калькулятор
бизнес-человек: деловой-человек
хотдог: колбаса
преобладание: эффект, мощность, преимущество
закрывать-кавычки: цитата
притяжательный-падеж-дело: родительный-дело, притяжательный-падеж-дело
генетически: ген, генетика
уступительный: сдвинуть-с-места, мягкий
непрямой-объект: непосредственный-объект
запретительный-настроение: запретительный-настроение
разрабатывать: упражнение, Работа, разрабатывать
разделенный: ограниченное, раздельный
вопреки: задний-ход, оппозиция, напротив, инверсия, контрастные
подъем: подъем
невероятно: необычно, супер
ноль: нуль, пустой
закрытие: закрыть, ткацкий-станок
дешево: дешево
холст: ткань, Web
образованный: образование, вежливый
живая-природа: природа, дикий
сопротивление: оппозиция, напротив, в-направлении
ноль: нуль, пустой
выкапывать: копать
зараженный: инфекционное-заболевание
ноль: нуль, пустой
вооруженный: оружие
то-есть: а-именно
никто: ничего
ругань: клянусь, бранное-слово
коническая: тонкий, конус
конферансье: развлекательная-программа, художник
и-т.п.: 
Помимо: Кроме
контур: контур, экологическая, форма
Сотовый-телефон: мобильный-телефон, клетка
Мисс: порез, потерять, проводить
тревожный: ужасный, тревожный
будущее: будущее
сослагательное-наклонение-настроение: условный-настроение, оптатив-настроение
должен: должен
мотоцикл: мотоцикл, двигатель
кредитная-карта: кредит
ноль: нуль, пустой
общественного: общественного
Сотовый-телефон: мобильный-телефон, клетка
ноль: нуль, пустой
кишечник: потрошить
развертывать: распространять, разброс, потреблять
депортировать: выталкивать
доля: доля, часть, квантовая
компетентность: умение, юрисдикция
землевладелец: ангел
предложный-падеж-дело: 
распределение: выделение, дивиденд, пособие
тревожным: тревожный
отлично: одна-и-та же, очень
принуждение: принудить
за-фраза: за-предложение
рецептор: ловец
вводить: вводить
оглушающий: поражать, поразительный
кашляющий: кашель
рядом-с: следующий
