инфинитив: hnit
именительный-дело: hnak
винительный-дело: hkak
тема-дело: htak
родитель: hmat
папа: hpap
Мама: hmam
Здравствуйте: hnat
предок: htat
бабушка-или-дедушка: hyat
голодный: hcac
родительный-дело: hnik
имя-прилагательное: hcit
а-также: hwan
меня: hmic
вы: hnan
нас: hnam
Это: hyic
место-назначения-дело: htas
дательный-дело: htik
интерьер-контекст: htis
человек-контекст: hpak
зависимый-пункт: htan
совершенный-аспект: htap
мимо-напряженный: hkat
мужской-Пол: hsan
comitative-дело: hmik
настоящее-время-напряженный: hyan
благословляющий-дело: hpik
щий-дело: swik
не: hnic
его: hsis
поверхность-контекст: hsak
adpositional-дело: hpan
место-нахождения-дело: hwak
пространство-контекст: hnos
путь-дело: hrak
инструментальный-дело: hsik
который: hkan
вопросительный-настроение: hnim
а-также-или: htam
Эксклюзивный-или: hkit
источник-дело: hsok
аблятив-дело: hlak
демонстративный: hdit
но: hlan
все: hsut
женский-Пол: hnin
Oни: hwin
множественное-число-номер: hlun
один: hyik
будущее-напряженный: hwet
Социальное-контекст: hson
когда: hkap
несовершенный-аспект: hmap
там: hkac
условный-настроение: hcan
Больше: hdoc
вне: htac
относительный-дело: hrik
выражающий-заключение-дело: hlik
делать: hkas
директива-настроение: hden
деонтические-настроение: hdim
вопрос-слово: hwac
связка: hkok
человек: hpon
мужской: hman
мог: kwat
Другие: hcon
номер: hnoc
очень: tcac
время: htim
время-контекст: htos
временной-дело: hmak
около: hkam
эпистемическое-настроение: hsim
только: htun
немного: hcak
тогда: pcan
наставительный-настроение: hton
ретроспективный-аспект: hrip
Великий: hcat
волевых-настроение: hlim
до: hsec
должен: pcic
два: htut
видеть: tcan
знать: hsat
вниз: hcin
после: hcas
первый: hpas
своя: hpun
отчуждаемый-владение: hlic
никогда: hnac
неотъемлемое-владение: hkic
старый: hwat
совещательный-настроение: hcim
день: htin
где: hnap
приехать: hlat
путь: hyas
Работа: hkaf
гласная-буква: hwaf
идти: hkun
perlative-дело: pwik
прогрессивный-аспект: hpip
длинный: hlac
сказать: hsac
как: hkin
даже: hpit
назад: hwap
Вот: hcic
думать: hcik
одна-и-та же: hsam
последний: kcac
далеко: twan
под-контекст: hnas
взять: htit
найденный: hfan
рука: cyat
молодой: hyac
хоть: hyap
дайте: hkik
Бог: hmac
delative-дело: lwak
ничего: hmin
правильно: hyit
один-раз: hyam
semelfactive-аспект: fwip
часть: hpat
увидел: htic
дом: hfas
Мир: tcat
глава: hcaf
три: tyin
нео: hnon
фокус: hcok
люблю: hpac
всегда: hsit
ночь: hwit
каждый: hmit
король: hyak
между: hsin
сердце: cyin
paucal-номер: plom
потому-как: hyok
причинный-дело: ksak
вещь: hkis
задавать: swat
имя: hnem
надлежащий-имя-существительное: hran
наставительный: hrat
страна: hlit
спросил: hput
видимый-доказательный: crit
лучше: pcac
боковая-сторона: psac
курс: hkus
женский-пол: hfin
достаточно: kyat
скоро: hpuc
полный: hcun
комната: hfac
почти: hlap
не-могу: nyat
воды: hwik
дезидеративный-настроение: hdin
легкий: lyak
ни: hnun
слово: slat
дверь: tyan
использование: hpus
утро: hsap
terminative-дело: twik
мощность: hkuk
самих-себя: hmis
настоящее-время: hyin
голос: hwas
белый: hpis
Деньги: tlan
следующий: kyak
бедные: hyis
смерть: hmut
форма: hfam
инессив-дело: nwik
своего-рода: tyac
довольно-часто: tsan
год: nwan
друг: myat
заказ: hyut
императив-настроение: hpim
круглый: hcut
считают,: hban
общественного: hpin
государство-контекст: hsas
сын: psat
сто: hmas
дети: hcis
таким-образом: tyak
надеяться: hcap
выше: hyip
Уважаемые: pyin
читать: pyac
город: hsic
уже: hpic
факт: hfat
каузальный-доказательный: hfit
слышать: hsun
наименее: hmim
возможно: pyat
открытый: kcat
тело: tcic
воздух: cwac
природа: nyit
Помогите: mlat
письмо: lyat
4: ksat
оптатив-настроение: hpam
Огонь: hfak
следовательно: hyif
час: hcam
свободно: tyit
война: syat
будь-то: hsaf
причина: kyan
единый: hnut
вызов: hkuc
Зачем: hwam
потерял: hkut
тысяча: tsas
семья: hfic
душа: twam
вопрос: swac
забота: kcan
REALiS-настроение: hlin
имею-в-виду: mwit
потенциал-настроение: hten
в-направлении: cyan
allative-дело: lwik
антропный-Пол: hrin
короткая: kyut
в-состоянии: hyuk
жить: hkip
предмет: hsek
одна-и-та же предмет маркер: hcek
другой-предмет: hfek
ответ: tsat
море: mwat
страх: hcoc
Понимаю: pcat
жесткий: kyin
сроки: tyut
сомнение: hdac
dubitative-настроение: twin
просить: psan
оружие: tcas
черный: clis
приносить: tyat
красивая: ksis
темно: tcak
держать: psak
10: htaf
показать: pyan
история: hkif
общий: kwan
книга: hkup
электронный: lyin
говорить: plak
отметка: myac
интерес: nyis
записывать: kcit
постель: pwat
необходимо: syis
идея: hwis
Изобразительное-искусство: klat
Vialis-дело: hlas
брат: pyak
иногда: ksas
линия: lyan
Таблица: tlas
река: nwit
глаз: kyac
Информация: fyin
вдруг,-внезапно: tfan
странный: hgan
глубоко: ksan
изменение: hrit
чувство: nwac
встретить: mlit
цель: htuc
счастливый: hcuc
кажется: syit
кровь: cyac
Роза: kwas
на-юг: swan
холодно: tlat
вперед: myik
должность: psis
поздно: tyam
стоять: syan
предположим,: nlas
дочь: pyit
мой: myan
порез: hkim
копия: hfap
муж: hgat
шесть: hlis
запомнить: twat
эффект: hyaf
падать: htuk
Кроме: hsip
волосы: hpaf
проходить: pyas
Авторские-права: pcit
армия: cyit
бег: kcak
лошадь: kcas
будущее: hwic
запад: pcak
платить: plit
красный: hyun
золото: tcun
желание: hdan
играть: plin
мастер: mwas
офис: hfus
правительство: syak
церковь: kyas
длина: hlen
Компания: ksin
бумага: kyis
вероятность: hbin
особенно: cyas
медведь: pcas
окно: cyak
соглашение: hgac
красота: syac
долг: tfac
Отправить: fyan
расстояние: htif
тишина: slan
фут: fyat
дикий: kyik
умереть: myam
спасти: pfan
зеленый: kcin
беда: mlan
улыбка: myak
неправильно: clat
различный: pcin
спать: slit
квотатив-дело: kwik
начало: cwan
действие: kfan
посещение: fwat
следовать: nlan
пытаться: tcis
присутствие: psit
милая: tlit
богатые: tcin
враг: tcam
корабль: hcip
состояние: kyit
в-том-числе: hkum
включительно-человек: hlon
секрет: kwit
просительный-настроение: pwim
вежливый-регистр: hbit
зло: pwac
Март: myas
без-разницы: kwac
оставаться: hlam
вместо: plat
синий: plan
невозможно: psap
школа: hsuk
повод: ksac
в-браке: nwat
еда: hcuk
20: tsis
тихо: tcit
без-труда: hnis
предполагаемый-аспект: hrap
язык: lyac
выражение: syas
неделю: hsus
зал: hcum
Опасность: kcic
имущество: myit
Родился: nyan
суд: kcut
в-общем: tyap
гномический-аспект: hmip
стоимость: tyas
просто: syap
дерево: pyic
борьба: pyap
стена: twit
небо: cwak
начинательный-аспект: htip
повелительный-настроение: hjin
тон: twun
учитывая: klan
ожидаемый: pcik
месяц: hmaf
опыт: nyap
полностью: nyac
свежий: tsac
герцог: hnuk
покрытый: kwak
граница: hyim
восток: tyuk
камень: pwan
в-некотором-роде: kfat
направление: tlac
стул: kwis
поддержка: syut
Дата: tyic
деревня: klac
поле: clit
разрешение: nwin
разрешающий-настроение: hmom
успех: slak
надлежащий: hric
холм: clin
Музыка: ksik
дистальный-демонстративный: hdat
после-полудня: htup
плакать: hyuc
честь: hnaf
семь: swit
частный: pfat
Новости: nwas
место-действия: slac
сад: cyam
раса: htus
распределительный-дело: twak
учить: clan
политическое: syik
ложь: kcun
бросать: tsak
есть: kcam
пол: hlaf
больной: pwin
оригинальный: mlin
лето: kyam
религия: tlam
картина: ksit
побег: plap
автор: hlut
коричневый: pyun
определенный: htem
боль: hdon
весна: psin
век: syic
мягкий: mwan
угол: kyun
производить: psas
смех: cyaf
забывать: flat
Европа: hyup
8: lwat
платье: lwac
ужасный: cyap
дыхание: syaf
мудрый: hbas
притяжательный-падеж-маркер: srak
Память: myin
современное: fwan
место: tcap
подъем: hyus
ломать: pyik
50: hfis
остров: tlap
коснуться: hsuc
обещание: pcam
commissive-настроение: mwin
степень: tfat
план: plac
поведение: nyak
сюрприз: cran
минут: hmun
выстрел: hwut
хуже: pcap
стакан: klak
пример: tlin
безопасно: hsif
врач: tsit
заканчивающий-аспект: hmep
повторный: tyun
военный: slin
тепло: nyam
напиток: pfin
вопросов: pcaf
гнев: nran
непосредственно: tyik
шапка: hcup
собака: kwap
служащий: hnuc
гордость: hram
толпа: tcuc
поезд: nyin
моральный: myut
связано: kyim
войти: fyak
правило: nyas
меч: cwat
атака: kfak
здоровье: clac
параграф: pyaf
Социальное: hsum
возврат: tfit
Прости: hpec
мужество: krac
Грейс: hnen
официальный: hfaf
предоставлена: tsik
запрос: pwit
взгляд: klas
движение: hyon
ожидать: cwit
напротив: psam
двенадцать: tyaf
занято: nyut
вино: hwun
вкус: swut
железо: fyac
распространять: syin
сделка: myap
преимущество: twac
одежда: kfip
судья: fwak
разница: tfaf
тревожный: kcis
капитан: kwin
законченный: nlat
прекращение-аспект: hsep
любопытный: kyic
иностранный: kwic
усилитель: hnif
важность: myun
в-конце-концов: hfim
законопроект: fwin
доказывать: hpuk
не-допустить: flan
шея: cyun
правовой: hfik
сухой: swak
обслуживать: syam
потерять: pcut
доказательства: pyut
доказательный-дело: hdak
прогресс: pyis
здание: klit
поиск: syuc
грустный: hrac
грех: psip
30: tfis
честный: tsin
закрыть: kyap
банка: pcun
судьба: cyik
лес: hfun
измерять: mlac
в-противном-случае: htoc
поток: lyam
хлеб: hpup
дополнительный: tfak
выберите: twas
животное: nwam
содержащий-окаменелости-Пол: hzin
Событийный-настроение: hwim
одна-и-та же мероприятие маркер: hcom
мультипликативный-дело: tlak
толстый: hmus
существо: hyum
дождь: myic
поверхность: pfas
святой: swis
июль: clim
отчет: hfut
берег: pwas
файл: hfif
плечо: cwut
удивленный: kran
королевский: klik
песня: hkuf
комфорт: kfaf
кто-угодно: nyic
трава: kcap
привлечь: cwik
открытие: cyic
июнь: cwun
рыба: mlic
столица: klin
грудь: cyut
снег: hcif
образование: tlik
резкое: tcaf
жалость: hdam
расходы: fyas
ваш: hmuc
миллиона: mlun
устала: tcik
убийство: ksam
тень: cwap
вес: plas
масса: mlas
установленный: tlip
Храбрый: pyam
тонкий: plic
доволен: srat
проверить: kcik
добродетель: hdet
национальный: nyaf
божественный: swin
долина: clak
Угадай: kwam
спекулятивный-настроение: hken
желтый: clas
остатки: mwac
изогнутый: nlac
коробка: pwak
время-года: tsim
наука: slas
отверстие: kcuc
дядя: hmuk
список: lyit
август: ksut
популярный: hlup
неизвестный: fyit
знакомые: flak
знакомые-регистр: krit
читатель: tsut
подход: pcuc
дважды: tsap
интеллектуальной: tfik
действительно: tsam
священник: pcis
ранен: fran
печаль: hpom
дворец: kfas
бить: clap
а?: hnec
дурак: myuk
край: pfac
9: nwun
взрыв: psut
страдать: tfas
шум: hcus
литература: lyic
совет: swas
пустой: kcuk
ранг: psik
буря: tcut
карман: kyip
воображение: nlin
предложение: cwas
ноябрь: nwap
Декабрь: tsip
отсутствие: psic
спасибо: ryak
адрес: tyis
птица: pyuc
владелец: mlik
Пальто: kwut
подготовить: tyip
связи: lwan
дым: htum
январь: nwak
машина: clic
содержание: nyik
зубы: tlis
позор: hcet
бухта: kcaf
головной-мозг: pyuk
кольцо: klic
фраза-маркер: frak
квадрат: ksap
фрукты: fyut
чай: tsic
объяснять: slam
Добро-пожаловат: cwam
поэзия: pwis
купить: klam
верный: hdic
волнение: hcen
сорок: klis
апрель: pyip
любезно: kfit
октября: kfap
горький: kyuc
раб: tlaf
свободный: hluk
текст: tsus
кредит: cyip
15: pfit
жестокий: kcim
присоединиться: cluc
обработать: hpif
преступление: kyaf
пыли: tsuc
практическое: plik
цвет: nlak
уничтожить: nyuc
увеличение: lyas
нос: hnus
признавать: tyim
вчера: kfac
hesternal-напряженный: tlen
потерпеть-неудачу: slap
Продолжать: tcim
носить: pwam
слепой: nlit
дюжина: tsun
летать: fyap
хвалить: cwin
дьявол: cwaf
постепенно: twic
жертва: kyif
упражнение: cyis
совесть: tfin
теория: tlic
министр: myis
ненавидеть: hnet
озеро: cwic
центр: syun
слабый: pfic
рациональный-Пол: hron
осторожный: fwac
наслаждаться: nlam
поклонение: pwap
товар: twap
кожа: twaf
крыша: tlut
корона: gyan
замок: klap
трон: tcus
прикрепленный: nlaf
мили: mlim
крайняя: krim
тюрьма: fyis
кружка: kcip
член: mlam
гражданского: syim
везде: tsaf
очевидный: tfic
пара: pwaf
объем: clam
обычай: ksaf
лук: ksun
костюм: slut
мясо: mwak
молоко: hluc
растительный-Пол: hwen
видение: slic
редкий: nlap
двоюродная-сестра: ksic
мост: pwut
защищать: pfak
поваренная-соль: swam
невинный: hwus
Королева: kwim
подсчет: kcus
любопытство: hras
танец: tyus
Гостиница: clut
заполнить: flin
заключенный: psun
магазин: hjan
лестница: sric
очень-прошу: hmen
песок: sran
сильный: hgit
сентябрь: hsem
Вылет-из: prac
разорение: crin
умение: krin
крупный-рогатый-скот: hwec
оборудование: hwip
кухня: hkon
продавать: hbak
скорость: hsot
вывод: clon
компьютер: hkot
вечный: hsen
ограниченное: mrit
библиотека: hbek
база: hbac
путаница: hrun
славный: cris
также: hjic
испуганный: hbic
несчастный: prin
статья: hrek
готовить: kfin
группа: hbat
пустыня: hget
поцелуй: hbun
мяч: hbot
придерживаться: hpot
аргумент: hrut
наблюдать: nrak
благословение-настроение: hbim
поразительный: hrim
виновный: hdis
пистолет: hgin
полиция: plis
скрывать: hzan
экспедиция: srin
невежественный: nrin
щедрый: drac
облако: blan
отходы: htek
февраль: frif
болезнь: hren
проводить: bwan
источник: sron
инициатива-дело: hnok
тетя: hbam
задержка: dlic
задерживается-императив: hlip
сообщается-доказательный: prat
полночь: dyit
герой: nrac
философия: hfof
Палец: hjit
удобный: hzat
где-то: hmoc
Нажмите: bran
сотрудники: hraf
награда: rwan
вина: dlac
нищета: krat
лоб: htec
объявление: glan
ангел: htet
единственное-число-номер: hgam
рассвет: hbon
коммерческая: krak
прощать: pran
овца: hcec
терпение: hpen
ферма: crac
справочный: hrec
кукуруза: mran
ключ: kcif
большинство: hmot
слабое-место: hdut
атмосфера: traf
вздох: tcoc
человечество: mlis
оппозиция: pric
диск: hdik
Одинокий: hket
художник: nrat
рыцарь: cwis
очарование: tran
решение: drin
губернатор: gran
филиал: rwac
расположение: hsoc
энтузиазм: tsum
индуктивный-настроение: hdum
сообщество: hmum
масло: hyen
труба: hbap
Распечатать: trat
ой: dyoc
речь-контекст: hros
звательный-дело: hwok
кабина: ksen
аварийная-сигнализация: plam
нервный: hnes
постоянный: hset
нож: ksuk
шелк: slik
презрение: grin
ад: nrik
раздельный: plen
шутки-в-сторону: mrat
смешанный: mrik
деревянный: mrak
предпочитать: hpet
предупреждение: trin
замечание-настроение: htom
импульс: hmos
амбиция: mrac
Отрицать: hnek
конституция: swic
инструмент: srit
непрерывный-аспект: hnip
волна: hgas
колледж: klen
хвост: hkek
поколение: nric
Кот: blat
непосредственный-доказательный: hret
заброшенный: trac
11: hyec
инстинкт: nlik
характеристика: trit
племя: hgik
опасающийся-настроение: pcim
кров: crat
грубый: hruc
верховой: hris
трясти: hmon
промышленность: hdot
профессия: hres
лампа: hdap
кофе: kfif
подчиниться: htot
северный: nrit
медсестра: nris
гарантировать: hjat
цепи: ryin
учение: cric
обувь: hgut
двор: mram
неопределенный: hmec
в-другом-месте: hlet
квартира: pret
Мероприятия: twot
суббота: cram
Солнечный-свет: hduc
вдова: hwuc
элемент: hlem
отражение: hfen
организация: hgis
звезда: tram
инцидент: hgon
гость: hgip
бар: brap
бутылка: hbet
благословить: blak
размешать: crak
внутренний: trik
фиксировать: krik
выводить: prit
полый: hcot
провинция: hpos
цивилизация: srac
вешать: hgak
шок: crok
исключение: swap
напряжение: tren
стандарт: ryan
вождение: dran
избавиться: hruk
клянусь: kses
сокровище: zran
семена: hbis
башня: tras
любимый: fwit
в-последнее-время: hcem
недавний-мимо-напряженный: hrot
проснулся: srik
мебель: mrin
веревка: hkos
приключение: hdas
роялти: ryit
праздник: dyat
описывать: dras
шестьдесят: hses
масштаб: hkem
церемония: srec
охота: clik
шепот: psus
во-многом: ryat
христианство: ksim
адвокат: hwif
деталь: drit
принцесса: hrus
алтарь: dlat
Web: hwes
пурпурный: brin
собирать: hkoc
выборы: hben
концепция: kren
пьяный: crik
залить: brac
лифт: hlif
жест: hjis
управлять: rwin
обмен: tcen
определенный-статья: hdek
император: mras
дистанционный-пульт: hroc
уродливый: clup
безвредный: cras
рулон: hrof
дюйм: nlic
газета: grat
борода: dric
слеза: srim
комиссия: kson
в-то-время как: grak
пересечение: kcoc
независимость: htes
запах: hwon
18: hdec
исторический: tris
валовой: krut
корень: hrok
грязь: hbik
невеста: dlan
вуаль: pras
театр: tret
сравнение: kras
соперник: rwis
баланс: slen
тренер: kron
юмор: hnum
роман: rwas
жажда-мести: hbaf
ревнивый: ryut
колесо: hlok
сожжен: glat
вспышка: flac
Создайте: hkec
конфликт: hnot
проклятие: hlos
проклинающий-настроение: pram
беспомощный: hces
положительный: hzit
клуб: klup
наводнение: nras
зерна: gwan
равнодушие: hdun
горизонт: crim
предположительный-настроение: hsom
крутой: htop
гармония: mron
гром: hgot
детство: htok
колено: hgun
программного-обеспечения: pwen
травма: kram
квитанция: ryis
включить: nlim
протазис: hpoc
скольжение: slok
революция: hrif
фермер: hjim
Инсульт: trak
Платформа: hpof
вестник: hmes
привилегия: hpek
организованный: hyot
студент: clen
пещера: hgec
традиция: rwat
трагедия: tses
прощальный-привет: hjap
критика: ryik
хлопок: krap
больница: slot
аренда: kris
газ: hges
неизбежный: pwic
смертельно: hgim
лист: glit
публикация: plun
враждебный: tsup
перевод: dwan
похороны: jran
мука: mrun
переписка: ryon
романтический: hrom
хижина: clun
предложить: psot
подражательный: hmet
доллар: dlon
дневной-свет: hjac
шестнадцать: hsos
сборка: hzac
колония: klon
крыло: gyin
лев: hles
культура: klut
колонка: hkom
хитрость: glak
драма: dram
шутка: hjuc
туман: hdus
лекарственное-средство: dwas
14: hkes
кислота: sram
а-именно: hyet
доход: hmok
епископ: hbip
оранжевый: tron
ванна: byan
примитивный: rwit
корзина: ksek
секретарь: sris
солома: prak
нетерпеливый: pfif
спасение: slon
сегодняшний-напряженный: dlin
намереваться: zrin
Стим: tcip
яд: hwoc
талант: tlon
климат: lwim
эффективный: fric
выделить: tcif
мыть: dwac
признание: kfis
бред-какой-то: hjas
каменный-уголь: kyon
каноэ: kwon
временный: tric
delimitative-аспект: hdip
кость: hcos
понедельник: nwic
вторник: glac
среда: bwac
федеральный: frin
желательный: hzic
представитель: ryic
белье: lwin
раковина: swuk
племянник: bwin
кровавый: kric
осада: cren
желудок: hpem
латунь: pcon
саммит: hzik
пятый: pfik
дешево: brat
эксклюзивный-человек: kwen
воспользоваться: zrat
забор: hzas
статуя: tfam
артиллерия: tlep
охватывать: mrap
окружающих: sren
строго: srot
олень: hluf
куст: hbuc
железная-дорога: hrep
разряд: hduk
наследник: mris
дуб: blun
неприятный: pren
изобретение: hgic
пианино: pyon
убеждать: swen
невидимый: gric
общеизвестный: ryun
жестокость: kluk
искушение: hyoc
целенаправленный-аспект: hlep
экономический: kfik
Международный: troc
вмешиваться: tcek
философ: flif
элегантный: gyit
обеспечение: kyen
ловит-рыбу: mlak
украсть: truc
губа: hloc
выходить-на-пенсию: ryac
протяжение: sras
галерея: glen
параллельно: zlan
atelic-аспект: htep
континент: trap
запретительный-настроение: nrim
галстук: dwat
клетка: slep
яйцо: dyan
искусственный: jrat
между-тем: nwis
кризис: ksot
вежливый: sloc
обед: lyon
сосна: pwon
От-себя: hcef
альянс: lyen
Талия: hkop
чудо: hmek
моряк: slis
чистота: prut
республика: hguk
телефон: tfen
кнут: krip
Рубашка: cyim
вводить: ryas
диван: hsof
подметать: hsup
вор: ksif
сохранить: nrec
канал: kcen
личность: klim
реформа: kfam
угрожающий: hzim
Пальма: plim
оратор: hzak
порог: dwic
индуцировать: pris
копье: bzak
аккуратный: syec
сессия: cwen
пытки: crot
влажный: tcum
хребет: grit
путешественник: hyek
мельница: mwik
карта: jrac
воротник: klok
заменять: klif
умышленно: drat
пиво: hbif
бархат: hwem
сила-тяжести: gwit
проповедь: hpum
злоупотребление: glas
стадо: hgen
13: tres
оправдывать: jyit
пятница: crum
щетка: broc
скачать: dlas
крем: krem
утес: klaf
жюри: jrin
монстр: ksos
замороженные: hgoc
горшок: pfot
пенни: psen
настаивать: srut
яблоко: hpep
обсуждать: drak
задний-план: prun
транскрибировать: trim
периодический: prik
развлекательная-программа: nren
вирус: bris
детский: blit
отражать: flit
конвертировать: kcet
контур: kluc
опера: hpop
утверждение: nron
предавать: rwak
наказать: hzen
локоть: kcon
прикрепление: tcet
ремонт: hrop
подозрительный: cyec
семьдесят: swet
священное-писание: srip
яма: grac
расстройство: dlak
двоичный: byin
аббатство: bjan
стрела: tcec
тенденцию: trec
разрабатывать: frat
верность: hlot
монета: syip
дрожать: tcem
изгнание: gwin
механический: myim
ловушка: crap
кекс: kyek
сэр: cyes
колебаться: sret
семнадцать: syet
мед: myon
доля: dzat
протектор: hjam
кирпич: brit
восемьдесят: hpes
К-сожалению: pcen
консультироваться: kcot
легенда: lwen
уборка-урожая: hfos
продвижение: pfon
плита: hsop
бунтарь: bric
старомодный: hnom
зыбь: cron
болото: swot
повязка: hdes
аскет: pces
менеджер: mren
хор: cros
рациональный: tson
обработка: pson
волк: blaf
ковер: hgap
древность: hjak
плодородный: frut
свисток: slif
сыр: twis
укусить: byat
приглашать: jwan
кафедральный-собор: kyet
гавань: brak
бродить: djan
культуры: tsos
флот: nlen
маска: mrok
карандаш: pses
овощной: sroc
экспонат: hzet
брюки: tlun
коррупция: hrup
шкаф: nram
суп: srup
врач-хирург: syon
пособие: tcot
шпион: gyas
безрассудный: hlec
слухи: gyic
знак: hzon
Абстрактные: srok
Четверг: cwim
трафик: ryaf
архитектура: ryek
трещина: rwaf
орнамент: rwon
задний-ход: lwas
забавлять: mwun
восстановление: ksus
тротуар: plut
решающий: dyin
отрицательный: nraf
фестиваль: hfec
уменьшить: hrum
измена: zyan
охотник: djin
змея: syen
батарея: bret
воск: flam
детектив: dlit
анализ: nlis
акцент: hzot
плавать: twen
конверт: lwaf
кто-бы-ни: hgek
сигарета: jrit
двигатель: mrot
доброволец: hwot
реакция: ryif
Багаж: blam
глухой: hboc
сок: hjus
смирение: jlit
министерство: mret
сексуальное: hjon
диаметр: dyam
топор: blac
алмаз: dlam
заместитель: hlek
эхо: hgus
сдержанность: swon
идентичность: hdaf
экран: krun
ленивый: lwis
momentane-аспект: hmop
компактный: kfot
дрейф: hdif
исчезать: hgaf
луч: ryen
чернила: mwic
массивный: mraf
подвал: dyac
памятный: nrun
яркий-свет: klek
сенат: slet
гроб: tfap
прощение: frac
глотать: nlun
баловать: nlot
свинг: swun
луг: gram
сложный: klos
отставка: hzis
скромный-регистр: nret
заговор: swim
перец: prip
пони: pron
кандидат: hzam
лиса: flik
дымовая-труба: tcon
юрисдикция: drik
сельское-хозяйство: rwic
точность: tcuk
бывший-умерший: brim
демократический: mrek
бутон: hbos
одеяло: bwat
град: hgep
свинья: srus
профилированный: krek
слоновая-кость: craf
классическая: ksok
наблюдатель: nwet
слон: lwit
ногти: nwus
пчела: hmif
похоронить: dzan
актер: bzat
пот: zwan
полировка: ploc
иллюзия: hlus
неопределенность: pcet
вторичный: syif
сложить: tsot
сельский: grun
стон: nyen
походить: slec
цитата: hzun
мешок: cyek
раздражение: fren
игла: hjun
контролируемый: nroc
курица: truk
последовательный: kwot
баррель: bras
привычный-аспект: hcep
эксперт: ksec
впечатление: blin
оливковый: zlin
фургон: myen
препятствие: bwak
кивать-головой: kcec
способствовать: plaf
определение: fyic
день-рождения: gjin
молоток: hcof
ароматный: hfon
повторение: trun
тривиальный: twut
удар: hjik
копать: kwaf
домашнее-животное: plot
череп: hcop
законодательная-власть: dlik
каблук: cruk
хмуриться: crun
патент: plet
миллиард: blim
химическая: fyik
пилот: pyot
подражать: mlot
юбка: kwet
необычно: srap
еженедельно: jwik
технический: tfip
растительность: tset
ворона: kraf
Восход: sruc
продолжительность-жизни: glin
делать-вклад: hyom
крюк: hdok
тигр: blic
проникать: crut
рукав: slun
шоссе: jras
милиция: mlip
ров: kroc
целостность: kret
19: dzin
органический: rwik
теология: flic
поплавок: flut
ведьма: byac
скучающий: hwuk
дипломатический: dyik
студия: twos
превышать: kcok
шампанское: cyen
вдохновлять: crif
баннер: hbes
развод: lwon
болт: hbut
вена: jyan
пассивный: psif
пена: hgum
гравий: grik
фартук: tyen
планета: gren
полка: claf
поклонник: flon
тропический: hjip
фаза: fwas
произвольный: rwen
произносить: kfun
Меркурий: krok
ползать: hrem
самоубийство: tcos
репортер: prot
лишать: hpok
опытный: klun
балкон: blik
вилка: fras
наемный-рабочий: mlek
работодатель: myot
ширина: jrak
раздраженный: djit
обвинить: klot
пенсия: pyen
глагол: kres
обезьяна: mwon
приемлемо: hwek
подпись: tlim
ортодоксальный: rwos
Ирония: fron
питомник: nrap
нежелание: jlan
Импортировать: tyot
факел: croc
грамматика: gjak
депозит: gyat
колониальный: plon
яхта: jyat
логически-вытекающий: kwec
купол: kwun
толщина: hfot
упертый: cyon
мышца: hmup
величина: ryam
натирать: ryos
трусливый: rwam
упряжь: gwac
тост: tros
мышь: myus
слог: slim
похлопывание: prap
диалог: dlaf
нейтральный: nrot
усердие: dwin
противоречие: trot
достигать: kfic
козел: byak
процветать: hfet
наложить: mlon
анонимный: nwim
формальный-регистр: frit
теленок: hbof
руководство: mwut
плавиться: hjec
Удалить: flas
зонтик: gras
ботинок: bzut
минеральная: mrim
перемирие: crus
утка: hbok
планирование: pfam
мыло: hsuf
кукла: gwak
скелет: klet
вилла: blis
шитье: jlin
примириться: dyak
чайник: kset
зрелый: mruc
кролик: kruc
проводник: nwot
зависимость: djat
игрок: jlic
насекомое: pset
ресторан: cret
сова: lwun
радикал: djik
резидент: zwin
Дракон: dron
слуховой-доказательный: drot
жаждущий: kyos
задерживаться: dren
расчет: glun
регулирование: ryim
мэр: mlap
меньшинство: mric
получение: dwon
ветеран: bren
оркестр: ryes
бекон: bjin
недостаток: zwat
ткань: frap
музыкант: gzik
умственно: hnep
соединение: nyon
недостаточный: nrip
архитектор: tsek
лимон: nyim
кашель: kcos
Головная-боль: crek
арендатор: ryet
плодородие: srun
заживать: hfoc
девяносто: nwon
случайный: hbec
ложка: kcek
воздушный-шар: blon
мел: hfip
выведенный-доказательный: nlet
издатель: pcot
уксус: sruk
пепел: fyec
бранное-слово: slek
возрождать: nrut
восприимчивый: kfim
тоннель: tfun
головоломка: hpef
механизм: mwim
математика: gzit
увядать: frun
печень: jwin
sublative-дело: bwik
падение: dris
Ед.-изм: twim
монополия: hnop
игорный: hgup
подводная-лодка: bzin
землетрясение: hbem
лаборатория: brot
пробка: kruk
само-контроль: syot
Будда: hbus
вязать: bjat
посольство: blas
дальний: sres
декларативный-настроение: drim
стимул: tyuc
шоколад: clot
совпадение: tyon
перчатка: gwat
становиться-на-колени: hjek
география: hjif
инвестиции: nwes
словесный: mrec
аналогия: nlip
светский: srek
ястреб: blap
психология: nloc
скрепить: gjan
лом: krep
роль: cyum
дозировать: hdos
лосось: slom
пудинг: pwun
магнитный: gyik
насос: pcom
кислород: ksip
сертификат: tfot
медаль: hmem
риторика: trok
скрип: rwap
весло: dyas
телескоп: trip
ожерелье: clek
написание: prif
виски: hwos
ива: hwof
верблюд: hlum
любитель: myet
Выход: crec
биография: brif
осел: gzac
ежемесячно: mwis
игнорировать: nruk
отпуск: byit
щелчок: lyik
овальный: twon
эластичный: lyet
Словарь: kfon
ветчина: gzam
радуга: rwun
потреблять: kcum
плевать: tcup
бак: trek
коллега: clok
бабочка: trif
диаграмма: graf
близнец: jwat
независимо: trem
бамбук: hbum
дилер: jlat
накопление: kles
инспектор: nyet
кусочек: hyos
кошмар: hbom
варенье: gjam
музей: mrem
алфавит: lwam
разброс: zras
рейд: crip
раскрывать: clus
гниль: fraf
агрессивный: gris
трение: mroc
мол: gyac
паук: brik
картошка: trut
пересмотр: cwon
жадность: jlac
преждевременный: ryot
умножить: gzan
вращение: pcip
статистика: tsok
календарь: klem
выдвижение: nwen
триллион: tlos
чердак: tlok
утвердительный-настроение: rwim
Приложения: pfen
номинальный: nlon
неудовлетворенность: sraf
инфекционное-заболевание: hfok
кувшин: krot
пожимание-плечами: cyok
пионер: gzin
упущение: nlif
капуста: glic
Спортивное: tlet
пьянство: mrut
идиофон: hdof
рычаг: lwek
сенатор: syem
Ирис: nrif
муравей: mwam
ошибка: hbop
беременна: grim
осадок: hjet
лодыжка: tcok
классификация: glik
переменная: prim
заворачивать: ryap
кудрявый: krec
сера: hsef
диктовать: dwik
появляться: brun
лягушка: fram
чрезмерное-дело: twek
губка: hjen
раздражающий: djon
белка: slip
молоть: zyin
irrealis-настроение: flim
вулкан: glam
в-помещении: gron
эксплуатировать: kloc
геологических: jlik
заграничный-пасспорт: psop
аморальный: mlet
бисквит: hbuk
сотрудничество: kros
таблетка: tlot
релаксация: kces
атом: trom
СПИД: hzip
пирамида: psim
цикл: swok
ворс: hnup
незаконное: hjaf
лапа: pfap
застенчивость: crom
затмение: klip
лютня: lwap
метла: srum
панель: mwen
астрономия: tcom
лабиринт: blen
стипендия: bwit
черепаха: kfuc
консультант: dwak
волокно: fwic
крикет: jrik
голубь: ksom
приспособление: dyon
треугольник: tfon
казначей: tsen
водород: jron
хрупкий: hfuk
принтер: pyet
удушение: tcof
хронический: gzon
справиться: slaf
дилемма: dlim
инжиниринг: jyin
камера: hkef
принести-извинения: pluc
лизать: lwet
танцор: dret
миграция: mres
большой-теннис: tces
позвоночник: clip
жарить: zrac
ткацкий-станок: tfuc
попытка: twuc
пароль: psaf
полушарие: praf
стратегия: zrit
кварц: krus
ножницы: jris
патруль: proc
ледник: lwic
наполовину: dwam
меморандум: mwap
конус: kwuc
симметрия: hzut
производитель: zrak
ответчик: fwik
мечеть: djis
шахматы: cres
Потери: htof
вишня: tref
широко-распространен: kfen
спотыкаться: tfok
грузовая-машина: ryok
горчица: mros
процент: pfet
аукцион: jlam
сито: srif
неустойчивый: swoc
магнит: gjat
сосать: syus
ислам: slum
на-цыпочках: twip
мембрана: mlen
брить: clet
гитара: gjit
блестящий: bzan
вяз: hyem
витать: kcom
местоимение-маркер: ryec
основной: pcus
специи: zlat
залог: jlas
перевозчик: zyac
вибрация: bron
дразнить: trus
плуг: hlom
физиологический: zlik
желоб: hgok
комета: cyet
средневековый: dyic
воробей: grec
компенсировать: twet
пластик: psuk
сноска: cyot
орбита: rwot
скромный: twum
гольф: hgof
нуль: zrun
чип: tcep
угнетать: prok
зевать: gjac
неравенство: gwas
моль: tloc
керамика: frik
домохозяйка: hgif
рожь: rwem
не-подчиняться: hyes
толерантный: glon
эмбрион: brec
шахтер: jren
аплодировать: zlac
дрожжи: lyim
премия: pfim
слива: plem
банкротство: byas
орошение: rwif
мята: nyun
капиталист: glis
эластичность: hlef
акула: gyak
нанимать-на-работу: drut
место-хранения: zren
реализм: cles
имбирь: djic
скорая: blus
сравнимый: kwip
бумажник: bjap
гримаса: glim
ученый: gyis
потрошить: grot
невозмутимость: hwum
радио: href
значения: zlit
фасоль: bwam
неофициальный: frim
внучка: gyut
разногласие: dloc
стейк: tfek
азот: zron
бритва: hjut
контрастные: krom
пропаганда: pcoc
фейерверк: fris
поп: pcop
раздевать: crop
борозда: cruc
вредный: hzaf
иудаизм: hjum
дополнение: pluk
объектив: lyes
pegative-дело: pwek
рак: kfes
пешка: pyek
преподаватель: zyat
утечка: hzuk
квалифицировать: krif
плотность: djot
индукция: dyis
жевать: htuf
разговорчивый: bzit
Омар: hgos
скидка: dyut
такси: tsuk
иерархия: crem
нефрит: gyec
рычание: glaf
ящерица: lyis
водопад: crof
неутешительный: djak
вето: frot
президентство: ryip
покупатель: mrif
галлон: jlen
комар: mruk
отклонение: dwen
бороться: lyut
мозаика: myok
штекер: plok
приземистый: pcuk
продуктовый: ksoc
коммунист: myos
поражать: mwek
обвинительный-дело: rwuk
созвездие: nlos
диктатор: dwit
озабоченность: tyet
спутник: tlec
тапочка: hlop
согласный: fyon
приблизительный: tsif
безработные: byet
сторонник: sros
лотос: lwot
салат: sles
хлористый: lwok
бактерии: bwic
липкий: pcek
компонент: bwon
ядро: klec
симулировать: bjak
байт: bzet
секреция: sruf
недвусмысленно: pres
совпадать: mloc
балет: blet
моча: mrus
чеснок: lyun
прошедшее: hguc
экономика: kcem
средний-класс: hdom
проворный: gjic
щипцы: htef
прачечная: lyoc
клубника: srem
городской: pcos
смущать: mlaf
блокнот: tfut
альбом: zlam
бейсбол: hbep
сопение: sluc
буфет: hbuf
причастие: rwip
гараж: grek
диагноз: djas
костыль: ksuc
вымогать: srom
постановка-на-учет: psuc
растворимый: jlun
фосфор: psof
структурный: rwut
клей: glum
Тезис: twes
ремесленник: clif
банан: bwas
аксиома: kyom
ребро: psos
никель: nyek
Пи: pyim
автобус: bwos
цензор: swes
ракета: mlus
колбаса: slos
манипуляция: nlut
помидор: tfet
усиливать: kfut
разъем: syok
калий: tsom
извлекать: prup
виртуальный: zwit
алгебра: gjas
Дантист: dzit
оптический: pcok
сдвинуть-с-места: bzen
биология: bwim
безработица: byim
гусеница: krum
соло: slof
браузер: bjac
дистанционный-пульт-мимо напряженный: nyot
исторический-напряженный: crep
ядерного: nluk
спектр: pyem
натрий: syom
истерия: syes
доверенное-лицо: tyos
заложник: byik
тыква: gluk
морщина: kwuk
прозрачность: tfif
шип: swip
приоритет: pcif
пешеход: dyen
атеизм: tsem
монитор: mwot
избирательный-округ: nlec
неконтролируемый: hkof
зонд: grok
платина: plip
двойной-номер: dlun
легкое: pcep
супер: syup
тележка: trop
в-местном-масштабе: lyot
подстрекать: gzat
бензин: plif
почка: grif
добыча: bzac
оценка: dlen
мышьяк: syek
улитка: nrok
кузнечик: tsec
уравнение: fwen
социалист: swos
фильтр: flot
сенсорный-доказательный-настроение: hxin
расширять: kyot
испускают: mwet
привязь: pwet
мандарин: drun
жокей: hjok
пневмония: hnof
солидарность: gret
петля: cyif
продольная: nruc
дивиденд: dwun
кататься-на-коньках: hkep
экспонента: slop
инвалидность: dlif
навязчивая-идея: bwen
выделение: pfun
фотограф: trof
дельта: dlet
цифровой: djim
сука: brut
веко: hyop
диагональ: dyun
подсознательный: byon
бровь: bruc
чихать: pcec
веселый: dlis
индуизм: nwum
беженец: nyif
челнок: cwot
белок: pwot
свалка: hdop
усовершенствовать: flen
рвота: hwom
ген: gyen
первокурсник: hdem
социология: syoc
сквош: kwoc
рыболов: hfuc
региональный: jyen
движение-в-гору: hvok
ретроспективный: hxik
торнадо: gyon
инверсия: nwos
ТВ: twif
куб: kfet
производительность: pwuk
морковь: krop
молекулярная: mwuk
конгломерат: glet
бухгалтер: ksum
огурец: kyok
оргия: drok
растворитель: jlet
фосфат: psef
грунтовка: gwik
щелочной: flis
гимнастика: jyas
запятая: kwom
движение-спуск: hvat
выкидыш: jwac
стручок: tcop
донор: dzon
марганец: hzem
психолог: syos
хлор: clos
клавиатура: kyoc
элита: zyit
круглая-скобка: pfaf
регби: rwoc
язва: jlon
изменяемую: hxit
клев: nres
квантовая: fwam
свитер: swek
эволюционный: fwis
обозначение: nyoc
отскок: tcuf
рассечение: drec
кэш: kcep
линейный: lyec
сурьма: trum
superessive-дело: psek
опухоль: twom
эрозия: cyos
альфа: flaf
пупок: nwip
иммунный: myip
грипп: flun
пивоваренный-завод: bjit
упрощать: slef
сокращать: bram
вмятина: djen
пленять: dwim
принудить: brok
носок: bzas
кино: fyim
космос: klom
загрязнять: hpuf
общительный: gjen
пенис: zyis
лесоводство: lyif
алюминий: lwum
колебание: zlon
Гороскоп: ksop
выталкивать: dlek
включение: nluc
бенефициар: byic
дельфин: dlip
убийца: cyus
млекопитающее: myaf
индикатор: swif
диоксид: dwis
двоеточие: zlen
бюрократия: brus
искажать: jric
холодильник: frip
археологический: cluk
неприемлемо: kwok
Спецификация: pfis
листовка: pfut
антропология: nlom
вкусно: kyec
переходный: txit
приседать: kwus
подсолнечник: hzuc
вошь: glus
ион: lyos
туризм: tyum
модем: myom
ускорение: jrun
фальсифицировать: tsoc
эмиссия: hmef
похищать: drap
перекрытие: hwep
парикмахер: pfes
фольклор: floc
капиллярный: plek
национализм: nlum
ягодицы: nros
лейтмотив: hmuf
сублимировать: slem
разочарование: xras
кобальт: kwos
овес: gwam
движение-вверх-по течению: trup
анус: gyam
бычий: bwun
кувырок: flip
избыточность: dzun
видео: hwop
бойкотировать: bjik
викторина: cwif
хоккей: cwok
партизанский: grip
магний: hgem
радар: drek
шимпанзе: hzif
надежность: kwif
прямоугольник: tyec
ламинария: klep
обобщать: jlak
комендантский-час: kfec
гомосексуальный: mlok
сценарий: srop
формулировка: flus
реинкарнация: nrom
воспламеняться: zlak
уран: ryum
ловец: kwes
координировать: kyop
налогоплательщик: nwaf
интегрированный: trep
высказал-мнение,: hzap
гамма: hxam
сафари: fwim
движение-вниз-по реке: ht6n
коэффициент: kfus
Заголовок: zlic
аналитик: nles
мат: hzes
торговый-центр: hmof
висмут: bzim
открытка: psok
сходимость: bros
отвлекаться: djet
акционер: ksem
микроб: mrip
генитальный: jwit
морфологический: mluk
бета: byot
джинсы: gjis
база-данных: tles
калькулятор: klus
Рентгеновский: ksef
разбор: zram
экологическая: zyen
сигма: zyim
дизъюнкция: hxon
повестка-дня: gres
виза: bzis
инфраструктура: nyuk
Светляк: gyun
детектор: tyek
адаптивный: dyip
биолог: byis
сращивание: pyec
бром: brom
палладий: plum
икота: kfok
пастельный: psec
зоопарк: zwac
клиника: lyok
коннотация: nwoc
йога: hjoc
книжный-магазин: byun
терапия: grap
националист: zlis
обезглавить: zlet
Да: swec
проблематичный: byam
джаз: dzas
вольфрам: tsof
террорист: gwis
капать: droc
метаболизм: tlem
алименты: lyaf
выходные: hfom
хризантема: gzim
вакцина: byap
мотоцикл: tyok
мантра: dyot
семестр: myes
героин: gwon
папка: flap
катод: kfoc
идеология: dlec
стоянка: prek
тета: fret
антиклимакс: hxis
селен: clem
езда-на-велосипеде: blek
кора: pros
эквивалентность: swaf
текущий-актуальность-маркер: hxak
аэропорт: cwoc
ампутировать: gyet
баскетбол: bwet
самозванец: mwip
таракан: tlek
хром: hgom
литр: hl6t
тем-не-менее: nwec
гормон: cwom
недостатки: tluc
перфорировать: prec
анимизм: nyom
многоугольник: cloc
феминистка: hfes
сопряженный: kcop
евро: dros
женьшень: hjes
алгоритм: hlof
лазер: lwes
аптека: dlot
миллиметр: mlem
сгибать: flek
анод: nlok
нюанс: hzus
неполная-занятость: prem
чувствительность: nyec
демонстратор: drom
гелий: clum
двуязычный: dzic
акроним: hqim
аббревиатуру: nl6m
герундий: gros
плазма: psem
хромосома: rwom
порядковый: rwok
километр: klum
факс: tfes
генетика: nwek
веснушка: frek
отвертка: dres
брокколи: blok
претерит: xrit
витамин: tyem
кадмий: kyem
бомбардировщик: bwoc
графический: gjik
титан: dyim
бахвальство: clec
лямбда: lwem
Подруга: pcem
совокупляться: kyuk
песочные-часы: tlus
сопереживание: mlif
бор: bres
вертолет: cwet
теллур: tlum
крайний-срок: jyic
выравнивать: gwic
сантиметр: hfem
молибден: mlom
литий: tfim
мультимедиа: myum
Обновить: dyet
калория: clom
робот: ryoc
домашнее-задание: groc
логарифм: grom
богомол: gzas
устанавливать: nwut
амино-: myoc
глиф: glif
аорист: pyos
экология: plec
подделывать: flok
марихуана: bjam
микро: mrom
килограмм: lwom
переедать: jrot
предсказуемый: dzik
пицца: zyas
подслушивать: zris
лингвистика: bwis
стрижка: braf
иридий: ryom
расизм: gwim
оптимальный: gyim
индустриализация: drif
штаб-квартира: krup
церий: zrim
конгруэнтный: nrum
партитивный-дело: pxik
кассета: ksep
сила-воли: blot
мерное: dzen
параметр: rwet
синхронизировать: nrop
максимизировать: dzim
семинар: mwec
дискотека: dyok
неон: nyok
осмий: hzom
Богоявление: hp6n
заниматься-плагиатом: lyap
артефакт: rwek
реактор: fyet
орегано: ryop
плутоний: pwum
иттрий: tyom
увеличительный: hxat
имя-пользователя: mrum
аспирант: zrot
правое-крыло: dwaf
аргон: jros
фобия: hxot
общаться: sluk
глобализация: bluc
длина-волны: hnef
кодировать: kfom
перерабатывать: psoc
перезапуск: nrek
гепатит: pyes
торус: fros
химиотерапия: myep
по-модулю: mwok
протон: zwot
дискета: dwet
миллиграмм: mlum
пиксель: psep
тантал: twem
растворенное-вещество: hjot
геноцид: nyos
хищник: rwes
галлия: glem
цирконий: hzum
детерминанта: txin
нелинейный: nlem
пестицид: pyif
бериллий: brem
нейрон: nrus
предикативный: pxit
Трусы: tlif
факториал: kref
нейтрон: zrut
ниобий: nwom
германий: hjem
металлоид: tlop
положил-на: dlap
prolative-дело: hl6k
биоразнообразия: jwic
джойстик: jyok
антибиотик: twok
актиний: gjim
астронавт: srof
внеземной: tyes
ненормальный: hwup
марафон: mrof
иттербий: zwim
аутизм: tyif
ионизировать: nlof
радон: cwos
Нериум: nrem
эпидемиология: pwip
старость: lyuc
кемпинг: kyep
в-полоску: drip
индий: nyum
правдивый: hvik
Веб-сайт: bwes
Коран: kwek
столовый-прибор: fwet
п--корень: tfec
лоуренсий: lyem
гражданские-права: glip
мобильный-телефон: mlof
парализованный: twoc
протактиний: prum
излучение: hd6n
зависеть-на: pxin
торий-атом: hxim
синие-джинсы: bjun
домашнее-растение: hxas
в-отдельности: dvit
поток-тока: lwuk
тройной-точкой: ht6t
тело-человека: hn6n
физика: bzik
розничная-торговля-магазин: hxan
цезий: hs6m
длинный-тому-назад: hqan
таблица: hxet
Блок---масс: hn6m
компилировать: ml6n
двоичный-значение: vrim
человек-являющийся: nyus
от-означает-из: hvan
depan-PF: pxat
празеодимий: pyom
картон: kxat
конечный-глагол: hqik
испытание-номер: hr6n
за-предложение: hr6t
критик: hk6k
упаковка: pxas
непостоянство: pxan
в-большинство: txas
дескриптор: drop
неодим: nyem
дружба: hvit
читать-только: xyak
основывает: xwan
гномический-настроение: kxin
фонема: hxom
рациональность: xlit
фонологический: xlin
обеденный-комната: hxac
живой-комната: hxic
центральный-дело: zrik
предварительно-сегодняшний: hx6n
пациент-дело: hqak
косой-дело: bwok
сельский-площадка: hqat
Recurse: hr6s
средний-голос: dyos
мейтнерий: hm6m
почтальон: hvak
уклончивый: kxit
акции-рынок: xrak
опознаваемый: hxap
Цель-вызывать: krof
одна-секунда: hxen
нигиляционными-дело: dvak
рацион: hr6c
не-человек: hg6n
живой-вещь: hvic
слишком-немного: hxut
кинотеатр: hvin
гания: xyim
степенью-сбраживания: ty6t
multal-номер: ml6m
молочный-путь: txam
нептуний: nwem
литературный-раб: txik
транс-цифра: ts6s
валять-дурака: hqun
америций: myem
утро-слава: txan
пожарный: xran
беркелий: blem
галактика-Пол: kxan
нобелий: blum
пока-пока: hvac
буддизм: hfum
фермий: frem
голубой: xyan
соевый: syof
распределитель: qrit
штрейкбрехер: txak
процессор: ples
abessive-дело: bvak
адессив-дело: dvik
к-дело: kxak
агентивного-дело: dvek
резерфордия: hr6m
антитело: txip
в-виде-гораздо в виде: hjos
агент-вызывать: hg6t
актер-роль: xram
этидия: txim
общий-Пол: hk6n
сопровождающий: kl6n
сафлоровое: kxam
франция: fyam
эрбий: ry6m
пассивный-голос: xyis
астатин: hqit
жевание-жвачка: hqam
звезда-Пол: hqin
цитата-форма: ht6m
кюрий: jrim
комикс: kxis
дальтонизм: hqon
euler's-номер: hl6m
смотреть-в: kxas
пешеходный-переход: pwok
поле-битвы: txat
автомобилист: vrit
короткое-замыкание: txok
словесный-имя-существительное: hvis
плакать-вне: hk6t
статистически: xyit
йогурт: txot
ксенон: hs6n
гипнотизировать: hxif
взять-от: hxaf
Предложение-хвост: hxok
непосредственный-объект: dwot
продуктовый-магазин: kxun
состоять-из: hm6t
эргатив-дело: gvik
в---языке: txic
из-первых-рук: pxam
местный-дело: hqok
бассейн: slup
адвербиальный-дело: vlak
осмотреть: hqas
телевидение-задавать: ht6s
окончательный-частица: xlik
evitative-дело: hvek
реабилитация: xlat
регрессия: xris
блок-из-квартиры: kxot
разбудить-вверх: hxup
полиция-сотрудник: ps6s
клянусь-в: vran
интервьюер: qrat
рений: ryem
аэрозоль: xres
притяжательный-падеж-дело: kxik
номинализация: mlec
одержимый-дело: dzak
перезарядка: pxak
вспомогательный-глагол: xyik
первичная-объект: mlut
Компьютерный-вирус: prus
деловой-человек: hqis
люди: hqen
antessive-дело: ts6k
премьер-министр: pxis
лютеций: lyum
европий: rwum
переигрывать: xrot
Народная-музыка: zyik
поэт: vwit
Почта: pxot
предположительно: hvas
оживить-Пол: hven
subessive-дело: bvik
педаль-газа: glep
полярность: pr6t
средство-передвижения-Пол: vlin
минеральная-Пол: xrin
глагол---суффиксов: hvif
страстный: pc6n
самарий: sr6m
посредник: hs6t
мнимая-единица--: xyin
скорость-света: kxac
воздушные-силы: hxes
чуткими-радость: pfec
критическая-точка: qyit
на-постоянной-основе: hxem
гафний: xyam
ингибирование: hn6s
изменение-из-мероприятие: qrin
гольмий: xlim
другой-мероприятие: hf6t
вселенная-Пол: hvip
местонахождение-Пол: kxen
виртуальный-машина: hvim
исследование-Пол: txen
художественный-Пол: ts6n
crastinal-напряженный: sl6t
Абстрактные-Пол: srep
экзоцентричный-дело: zrek
переходный-глагол: txif
морфема: tfom
шовинист: dvis
мимо-совершенный: xrat
профессиональное: hy6n
непрямой-речь: tyoc
второй-язык: draf
к-быть: txis
кладбище-сдвиг: vrak
коллектив-имя-существительное: hxos
абсолютива-дело: bvuk
пациент-вызывать: tr6t
само-уверенность: hs6s
фекалии: hzos
возвратный-голос: hf6s
безличный-глагол: hxek
сиборгия: br6m
белое-пространство: hxep
модальный-дело: dlok
неодушевленный-Пол: hj6n
причинный: qran
propositive-настроение: psom
электрический-текущий: tr6n
ассоциативный-дело: nwok
превосходный-дело: tluk
слишком-гораздо: xyut
планетарный-Пол: pxen
анимационный-мультфильм: nwuk
взаимная-голос: vrik
законодательствовать: hqaf
в-наименее: vlas
грамматическая-случая: qrak
пользователь: pxut
ядро-благословляющий: kfef
вратарь: hgop
:-ekstsept-odds: kcef
знаменатель: dvan
еще---если: lyek
боком: hx6s
друг-друга: dles
последующий-пункт: lyuk
изнашивания: hxun
шорты: ht6k
диспрозий: prom
скоро-будущее-напряженный: rwec
си-единицы: vyin
криптон: kxon
менделевий: dlem
аппликативны-голос: hp6s
antipassive-голос: tsef
continuative-аспект: ht6p
радиационно--болезни: hr6k
necessitative-настроение: hn6t
Один-действие-глагол: hqek
автомотриса: xlak
превосходный-степень: tlup
экзистенциальный-пункт: hs6k
калифорний: kf6n
настоящее-время-причастие: vrat
светящийся-интенсивность: hc6t
singulative-номер: slus
грамматическая---объект: hy6t
пассивный-причастие: vris
чрезмерное-продолжительность: kxic
сверхкритической-жидкости: sr6t
количество-из-вещество: ks6t
послелоги-дело: pxok
факультативный-квантификатором: lwif
гадолиний: dl6n
вставной-морфема: hp6m
негативный-квантификатором: nwif
эйнштейний: ny6n
искусственный-язык: txac
соединительный-частица: qrik
дистанционный-пульт-будущее напряженный: twec
многократный-аспект: hfep
дистрибутивный-местоимение: bvin
назидательная-речь-соглашение: hk6m
лысый: blos
пригород: syum
универсальный-квантификатором: vlit
компьютер-программирование: mr6m
телевидение-программа: tr6m
с-плавающей-точкой номер: hvun
экзистенциальный-квантификатором: tl6t
день-после-завтра: dwek
альтернатива-квантификатором: lw6t
раздражительный: hdup
мимо-пассивный-причастие: hp6t
день-до-вчера: txet
местный-направленный-дело: tc6k
контрфактическое-условный: ht6c
