здраво: zdravo, Zdravo, ПИ, збогом
: 
од: између, o-tome, његов
у: доћи, морати
у: 
:-first-person: 
ја: ми
:-third-person: 
to: to, који
његов: његов, властити
он: to
са: 
за: o-tome, за
као: који, пример, kako
:-second-person: 
бити: 
њој: његов
na: позив, o-tome
у: коњ
od-strane: проћи, и, o-tome
имати: сносити
или: ни
од: 
ово: to
њега: његов
она: они, to
мој: мина, ми
њихов: његов, они
prema-tome: тако, ускоро
: 
им: они, vi
ми: нас, ми
ko: ма-ко, који
би: мислити, довести
volja: снага-воље
ne: не
ako: да-ли, обезбеђен
горе: изнад, расти, напоље, горе
у: један
bilo-koji: to-jest, који, све, сваки
твој: твој
Šta: ни, који, ствар
индикативан-расположење: директива-расположење
човек: лице, супруг, Muški
од: више, o-tome, kako
наш: пролеће, нас
неки: нешто
на: после, изнад, напоље
može: u-mogucnosti
сада: присутан
voleo: kako, ljubav, држати
моћи: u-mogucnosti, mogao, кутија
treba: морати
јесам: uradite, чињеница
тако: тако
: један
ово: они, to
преко: изнад, више
много: веома, обим
gospodin: сер, мајстор
Dobro: lep, veliki, врста
највише: више, у-великој-мери, већина, веома
ћу: морати
оне: они, његов
себе: властити, исти, себе
живот: живети, животни-век, самогласник, струк
без: 
napraviti: uradite, створити
dobro: комфоран, jel-tako
дискурс-маркер: 
кроз: проћи, пробити
моћ: снага, можда, mogao
сувише: веома, чак
опет: онда, назад, једном
многи: већина
сваки: сваки, који
људи: лице, заједница, људи
мисао: идеологија, идеја, мислити
ispod: доле
jos-uvek: више
место: место, положај, где
док: а, време, привремен
само: само, једноставан
такође: чак, исто-тако, више
још: ali, ни, поред-тога, више
против: за, pre-toga
добити: susret, узети, извести
икад: вечан, никад, увек
од: затворити, далеко, напоље, покривен
лице: површина, сто, лице
Drugi: последњи, други
лево: далеко
нови: neo, роман, свеж, девет, млади
Gospođa: 
ставити: комплет, последњи, дати
рећи: рећи
ум: интелектуалац, мислити
мало: пар, мало
кога: који, ма-ко
далеко: далеко, даљински, веома
назива: мислити
цео: пун, све
обоје: два
наћи: našao, претраживање
погледати: видети, проверавати, поглед
пустити: аутобус, емитовати, дати, омогућити
господар: мајстор, сер, краљ
кући: кућа
нешто: ništa, нешто
тренутак: време
отац: тата
међу: између
žene: женски
мајка: мама
крај: готов, последњи, касно
мали: мало, микро
ти: vi
желети: морати
међутим: ali, поред-тога, иако
сасвим: потпуно, нешто, веома, dovoljno
чији: који
најбоље: боље
сам: ми, себе
sve-dok: чак, pre-toga, zdravo
од: онда, први, јер
полован: стар, рециклирати
пре: уместо-тога, нешто, више
мање: кратак, доле, најмање
u-sklopu: унутрашњи, дубоко, унутра
заједно: комплет
велики: veliki, масиван
материја: ствар, предмет, питање
сигуран: одлучан, jel-tako
она-сама: себе
пола: на-пола-пута, млевење, страна
истински: заиста, чињеница, jel-tako
било-шта: šta-god, нешто, ništa
држати: држати, комплет, задржати
жена: женски
средства: начин
близу: проћи, скоро
država: услов, унети, земља, влада
сам: усамљен, соло, један
случај: pasti, пример, odelo, случај, јер
те: vi
висок: изнад, pod
девојка: ћерка, женски, девојка
сигуран: осигурати, jel-tako, заиста
zaista: заиста, чињеница
се: себе, властити, да-ли
дуж: повезан, дугачак, дужина
земљиште: земља
повратак: регресија, назад, враћање-новца
оставити: одлазак, одмор, напуштен, далеко, дозвола
или: чак
закон: jel-tako, правни, правило
положити: комплет, секуларни, pomoć
тачка: место, акција, само, став
дете: деца
желети: nadati-se, жеља
говорити: рећи, разговор
током: време, а
више: туце, пар, више
бизнис: трговина, продавница, privredno-društvo, рад, трговачки, покрет
манир: начин, приступ
други: други
општи: заједнички, обично, јавни
иза: назад
постати: доћи
мртав: умрети, смрт
земља: земља
дечак: син
осетити: осећај, чути
duh: душа
истина: чињеница
тло: pod, земља, место
стварно: заиста, веома, чињеница
одмор: други, удобност, пензионисати, остаци, одмор
различит: разноврстан, разлика, други
могућ: можда
људски: лице, хуманост
град: град
следећи: следећи, следити, после
potreba: неопходан, морати
узрок: разлог, изазвати, јер
veče: ноћ, поподневни
пет: пети, година
јак: снага, u-mogucnosti, насилан
дама: женски
око: који-окружује, скоро, o-tome, око
ред: страна, комплет, ред
смисао: значити, осећај, конотација
близу: затворити, скоро
карактер: карактеристика, личност, ознака, природа
врста: класификација, врста
призор: визија, напред, сцена, видети, поглед
žurka: гозба, зарез, земља
фино: veliki, танак
спреман: pripremiti, већ, на-врховима-прстију, готов
рачун: разлог, рачун, рачуница, рачунати
написан: писати
старост: стар, век
друго: други, последњи, другде, више
сила: снага, приморати, наметнути
preko: изнад, супротан
рано: превремени, почетак, примитиван, ускоро
сунце: 
kasnije: будућност, онда, после, следећи
све: све
прошлост: протекло, ретроспективан, последњи, после
дело: рачун, глагол, акција, рад, покрет
даље: напред, више, додатни
изван: више, напоље
ни: ни, који
поглед: изнео-мишљење, поглед, видети, визија, сцена, календар
звук: глас
ниједан: ništa, никл
јасно: отворено, очигледан, упечатљив, светло
пут: аутопут, начин
прави: виртуелна, чињеница, краљевски
скоро: скоро, o-tome
знање: информације
ка: за
лоше: горе, зло, слаб
живот: живети, струк, животни-век
мир: соба
низак: кратак, јефтин, побачај
северно: одговор, северни, поноћ
природни: природа
прилично: lep, веома, dovoljno
фер: jel-tako, извештај, десет
сервис: служити, нега
испод: доле
задовољство: срећан
историја: прича, датум, историјски
Beleška: запамтити, нотација
иако: иако
предњи: супротан, напред, pre-toga
велики: veliki, масиван
сигурно: строго, курс, заиста
ветар: ваздух, поткровље
примити: признаница, узети, извести
пажња: нега, приоритет, фокус, обзир, истицање
снага: снага
вероватно: можда
drago: срећан, смешан, задовољан
важно: неопходан, значајан
сами: властити, себе
колега: колега, пријатељ
мишљење: изнео-мишљење, идеја
вера: веровати, лојалност
пре: источно, онда, pre-toga, напред, назад
наплатити: путарина, трошак, узети
рука: рука, слаб, рукав, оружје, раме
потоњи: последњи
објекат: сврха, ništa, предмет
господин: Muški, сер, мајстор
посебан: посебно, to-jest
једва: не, скоро, редак
главни: менаџер, глава
прилика: случајност, положај, прилика, вероватноћа
договор: план, продавница, споразум
мишљење: мислити
тежак: понављање, тежина, озбиљно, тврд
обичан: отворено, једноставан, шупаљ
одмах: једном, ускоро
уста: лице
уплашен: уплашен, страх, забринут
сингл: један, усамљен
радост: срећан, узбуђење
поломљен: сумпор, рез
ако-не: осим
носити: сносити, nositi, довести, омогућити
утицај: ефект, грип
izgledati: појављују, изгледати
ван: напоље, осим
Molimo-vas: љубазно, питати
изглед: појављују, изгледати
полако: постепено, касно
раздобље: фаза, време
sestra: брат
битка: борба, рат
бивши: стар
омладина: млади
само: само, једноставан, усамљен
достићи: приступ, постићи, доћи
систем: ред, хијерархија, организација
вечера: ноћ, ручак
после: будућност, после
ходати: газити, ићи, pod, нога
Питам-се: чудо, чудан, iznenađen
уобичајен: обично, заједнички, увек
фигура: дигитални, статистика, у-облику, број, путарина, слика
древни: стар, старомодан
поштовање: обзир, част, опасност, за
трећи: три, уторак
остати: остати
друштво: друштвени, заједница, privredno-društvo
резултат: закључак, ефект
команда: ред
пуки: само, једноставан
поред: проћи, следећи, осим
нем: миран
savršen: правилно, veliki
улица: начин
писање: писати, писмо
дрва: дрвен, дрво, штап
брзо: ускоро
белешка: видети, оглас, упозорење
светао: оштар, светло, сјајан, упечатљив
брод: брод, пловак, јахта
племенит: veliki, славан
изненадан: изненада
вредност: вредност, ранг, значај
због: јер
читање: читати, питање
dogovoriti-se: споразум
чекати: очекивати, држати, остати
комад: чип, део, растезање
ек: стар
разговор: разговор, дијалог
прилика: прилика, положај
цена: трошак, платити
знатан: veliki, значајан, упечатљив
седети: остати
врх: оптималан, гребен, изнад, врх
брак: u-braku
корак: акција, газити, фаза
почети: почетак
по: сваки, за
pojedinac: лице, појединачно, атом
тежак: тврд
бит: део, мало, вашка, залогај
говор: разговор
ауторитет: надлежност, снага
срећа: срећан
обезбедити: обезбеђен, дати, осигурати
студија: учити, анализа, студио
лични: приватан, појединачно, особље
rucni-sat: проверавати, монитор, видети
задовољан: задовољан, срећан
врућ: топао, ватра
напор: покушати, напрезање
припремљен: pripremiti, већ
покушај: покушати, квиз, убод
брзо: ускоро, окретан
испод: доле, после
namenjen: nameravam, фокус, сврха
право: директно, једноставан
вероватно: lako, вероватноћа, можда, наводно
правда: jel-tako
просто: само, једноставан
поверење: веровати, лојалност
пролаз: део, прелаз, колона, проћи, растезање
затворено: затворити, разбој, покривен
сами: себе
претицање: проћи, протекло, прелаз
средњи: секундарни, значити
поседовање: imovina
пријатан: комфоран, врста
савршено: потпуно, заиста
обично: заједнички, обично, склони
гроб: тврд
фиксни: поправити, иако, стандардни, трајан
трупе: војска
састанак: седница, монтажа, susret
камп: камповање, поље
народ: земља, државни
постојање: присуство
одговорити: одговор, враћање-новца
небо: атмосфера, небо
једнак: исти, степен
богатство: судбина, услов, imovina
домен: поље
ситуација: положај, услов
средњи: значити, на-пола-пута, струк
зима: хладан
допустити: дозвола, омогућити
блед: жут, боја, несвестица, пастел, отворено, светло
трчање: rasa, trcati
верски: религија, хемотерапија
довести: изазвати, довести
потез: газити, расправа, померити, покрет, акција
зауставити: пауза, стајати
говорни: рећи, усмен, разговор
табла: расти, табла, савет, ивица, комисија
сујетан: бесплатно, празан
губитак: nedostatak, изгубљен, цурење
понуда: обезбеђен, предложити, дати, експонат, служити, привилегија
класа: врста, орбита, ранг
комплетан: пун
приступ: посета, приступ, аквизиција
страст: ентузијазам, осећај
физички: физика, тело
пример: пример
почетак: почетак
инат: љутња
озбиљан: veliki, озбиљно, екстреман
сребро: новац, петак
довољан: dovoljno
главни: глава, мајстор, кључ, оригиналан, спајалица
предиван: чудан, насилан, veliki
путања: начин
značenje: конотација, значити, значај, предмет
пристајати: odelo, правилно
много: маса, веома, судбина
седиште: столица, опсада, седиште
игра: коцкање, игра
изјава: израз, извештај
сањати: ноћна-мора, сан
камен: литица, сукња, камен
посебан: посебно, приватан, експерт
провизија: трошак, путарина, платити
удео: део, улог, улога, делити
ширење: детаљ, распрострањен, растурање, разлог
слава: част, похвала
простор: положај, сала, поље, астронаут
обичан: заједнички, једноставан
razmotriti: мислити, обзир
веома: веома, у-великој-мери
официр: званичник
стопа: стандардни, част, курс
знак: нотација, гест, ознака, место
домородац: природа, оригиналан, резидент
рад: запосленик, рад
удати-се: u-braku
обим: граница, обим, степен
метод: начин, једном, приступ
одличан: боље, veliki
поверење: веровати
baš-tako: заиста, посебно, пун, потпуно
огроман: veliki
машта: машта, lep
брз: ускоро, окретан
да: да, тако
слобода: бесплатно, независност
занимљив: нацртати, радознао
по-страни: одвојен, постранце, осим
чист: свеж, истинит
о: изнад, o-tome, обзир
доказни: доказ, очигледан
удаљен: далеко, даљински
сличан: личити, исти, подударан, упоредив
узак: танак, кратак
свеукупно: потпуно
страна: страна, двориште
нарочито: посебно
planina: брдо
поносан: понос
јасно: експлицитно, отворено, очигледан
цена: част
болестан: болестан
пресуда: одлука, реченица, правило, судија, надлежност, криза
прихватити: прихватљив, признати, узети
врста: врста
тражити: претраживање
част: част
уво: дозвола
dno: доле, pod, база
помоћ: помагала, pomoć, подршка
потпуно: пун, потпуно
уживање: срећан, непријатан
износ: квантни, обим, гомила, број
добити: аквизиција, извести, узети
порез: закуп, линија
прећи: прелаз, проћи, прекорачити
странац: гост, чудан, страних, непознат
изазов: храброст
расти: расти
лажан: лаж, погрешно, болестан, погрешна
висок: дугачак, pod
капија: врата
слободно: независност, бесплатно, независно, лабав
ударац: шок, moždani-udar, хитац, шут
мода: приступ, доћи
дневно: дан
дистрибуција: делити
богатство: новац, imovina
слобода: бесплатно, независност
напредовати: напредак
нежан: мек, сладак
сигурно: курс, заиста
осигурати: безбедан, заштитити, осигурати
заузет: уграбити, довикнути, ангажован
фаза: платформа, акција, фаза, услов, сцена
порција: део, следовање
језик: језик, ражањ
љут: љутња
кола: воз, тролејбус, шатл
време: клима, ваздух, време
нужност: значај
пракса: вежба, акција, обичај
потраживање: захтев, odelo
кнез: војвода
група: комплет, конгломерат, стадо, група, табла
током: свуда
додати: проширити, додатни, povećati
молити: питати
водећи: значајан, мајстор
сив: браон, пепео
често: често, поновљен, трајан
познат: популаран, познат, самогласник
моћан: снага, u-mogucnosti
жив: живети
слаб: несвестица, слаб
материјал: садржина, предмет
искрен: поштен, аксиом
топлота: лето, топао
стражар: заштитити, нега
једнако: равнотежа, исти, исто-тако
природно: природа
изванредан: чудан, необично, veliki
месец: месец
мала: мало, lako, светло, танак, кратак
стил: светло
заједљив: хемисфера, оштар
принцип: теорија, аксиом, почетак
непосредан: ускоро, директно
вољан: већ, на-врховима-прстију, миља
последица: значајан, ефект, закључак
понуда: мек, споразум, rasa
заинтересован: nameravam, интерес
четвртина: нога
напредан: изнад, напред
очигледно: експлицитно, наводно, изгледати
активан: рад, акција
свестан: намерно, знати
опасан: опасност, штетан, претећи
миран: миран
свети: божански, свети
краљевство: краљевски
цео: потпуно, све, пун
lep: lep
навика: карактеристика, начин, обичај
директан: очигледан, директно, из-прве-руке
заправо: заиста, чињеница
слух: чути
Hodanje: газити, нога, пешачки
бацити: емитовати, бацити, хитац
мудрост: интелектуалац
погон: вожња, припев, експедиција, гурање, trcati, диск
кривица: кривица, погрешно
афера: ствар, предмет, везе
контакт: преписка, додирнути
станица: стајати, центар, сезона
слушати: чути, питати, слушати
повредити: повреда, бол, рањен
изразити: израз, објаснити
фаворизовати: страна, милост, подстичу
висина: дужина
величина: димензионалан, величина, пун
задатак: акција, рад, дужност
симпатија: емпатија, штета
обучен: хаљина
даље: напред
брод: инструмент, брод
љубав: ljubav
патња: мучење, беда, горак, проблем
месо: месо, тело
grand: масиван, veliki
после: ранг, пошта, после, послати, положај
колекција: акумулација, комплет, галерија, закључак
zamisliti: машта, мислити
долазак: доћи
гласно: инсистирати, veliki, тврд
диван: lep, славан
изванредан: чудан, необично
деси: ни
доручак: јутро, ручак
становништво: гомила
серија: ланац, комплет
рељеф: помагала, удобност, глипх
утисак: ефект, осећај, импресионирати, штампа
задовољство: задовољан
облик: димензионалан, образац, у-облику
рођење: рођен
разматрање: идеја, обзир
редован: периодичан, поновљен, редни
мовинг: померити, покрет
Zauzet: ангажован
квалитет: маса, степен
открити: našao, претраживање, открити
у: унутрашњи, дубоко, унутра
земља: блато, pod, соло, земља
потпуно: потпуно
порука: информације, вести
фраза: израз, реченица
споменути: Muški
пар: jel-tako, пар
наслов: наслов, глава, предмет
разумевање: разумети, емпатија
недеља: недеља
луд: лудак, будала
апсолутно: потпуно, строго
споро: миран
милост: штета, милост
садржати: uključujući, садржина
туга: туга, бол
војник: војска, пешак
претходна: источно
објашњење: објаснити, информације
молитва: захтев
веровање: веровати, лојалност
константа: поновљен, стандардни, поправити, трајан
коначни: последњи, коначно
вожња: јахање, сафари, расти, вожња
политика: политички
цртеж: слика, нацртати, план
умирање: смрт, умрети
потражња: захтев, питање
горњи: изнад
збир: и, јога, број
кретање: покрет, предложити
помоћ: подршка, pomoć
достојанство: част
улов: држати, узети, концепција
међу: између
струја: присутан, поток
могуће: вероватноћа, можда, mogao
засебан: одвојен, разлика, соло
најгоре: горе, слаб
терор: страх, терориста
контрола: регулација, контролисано, проверавати, управљати
способан: омогућити, u-mogucnosti, вешт, вештина
фирма: privredno-društvo, иако
супериоран: боље
духовни: ментално, моралан, интелектуалац
доказ: доказати, доказ
однос: везе, извештај, обзир
забринут: нега, забринут, повезан
дубоко: дубоко, детаљ
певати: читати
пријатељски: подударан, љубазно, пријатељство, врста
улаз: врата, признаница
снабдевање: ширина, обезбеђен
чист: свеж, уредан
користан: неопходан, ефикасан
деликатан: крхак, танак, елегантан
уклонити: ослободити, избрисати, нацртати
избор: изабрати, избор, проверавати
огроман: масиван, veliki
неспособан: не-могу, не, изневерити
поклопац: капут, укључење, ћебе, замотати, тротоар
двоструко: близанац, dva-puta, пар
победа: успех
стално: често, поновљен, увек, наставити
ниво: стандардни, услов, површина
пуштање: пражњење, публикација, бесплатно
груб: горе, злоћудан, непристојан
напред: напред, изнад
повезан: граница, привржен, повезан, коњугатом
добит: аквизиција, предност
додатак: додатни, допуна
комора: соба, сала, Kamera
познаник: упознат, буквар
грешка: погрешно
na-osnovu: база, uslovi
ауто: воз
нико: bilo-ko, ništa
енергија: снага
огољен: отворено, Бар, срамота, шупаљ, ћелав
делимично: на-пола-пута, део, нешто
боја: боја
безбедност: безбедан, спас, нега
опис: описати, информације, дескриптор, дефиниција
заспао: сан
кап: потапање, pasti, цурење
бриљантан: славан, сјајан, veliki
кратак: акроним, кратак
сив: браон, пепео
високо: веома
узбуђен: узбуђење, изиритиран
очајање: фрустрација, несвестица
ублажити: удобност, смањити
укупан: бруто, све
љубазност: врлина, милост
круг: циклус, стан, круг, точак
туп: бушотина
намера: nameravam, сврха
термин: uslovi, семестар, rok
темељно: комфоран, потпуно
применити: употреба
рад: рад
интелигенција: интелектуалац
штрајк: напад, упечатљив
поштено: потпуно, dovoljno, веома
у-складу: susret, слушати, садржина
догађај: случај, прилика, шоу
нежно: мек, љубазно
веза: везник, privrženost, позив
заштита: заштитити, склониште, нега
свестан: будан, намерно, осећај
издање: трошак, штампа, публикација, дозвола
лет: птица, летети, соар
разноврсност: врста, разноврстан
одвојено: одвојен, далеко, осим, независно
грозан: страшан, штета
сви: све, bilo-ko
rad: рад
љубавник: драг, девојка
певање: песма
жељан: жеља, нестрпљив, радознао, забринут
захтевати: питати, захтев, инсистирати
сваки-пут-кад: kada
успешан: успех
подићи: проширити, дизање, povećati, расти
развој: напредак
хладан: хладан, lep
суђење: сонда, процес, суд
inostranstvo: страних, изгнанство
одан: лојалност, веран
књижевни: литература
писац: аутор
Стоцк: штап, улога, акција
тип: врста, писати, преса
много: богат, redundancija, dovoljno
избегавајте: спречити
фаворизовати: страна, милост, подстичу
ментални: интелектуалац, ментално, унутрашњи
став: поглед, стајати, гест, приступ, зависност, став
дивљење: похвала
анксиозност: забринут, страх, преокупација, узбуђење
научити: знати, учити
видљив: знати
водити: упутство, доказ, вожња
актуелан: виртуелна, чињеница, краљевски
бедан: неадекватан, тужан, несрећан, беда, беспомоћан
штета: зло, штетан, повреда, штета
помиловање: опростити, извините, izvinjavam-се, милост
ретко: ponekad
запис: регистрација, диск, спасити
маст: уље, дебео
раван: стан, месања, план
поклон: nagrada, присутан
храм: кућа, катедрала
лиценца: дозвола
пристанак: одобрење, дозвола
довољно: пун, dovoljno
рана: повреда, рањен, чир
одважан: храброст, храбар
било-куда: негде, свуда
сведок: доказ
будаласт: неук, будала
bilo-ko: bilo-ko, ма-ко
Селф: приватан, себе, властити
екстремно: веома, необично
лечење: терапија, нега
грло: врат, соар, краставац
пацијент: болестан
раст: povećati
количина: квантни, маса, гомила, доза, број, величина
озбиљан: строго, насилан, тврд
изговор: опростити, разлог, прелазан, извините
порекло: оригиналан, природа
публика: пасиван, јавни
остали: остаци
pobediti: успех
собарица: слуга
меко: мек, миран
реалност: чињеница
сајт: сцена, вебсајт, место
једро: брод, вео
продавница: продавница, складиштење, спасити
примедба: изнео-мишљење, обзир
пауза: пауза
вредан: вредност
стога: тако, дакле
биљка: расти, дрво, млин
лед: снег
апсолутан: пун, потпуно
спремно: lako, ускоро
жестока: оштар, насилан, тврд, окрутан, грабљивица, дивљи
бес: љутња
откриће: našao, претраживање, изум, отварање
повезан: повезан
казна: реченица
мало: мало, lako, нешто
мистериозан: тајна, нејасан, невидљив
нијанса: сенка, тон, нијанса
убиство: убити
емоција: осећај, страстан
разарање: рушевина, уништити
ужас: страх
Локална: локално, унутрашњи, место
домет: разноврстан, растојање, комплет
домаћин: војска, гост, гомила
мокар: киша, влажан
мистерија: тајна
поседовати: властити, сносити
свест: рационалност, осећај, савест
раније: pre-toga
производња: произвести
палуба: мост
имање: imovina
владати: краљ, Роиалти
сагласност: следити, адаптација
њен: његов
несрећан: na-nesreću, случајност, несрећан, штета, неадекватан
цвет: провести, интерес, блато
хвала: захвалити
припадати: imovina, uključujući
тржиште: купити
капа: шешир, плута
Одушевљени: срећан
домаћинство: породица, кућа
флота: брод, морнарица, пловак
беба: деца, лутка
регија: поље
тачан: брашно, правилно, пун, пажљив
слика: слика
сумња: сумња, сумњив
одбити: порећи, вето, отпадни
одговорност: дужност, кривица
посрамљен: срамота
оброк: храна, јести, брашно
статус: положај, услов
указати: унети, шоу
песма: поезија, песма
устати: појављују, расти
путовање: сафари, експедиција
присуствовати: придружити
приуштити: купити, дати, сносити
поклонити: допринети, дати
посао: рад
поступити: наставити, povećati, напредак, проћи
žaljenje: извините
ризик: опасност
брз: ускоро, окретан
посебан: одвојен, разлика
прописно: правилно, комфоран
слава: похвала
једнина: јединствен, јединица
грешка: погрешно
углед: похвала
žalba: нацртати, позив
недостатак: рез, погрешна, одсуство
насиље: насилан
учинити: uradite, увести, дати
каријера: професија, рад
дизајн: концепција, план
предлог: реченица, предложити
потпун: изговорити, пун
резолуција: одлука, закључак, анализа, проширити
резервни: наизменичан, додатни, заменити, копље
домаћи: грађански, унутрашњи, резидент, државни
упућивање: референтна, меморија
постојати: присуство, присутан
pitanje: проблематичан, uslovi, проблем, предмет, питање, емисија
пружање: обезбеђен, дати
пламен: ватра
незнање: неук, игнорисати
povremeno: ponekad, поновљен
летећи: летети
тканина: тканина, одећа
добит: предност
четврти: четири, Среда, соба
звоно: алармни, сат
корист: предност
поглавље: врата, део, глава, сезона, капитал, себе
рупа: бушотина, јама
разуман: правилно, мудар, рационалан
шећер: пијанство, начин
замена: заменити, уместо-тога, џепарац, наизменичан, размена
потисак: инсистирати, книт, платити, гурање, импулс
Ram: скала, правни, хитац
супстанца: предмет
e-маил: послати
подела: део
ропство: роб
стих: поезија, став
вероватан: можда
болан: горак, бол
заувек: увек, вечан
океан: море
задњи: после, назад, преокренути
лидер: глава, менаџер, диригент, упутство
оштар: nameravam, забринут, оштар
срећа: судбина
очигледан: очигледан, аксиом
пожурити: ускоро, теле
шема: план, стрипед, графикон
бескористан: отпадни
ипак: иако, поред-тога
гладак: мек
солидан: демонстративан, утврђен, иако, компактни
обавезно: морати, неопходан
изградити: створити, зграда, формулисање
покушај: покушати, убод
еквивалент: исти
скорашњи: недавно, модеран, последњи
путовање: посета, туризам
подне: поподневни, југ
nalazi-se: pasti
објава: оглас
прекид: спречити
околност: услов, коверат
шатор: кабина, сцена
чести: поновљен, често
наглас: глас
независан: независност, лабав, независно
суштински: неопходан, спајалица
посматрање: посматрати
захвалност: захвалити
сачувати: задржати, складиштење, заштитити
аспект: елемент, страна
страх: страх, фобија, уплашен
паметан: вешт, мудар
округ: живети
неуспех: изневерити, погрешно, стечај, побачај
цент: пени, проценат, сто
осећање: осећај
заступник: значити
очајан: несвестица
унија: савез, јединствен
одобрити: признати
ударити: умножити, шут, успех
огроман: veliki, масиван
осуда: реченица
грозница: ватра, грип
лечити: терапија, процес, лечити
наш: пролеће, нас
у-заблуди: погрешно, злоупотреба, погрешна
идеалан: боље
навала: гомила, moždani-udar
исправан: правилно, jel-tako, веран, поправити
вршити: шоу, uradite
na-neki-način: нешто
појам: концепција, конотација, идеја
дискусија: дискутовати, расправа
чврсто: утврђен, иако
стабилан: стандардни, поправити, доследан, трајан
царство: краљевски
перо: оловка, глава
дозвола: дозвола
одржавати: држати, заштитити, задржати
препун: гомила, густина
ограничење: граница, уздржавање
ужасан: страшан
лука: лука, врата
искусан: искуство, вешт, експерт
супротан: опозиција, супротан, за, упоредан
споразум: меморандум, споразум
доћи: доћи
тражи: moliti, претраживање
практично: скоро, заиста, практичан
траг: ознака, вето
весео: срећан, смешан
аранжман: ред, распоред, организован, споразум
западни: западно
притисак: истицање, штампа, гурање, тежина
политика: политички
научни: Nauka, научник
заслуга: похвала, квалификовати, вредност
интервју: посета, анкетар
територија: поље
секс: пенис, полни, шест
стварање: створити, формулисање, утврђен
стаза: ознака, избор, начин
изглед: nadati-se, вероватноћа, визија, сцена
операција: заношење, процес, акција, хирург
дубок: дубоко
utakmica: коцкање, подударати, случајност, rasa
униформа: хаљина
дуг: кривица, религија, дужност, кредит
подухват: авантура, инвестиција, privredno-društvo
извршење: акција
расположење: осећај, хумор, распоред
посада: особље
опазити: разумети, концепција, видети
прогласити: објаснити
верзија: копија, mobilni
непаран: чудан, необично
захвалан: захвалити
бесконачан: вечан, инфинитив
безбедност: безбедан, нега
разуман: мудар, рационалан, осетљив
колиба: колиба, кабина
капацитет: u-mogucnosti, вештина, обим
населити: остати
умешан: ангажован, придружити
савет: савет
преглед: сонда, проверавати, изабрати
челик: гвожђе
проба: проверавати, покушати
милосрђе: ljubav
пролити: сипати, бацити
комуникација: преписка, везе
неко: ма-ко, лице, bilo-ko
ред: линија, редни, комплет, влада, ред
сиромаштво: слаб
интензиван: ивица, екстреман, насилан
свађа: борба
доступан: обезбеђен, присутан
отпорност: опозиција
неуобичајен: необично, заједнички
напуштен: напуштен, пустиња
глас: изабрати, глас
подносити: сносити, присталица, последњи, патити
успети: успех
нога: нога, кост
понуда: предложити, захтев
унутрашњост: унутрашњи
лако: lako, светло
prikaz: шоу, експонат, екран, сцена, доказ
ограничен: ограничен, само
циљ: сврха, фокус
критичан: неопходан, критичар
торба: џеп, врећа, корпа
понављање: понављање, назад, поновљен
стаза: монитор, песма, начин, следити
пребивалиште: склониште
забава: срећан, смешан, забава
бранити: заштитити
тешко: тежина, озбиљно
ствари: садржина, роба, ствар
одељак: део, дисекција
poravnanje: споразум, склониште, регулација
tanjir: табла, диск, диско
савладати: цопе, прекорачити, победити
терен: разлог, uslovi, мотив
мермер: камен
способност: u-mogucnosti, вештина, таленат
талас: талас, нејасан
људи: људи, популаран
могућност: вероватноћа, u-mogucnosti
maslac: уље
мржња: презир, мрзети
тежња: претраживање
повући: нацртати, маказе
знак: гест, ознака, лозинка
безбедно: безбедан
спалити: спаљен, дим
лекција: образовање, предмет, курс
годишњи: година
картица: картон, карта, кратак, папир
апликација: употреба, софтвер, захтев
интелигентан: интелектуалац, мудар
округ: бојкот, регионална, град, земља
формат: образац, бацити
проток: поток
штета: рушевина, повреда, штета
штавише: додатни, чак, више
трговина: трговина
јужни: југ
спољни: напоље
srednja-vrednost: секундарни, значити
наг: срамота
очигледан: очигледан, отворено, аксиом
темељ: база, платформа
брига: нега, забринут, повезан, интерес, преокупација
магија: шарм
кампања: покрет, експедиција
либералан: великодушан
обично: заједнички, често, обично
лов: лов
учитељ: аутор
ускоро: ускоро, кратак, скоро
благослов: благословити
сићушан: мало, микро
оштро: брзина, оштар, озбиљно
grudi: груди
дубина: дубоко
перформансе: шоу, продуктивност
просперитет: цветати, успех, благостање
службеник: запосленик, званичник
odluciti-se: одлука, одлучан, одлучујући, супстанца-која-се раствара
жртва: лов, жртвовање, путарина
мотив: nameravam, мотив, моторни, сврха, подстицај
одређен: одлучан, очигледан
тенденција: карактеристика, миља, распоред, заношење
завршити: готов, боја
застава: барјак, знати
администрација: правило, управљати
ретко: редак
прави: виртуелна, оригиналан
тренинг: образовање, настава
лоше: погрешно, веома, горе, зло, болестан
напајање: јести, подстичу, храна
централни: центар, федерални
kontrast: упоредан, опозиција, конфликт
структура: зграда, структурни, организација
плаћање: платити
темпо: брзина
истрага: сонда, захтев, претраживање
gde-god: где
дуговати: крив, дужност
руковати: процес, управљати, цопе, манипулација
путовање: посета, сафари, разгледање, експедиција
пуцати: хитац, изгнанство, емитовати
запослење: незапослен, преокупација, рад
сечење: рез
одолети: опозиција
одредити: Детерминер, одлучан, одлучујући, наметнути, поправити
трговац: трговац, пословна-особа, трговина
живо: живети
поветарац: ваздух
u-odnosu: рођак
тиме: тако
снабдевање: увести, обезбеђен, благостање, расподела, распоред
у-погледу: o-tome, обзир
одабрати: изабрати, узети
upropastio: уништити
доставити: дати, увести
неочекиван: изненађење
radni-sto: табела, канцеларија
трака: линија, група
представљати: представник, пример
угледан: част
одговорност: дужност, кривица
разочаран: амбиција, разочаравајући
погодан: подударати, правилно
зависити: зависност, граница
џин: veliki, чудовиште
схватање: разумети, уграбити
стићи: доћи, постићи
једноставност: једноставан, понизност
jesen: pasti
одсутан: одсуство, далеко
суморност: мрак
сумњив: Претпостављам, сумња, сумњив
одлучност: одлучан, одлука, извештај, дефиниција
основа: база, uslovi
испитати: посматрати, проверавати, анализа
награда: nagrada, премија
куповина: купити
неко: лице, bilo-ko, иако
схватити: постићи, разумети
пораз: победити, огрлица, изневерити
криминалац: крв
глуп: будала, неук
опозив: запамтити
занимање: рација, професија, занатски, агресиван
дискурс: модеран, разговор
помоћи: pomoć, подршка, сарадња
продаја: аукција, продати, попуст
позив: позвати, позив
инфериоран: неадекватан, доле, горе
препознати: признати, дијагноза
портрет: слика
предложити: предложити, претпоставити
разочарење: фрустрација, амбиција, антиклимакс, разочаравајући, рачунати
конструкција: зграда
ревност: ентузијазам, марљивост
одговоран: дужност
лек: терапија, лечити, нега
обухватити: uključujući, унети, укључење, разумети, садржина
задовољити: susret, задовољан, садржина, размазити
агонија: горак
глуп: лудак, неук, будала
уживање: уживати
сакрити: сакрити
прецизно: правилно, пун
претпоставити: moliti, претпоставити, обзир
процена: процена, Претпостављам
рута: начин
посетилац: путник, гост, посматрач
не: не
жица: линија
углавном: посебно, у-великој-мери
nesvestan: несвестица
заједнички: један-другог, заједнички
спољни: напоље, страних
свемир: космос, свет
сат: сат
упутство: настава, правац, упутство
болан: чир, болестан, бол
дисциплина: предмет
увод: увести, обезбеђен, промоција, буквар, увоз
дивљина: пустиња
збуњен: нервозан, фрустрација
венчање: u-braku
u-ime: представник, страна, милост, део
рачунати: веровати, рачуница, рачунати
несигуран: несигурност, нестабилан, нејасан
ангажовање: ангажован, номинација
прљав: емисија, бруто
лекар: доктор
покрива: покривен, укључење, кров, замотати
искрен: поштен, заиста, истинит
сензација: осећај
специфичан: посебно, приватан, експерт
gostionica: хотел
крут: тврд
пратити: следити
скор: ознака, извештај
девица: ћерка
глад: гладан
фаворит: фаворит
царина: традиција, инч, дужност, обичај
impresioniran: осећај
плен: лов, пљачкати, жртвовање
музички: музика, музичар
задовољавајући: болест
смешан: неук, смешан
лист: папир, лист, летак
срамота: срамота
оригинално: оригиналан
плата: платити
обиман: распрострањен, дубоко
Slobodno-vreme: забава, празан, пензионисати, релаксација
брада: брада
сјај: блесак, светло, зрачење, блиц
љубомора: љубоморан
железнички: железница, воз
фунта: књига
источни: источно
грађанин: грађански
плажа: обала
одлика: елемент, карактеристика, imovina
резерва: задржати, књига
урлик: бука
чудно: чудан
кора: кора, кожа
пријем: Dobrodošao, признаница
пријатан: непријатан, врста
пробудити: будан
истраживање: анализа, претраживање
монарх: цар, краљ
одећа: тканина, хаљина, одећа
болест: болест, болестан
лакрдија: šala, иронија, смех
коментар: објаснити
метал: гвожђе, минерал
rešenje: поправити, одлука, одговор
дуван: цигарета, дим
ентитет: инструмент, јединица, присуство, организација, privredno-društvo, лице
отићи: одлазак, одступити, пукотина, ићи
горко: горак
миран: миран
узнемирен: забринут
трик: регрут, газити, будала, манипулација, лукав
финансијски: новац, економски
припрема: pripremiti
љуска: махуна, кора, кожа
гнездо: живети, утичница
замислити: концепција, разумети, мислити
именовање: номинација, обећање
донети: довести, повратити, узети
свећа: светло, восак
прекршај: напад, злочин, маса
мешавина: помешан
модел: пример
мана: кривица, бора, инвалидитет
приговор: неслагање, опозиција, контрадикција
занат: уметност, занатски, вештина
занемарити: игнорисати, напуштен, пропуст, бојкот
подаци: информације
оружје: оружје, топ
розе: ружа
корисник: o-tome, корисник
деда: предак, деда
nula: нула, празан
енергичан: насилан
муња: електронски, завртањ, блиц
спорт: покрет, вежба
прах: брашно, прашина
слика: слика, табла
узвик: бука, нож, плач
немаран: немаран, равнодушност
извод: извести
улаз: врата
погодан: једноставан, практичан, комфоран, lako, правилно
пошта: пошта, писмо
боја: боја
предаја: традиција
успоставити: увести, утврђен, поправити
благ: мек, светло
брзо: једном, правилно
одељење: део
заслужују: вредност, квалификовати
одустати: напуштен, појављују, пукотина, бацити
уверење: осигурати, кауција
огледало: стакло
земљиште: завера, план, прича
нагоре: више
нажалост: тужан, na-nesreću
скроман: заједнички, једноставан, понизност, штедљив
јело: суд, храна, јести
нето: web, истинит, свети
топлота: ентузијазам, топао
немиран: забринут
експеримент: пилот, искуство, покушати
данас: дан
огроман: страшан, veliki, масиван, веома
побољшање: реформа, поправка, напредак, опоравак, лечити
расправа: неслагање, расправа
предлог: предложити, реченица
mogu-biti: можда, mogao
пушка: топ
штит: заштитити
запослити: закуп, употреба
супротно: разноврстан
опоравити-се: спасити, повратити, опоравак
prijatelj: ражањ, колега, пријатељ
urediti: ред, доносити-законе, организован
одбор: табла, комисија
стар: стар
duh: душа
Откровење: израз
препознавање: признати, исповест
глина: блато, кртица
стабло: племе, пртљаг, чизма
управљање: управљати, вожња
повратити: задржати, назад, опоравак, повратити
протест: опозиција, марш
гомила: депонија, улог, гомила
умерен: секундарни, значити
чаролија: шарм, правопис
област: поље, регионална, површина
формалан: званичник
уредник: аутор, издавач
признати: исповест, признати
лек: медицина, терапија, поправити
гонити: размазити, монитор, провести, следити
пол: извините, колона, екстреман, пупак
виталан: неопходан, одлучујући, кључ
председник: глава
штићеник: крило, регионална, део
Gospođa: 
навијање: срце, ентузијазам
оправдан: рационалан, jel-tako, оправдати
дивити-се: похвала
отворено: експлицитно, отворено, отварање
модификација: промена, адаптација
драматичан: драма, демонстративан
горе: изнад, горе
разнолик: разноврстан
силазак: природа
завист: љубоморан
оптерећење: тежина, напрезање, Бар, племе
pretvarati-se: симулирати, драма
интерни: унутрашњи
завеса: вео, екран
здрав: здравља
нејасан: нејасан, помрачење
центар: центар
такмичење: rasa
изменити: претворити, промена, заменити
светлуцање: поглед, визија
ugovor: меморандум, ред, држати, споразум
чување: спасити, складиштење, економија
niz: конопац, ланац, комплет
комбинација: случајност, помешан, комплет, позив
ухапсити: причврстити, концепција
температура: топао
строг: строго, оштар, тврд
професионалац: професија, занатски
повређен: рањен, повреда
суседство: који-окружује, живети, еколошки
пушење: дим, цигарета
медицински: доктор
обавестити: новине
истакнут: популаран, памћење, значајан, кључ, познат
институција: организован, privredno-društvo, организација
паковање: замотати, затворити, паковање
бол: горак, беда, бол, туга
очито: очигледан, отворено, експлицитно
хватање: заробити, узети, концепција
обиман: dovoljno, неадекватан
спаваћа-соба: соба
потпуно: само, потпуно, свети
заједнички: заједнички, помешан, позив
упутити: референтна, консултовати
идентификовати: идентитет, идентификовати, поправити
клупа: банка
спашавање: опоравак, спасити
граница: граница, скратити
очекивање: очекивати
програм: план, дневни-ред
електрични: електронски
размак: привремен, пауза
потера: лов
окупирати: узети, уграбити
хаљина: капут, хаљина, odelo
закључати: замак
предлог: предложити, реченица, план, закључак
сретно: срећан
следећи: следећи
несигуран: нестабилан, непријатан, забринут, тврд
сјај: блесак, блиц
машина: механички, машина, механизам
атрактиван: магнетни, нацртати, пожељан
производ: роба
болест: болест
мотор: моторни, машина
њихов: они
кожа: кожа
суптилан: микро, танак
нагиб: миља, потапање, савијен
брига: забринут, преокупација
жестоко: тврд
наведено: одлучан
дрво: дрвен, штап, дрво
израчунати: рачуница, рачунати
убијање: убити
смешан: чудан, смешан
увреда: презир, срамота
неспособан: u-mogucnosti
вечерати: јести
осетљив: осетљив, кључ
апетит: жеља
учтивост: учтив, част
сфера: поље, лопта, регионална
почасни-израз: част
кривица: крив, злочин, кривица, грех
укусан: укусан, укус
пшеница: фолклор, зрно, кукуруз
хумор: хумор
сусрет: цопе, susret, датум
сутон: зора
парк: башта
привреда: економски, економија
управљати: управљати, правило, мајстор
формација: образовање, формулисање
мршав: миља, танак
куцати: оклевати, Пат, победити
јединство: јединствен, јединица, солидарност
главни: пионир, кључ, родитељ, veliki, спајалица
прелиминаран: отварање, оригиналан
граница: граница, ивица
дисати: дах
ослобођен: бесплатно, ослободити, опростити
богат: богат
инспирација: импулс, инспирисати
свако: све
обилан: богат
сликар: уметник
наочаре: стакло
пуцање: хитац, лов
вагон: воз, тролејбус
позајмити: дати, кредит, цитат
предузети: почетак, uradite
печат: прстен
свештенство: свештеник
постоље: инсталирати, povećati, брдо
ред: колона, комплет, ред
магазин: преса
груб: тврд, строго
упркос: иако
тесан: строго
пејзаж: сценарио, еколошки, визија
напустити: напуштен
уметнички: уметност
углавном: посебно, у-великој-мери
одан: лојалност, поштен, веран
одговара: подударан, подударати, правилно
саветовати: савет, саветник
стабилан: утврђен, одлучан, стандардни
максимум: максимално, екстреман
извршити: обећање, uradite
утицати: ефект, импресионирати
сељак: пољопривредник
знатно: веома, значајан
продужити: детаљ, проширити, растезање
лично: појединачно, приватан, властити
моралност: моралан
побуна: побуњеник, револуција
навој: линија, Спин
бакар: месинг
одговор: реакција, одговор
царски: краљевски
празан: празан, шупаљ, бео
малолетник: секундарни, мало, рудар
погодба: трговина, прилика
умор: уморан, напрезање
не-волети: презир, мрзети, опирање
нормалан: заједнички
скица: контура, план
врли: врлина
U-svakom-slučaju: поред-тога, већ
возач: возач, вожња, диригент
декларација: оглас
вишак: додатни, redundancija
одвајање: раздвајање, растојање, одвојен
гађење: презир, фобија, мрзети
праведно: исти, правилно
руља: гомила, маса
непотребан: отпадни, морати
крзно: кожа, капут
охрабрити: инспирисати, гурање
данак: закуп
ослободити: смањити, ослободити, опростити
законодавство: доносити-законе, правило, законодавство
пројекат: план
вила: анђео, плава, вила
закључити: држати, закључак
срећан: срећан
круг: колено, кецеља, круг
покварити: пљачкати, рушевина, покварити
одговоран: lako, склони, осетљив
пажљив: пажљив, забринут, мудар
повољан: подударан, flex, пожељан
калај: банка
зависан: зависност, привржен, запосленик
налог: осигурати, оправдати, меморандум
жалба: бео
конвенција: меморандум, споразум
угао: угао, полигон
широко: распрострањен, веома, обично, у-великој-мери
крава: стока
предрасуда: мрзети
трем: сала, балкон
изненађујуће: чудан, задивити, изненађење, упечатљив
фонтана: извор
прикладан: правилно, odelo, доследан
сигуран: храброст, безбедан, веровати
оргуље: инструмент, члан, елемент, тело
избор: изабрати, номинација, избор
страхопоштовање: фобија, страх
упоредити: поређење
односе: причврстити, кука, везе, повезан
претпостављати: веровати, Претпостављам, претпоставити, обзир
нестао: изгубљен
модеран: модеран, елегантан
позитивно: позитиван
расуђивање: идеја, расправа
узнемирити: нервозан, агресиван, ометати, досадан
ортак: девојка, заједнички, акционар
удружење: везник, обзир
братаница: братанац, унука
телесни: физиолошки, тело
факултет: колеџ, факторијел
топ: лопта, артиљерија, топ
једрење: брод, вео
паметан: мудар
ситан: прстен, тривијалан, мало
опрез: упозорење, нега
рукопис: рачун
ратник: херој
течност: вода
концепт: концепција, конотација
посебно: посебно
скок: летети, плес, пета, скок
невољан: nameravam
екстра: додатни
нагиб: тротоар, тон, не
неспретан: неадекватан, чудан
ценити: аплаудирати, уживати
преживети: живети, остати
u-kratkim-crtama: акроним, кратак
пиринач: месинг
момак: лице
понашање: карактеристика, понашање
усвојити: претпоставити, узети
правилно: често, поновљен, трајан, правилно
истрага: сонда, претраживање
уставни: устав
најновији: последњи
ученик: ученик
потпуно: потпуно
уврнут: савијен
разликују: одвојен, разлика, разноврстан
катастрофа: рушевина
опклада: улог, услов, вето
сиров: живети, извор, бруто, zelen
лог: унети, регистрација, клуб
гостопримство: великодушан
колица: воз, тролејбус
хаљина: хаљина
ангажовати: привржен, употреба, закуп, задржати
стадо: стадо
прикупити: окупити
тигањ: лонац
напад: напад, рација
преварити: будала, издати
жалост: туга
повући: ослободити, нацртати, пензионисати
мелодија: песма, хармонија
саосећање: емпатија, штета
прерушити: сакрити
транскрипција: копија
документ: фајл
комшија: који-окружује
блокирање: спречити, обим
обавеза: дужност
пад: порећи, pasti
амбициозан: амбиција
одмор: одмор, гозба
песница: први
орао: Јастреб, Тие
частан: част
значајан: неопходан, значајан, упечатљив
густ: компактни, дебео
фикција: роман, машта, прича
препоручити: предложити, увести, савет
образовни: образовање
нагоре: више, изнад
рог: кукуруз
фонд: кутија, капитал
ложа: колиба, фајл, кабина
костим: хаљина, odelo, обичај
карта: закуп, ићи, карта
аплауз: аплаудирати, одобрење
подсетити: запамтити, личити
јастук: река
нигде: место
леш: тело
суштина: mobilni, створење
надморска-висина: стрм
царство: поље, свет
степениште: степенице, скала
споразум: меморандум, компактни, odelo, подударати, споразум
чипка: шиљак, приход
учењак: ученик, научник
владар: војвода, гувернер
луд: лудак, будала
забавити: Dobrodošao, забавити, забава
поздрав: Dobrodošao, разгледница
женски: женски
монструозан: чудовиште, страшан
постројење: опрема
опљачкати: украсти, пљачкати
мердевине: степенице, диригент, скала, школа
завршни: последњи
Дивиде: разлика, делити
neverovatan: чудан, необично
свод: лук
изабрани: избор, изабрати
стидљив: снебивљивост, срамота
магла: измаглица
обојен: боја
упозорити: упозорење, изазвати
плитак: дубоко
охрабрење: подстицај, удобност
неправилан: заједнички, необично
верно: лојалност, веран, правилно
пренос: превод
основни: база, спајалица
сноп: затворити, влакно
трагичан: страшан
преглед: ревизија, критика
ужасно: страшан, веома, горе
кување: кувар, кухиња
побуна: побуњеник, револуција
побољшати: поправити, лечити
олупина: уништити
убедити: убедити, осигурати
чинија: шоља
илустрација: пример, слика
нерв: вена, храброст, нервозан
старе: поправити
констатовати: знати, осигурати, одлучан, проверавати, поправити
залог: осигурати, обећање, талац, кауција, пешак
зарадити: служити
одабрати: изабрати
индустријски: индустријализација, индустрија
тумачење: превод
изазов: позив
забранити: спречити, порећи
тема: мотив, предмет
улаз: признаница
базен: базен, јама
конференција: седница, монтажа
једнакост: аналогија, равнотежа, еквиваленција, једначина
ново: neo, недавно, роман
окружење: еколошки, који-окружује
инвазија: напад, рација
образац: пример, једном, стандардни, образац
открити: открити, издати
реши: лабав, поправити
проповедати: проповед
бака: невеста, деда
вуна: памук
комуницирати: дијалог, социјализовати, везе
u-suštini: uslovi
противе: опозиција
примерак: пример
вући: нацртати, маказе
усев: усеви, жетва, рез
тачан: правилно, брашно, пажљив
одмаралиште: узети, склониште, пауза
одбијање: порећи, отпадни
веза: кључ, кауција, копула
саосећајан: штета
плата: платити
непрекидан: наставити
узбудити: изазвати, подстицање
дивље: дивљи, насилан
туга: туга, трагедија
савезнички: јединствен, повезан
plafon: ћебе, кров
циљ: фокус, сврха
готовина: новац
празан: отворено, бесплатно, празан, лабав, нејасан
презирати: презир
травњак: трава, ливада
Турска: 
комшија: који-окружује
крајњи: последњи, екстреман, коначно, спајалица
подношење: слушати, послати
улазак: унети
темељан: дубоко, пун
узбудљив: нацртати, радознао
победа: успех
конзервативан: pravoslavan, гувернер
одушевљен: ентузијазам, забринут
доле: доле
чир: кувар, чир
лепо: лепота, lep
сутра: јуче
неудобан: забринут, непријатан
апарат: опрема
тврдити: инсистирати
исказ: изговорити, израз
шина: железница, воз
несавршен: пун, инвалидитет, погрешна
стећи: аквизиција, извести, купити
офанзива: рација, напад, агресиван
хладно: хладан
предавање: курс
при-чему: где
перцепција: осећај, поглед, концепција
razviti: разрадити
функција: церемонија, рад, активност
метак: таблета, хитац, лопта
везати: причврстити, граница
идентичан: исти
знатан: демонстративан, veliki, значајан, упечатљив
najveći: маса, величина, обим, тумор
продужен: дугачак, развлачити
iznerviran: изиритиран, непријатан
узнемирен: нервозан, тужан
група: копула, група
сено: трава, слама
дебата: неслагање, расправа
тишина: тишина
делимичан: изузетак, део
говедина: месо
ујединити: солидарност, појас, помирити, придружити
сечиво: лист, мач, нож
фабрика: млин
nula: нула, празан
часопис: новине, преса
поштено: лојалност, поштен
легитиман: правни
акценат: изговорити, истицање, фокус
искрено: озбиљно
лига: савез
одобрити: одобрење
уд: члан, екстреман
управник: менаџер, слуга
еволуција: реформа, еволуциони
anketa: проверавати, претраживање
савремен: модеран
скандал: корупција
намеран: намерно
симбол: нотација, гест
прање: прање, веш
прецизан: правилно, брашно, пажљив
догађај: случај, прилика
вратило: јарак, раме, дрво
стабљика: суво, племе, корен
корпорација: privredno-društvo, организација
предност: привилегија, више-волети, предност, изабрати
нагон: изазвати, импулс, жеља
уклањање: растојање
тврдња: одобрење, истицање
приступачан: посета, našao
комедија: хумор
руменило: боја, узбуђење
код: двориште, шифрирати
адекватан: dovoljno, правилно
сплит: делити
историчар: историјски
интензитет: густина, напрезање
демократија: република
вероисповест: исповест
атракција: шарм, гравитација
концерт: фестивал
надоле: доле
канал: канал, цев
брз: ускоро, захтев, окретан
бронза: месинг, браон
одевни-предмет: одећа
покајање: тужан, штета
ексклузиван: монопол, приватан
носач: nositi, носач
цртица: линија
трака: група
на-крају: коначно
тим: припев
скуп: драг
штаб: седиште, центар
акутан: оштар
збуњен: нервозан, срамота
потомак: деца
мрежа: web
авион: птица, површина, машина
делимично: део
поносно: понос
тераса: балкон, кров
дршка: држати, замка
експлозија: прасак
чета: војска, војни
чврсто: строго
казна: штета, реченица
прљавштина: влажан, измет, блато
доба: сезона
амбасадор: гласник
раса: умножити, rasa
мешање: ометати, мука, поремећај
sastojati-se: проћи, садржина
прихватање: прихватљив, одобрење, признаница
инжењер: механички
застој: нога
алтернатива: наизменичан, заменити
печат: прстен
бројач: диск, опозиција, супротан
Венера: петак
имагинаран: машта
пењање: расти, Црееп
привући: нацртати, импресионирати
задивљујући: изненађење, упечатљив
конкуренција: супарник
кристал: стакло
туш: купатило, киша
филозофски: философ, философија
бучан: бука
уређај: опрема
превоз: саобраћај, шатл
konačno: коначно
ужасно: веома, страшан
размишљање: одразити, одраз
proizvodnja: индустрија, произвести
удобно: комфоран
изложба: експонат, извештај
пољопривредни: пољопривреда, фарма
трагање: претраживање
продужетак: детаљ, проширити
полемика: контрадикција, расправа
грубо: скоро
преко-главе: изнад
обуздати: инхибиција, спречити, уздржавање, задржати
чување: спасити, нега, задржати
паб: Бар
базен: долина, базен, лавабо
мелодија: тон
запослити: закуп
забринут: забринут, нервозан
старије-особе: старо-доба, стар
универзитет: колеџ
обазрив: пажљив
пре: источно, pre-toga
компликован: комплекс, тврд, разрадити
извињење: izvinjavam-се, извините
престрашен: уплашен, страх
заменити: наизменичан, џепарац, заменити
употреба: употреба
рестаурација: поправка, опоравак, повратити
ограда: ограда
основни: мајстор, база, оригиналан, спајалица
зрак: зрак
турнеја: посета, експедиција
претеран: со
надлежан: омогућити, u-mogucnosti
хитан: ускоро, убрзати
опрезан: упозорење, алармни, будан
пећ: пећ
заобљен: круг
конвенционалан: заједнички
навести: moliti, оправдати
врпца: конопац
уз: паралелно, следећи, везник
екстракт: цитат, сок
упаљач: светло
пинта: пиво
цев: цев
авенија: прилика
ефикасан: вешт, ефикасан, ефект
мешати: помешан, комешање
поремећај: поремећај, мука
извршни: менаџер
десети: десет
компаративна: поређење
ујутру: јутро, сјајан
кавез: замак, mobilni
затвор: затвор, ланац
вешт: вешт, лукав, u-mogucnosti
крик: плач
компромис: споразум, хармонија
муниција: хитац
асистент: присталица, pomoć
трска: штап
расправљати: дискутовати, инсистирати
логика: расправа, рационалан, рационалност
паника: страх
циркулација: вожња-бициклом, циклус, саобраћај, разгледање
стрес: напрезање
потрошња: употреба, потрошити, јести
одржати: подршка, задржати, држати, патити
судар: pasti, конфликт
нема: неадекватан, рез, погрешна
постепен: постепено
гужва: уништити, гравитација, бундева
феномен: случај, ствар
извршити: trcati, акција
поздравити: здравља, Dobrodošao, довикнути
монархија: краљевски, imovina
понашати: живети
баријера: препрека, праг
крива: лук
ослонити: рачунати
погодност: lako, удобност
јагњетина: овца, Црееп
логичан: рационалан
исхрана: храна
судски: суд, правни
неповерење: сумња, лојалност
перо: пролеће, штета
добровољан: волонтер
јакна: капут, џемпер
пливање: пливање
импресиван: упечатљив
испод: доле, после
провинцијалац: сеоски, провинција
компензација: надокнадити, џепарац
конобар: слуга
унапредити: убрзање, промоција, подстичу, гурање, допринети
посветити: nameravam
непријатељство: непријатељски
плантажа: фарма, jaslice
изложити: контура, открити, отворено
закрпа: место, privrženost
прекид: пауза, мука
палац: инч
револуционар: револуција
Neverovatan: чудан, задивити
врх: хемисфера, шиљак, екстреман, брада, врх, савет
претња: претећи, опасност
џунгла: шума
типичан: заједнички, карактеристика
гориво: уље
миран: миран
дестинација: понављање, сврха, судбина
игла: тајна, игла
Марс: марш
помоћник: повезан, колега, везник, заједнички, паралелно, привржен
злобан: неморалан, зло
банкет: гозба
детаљан: разрадити, дубоко, шарка, детаљ, пажљив
плакар: орман
zakonodavni: доносити-законе, законодавство
маржа: ивица, поље
шампион: херој
пулс: импулс
побећи: trcati, бекство
клаузула: поток, став
једињење: везник, комплекс
чвор: држати, книт
odnos: везе, извештај, обзир
агенција: организација, privredno-društvo, канцеларија
кез: осмех, гримаса
демонстрација: шоу, марш
депресија: туга
vozilo: машина
позајмити: кредит, цитат
оток: надути
тема: мотив, предмет, наслов
пресуда: одлука, правило
субота: субота
идентификација: идентификовати, идентитет, дефиниција
fotografija: слика, хитац
савезник: пријатељ, пријатељство, јединствен
расправа: начин, растезање, расправа
трака: група, филм
више: више
транспарентан: провидност, очигледан
парфем: мирис
сметати: проблем, ометати, досадан, мука
квалификован: u-mogucnosti, квалификовати, вешт
есеј: чланак, извештај
јахач: витез, јахање
усамљеност: усамљен
ручни-зглоб: рука
фино: мек, танак, коначно
nula: нула, празан
осудити: реченица
вилица: Бор
јединствен: јединствен
неизбежно: неизбежан
бубањ: плес, празан
bin: кутија, корпа
trajanje: привремен, трајан, време, дужина
вагати: мерити, тежина
манастир: опатија
објавити: публикација, делити, открити
увид: визија
дефинитивно: очигледан, строго, курс, заиста, експлицитно
смена: промена
вечерас: дан
фактор: разлог, запосленик, коефицијент
неред: агресиван, поремећај, забуна
пракса: вежба, акција
светилиште: олтар
психијатар: акроним, окупити
трошак: трошак, употреба, провести
охрабрујући: срце, инспирисати
излагање: израз, експонат, извештај, ефект
сиров: бруто, zelen
карта: барјак, карта
уназад: назад
ципела: ципеле, чизма
превара: илузија
експлозија: прасак
камин: димњак
тегла: стакло, боца, бацач, лонац
сос: прелив
труо: лењ, неморалан, слаб
понашање: карактеристика, понашање
зајам: кредит, цитат
неразуман: рационалан, бесмислица
пожуда: амбиција
сваке-године: година
течност: вода
дете: деца
луд: лудак, будала
оборити: сипати
достигнуће: успех, ранг, искористити
претпоставка: претпоставити, машта, наводно
шаљив: хумор, смешан
екстаза: ентузијазам
пензија: пензионисати, оставка, пензија
парламент: законодавство, сенат
хитан: забринут, криза
парцела: замотати, део, затворити
фиока: кутија, степенице
допринос: допринети, улог
линк: privrženost
одважност: храброст, изнудити
штампање: публикација, штампа, преса
адвокат: advokat, оправдати, оптужени
životna-sredina: атмосфера, еколошки
потврдити: доказати, осигурати, појачати
најавити: открити, публикација
оставка: оставка, пензионисати
одбити: порећи, вето
жилав: тврд, окрутан
фрагмент: чип, залогај, туча, растезање
медитација: нега, одразити
мрља: место
сахрана: сахрана, сахранити
хипотеза: претпоставити
хипотетичан-расположење: спекулативан-расположење, претпостављен-расположење, условни-расположење
трансакција: активност, трговина
срамота: љутња, презир, срамота
варирати: варијабла, разноврстан, заменити
адвокат: advokat, представник
увредити: крив
пакет: замотати, џеп, затворити
класик: класичан
ранч: фарма
пита: торта, ПИ
тачно: jel-tako, тачност, строго
бацање: бацити
морски: морнарица, море
певач: читач
elektricitet: електронски, поток
странац: страних, гост, ванземаљци
напукнут: прасак, пукотина
утучен: тужан, туга
густо: дебео
разумно: разлог, рационалан
кабл: шупаљ, flex
илустровати: објаснити, одразити
усвојење: одобрење, признаница
познат: познат
повредити: повреда
исправно: тачност, правилно, jel-tako
пашњак: врба, ливада
црв: маска, дубоко
процена: процена, Претпостављам
одећа: организација, одећа, опрема, хаљина
несрећан: несрећан, na-nesreću
осми: осам
опуштен: удобност, релаксација, миран
суседни: скоро, који-окружује
виши: ветеран, родитељ, глава
уплашити: алармни
учитељ: тренер
пљачка: пљачкати, украсти
трговински: трговина, трговачки
изумро: нестати
грумен: маса, плодиште, удубљење
случајан: случајан, привремен, случајност, изненађење
просторије: кућа, место, зграда, унутра
испорука: увести
закривљен: савијен, flex
продуктиван: произвођач, произвести
отечен: надути
гајити: подстичу, фарма
варијација: промена, разлика
противник: супарник, опозиција
унук: унука, братанац
ексер: нокти, шиљак, завртањ
доброчинство: великодушан, благостање, врлина, милост
прецизност: тачност
индикација: ознака
смањење: смањити, рез
стомак: стомак, пупак
згрожен: мрзети
саставити: писати, створити
путник: путник
убод: убод, горак, угристи
истовремено: у-међувремену
епизода: значајан, део
упоран: доследан, наставити, трајан
умирати-од-глади: гладан
консултације: консултовати, савет
кисео: киселина
нагласити: инсистирати, истицање
парада: марш
Kaciga: шешир
прогласити: пропаганда, публикација
смештај: хотел
спреј: медицина
формално: званичник
узнемирујући: нервозан, ометати, забринут, досадан
ишчекивање: очекиван, очекивати
разред: мост, коефицијент, ранг, процена, степен
столица: измет, столица
оправдање: оправдати
странац: страних, гост
транспорт: саобраћај, шатл
разумевање: разумети
директор: менаџер, глава
временски: привремен, време
лепо: lep
применити: наметнути, приморати, омогућити, полиција
обиман: дубоко, пун
претити: претећи
прогресиван: напредак, радикал
ресурс: извор
ограничити: ограничен, уграбити, скратити, смањити
честитати: похвала
осигурање: безбедан
именовати: око
прекидати: препрека, рез, ометати, ампутирати, пауза
угушити: угњетавати, спречити
слој: колона
индиција: доказ, кључ
зуб: зуби, зубар, удубљење
гаранција: осигурати, кауција
поступак: процес, механизам, акција, приступ
препорука: савет
раскорак: пауза, отварање
подразумевају: значити
причврстити: привржен, сплет, причврстити
држање: гест, индикатор, положај, стајати
апартман: крило, комплет, стан
драгуљ: благо, цветати
емотиван: осећај, страстан, осетљив
бетон: демонстративан, доследан
комбиновати: савез, везник
врх: врх
валута: новац, новчић
објективан: сврха, фокус
споменик: меморија, упозорење
одвојено: одвојен, разлика, појединачно, усамљен
послужавник: диск
хоризонтала: равнотежа
повеља: устав, папир, закуп
ставка: роба, чланак, елемент, глас, врста, положај
експанзија: детаљ, проширити
увити: завртањ, Спин, иронија
традиционалан: традиција, класичан
обухватити: uključujući, укључење, садржина
рутина: заједнички, механизам
решити: плуг, лабав, поправити
изазвати: зафркавати, изазвати
неуспешан: изневерити
политичар: политички
поклопац: кров
повреда: повреда
чвор: редни, прелаз
газда: власник, менаџер, послодавац, глава, лопов
хардвер: опрема
Странд: обала, група
ивица: ивица, литица, усна
роба: трговина, роба
резервисан: одвојен, далеко, даљински
азил: болница, склониште
потврдити: доказати, осигурати
распоред: табела, календар, графикон, распоред
ров: јарак
општински: град
побуна: комешање
сведочити: доказати
матерински: трудна, мама
скулптура: статуа
укус: укус
марка: упутство, ознака
пртљаг: пртљаг
ђубре: бесмислица, туча, депонија
алатка: инструмент
хаос: поремећај, забуна
гоњење: odelo
напет: нервозан, време
кокошка: пилетина
трим: украс, смањити, рез
дискретан: мудар
оплакивати: плач
дијалект: пољски
елементарни: база
теретни: пртљаг, Бар, kamion
обрисати: замах
порицање: порећи
подземни: тајна
средњи: проверавати
формула: једначина, преса
варати: будала, манипулација
утвара: оклевати, фобија
registrovati: листа, регистрација
неодређен: нејасан, аорист
вишак: додатни
језа: дрхтати
ткиво: организација, web, тканина
нацрт: контура
играчка: лутка, игра, коцкање
степеник: степенице, скала
прелаз: инфекција, промена, прелазан, прелаз
дугме: кључ
нељубазан: непристојан
програм: план, дневни-ред
производња: индустријализација, млин, произвести
зона: поље, регионална, група
девети: девет
алкохол: вино
похлепан: амбиција, похлепа
управљати: управљати
утицајан: ефикасан, пробити
surround: крагна, опсада
udaviti-se: лавабо, угао
клизање: клизање
крмача: расти, хлеб, свиња
доминантан: veliki, рација
руководство: хијерархија, упутство
дневник: новине, календар
прославити: убедити
фрка: узбуђење, бука, досадан, забуна
заменик: представник, наизменичан
аутомобил: моторни
амандман: ревизија, промена
вертикала: стајати, уздужни
недовољан: неадекватан, dovoljno
prokleti: танак
закључак: Претпостављам, закључак
инференцијалне-расположење: индуктиван-расположење
реклама: оглас, трговачки, пропаганда
крађа: украсти, плагирати
спонтан: инстинкт, произвољан
корисност: организација, употреба, инструмент
повезати: причврстити, кука, сплет, придружити
низбрдо: доле
интервенција: ометати
буђење: оживети, опоравак
Интернет: трговина
физички: физика, тело
тачка: место
шокантан: шок
непристојно: непристојан
уравнотежен: доследан
индекс: експонент, листа, индикатор
слати: послати, делити
ка: изнад, напоље, напред
Ćaskanje: разговор, статистика
ћилибар: жут
тона: тон
глатко: комфоран
напетост: напрезање, узбуђење
кит: избор
отрован: отров
концесија: померити, привилегија, попуст
радник: запосленик
нагиб: потапање, коњугатом
тоалет: орман
прекршај: напад, злочин
кивност: мрзети, освета
храброст: стрпљење, храброст
očekivati: nadati-se, очекивати
ритам: победити
пацов: миш
одговарати: преписка, odelo, правилно, одговор
задржавати: спречити, уграбити, задржати
протумачити: објаснити
салон: сала
оперисати: манипулација, рад, trcati, акција
одвод: олук, trcati
плата: платити
гадан: мрзети, зло, непријатан, разочаравајући, ружан
гробље: сахрана
гипс: креда
славина: цев, млеко
одбацити: врећа, игнорисати, порећи, вето, разликовати, redundancija, опростити
изазивати: узбуђење, изиритиран
становати: остати, живети
декорација: украс
ножни-прст: на-врховима-прстију, нога, прст, шапа
неспособност: инвалидитет, слабост
измислити: изум
дефинисати: Детерминер, разрадити, описати
ограничен: ограничен, граница
kredenac: орман, полица
рацк: полица
домар: диригент, инспектор
презентација: увести, шоу, експонат, промоција
гума: лопта, еластичан
искључити: лишити, избрисати, разликовати
привилегован: привилегија
пустињак: аскета
гребање: огреботина, почетак
шраф: завртањ
истражити: посматрати, искористити
осигурати: осигурати
цилиндар: диск
резиме: контура, апстрактан
невероватно: вероватноћа
рој: стадо, син
систематичан: механизам
практично: заиста, скоро, практичан
клијент: обичај, гост
каталог: листа, табела
хемија: хемијски
испећи: хлеб, кувар
пробити: убод, пробити, бушотина, пробушити
зграбити: pocepati, уграбити, киднаповати
лансирање: емитовати, бацити
пољопривреда: пољопривреда
глумица: глумац
позориште: театар, сала
лек: медицина
штетан: горе, nedostatak, преокренути, негативан, штетан
бомбона: нана, чоколада, сладак
паста: комплет, огрлица
осуђеник: замка, казнити, крив
истражити: сонда, посматрати, проверавати
пакет: замотати, комплет, затворити
пузати: Црееп, најежити-се
талас: pop, клик, слика, талас, ускоро
гума: ембрион, прстен
приметан: упечатљив, очигледан
језгро: база
предходник: предак
слично: исто-тако, исти
брана: прашина
клизав: клизање
трансформација: промена
реса: ивица
локација: положај, место
група: конгломерат, маса, група
цитат: цитат
старатељство: марљивост, нега
веродостојан: прихватљив
бацање: бацити
пречага: газити
концентрација: акумулација, фокус
спретан: практичан, комфоран
мамац: укус, буквар
разни: разноврстан
кришка: чип, диск, залогај
бушилица: бушотина, kopati
одговарати: реакција, враћање-новца, одговор
морталитет: смрт
коров: трава
релативно: обим
математички: математика, атлетски
морално: моралан
дахтати: уздах, дах
трке: rasa
изолација: раздвајање, одвојен
неко-време: ponekad
одрасла-особа: зрео
тегоба: горак, беда, проблем, мука
гласина: трач, глас
издржати: задржати, сносити, последњи
млађи: млади
плетење: книт
индиректан: директно
преседан: пример
пролаз: зрак, сала, прелаз
противречити: контрадикција, порећи
искупити: спасити, надокнадити
стаза: начин, Конверзија
зупчаник: опрема, зуби, ребро, trcati
прослава: гозба
подесан: топао, комфоран
објављивање: публикација, делити
купац: гост, купац
тепих: тепих, pod, ћебе
подела: рачунати
изгледи: поглед, визија
естетски: лепота
вређати: мрзети
поза: предложити, изазвати, стајати
задовољство: задовољан
организам: створење
неинтелигентан: разумети
недвосмислен: истицање
подне: поподневни, југ
љиљан: читати
именица: номинализатион, име
на-склапање: преклопити, савијен
користан: pomoć
истрајати: инсистирати, наставити, последњи
излаз: излаз, утичница, одлазак
наследити: наследник
брзина: брзина, убрзати
увредљив: усмен
недостатак: неадекватан, рез, пропуст, погрешна
обезбедити: осигурати
неправедан: jel-tako
sub: заменити
кофа: барел, кашика
организација: организација
најпре: посебно
обред: церемонија, обожавање
бутина: шунка, нога
гардероба: одећа, орман
текстура: организација
турбулентан: насилан
мочвара: мочвара
несвестан: неук
почетни: отварање, оригиналан, почетак, први, примитиван
минимум: најмање
корекција: реформа, ревизија, поправка
превидети: игнорисати, заборавити
једногласан: јединствен
угљеник: угаљ
калем: фајл, ролна, kovrdžava
хрскав: крхак, оштар
речник: рјечник
шетња: лутати
фитнес: вежба, гимнастика, услов
националност: национализам, државни
укус: укус
неважан: неопходан, тривијалан, безначајан
ударац: победити
напредовање: напредак, газити
оса: раме, штампа
задовољавајући: болест, задовољан
поуздан: веран
одвратан: мрзети, ружан
етички: моралан
колапс: pasti
јастук: река
збунити: фалсификовати, уништити, задивити, изневерити, збунити
мит: прича, легенда
својина: imovina
уплашити: уплашен, страшан, страх
кочница: пауза
орах: пасуљ, семе
увећати: надути, povećati
соларни: sunce
кљун: усна, јединица
закуп: поводац, закуп
однос: везе, поређење, скала, извештај, аналогија
чешаљ: четка, раме, гребен
превести: превод, flip
рекреација: забава, одмор, релаксација
каприц: боја
узорак: пример, покушати
множина: маса
иницијатива: план, покушати
желе: џем, млеко
анархија: поремећај
профил: контура, фајл, вебсајт
финансије: новац
основни: база, спајалица
прогнати: депонија, рација
електрични: електронски
трава: трава
напредовати: цветати
сличност: аналогија, личити, солидарност
приватност: приватан
арена: поље
путник: путник
честица: атом, семе
урођен: оригиналан
становник: резидент
флаута: звиждук
репродукција: плодност
распон: дужина
салата: зелена-салата, снага
боја: боја
демонстрирати: доказати
етика: моралан
званично: званичник
сметати: ометати, досадан, зафркавати, подстицање, бушотина
клизити: клизање
црта: карактеристика, imovina, растезање
композитор: музичар
фудбал: шут
партнерство: сарадња, савез, допринети
настављање: наставити
ненормалан: необично, лудак
секвенца: ланац
стисак: гурање
прибор: уграбити, цопе, опрема
ивичњак: инхибиција, тротоар, уздржавање
оглашавање: оглас, пропаганда
повлачење: регресија, утичница, закључак
хипотека: талац, кредит, пешак
стрпљење: стрпљење, сносити
потиснути: спречити, угњетавати
супруга: супруг
важи: ефикасан
вентил: комби
изградити: створити, зграда, формулисање, фаза
пара: пара, пар
шишмиш: штап, клуб, напред
контрадикторан: контрадикција, безначајан, упоредан
аутоматски: директно
експлицитан: отворено, провидност, аксиом
ефектно: ефикасан, ефект
ослањање: зависност
прегледати: посматрати, проверавати, разгледање, анализа
необично: чудан, необично
вући: нацртати, пљачкати
посрамљујући: срамота, збунити
онемогућен: инвалидитет, пасиван
арогантан: понос
Цурл: kovrdžava, прстен
драгуљ: камен, цветати
годишњица: рођендан
престиж: кредит
немарност: пропуст, презир, равнодушност
само-: приватан
дискриминација: изузетак, разликовати
континентална: континент
мета: сврха
тезга: продавница, стајати
инвестирати: инвестиција
крстарење: брод
митинг: солидарност, акција
гласина: трач, глас
активно: озбиљно
проверити: проверавати
одељак: стан
посебно: посебно
прасак: pop, прасак, хитац
скуп: бруто, заједнички
фракција: део, улог
незаконит: незаконит, дивљи
растворити: избрисати, растворљив, растварач
равнотежа: равнотежа
истраживање: сонда, анализа
лук: лук
склоност: аналогија, солидарност, зависност
нечастан: веран
сукоб: конфликт, шок, ометати
фотеља: столица, Sofa
тесто: брашно, маса, квасац, торта
укрцати: придружити
транс: визија
одбацивање: порећи, отпадни
варијација: разлика, правилно, контрадикција
апсорпција: кожа
колективан: маса
на-време: време
напасти: напад
отпуштање: врећа, redundancija
значајно: у-великој-мери
експерименталан: пилот
филм: филм, ТВ, слика
публицитет: пропаганда, промоција, оглас
проширити: проширити, детаљ
пад: посрнути, pasti, потапање, одећа
фалсификовати: створити, фалсификовати
фосил: уље, археолошки
ограничење: препрека, регулација, уздржавање
полет: ентузијазам, зачин, искуство, укус, кожа
пробирљив: досадан
Хамлет: Предграђе, село
успон: цветати, скок, прасак
репродуковати: копија, имитирати
конгрес: монтажа
грожђа: вино
радионица: студио, семинар
смањење: смањити, рез, pasti
изговор: изговорити
пресуда: одлука, реченица, правило, судија, надлежност, криза
концентрат: пажљив, фокус
расплести: открити, назад
трајект: јахта, брод
искрен: једноставан, директно, lako, провидност, линеаран
висина: дужина
означити: шоу, значити
извоз: излаз
преступник: комета, крив
неодобравање: опозиција, вето
по: пар, равнотежа
укинути: избрисати
подесити: ревизија, поправити, адаптација
чланство: члан
колосек: мерити, скала, величина, танак, индикатор
толерисати: опростити
кук: задњица, струк
придржавају: следити, придружити, штап, задржати
одбити: спречити
немир: поремећај
чедност-непорочност: тачност, чистоћа
затишје: релаксација, лабав
стезање: снебивљивост
новинар: новинар
симптом: експонат
бицикл: вожња-бициклом, циклус
катран: тротоар
спирала: Спин
коментар: вакцина, дефиниција
преношење: инфекција
гласачки-листић: глас, избор
потенцијал: u-mogucnosti
квалификован: u-mogucnosti, jel-tako, квалификовати, правилно
петља: вожња-бициклом, шарка, прстен
радник: запосленик
гонити: кривица
лиценца: дозвола
одрећи-се: пражњење
ја: себе, дах
млазни: избацити, птица, поток
прекршити: бити-непослушан, рез
зависник: зависност
опстанак: животни-век, самогласник
замрзнути: смрзнут
ткати: книт
службеник: утврђен, корисник
апатија: равнодушност
организовати: организација, pripremiti, доносити-законе, организован
вероватно: можда, наводно
акорд: споразум
крварити: крв, крвав
откривање: našao, претраживање, открити
смеч: уништити, пауза
олакшати: убрзање, подстичу, допринети
фреквенција: циклус, оклевати
шав: шивење
именик: доказ
котлет: угристи, рез, бифтек
грејање: топао
депресиван: разочаравајући, тужан
генијалан-потез: револуција, хитац, moždani-udar
самилостан: штета
мислилац: интелектуалац
буџет: равнотежа
грађански: грађански, урбани
уметнути: унети, povećati
медитирати: одразити, мислити
флексибилан: једноставан, flex, еластичан
плоча: табла, таблета, пећ
квалификација: таленат, квалификовати
прекидач: преокренути, претворити, кључ
пешкир: тканина
декада: десет, држати
више: разноврстан, више
завој: прелив, причврстити
уредан: уредан
пљесак: Пат, аплаудирати
јавор: палма
грабуље: замах
празнина: празан
срж: уље, мозак, тиква
корице: капут, коверат, махуна
апсорбовати: искористити, сисати, пригрлити
предвиђање: предвидљив, Претпостављам
образовати: образовање, воз, настава
упит: сонда, захтев, претраживање
доминација: правило
родитељски: родитељ
учествовати: делта, придружити, ангажован
лифт: дизање
бочни: страна
одложити: кашњење
гађење: презир, мрзети
језгро: нуклеарна, mobilni, ембрион
метафора: пример
деминутив: мало, микро
бомба: пумпа
критички: дубоко, критичар
рђа: проћи
резервација: задржати, уграбити
шити: шивење
хемичар: хемијски
салон: пауза, сала
почетак: почетак, рација, напад
роњење: потапање
непријатељски: непријатељски
попис: рачуница
отказати: оптужити, реченица
лан: постељина
обуставити: спречити
шамар: победити
опустити: релаксација
удварање: двориште
роба: роба
непрекидност: везник
реципрочан: размена, инверзија
рецепт: медицина, копија
мехур: пена
лопата: клешта, весло
искористити: искористити, употреба, провести, појас, потрошити
издржљив: дугачак
род: упознат
цинк: лавабо
који-год: šta-god, који
ограничен: ограничен, коначно, готов
помоћни: присталица, помагала
јагма: искривити, борба, moždani-udar
академски: образовање
гума: ембрион, прстен
потрошач: употреба
пуноважност: вредност, кредит
Približno: скоро, приближан
плетен: книт
микроскоп: телескоп
цивил: грађански
каиш: поводац, конопац
симболичан: гест, идентитет
prilagoditi: адаптација, цопе, преписати
вероватноћа: вероватноћа, u-mogucnosti
субјективан: ментално
заменица: савест
погрешно: погрешно, злоупотреба
обесхрабрити: збунити, амбиција
новајлија: гост
бескрај: инфинитив
графички: графикон
смоква: у-облику, слика
ниша: доследан, кључ
разочарати: разочаравајући, издати, изневерити
пројекција: план, шоу
ослобођење: пражњење, спас
рецепт: подстицај
лиценца: привилегија
неподесан: бесмислица, безначајан, неадекватан
ротација: циклус, револуција, Спин
дугме: пупољак
метар: мерити
ограничење: граница, уздржавање, регулација
категорија: заједница, ранг
расни: rasa, расизам
замена: уместо-тога, заменити, промена
иновација: изум
суочити: цопе
забрана: порећи
украсни: украс
лоби: изазвати, сала
бацити: бацити, kovrdžava
свитак: књига, ролна, kovrdžava
механичар: механички, занатлија
агресија: напад, агресиван, прекорачити
еј: Zdravo, Dobrodošao
мера: мерити
такмичити-се: рвати-се, супарник
академија: колеџ
почетник: регрут, свеж
разведен: развод
млекара: млеко
резервоар: резервоар
шопинг: продавница, трговина
имплицитан: доследан
стратешки: стратегија
калуп: модулу, образац, штампа, бацити
проба: вежба, понављање
инсистирање: инсистирати
предходити: pre-toga
средњи: средњевековни, на-пола-пута, струк
туристички: путник, туризам
напитак: пиће
свестан: пажљив
артикулисати: објаснити, израз
поново: онда, назад
измени: ревизија, промена, заменити, сплет, реформа
дијаграм: графикон, карта
дедуктиван-расположење: индуктиван-расположење
затрпати: угњетавати
мобилни: телефон, mobilni
подићи: промоција, дизање
парадокс: контрадикција
преувеличавати: со, максимално
плавуша: жут
шлагворт: ознака, лозинка, штап
тркач: сала
преговарати: разговор, дискутовати
режим: правило
толеранција: толерантан, сносити
опција: наизменичан, краставац
крсташки-рат: покрет
епидемија: трагедија, превод
техника: технички, приступ, инжењеринг, опрема
терминал: коначно
дипломирани: проћи
излаз: трошак, закључак, публикација, одлазак, продуктивност, излаз
лоцирати: место
Уобичајено: пропуст, стандардни
контекст: еколошки, сцена, конотација
коалиција: савез
мана: кривица, погрешно, инвалидитет, nedostatak
уступити: признати
емитовање: публикација, послати
бирати: изабрати, прстен, окупити
распрострањеност: популаран
све: све
трансформисати: промена, претворити
змај: змај
двосмислен: нејасан, контрадикција
кафе: кафа, Бар
награда: nagrada, премија, признати
ознака: студио, ознака
одобравајући: одобрење, признати
сродство: аналогија, социјалистички
реалистичан: заиста
рептил: змија
на-отвореном: напоље, отворено
политичко: политички
остатак: остаци, отпадни
трака: касета, група, филм
благ: мек, сладак
орално: усмен, усна
шпекулисати: Претпостављам
протерати: избацити, пражњење
мана: место, инвалидитет
прескочити: плес, провести
кригла: шоља, гримаса
клин: шиљак, улог, угао
изузимање: попуст, изузетак, redundancija
prenosiv: мало
паковање: паковање, замотати
сјај: таленат, лепота, блесак
пераје: весло, балет
мрмљање: шапат
бобица: залив
имиграција: миграција
мотика: плуг
хирургија: хирург
нагомилати: акумулација, депозит, окупити
уморити: измет, цев
стомак: стомак
импликација: конотација, укључење, закључак
подстицај: подстицај
кључ: шрафцигер, кључ
село: сеоски, Предграђе, поље, село
деградирати: уништити, смањити
домаћи: природа, оригиналан, резидент
димњак: депонија, гребен, димњак
диск: диск
тренд: понашање, правац, савијен, распоред, заношење
корпоративни: privredno-društvo, заједнички
ослободити: ослободити
нестабилан: нестабилан, пролазност
компатибилан: доследан, паралелно, подударан
телефон: телефон
вакуум: празан
грабити: убод, узети, уграбити
конвулзија: земљотрес, прасак
досадан: досадно, бушотина, досадан
портфељ: комплет, новчаник
пукотина: пукотина
компликација: проблематичан, путарина
интервенисати: ометати
поларни: поларитет, екстреман
делегат: представник, гласник
воља: снага-воље, жеља
предвидети: предвидљив, Претпостављам
оптимизам: nadati-se, веровати
кора: кожа, махуна, кора
исећи: угристи
lebdeti: пловак, соар, оклевати
сектор: поље, индустрија, регионална, део
презиме: име, они
институт: организован, privredno-društvo, организација
хитност: забринут
пријатан: врста
одвратити: спречити
негација: порећи
победник: успех
мешавина: помешан
udar: ефект, конфликт
влакно: влакно
гутљај: прогутати
визуелан: оптички, сцена
канџа: шапа
тужитељ: глумац, носач, разлог
осудити: штета
завести: искривити, задивити, будала
забранити: инхибиција, спречити, порећи
извођач: глумац, уметник, играч
турнир: rasa
услов: захтев, услов
минус: најмање
неуредан: немаран
заразан: инфекција
нагласити: инсистирати, истицање
pantalone: панталоне
збунити: слагалица, задивити, збунити
посветити: волонтер, nameravam
хируршки: хирург
истинитост: чињеница, тачност
стоти: сто
слопед: стрм, потапање, савијен
близу: скоро, ускоро, који-окружује
нормално: заједнички, често, обично, склони
збуњујуће: контрадикција, слагалица, забуна
пропорционалан: упоредив, равнотежа
слажем-се: неслагање
надражити: љутња, ометати, зафркавати, изиритиран
изванредан: боље, упечатљив
иницирање: почетак
таложење: убрзати
престравити: алармни
хоби: забава
граматички: граматика
нумерички: број, дигитални
критеријум: стандардни
прогноза: предвидљив, Претпостављам
осуђивати: порећи
егзотичан: страних, чудан
сијалица: лампа
повећати: проширити, povećati, максимално, лечити
фузија: Мелт, позив
анкета: избор
талентован: таленат, вешт
растопити: Мелт
исправити: растезање, поправити
украсити: украс
председнички: председништво
џомба: превремени, умножити, шут, удубљење, тумор
честитка: похвала
скенирати: замах
дати-право: омогућити, jel-tako
клађење: услов
технички: технички, инжењеринг
емпиријска: искуство
доминирати: мајстор
рекламирати: оглас, пропаганда
дифузија: делити, публикација
огреботина: огреботина
опрема: опрема, кутија, комплет
практичар: доктор, тренер
потопити: сисати, потапање
конзервација: заштитити, спасити, нега
муљ: блато, тротоар, дриблинг
изазован: тврд
загађење: загадити, корупција
хемикалије: хемијски
серија: стадо, импулс, обим
мама: мама
застрашујући: страшан, претећи
специјалиста: експерт
чезнути: жеља
купатило: купатило
коцкање: коцкање, игра, авантура
саставни: неопходан, интегрисан
елиминисати: ослободити, избрисати
грашак: пасуљ
додатак: privrženost, додатни, џепарац
циркулисати: делити
укључујући: јединствен
продавац: трговац
узнемиравати: нервозан, ометати, опсесија
експлодирати: прасак
загледати: радозналост, полуга
просипање: цурење, сипати
бесплатно: бесплатно
састојак: елемент
мањак: отворено
узнемирујући: нервозан, досадан, непријатан, тужан, поремећај
кућиште: кућа
фотографски: фаза, слика, фотограф
штеточина: инсект
пилула: таблета
тренутно: присутан
медиј: преса
олупина: рушевина
корпус: тело, комплет
мени: листа
прелом: пукотина
форум: платформа, бушотина, суд
импулс: брзина, импулс
нагиб: лаута, савијен
плочица: цигла
полица-за-књиге: библиотека, књижара
рачунање: рачуница
продуцент: произвођач
монетарни: новац
насликати: описати, одразити, увести
инфлација: надути
маргинални: ивица
фантазија: машта
поткопати: уништити
кохерентан: строго, везник, доследан
фундаментално: uslovi
намеран: намерно
преживели: породица
флукс: река, поток
конкурентан: супарник
накит: украс
алкохоличар: пијан, вино
разликовати: разликовати
ратоборан: радикал, терориста, војни
разоружати: оружје
пресудан: неопходан, одлучујући
dodeljivanje: рад, вежба, дужност, расподела
квота: привилегија, расподела, квантни
ископавање: јама, kopati
калцијум: шут
спомен: убедити
историјско: историјски
ћао: Zdravo, Dobrodošao, спас
елиминација: ослободити, пропуст, избрисати
затегнут: уредан
опуштање: удобност, комфоран, релаксација
ефикасност: ефикасан, ефект, вештина
рањив: осетљив
атлета: атлетски
пруга: стрипед, линија, група, филм
фасада: маска, визија
клип: спајалица, клешта
прототип: пример, оригиналан
офсет: цопе, надокнадити, одступање
nula: нула, празан
ограничити: спречити, скратити, смањити
крпељ: ознака, вашка
бачва: резервоар
силовање: прекорачити
nula: нула, празан
условни: привржен
културни: култура
технологија: технички, опрема
Маркетинг: трговина
кравата: Тие
економично: економски
Администратор: менаџер, повереник
осликати: описати, увести
унуче: унука, братанац
Дуал: два, пар, близанац
синтеза: оригиналан, инсталирати, комплет
специјалитет: занатски, карактеристика
бизаран: чудан
подносилац-молбе: кандидат
лингвистички: језик, лингвистика
гљива: плута, сунђер
бундева: бундева, тиква
подићи: дизање, расти, напредак
феноменалан: необично, соло, супер
динамичан: снага
прерадити: ревизија, поправити, проверавати
слом: раздвајање, pasti, анализа
заморан: уморан
студентски-град: колеџ, школа
дисертација: теза
статистички: статистика, статистички
формулисати: pripremiti, формулисање
сендвич: хлеб
nula: нула, празан
стимулација: убрзање, узбуђење, изиритиран
цензура: цензор, регулација
опремити: допуна
номиновати: номинација, предложити
отказати: избрисати, туча, фрустрација
метар: мерити
притиснути: угњетавати
господин: сер, мајстор
реконструисати: поправка, опоравак
судија: правило, судија
атомски: атом, нуклеарна
контроверзан: контрадикција
софистициран: комплекс, модеран
трзај: слегање-раменима
неприкладан: безначајан, неадекватан
талог: убрзати
одбијати: презир, кривица
варијанта: разноврстан
критиковати: критика
досада: досадно, мука, беда
сарађивати: сарадња, везник
анализирати: анализа, аналитичар
падавине: киша
младица: пупољак
авион: птица
пикантан: оштар
еластичност: еластичност
ракета: ракета
прилог: коверат
нестабилност: нестабилан
лишавање: лишити, nedostatak
чучнути: чучањ
генерисати: произвести, створити
апроксимација: приближан, приступ, конвергенција
морал: будан, моралан, ментално
оптимистички: nadati-se, веровати
разврстати: класификација, делити
наставни-план: курс, дневни-ред
напољу: напоље
реаговати: реакција, глагол
skripta: сценарио, линија, натпис
уцена: изнудити
бонус: nagrada, премија
преимућство: imovina, присуство, предност, капитал
варијабилност: разлика
двосмисленост: нејасан, контрадикција, несигурност
nula: нула, празан
средњи: неутралан
хендикеп: збунити, препрека, инвалидитет, nedostatak
фотографија: слика
мањак: рез, одсуство
премештање: заменити
гљива: бактерије, сунђер, плута
текст: формулисање, текст
дипломата: дипломатски, гласник
покренути: увести
спојити: појас
разбити: пауза
удисати: инспирисати
котур: улога
мршав: танак
гласач: изборна-јединица
федерација: федерални
мобилност: покрет
растеретити: пражњење
станиште: склониште
пробудити: комешање, изазвати
разблажити: танак
збогом: zdravo, збогом
рушити: уништити
синтакса: пензија
потковица: коњ
distorzija: одступање, искривити
тресак: победити
релевантан: доследан, правилно, повезан
функционалан: практичан, рад
померити: заменити, избацити, померити
аутономија: независност
смрад: мирис
диференцијација: разликовати
доступност: аквизиција
основне-студије: ученик
графикон: графикон, карта
фасцинирати: заробити, зафркавати
сладак: lep, сладак
абдомена: стомак
писменост: образовање
синтетички: вештачки
тренер: тренер
чувати: складиштење, спасити, заштитити, задржати
смеће: туча, депонија, отпадни
слика: слика, хитац
уџбеник: упутство, књига
консолидовати: појачати
ограничити: приморати, ограничен, изнудити
економиста: економски
Атлетика: атлетски, вежба
вртети-се: гримаса
јод: минерал
заразити: инфекција, загадити
дизајнер: одлучан
лучити: лучење, сакрити, избацити, тајна, разликовати
спанаћ: подстичу, зелена-салата
интензиван: екстреман, насилан
убедљив: демонстративан
деби: први, почетак
хиљадити: hiljada
унутрашњи: унутрашњи, дубоко, унутра, покривен
опозвати: лишити
амплитуда: величина
димензија: правац, после, димензионалан, следећи
Библија: натпис
плакат: барјак, web
убрзати: убрзати
појачати: појачати, појачивач
абортус: побачај
типично: обично, заједнички, често, склони
приврженост: обећање
ред: реп, ред
држач: спајалица, лакат, кука, присталица, подршка
по-: стар
обрнут: преокренути, инверзија
испарити: Мелт, зевање
авијација: атмосфера, ваздух, летети
корелација: поређење
етнички: националиста, државни
смањити: рез, смањити
варљив: лукав, разрадити, комплекс, тврд
карактеризација: описати, карактеристика
лепити: сплет, паралелно
молекул: молекуларна
конфигурација: распоред, структурни, монтажа
интеракција: разговор, преклапање
квантитативан: обим
самоиспитивање: ретроспективан
Оријент: источно
сперма: семе
одобрити: подршка, признати, одобрење
не-: ни, не
веродостојност: лојалност, поузданост, кредит
субверзија: рушевина
скретање: заношење, одступање
убризгавање: игла
сандала: папучица, ципеле
комад: чип, став, растезање
телевизија: ТВ
житарица: зрно, пасуљ
контејнер: инструмент, резервоар, лонац
мигрирати: миграција, лутати
терминологија: uslovi
гласачко-тело: изборна-јединица
брисати: избрисати, уништити
посредовати: помирити
капитализам: капиталистички
скија: клизати
зазор: коцкање, дозвола
селективан: изабрати
статички: стандардни
конвергирати: susret, конвергенција, фокус
азбучни: азбука
глобалан: међународни, свет
жртва: жртвовање
ок: исти, поправити, веома
прагматичан: практичан
судија: правило, судија
диференцијал: разлика
издисати: емитовати, дах
вододелница: вода
учвршћење: адаптација, опрема
инсталирати: инсталирати, утврђен, затворити
резонанца: вибрација
традиционално: традиција
учионица: орбита
протокол: споразум
рачун: рачуница, рачун
грам: топао, трава
бензин: бензин
галаксија: констелација
адолесцент: млади
месити: проблем
радијум: радио
разређен: танак
авион: птица
педала: газити
отприлике: скоро, o-tome
батеријска-лампа: објектив
кофер: кутија, пртљаг
размена: размена
опционо: обичај
матрица: стомак
сликање: раме, слика
пред: источно, pre-toga, ливада
оглас: оглас
ошамутити: задивити
учесталост: случај, потапање
срушити: сипати, срце
чулни: осећај, страстан
консензус: споразум
надгледати: управљати, монитор, полиција
пресађивање: наизменичан
алуминијум: алуминијум
флуктуација: осцилација
симулирати: имитирати, симулирати
компликује: комплекс
ментор: саветник, тренер
прорез: отварање
топ: врана, кула, замак, топ
манипулисати: манипулација, комешање
вегетаријанац: поврће
норма: спецификација, стандардни, правило
Метро: тунел
респираторни: дах
симулирање: имитирати
шприц: игла
мутација: промена, претворити
donje-rublje: гаће, постељина
вагина: залив
разликовати: разликовати, разлика
сезонски: сезона
сељак: сеоски
сусам: кртица
кома: зарез
обрнути: инверзија, преокренути
надзорник: посматрач, упутство
свргнути: избацити
ревизија: проверавати, ревизија
пешачење: соар, лутати, дизање
место: место
рецесија: економија
пљачкање: пљачкати
парола: лозинка
фетус: ембрион
интеграција: сарадња, укључење
блацк: љубичаста, блацк
умањити: најмање, смањити
стамбени: склониште
цифра: дигитални, број
слан: со
nula: нула, празан
теоретичар: теорија
акваријум: риба
вуча: вето
падобран: кишобран
важније: неопходан
уопште: обично, све, заједнички
погоршати: трулеж
nula: нула, празан
сексуалност: полни
калем: обим, замотати
претежно: у-великој-мери
вискозан: лепљив
црево: гут
археологија: археолошки
кикирики: пасуљ
апозиција: џепарац
шпорет: пећ, кухиња
панталона: панталоне
kriterijumi: стандардни, индикатор
преглед: контура
квалитативан: карактеристика
наочаре: стакло
генетски: морфолошке, генетика, ген
учесник: придружити, улога, партицип
репертоар: таленат, софтвер
ротирати: циклус, Спин
распоред: организација, план, распоред
ваучер: утикач, признаница
теорема: реченица, теорија, аксиом
когнитивни: дијагноза
разјаснити: разрадити, објаснити
отрован: отров
истакао: истицање
грамофонска-игла: игла
рецесија: криза
снабдети: служити, обезбеђен, осигурати
анти: опозиција
отпоран: хроничан, опозиција, имун
ужина: тост
биоскоп: филм, биоскоп
славина: цев
маркер: ознака
периферни: који-окружује, регионална
самопоуздан: одлучан, предикативни, агресиван, одлучујући, тврдоглав
чвор: книт
гојазан: дебео
одузети: избацити, смањити, нацртати, лишити
непрелазан: неопходан
спирала: пуж, kovrdžava
колачић: бисквит, торта
надувати: надути
електроника: електронски
преписати: преписати
лабораторија: лабораторија
радни: професија, трговачки, занатски, рад
нагиб: миља, потапање
разнобојан: боја
pokrivenost: покривен, вакцина, нега, ћебе, кров, обзир, обим
учешће: придружити, укључење
оријентација: правац
измишљати: створити, произвести
термални: уље
стереотип: изузетак
tech: технички
остатак: остаци, redundancija
камион: kamion
стадион: поље
координација: координата
бактеријски: бактерије
приступ: приступ
силицијум: ПИ
меморисати: меморија, спасити, запамтити
дијагностика: дијагноза
Наставни-план: апстрактан
провођење: линија, киднаповати
милионити: милион
продавац-на-мало: трговац
баријум: Бар
матица: кључ, секундарни
значајан: значити, значајан
звучни: глас
појмовни: концепција
решетка: web
просторни: атмосфера, димензионалан
испит: квиз
средином: секундарни, струк
надокнадити: надокнадити
дискретна: одвојен, соло
инхибирати: инхибиција, спречити
више: разноврстан, више, веома
спаран: влажан, топао
морфологија: морфолошке
поставити-дијагнозу: дијагноза
грип: грип
графика: графикон
коронарни: болест
задњице: задњица, шунка
Архива: фајл
конфронтација: борба, конфликт, поређење
теретњак: kamion
оптимум: оптималан, veliki
у-основи: uslovi
мотивација: подстицај
тестис: јаје
сумпор: сумпор
оперативан: манипулација, акција
путања: орбита, начин
релевантност: повезан, значај, везе
бицикл: вожња-бициклом, циклус, точак
директива: демонстративан
ваздушна-линија: птица, ваздух
литар: литар
препрека: фрустрација, шок, регресија, изневерити, препрека
ујединити: појас, помирити
став: стајати, положај, став
минималан: најмање
цикличан: вожња-бициклом, периодичан
Подлога: молекуларна
подводни: подморница
ekspertiza: искуство, вештина
nula: нула, празан
електрон: електронски
интерактиван: преклапање
у-почетку: оригиналан
саботажа: уништити
интеракција: разговор, социјализовати
математика: математика
фетални: ембрион
модернизовати: модеран, ажурирање
екстремиста: радикал, екстреман
мокраћа: урин
пригрлити: пригрлити
Добро: поправити, веома
ударити: украсти
решен: намерно
полу-: на-пола-пута, продати, млевење, ширина
нервни: нервозан
anti: опозиција
сочиво: објектив
proksimalni: скоро
за-исхрану: минерал, храна
нејасан: нејасан, очигледан
траума: шок, повреда, чир
трампити: размена
вектор: носач
тактика: приступ
проценити: процена
nula: нула, празан
клон: копија
одржив: предност, ефикасан
копија: копија
реактиван: реакција
распоред: календар, време, распоред
синтаксни: судбина
стабилизовати: миран
дисидент: супарник
повратна-информација: реакција
упитник: квиз
оксидисати: позив
милиметар: милиметар
психијатријски: интелектуалац
синдром: болест
парадигма: пример
активирати: омогућити, uradite, акција
насумице: случајан, случајност, до-случај
одбачени: одвојен, бојкот
подскуп: део
методологија: начин, приступ, једном
илустрације: рад
Секуентиал: доследан, редни
затворити: држати, уграбити, затворити
километар: километар
мултинационална: међународни
пројектант: станар, стрипед, план
експоненцијалан: експонент
изгубити: изгубити
истраживач: научник
супер-маркет: тржни-центар
доделити: расподела, разликовати, делити, дисекција
nula: нула, празан
фудбал: шут
pravo: jel-tako, правилно
остаци: остаци, отпадни
одрживи: стандардни
свемирски-брод: шатл
искуствено: искуство
семантички: конотација, предмет
упућени: унутрашњи, члан
тона: тон
модул: модулу, јединица, обим
ензим: квасац
начин-живота: животни-век
тестенина: маса
Studentski-dom: склониште
тинејџер: млади
врхунац: ознака
негирати: порећи, уништити
дечко: девојка, пријатељ
понашања: понашање
Хвала-вам: захвалити
планирати: мозак, душа
еколошки: екологија, еколошки
имигрант: избеглица
Ембед: укључење, потапање, сахранити
фотокопија: копија, слика
активиста: акција
мајица: кошуља
терапеут: доктор, терапија
Тицоон: краљ
узбуђење: узбуђење
синц: синхронизовати
кисела: киселина
лексички: рјечник, реч
Провалити: пауза
класификатор: класификација
авангардни: пионир
председавајући: глава
летак: летак
каризматичан: шарм
скандијум: телур
директива: упутство
претпоставити: претпоставити, наводно
фрижидер: фрижидер
рестарт: поново-покренути
идеја: трести, идеја
поновити: копија, имитирати, понављање
ангст: страх
прекид-ватре: примирје
гаф: пропуст, погрешно
индустријализовати: индустријализација, индустрија
полубрат: брат
portparol: звучник, представник
отети: киднаповати, плуг
не-метала: металоид
који-цури: грип, влажан, trcati
аспект: правац, у-облику, страна
од-случај: 
доброта: врлина, предност
лабаво: лабав, бесплатно
накнадно: будућност, онда, после
проблем: проблем
тима: група
широко: ширина, проширити, обично
корелација: повезан, кука
према: назад
nula: нула, празан
билтен: летак, информације
одобрава: одобрење, неприхватљив
када-за-купање: купатило
забаван: забава, забавити, смешан
осим: осим
pojava: појављују, излаз, расти
nula: нула, празан
образ: игра
морати: морати, дужност
проценат: проценат
parnica: odelo
nula: нула, празан
преко: проћи, изнад
сопран: детињаст
забаван: смешан
увече: поподневни, ноћ
беланце: беланчевина
крвопролиће: крвав
тулијум-атом: торијум-атом
кривина: савијен, flex
везник: везник
који-опомиње: бодрећи
тербијум-атом: торијум-атом
изнајмити: закуп
надокнадити: надокнадити
духовита-примедба: šala
цонфиг: структурни
прошлост: последњи
podijeliti: разликовати, делити
profesor: мајстор
родијум-атом: торијум-атом
држава-маркер: 
простор-маркер: 
бирократски: бирократија
појас: група, појас
nula: нула, празан
продавац: трговац
nula: нула, празан
лантан: телур
тема-случај: тема-случај
конструктиван: створити, формулисање, произвођач
nula: нула, празан
женски: женски
ревизор: инспектор, рачуновођа
микрофон: микро
izvan: напоље, осим
снимање: укључење, регистрација
кажипрст: индикатор
покровитељство: стипендија, нега
неук: неук
nula: нула, празан
стандардизовати: спецификација, стандардни
сати: место, сат
газда: власник
истраживач: Детерминер, научник, детектив
фларед: спаљен
nula: нула, празан
овластити: омогућити
одбрана: нега
ходник: сала
преговарање: разговор
освежен: свеж, ажурирање
Меандеринг: савијен
напред: први, следећи, напред
дисање: имун, дах
nula: нула, празан
прогресија: напредак
непрелазан: неопходан
еуфорија: ентузијазам
широк: проширити, ширина, распрострањен
непрелазан: неопходан
цонтрастиве: упоредан, цопе
задивљен: iznenađen
упућивање: увести
потомак: упознат, унука, генерација
Сладолед: крем
полупречник: зрак
алтернативно: иначе
комшилук: који-окружује, живети, еколошки
користи-за: обичај
збуњеност: срамота, поремећај
битно: у-великој-мери
свеже: свеж, недавно, корен
играње: игра, плес
nula: нула, празан
износ-маркер: 
друштвени-маркер: 
критика: критика
рубидијум-атом: торијум-атом
борба: борба, конфликт, рат
жале: o-tome
nula: нула, празан
ванадијум-атом: торијум-атом
средњи-пол: мушки-пол
флуор-атом: торијум-атом
путовање: посета, сафари, експедиција
мушки: Muški
nula: нула, празан
развојни: еволуциони, напредак
примењен: практичан
zatvoriti: затворити
хвалисање: разметање
уназад: назад
поклон: присутан
nula: нула, празан
рандомизе: случајан
задруга: колега
пензионисан: пензионисати
nula: нула, празан
забављен: срећан, смешан, забавити
апроксимативни: приближан
Диадиц: бинарни
допунски: допуна, додатни
комуникативан: преписка, говорљив
nula: нула, празан
у-случај: до-случај
полонијум-атом: торијум-атом
слом: раздвајање, анализа
препланулост: браон
проблем: проблематичан, проблем
превести: превод, flip
nula: нула, празан
талијум-атом: торијум-атом
клика: конгломерат, клик
лако: lako, једноставан
moderator: модератор, менаџер
друштвено: друштвени
одговарајући: odelo, подударати
несрећа: случај
ono-što: који
занимљиво: нацртати
наопако: преокренути
хербицид: отров
nula: нула, празан
учесник: партицип
na-primer: пример
тумор: тумор
распад: трулеж
nula: нула, празан
вебсајт: вебсајт
огромно: масиван, веома, супер
biće: 
у-односу-случај: у-односу-случај
објективан-случај: дестинација-случај
наградити: надокнадити, платити
малтретирати: погрешно
плетеница: гребен, книт
уместо: уместо-тога
археологија: археолошки
конектор: копула, утикач, privrženost, утичница
nula: нула, празан
генерализација: уопштити
стронцијум-атом: торијум-атом
рутенијум-атом: торијум-атом
одбачено: осим
nula: нула, празан
повлачење: одступити, регресија, пензионисати
пензионер: пензионисати
једно-другог: један-другог, други
широк: распрострањен
рачунање: рачуница, рачунар, калкулатор
посао-лице: пословна-особа
Хот-дог: kobasica
доминација: ефект, снага, предност
завршити-цитат: цитат
посесиван-случај: генитив-случај, посесиван-случај
генетски: ген, генетика
попустљив: померити, мек
индиректан-објекат: директан-објекат
заштитни-расположење: заштитни-расположење
разрадити: вежба, рад, разрадити
делимитед: ограничен, одвојен
супротно: преокренути, опозиција, супротан, инверзија, упоредан
пењање: расти
невероватно: необично, супер
nula: нула, празан
затварање: затворити, разбој
јефтино: јефтин
платно: тканина, web
образован: образовање, учтив
дивље-животиње: природа, дивљи
супротна: опозиција, супротан, за
nula: нула, празан
ископати: kopati
заражен: инфекција
nula: нула, празан
наоружан: оружје
т.ј.: to-jest
нико: ništa
псовање: псовати, псовка
сужава: танак, купа
забављач: забава, уметник
итд: 
сем: осим
контура: контура, еколошки, образац
мобилни-телефон: мобилни-телефон, mobilni
Gospođica: рез, изгубити, провести
алармантни: страшан, забринут
будућност: будућност
коњунктиван-расположење: условни-расположење, оптативан-расположење
треба-да: морати
моторцикл: мотоцикл, моторни
кредитна-картица: кредит
nula: нула, празан
јавни: јавни
мобилни-телефон: мобилни-телефон, mobilni
nula: нула, празан
изнутрице: гут
развити: делити, растурање, потрошити
депортовати: избацити
пропорција: улог, део, квантни
надлежност: вештина, надлежност
земљопоседник: анђео
предложни-случај: 
расподела: расподела, дивиденда, џепарац
zabrinjava: забринут
У-реду: исти, веома
примењивање: приморати
професионалац-фраза: професионалац-реченица
рецептора: хватач
убризгати: увести
диван: задивити, упечатљив
кашаљ: кашаљ
поред: следећи
