bye: hejdå, Hallå, pi, farväl
de: 
av: mellan, handla-om, dess
till: komma, måste
i: 
:-first-person: 
jag: mig
:-third-person: 
att: Det, som
hans: dess, egen
han: Det
med: 
för: handla-om, mot
som: som, exempel, hur
:-second-person: 
vara: 
hennes: dess
på: ring-upp, handla-om
på: häst
av: passera, och, handla-om
ha: björn
eller: inte-heller
från: 
detta: Det
Hej-M: dess
hon: de, Det
min: mina, mig
deras: dess, de
så: således, snart
en: 
dem: de, dig
vi: oss, mig
som: vem-som-än, som
skulle: tror, ta-med
vilja: viljestyrka
Nej: inte
om: om, under-förutsättning
upp: ovan, stiga, ut, värre
in-i: en
några: nämligen, som, alla, varje
din: din
vad: inte-heller, som, sak
indikativ-humör: direktiv-humör
man: person, man, manlig
än: mer, handla-om, hur
vår: vår, oss
några: något
på: efter, ovan, ut
Maj: kunna
nu: presentera
tycka-om: hur, kärlek, håll
Kan: kunna, kunde, låda
skall: måste
gjorde: do, faktum
sådan: således
en: en
dessa: de, Det
över: ovan, mer
mycket: mycket, volym
herr: sir, bemästra
bra: vacker, bra, snäll
mest: mer, i-stora-drag, majoritet, mycket
skall: måste
de: de, dess
han-själv: egen, samma, dem-själva
liv: bo, livstid, vokal, midja
utan: 
gör: do, skapa
väl: bekväm, höger
samtala-markör: 
genom-: passera, penetrera
makt: driva, kanske, kunde
för: mycket, även
igen: sedan, tillbaka, en-gång
många: majoritet
varje: varje, som
personer: person, gemenskap, en-personer
trodde: ideologi, aning, tror
under: ner
fortfarande: mer
plats: fläck, placera, var
medan: medan, tid, tillfällig
precis: endast, enkel
också: även, likaledes, mer
än: men, inte-heller, ändå, mer
mot: mot, före
skaffa-sig: träffa, ta, härleda
någonsin: evig, aldrig, alltid
av: stänga, bort, ut, täckt
ansikte: yta, hundra, person
en-annan: sista, andra
vänster: bort
ny: neo, roman, färsk, nio, ung
Fru: 
sätta: uppsättning, sista, ge
berätta: säga
sinne: intellektuell, tror
ett-fåtal: par, liten
vem: som, vem-som-än
långt: bort, avlägsen, mycket
heter: tror
hela: full, alla
både: två
hitta: hittades, Sök
se: se, kolla-upp, blick
låta: buss, avge, ge, gör-det-möjligt
lord: bemästra, sir, kung
hem-: hus
något: ingenting, något
ögonblick: tid
far: pappa
bland: mellan
kvinnor: kvinnlig
mor: mamma
avsluta: färdiga, sista, sent
små: liten, mikro
du: dig
brist: måste
dock: men, ändå, fast
ganska: helt, något, mycket, tillräckligt
vars: som
bäst: bättre
jag-själv: mig, dem-själva
fram-tills: även, före, hejdå
sedan: sedan, först, därför-att
Begagnade: gammal, återvinna
snarare: i-stället, något, mer
mindre: kort, ner, minst
inom: inre, djup, inomhus
med-varandra: uppsättning
stor: bra, massiv
materia: sak, ämne, fråga
viss: bestämd, höger
henne-själv: dem-själva
halv: halvvägs, slipa, sida
sann: verkligt, faktum, höger
något: vad-som-helst, något, ingenting
ha-kvar: håll, uppsättning, behålla
fru: kvinnlig
betyder: sätt
nära: passera, nästan
ange: skick, ange, land, regering
ensam: ensam, solo-, en
fall: falla, exempel, kostym, incident, därför-att
dig: dig
hög: ovan, golv
flicka: dotter, kvinnlig, flickvän
Säker: försäkra, höger, verkligt
verkligen: verkligt, faktum
sig: dem-själva, egen, om
längs: associerad, lång, längd
landa: land
komma-tillbaka: regression, tillbaka, återbetalning
lämna: avresa, semester, övergiven, bort, tillstånd
antingen: även
lag: höger, rättslig, regel
lägga: uppsättning, sekulär, hjälp
punkt: fläck, handling, endast, stycke
barn: barn
önskar: hoppas, önskan
tala: säga, prata
under: tid, medan
flera: dussin, par, mer
företag: handel, handla, företag, arbete, kommersiell, rörelse
sätt: sätt, närma-sig
andra: andra
allmän: gemensam, allmänt, offentlig
Bakom: tillbaka
bli: komma
död: dö, död
jord: land
pojke: son
känna: känsla, höra
anda: själ
sanning: faktum
jord: golv, land, fläck
verkligen: verkligt, mycket, faktum
resten: andra, bekvämlighet, gå-i-pension, ligger-kvar, semester
olik: olika, skillnad, andra
möjlig: kanske
mänsklig: person, humanitet
stad: stad
följande: nästa, Följ, efter
behov: nödvändig, måste
ge-upphov-till: anledning, inducera, därför-att
kväll: natt, eftermiddag
fem: femte, år
stark: driva, kunna, våldsam
lady: kvinnlig
runt: omgivande, nästan, handla-om, öga
sväng: sida, uppsättning, beställa
känsla: betyda, känsla, konnotation
på-nära-håll: stänga, nästan
karaktär: karakteristisk, personlighet, markera, natur
sortera: klassificering, snäll
syn: vision, fram-, scen, se, blick
part: fest, kommatecken, land
bra: bra, tunn
redo: förbereda, redan, tå, färdiga
konto: anledning, fakturera, beräkning, räkna
skriven: skriva
ålder: gammal, århundrade
annan: andra, sista, någon-annanstans, mer
tvinga: driva, tvinga, förelägga
tvärs-över: ovan, motsatt
tidigt: för-tidig, början, primitiv, snart
sol: 
senare: framtida, sedan, efter, nästa
allt: alla
dåtid: förflutit, retrospektiv, sista, efter
handling: fakturera, verb, handling, arbete, rörelse
ytterligare: fram-, mer, ytterligare
bortom: mer, ut
varken: inte-heller, som
se: menade, blick, se, vision, scen, kalender
ljud: röst
ingen: ingenting, nickel
klar: öppna, uppenbar, slående, ljus
väg: motorväg, sätt
verklig: virtuell, faktum, kunglig
nästan: nästan, handla-om
kunskap: information
mot: mot
dålig: värre, ondska, fattig
levande: bo, midja, livstid
fred: rum
låg: kort, billig, missfall
norr: svar, norra, midnatt
naturlig: natur
ganska: vacker, mycket, tillräckligt
rättvis: höger, rapportera, tio
service: tjäna, bry-dig
Nedan: ner
nöje: lycklig
historia: berättelse, datum, historisk
Notera: kom-ihåg, notation
även-om: fast
främre: motsatt, fram-, före
stor: bra, massiv
säkert: strikt, kurs, verkligt
vind: luft, vind
ta-emot: mottagande, ta, härleda
uppmärksamhet: bry-dig, prioritet, fokus, betrakta, betoning
styrka: driva
förmodligen: kanske
glad: lycklig, munter, nöjd
viktig: nödvändig, följd
själv: egen, dem-själva
kollega: kollega, vän
åsikt: menade, aning
tro: tro, lojalitet
sedan: öster, sedan, före, fram-, tillbaka
avgift: vägtull, bekostnad, ta
ärm: hand, fattig, ärm, vapen, axel
senare: sista
objekt: syfte, ingenting, ämne
herre: manlig, sir, bemästra
särskild: i-synnerhet, nämligen
knappast: inte, nästan, sällsynt
chef: chef, huvud
chans: tillfällighet, placera, tillfälle, sannolikhet
handla: planera, handla, avtal
tänkande: tror
tung: upprepning, vikt, allvarligt, hård
enkel: öppna, enkel, ihålig
omedelbart: en-gång, snart
mun: person
rädd: skrämd, rädsla, angelägen
enda: en, ensam
glädje: lycklig, spänning
bruten: svavel, skära
såvida-inte: bortsett-från
bära: björn, Bär, ta-med, gör-det-möjligt
inflytande: effekt, influensa
synas: uppstå, verka
utanför: ut, bortsett-från
snälla-du: vänligt, be
utseende: uppstå, verka
långsamt: gradvis, sent
period: fas, tid
syster: bror
slåss: bekämpa, krig
före-detta: gammal
ungdom: ung
endast: endast, enkel, ensam
nå: närma-sig, uppnå, komma
system: beställa, hierarki, organisation
middag: natt, lunch
efteråt: framtida, efter
gå: trampa, gå, golv, fot
undra: mirakel, konstig, överraskad
vanliga: allmänt, gemensam, alltid
figur: digital, statistik, formad, antal, vägtull, bild
gammal: gammal, gammaldags
respektera: betrakta, ära, fara, mot
tredje: tre, tisdag
förbli: bli-kvar
samhälle: social, gemenskap, företag
resultat: slutsats, effekt
kommando: beställa
ren: endast, enkel
bredvid: passera, nästa, bortsett-från
tyst: tyst
perfekt: rätt, bra
gata: sätt
handstil: skriva, brev
trä: trä-, träd, pinne
snabbt: snart
få-syn-på: se, a.d, varning
ljus: skarp, ljus, glänsande, slående
båt: fartyg, flyta, yacht
ädel: bra, härlig
plötslig: plötsligt
värde: värde, rang, betydelse
på-grund-av: därför-att
läsning: läsa, fråga
enas: avtal
vänta: förvänta, håll, bli-kvar
bit: chips, del, sträcka
ex: gammal
konversation: prata, dialog
möjlighet: tillfälle, placera
kosta: bekostnad, betala
betydande: bra, följd, slående
sitta: bli-kvar
högst-upp: optimal, ås, ovan, toppmöte
äktenskap: gift
steg: handling, trampa, fas
börja: början
per: varje, mot
enskild: person, individuellt, atom
svår: hård
bit: del, liten, lus, munsbit
tal: prata
myndighet: jurisdiktion, driva
lycka: lycklig
förse: under-förutsättning, ge, försäkra
läsa-på: lär-dig, analys, studio
personlig: privat, individuellt, personal
kolla-på: kolla-upp, övervaka, se
nöjd: nöjd, lycklig
varm: värma, brand
ansträngning: Prova, anstränga
beredd: förbereda, redan
försök: Prova, frågesport, hugg
snabb: snart, vig
under: ner, efter
avsedd: avsikt, fokus, syfte
rakt: direkt, enkel
troligt: lätt, sannolikhet, kanske, förment
rättvisa: höger
helt-enkelt: endast, enkel
förtroende: tro, lojalitet
passage: del, korsning, kolumn, passera, sträcka
stängd: stänga, vävstol, täckt
oss-själva: dem-själva
godkänd: passera, förflutit, korsning
medium: sekundär, betyda
besittning: fast-egendom
trevlig: bekväm, snäll
perfekt: helt, verkligt
vanligtvis: gemensam, allmänt, tendera
grav: hård
fast: fixera, fast, standard-, permanent
soldater: armén
möte: session, montering, träffa
läger: camping, fält
nation: land, nationell
existens: närvaro
svar: svar, återbetalning
sky: atmosfär, himmel
lika: samma, grad
förmögenhet: öde, skick, fast-egendom
domän: fält
situation: placera, skick
mitten: betyda, halvvägs, midja
vinter-: kall
tillåta: tillstånd, gör-det-möjligt
påle: gul, färg, svag, pastell, öppna, ljus
spring: lopp, springa
religiös: religion, kemoterapi
bly: inducera, ta-med
flytta: trampa, argument, röra-sig-ur fläcken, rörelse, handling
sluta: gå-sönder, stå
talad: säga, verbal, prata
styrelse: stiga, panel, råd, kant, provision
fåfäng: fri, tömma
förlust: nackdel, förlorat, läcka
bjuda-på: under-förutsättning, föreslå, ge, utställning, tjäna, privilegium
klass: snäll, bana, rang
komplett: full
få-tillgång-till: besök, närma-sig, förvärv
passion: entusiasm, känsla
fysisk: fysik, kropp
exempel: exempel
start: början
trots: ilska
allvarlig: bra, allvarligt, extrem
silver-: pengar, fredag
tillräcklig: tillräckligt
huvud: huvud, bemästra, nyckel-, original-, häftklammer
underbar: konstig, våldsam, bra
väg: sätt
menande: konnotation, betyda, betydelse, ämne
få-plats: kostym, rätt
massa: massa, mycket, öde
sittplats: stol, belägring, huvudkontor
spel: spelande, spela
påstående: uttryck, rapportera
dröm: mardröm, sova
sten: klippa, kjol, sten
särskild: i-synnerhet, privat, expert-
avgift: bekostnad, vägtull, betala
del: del, insats, roll, distribuera
spridning: detalj, utbredd, sprida-ut, anledning
härlighet: ära, beröm
utrymme: placera, hall, fält, astronaut
vanlig: gemensam, enkel
fundera-på: tror, betrakta
mycket: mycket, i-stora-drag
officer: officiell
hastighet: standard-, ära, kurs
skylt: notation, gest, markera, fläck
inföding: natur, original-, bosatt
arbetssätt: anställd, arbete
gifta-sig: gift
utsträckning: bunden, volym, grad
metod: sätt, en-gång, närma-sig
excellent: bättre, bra
förtroende: tro
exakt: verkligt, i-synnerhet, full, helt
omfattande: bra
lust: fantasi, vacker
snabbt: snart, vig
ja: ja, således
frihet: fri, oberoende
intressant: dra, nyfiken
åt-sidan: separerat, sidled, bortsett-från
ren: färsk, veridical
rörande: ovan, handla-om, betrakta
bevis: bevis, uppenbar
avlägsen: bort, avlägsen
liknande: likna, samma, kongruent, jämförbar
smal: tunn, kort
sammanlagt: helt
sida: sida, gård
särskilt: i-synnerhet
berg: kulle
stolt: stolthet
helt-klart: uttryckligen, öppna, uppenbar
pris: ära
sjuk: sjuk
dom: beslut, mening, regel, bedöma, jurisdiktion, kris
acceptera: godtagbar, erkänna, ta
arter: snäll
sträva-efter: Sök
ära: ära
öra: tillstånd
botten: ner, golv, bas
hjälpa: aids, hjälp, stöd
fullt: full, helt
glädje: lycklig, obehaglig
belopp: kvant, volym, skara, antal
erhålla: förvärv, härleda, ta
beskatta: hyra, linje
korsa: korsning, passera, överstiga
främling: gäst, konstig, utländsk, okänd
våga: mod
växa: stiga
falsk: lögn, fel, sjuk, bristfällig
lång: lång, golv
gate: dörr
fritt: oberoende, fri, oberoende-av, lösa
blåsa: chock, stroke, skott, sparka
mode: närma-sig, komma
dagligen: dag
distribution: distribuera
rikedom: pengar, fast-egendom
frihet: fri, oberoende
förskott: framsteg
mild: mjuk, ljuv
säkert: kurs, verkligt
säkra: säker, skydda, försäkra
ockuperade: ta-vara-på, hagel, engagerade
etapp: plattform, handling, fas, skick, scen
del: del, ransonera
tunga: språk, spotta
arg: ilska
transport: tåg, vagn, transfer
väder: klimat, luft, tid
nödvändighet: betydelse
öva: träning, handling, beställnings-
krav: begäran, kostym
prins: hertig
grupp: uppsättning, konglomerat, flock, band, panel
genom-hela: överallt
Lägg-till: bredda, ytterligare, öka
be: be
ledande: följd, bemästra
grå: brun, aska
ofta: många-gånger, upprepad, permanent
känd: populär, välkänd, vokal
kraftfull: driva, kunna
Levande: bo
svag: svag, fattig
material: innehåll, ämne
frank: ärlig, axiom
värme: sommar, värma
skydda: skydda, bry-dig
lika: balansera, samma, likaledes
naturligtvis: natur
anmärkningsvärd: konstig, ovanligt, bra
måne: månad
lätt: liten, lätt, ljus, tunn, kort
stil: ljus
spetsig: hemisfär, skarp
princip: teori, axiom, början
omedelbar: snart, direkt
villig: redan, tå, mile
följd: följd, effekt, slutsats
anbud: mjuk, avtal, lopp
intresserad: avsikt, intressera
fjärdedel: fot
avancerad: ovan, fram-
tydligen: uttryckligen, förment, verka
aktiv: arbete, handling
medveten: avsiktligt, känna-till
farlig: fara, skadlig, hotfull
lugna: tyst
helig: gudomlig, helig
rike: kunglig
hel: helt, alla, full
fin: vacker
vana: karakteristisk, sätt, beställnings-
direkt: uppenbar, direkt, första-hand
faktiskt: verkligt, faktum
hörsel: höra
gående: trampa, fot, fotgängare
kasta: avge, kasta, skott
visdom: intellektuell
kör: körning, kör, expedition, skjuta-på, springa, disk
fel: skylla-på, fel
affär: sak, ämne, relationer
kontakta: korrespondens, Rör
station: stå, centrum, säsong
lyssna: höra, be, lyda
ont: skada, smärta, sårad
uttrycka: uttryck, förklara
förmån: sida, nåd, främja
höjd: längd
storlek: dimensionell, magnitud, full
uppgift: handling, arbete, tull
sympati: empati, medlidande
klädd: klä
längre: fram-
fartyg: instrument, fartyg
tillgivenhet: kärlek
lidande: tortyr, elände, bitter, problem
kött: kött, kropp
stor: massiv, bra
posta: rang, postkontor, efter, skicka, placera
samling: ackumulation, uppsättning, galleri, slutsats
tänka: fantasi, tror
ankomst: komma
högt: insistera, bra, hård
härlig: vacker, härlig
utöver-det-vanliga: konstig, ovanligt
hända: inte-heller
frukost: morgon-, lunch
befolkning: skara
serie: kedja, uppsättning
lättnad: aids, bekvämlighet, glyph
intryck: effekt, känsla, imponera-på, skriva-ut
tillfredsställelse: nöjd
form: dimensionell, form, formad
födelse: född
hänsyn: aning, betrakta
regelbunden: periodisk, upprepad, ordningstal
rör-på-sig: röra-sig-ur fläcken, rörelse
upptagen: engagerade
kvalitet: massa, grad
upptäcka: hittades, Sök, avslöja
inne-i: inre, djup, inomhus
jord: lera, golv, solo-, land
fullständigt: helt
meddelande: information, nyheter
fras: uttryck, mening
nämna: manlig
par: höger, par
titel: rubrik, huvud, ämne
förståelse: förstå, empati
söndag: vecka
galen: crackpot, lura
absolut: helt, strikt
långsam: tyst
barmhärtighet: medlidande, nåd
innehålla: inklusive, innehåll
sorg: sorg, smärta
soldat: armén, pantsätta
tidigare: öster
förklaring: förklara, information
bön: begäran
tro: tro, lojalitet
konstant: upprepad, standard-, fixera, permanent
slutlig: sista, slutligen
rida: ridning, safari, stiga, körning
politik: politisk
ritning: bild, dra, planera
döende: död, dö
efterfrågan: begäran, fråga
övre: ovan
belopp: och, yoga, antal
rörelse: rörelse, föreslå
bistånd: stöd, hjälp
värdighet: ära
fånga: håll, ta, uppfattning
bland: mellan
nuvarande: presentera, strömma
eventuellt: sannolikhet, kanske, kunde
separat: separerat, skillnad, solo-
värst: värre, fattig
skräck: rädsla, terrorist
kontrollera: reglering, kontrollerade, kolla-upp, hantera
kapabel: gör-det-möjligt, kunna, skicklig, skicklighet
fast: företag, fast
överlägsen: bättre
andlig: mentalt, moralisk, intellektuell
bevis: bevisa, bevis
relation: relationer, rapportera, betrakta
bekymrad: bry-dig, angelägen, associerad
djupt: djup, detalj
sjunga: läsa
vänlig: kongruent, vänligt, vänskap, snäll
ingång: dörr, mottagande
förse: bredd, under-förutsättning
rena: färsk, propert
användbar: nödvändig, effektiv
delikat: ömtålig, tunn, elegant
avlägsna: befria, radera, dra
val: välja, val, kolla-upp
enorm: massiv, bra
oförmögen: kan-ej, inte, misslyckas
täcka: täcka, integration, filt, slå-in, trottoar
dubbel: tvilling-, dubbelt, par
seger: framgång
ständigt: många-gånger, upprepad, alltid, Fortsätt
nivå: standard-, skick, yta
Släpp: ansvarsfrihet, offentliggörande, fri
grov: värre, PÅ-DÅLIGT-HUMÖR, ohyfsad
framåt: fram-, ovan
ansluten: bunden, bifogad, associerad, konjugat
få: förvärv, fördel
tillägg: ytterligare, komplement
kammare: rum, hall, kamera
bekantskap: bekant, primer
misstag: fel
baserad: bas, villkor
bil: tåg
ingen: någon, ingenting
energi: driva
bar: öppna, bar, skam, ihålig, skallig
delvis: halvvägs, del, något
färg: färg
säkerhet: säker, frälsning, bry-dig
beskrivning: beskriva, information, deskriptor, definition
sovande: sova
släppa: doppa, falla, läcka
lysande: härlig, glänsande, bra
kort: akronym, kort
grå: brun, aska
i-hög-grad: mycket
upphetsad: spänning, irriterad
förtvivlan: frustration, svag
lätthet: bekvämlighet, minska
total: brutto, alla
vänlighet: dygd, nåd
cirkel: cykel, lägenhet, runda, hjul
tråkig: borra
avsikt: avsikt, syfte
termin: villkor, termin, deadline
noggrant: bekväm, helt
tillämpas: använda-sig-av
arbetskraft: arbete
intelligens: intellektuell
strejk: ge-sig-på, slående
ganska: helt, tillräckligt, mycket
följa: träffa, lyda, innehåll
händelse: incident, tillfälle, show
försiktigt: mjuk, vänligt
förbindelse: samband, fastsättning, ring-upp
skydd: skydda, skydd, bry-dig
medveten: vaken, avsiktligt, känsla
utgåva: bekostnad, skriva-ut, offentliggörande, tillstånd
flyg: fågel, flyga, sväva
mängd: snäll, olika
isär: separerat, bort, bortsett-från, oberoende-av
förfärlig: fruktansvärd, medlidande
alla: alla, någon
arbetskraft: arbete
älskare: kär, flickvän
sång: låt
ivrig: önskan, otålig, nyfiken, angelägen
behöva: be, begäran, insistera
närhelst: när
framgångsrik: framgång
höja: bredda, hiss, öka, stiga
utveckling: framsteg
Häftigt: kall, vacker
rättegång: sond, behandla, domstol
utomlands: utländsk, exil
hängiven: lojalitet, trogen
litterär: litteratur
författare: författare
stock: pinne, roll, handling
typ: snäll, skriva, Tryck
massor: rik, redundans, tillräckligt
undvika: förhindra
förmån: sida, nåd, främja
mental: intellektuell, mentalt, inre
attityd: blick, stå, gest, närma-sig, beroende, stycke
beundran: beröm
ångest: angelägen, rädsla, upptagenhet, spänning
lära: känna-till, lär-dig
synlig: känna-till
guide: manuell, bevis, körning
faktisk: virtuell, faktum, kunglig
eländig: otillräcklig, ledsen, olycklig, elände, hjälplös
skada: ondska, skadlig, skada, medlidande
förlåta: förlåta, förlåt, be-om-ursäkt, nåd
sällan: ibland
spela-in: registrering, disk, spara
fett: olja, tjock
platt: lägenhet, noncommittal, planera
gåva: belöning, presentera
tempel: hus, katedral
licens: tillstånd
samtycke: godkännande, tillstånd
tillräckligt: full, tillräckligt
sår: skada, sårad, ulcus
djärv: mod, modig
någonstans: någonstans, överallt
bevittna: bevis
dåraktig: okunnig, lura
vem-som-helst: någon, vem-som-än
själv: privat, dem-själva, egen
ytterst: mycket, ovanligt
behandling: terapi, bry-dig
hals: hals, sväva, gurka
patient: sjuk
tillväxt: öka
kvantitet: kvant, massa, skara, dos, antal, magnitud
svår: strikt, våldsam, hård
ursäkt: förlåta, anledning, transitiv, förlåt
ursprung: original-, natur
publik: passiv, offentlig
återstående: ligger-kvar
vinna: framgång
hembiträde: tjänare
mjukt: mjuk, tyst
verklighet: faktum
plats: scen, webbplats, fläck
segla: fartyg, slöja
lagra: handla, lagring, spara
anmärkning: menade, betrakta
paus: gå-sönder
värde-: värde
därav: således, därför
plantera: stiga, träd, kvarn
is: snö
absolut: full, helt
lätt: lätt, snart
våldsam: skarp, våldsam, hård, grym, rovdjur, vild
rasa: ilska
upptäckt: hittades, Sök, uppfinning, öppning
släkt: associerad
bestraffning: mening
lätt: liten, lätt, något
mystisk: hemlighet, vag, osynlig
skugga: skugga, tona, nyans
mörda: döda
känsla: känsla, brinner-för
förstörelse: ruin, förstöra
fasa: rädsla
lokal: lokalt, inre, fläck
räckvidd: olika, avstånd, uppsättning
värd: armén, gäst, skara
våt: regn, fuktig
mysterium: hemlighet
besitter: egen, björn
medvetande: rationalitet, känsla, samvete
förr: före
produktion: producera
däck: bro
egendom: fast-egendom
regera: kung, royalty
överensstämmelse: Följ, anpassning
hennes: dess
olycklig: tyvärr, tillfällighet, olycklig, medlidande, otillräcklig
blomma: spendera, intressera, lera
tack: tacka
tillhöra: fast-egendom, inklusive
marknadsföra: köpa
lock: hatt, kork
förtjust: lycklig
hushåll: familj, hus
flotta: fartyg, marin, flyta
barn: barn, docka
område: fält
exakt: mjöl, rätt, full, försiktig
bild: bild
misstanke: tvivel, misstänksam
vägra: förneka, veto, avfall
ansvar: tull, skylla-på
skamsen: skam
måltid: mat, äta, mjöl
status: placera, skick
ange: ange, show
dikt: poesi, låt
uppstå: uppstå, stiga
resa: safari, expedition
delta-i: ansluta-sig
bildning: köpa, ge, björn
donera: bidra, ge
jobb: arbete
Fortsätt: Fortsätt, öka, framsteg, passera
ångra: förlåt
risk: fara
snabb: snart, vig
distinkt: separerat, skillnad
ordentligt: rätt, bekväm
berömmelse: beröm
singularis: förenad, enhet
fel: fel
rykte: beröm
överklagande: dra, ring-upp
brist: skära, bristfällig, frånvaro
våld: våldsam
göra: do, införa, ge
karriär: yrke, arbete
design: uppfattning, planera
förslag: mening, föreslå
uttala: uttala, full
upplösning: beslut, slutsats, analys, bredda
skona: alternativ, ytterligare, byta-ut, spjut
inhemsk: civil, inre, bosatt, nationell
hänvisa-till: referential, minne
existera: närvaro, presentera
problem: problematisk, villkor, problem, ämne, fråga, utsläpp
tillhandahålla: under-förutsättning, ge
flamma: brand
okunnighet: okunnig, bortse-från
ibland: ibland, upprepad
flygande: flyga
trasa: tyg, kläder
vinst: fördel
fjärde: fyra, onsdag, rum
klocka: larm, timme
dra-nytta: fördel
kapitel: dörr, del, huvud, säsong, huvudstaden, dem-själva
hål: borra, grop
rimlig: rätt, klok, rationell
socker: fylleri, sätt
ersättning: byta-ut, i-stället, ersättning, alternativ, utbyta
sticka: insistera, sticka, betala, skjuta-på, impuls
ram: skala, rättslig, skott
ämne: ämne
e-post: skicka
division: del
slaveri: slav
vers: poesi, stycke
sannolik: kanske
smärtsam: bitter, smärta
evigt: alltid, evig
hav: hav
bak-: efter, tillbaka, omvänd
ledare: huvud, chef, dirigent, manuell
angelägen: avsikt, angelägen, skarp
lycka: öde
skenbar: uppenbar, axiom
skynda: snart, kalv
schema: planera, randig, Diagram
onyttig: avfall
ändå: fast, ändå
jämna: mjuk
fast: demonstrativ, etablerad, fast, kompakt
nödvändigtvis: måste, nödvändig
bygga: skapa, byggnad, formulering
försök: Prova, hugg
ekvivalent: samma
nyligen: nyligen, modern, sista
resa: besök, turism
middag: eftermiddag, söder
belägen: falla
meddelande: a.d
upphöra: förhindra
omständighet: skick, kuvert
tält: stuga, scen
frekvent: upprepad, många-gånger
högt: röst
oberoende: oberoende, lösa, oberoende-av
grundläggande: nödvändig, häftklammer
observation: observera
tacksamhet: tacka
bevara: behålla, lagring, skydda
aspekt: element, sida
fruktan: rädsla, fobi, skrämd
duktig: skicklig, klok
distrikt: bo
fel: misslyckas, fel, konkurs, missfall
cent: penny, procent, hundra
känsla: känsla
ombud: betyda
desperat: svag
union: allians, förenad
bevilja: erkänna
slog-till: multiplicera, sparka, framgång
enorm: bra, massiv
övertygelse: mening
feber: brand, influensa
behandla: terapi, behandla, läka
vår: vår, oss
felaktig: fel, missbruk, bristfällig
idealisk: bättre
rusa: skara, stroke
rätta: rätt, höger, trogen, fixera
utföra: show, do
på-något-sätt: något
begrepp: uppfattning, konnotation, aning
diskussion: diskutera, argument
fast: etablerad, fast
stadig: standard-, fixera, konsekvent, permanent
imperium: kunglig
penna: penna, huvud
tillåta: tillstånd
upprätthålla: håll, skydda, behålla
fullt-med-folk: skara, densitet
begränsning: bunden, återhållsamhet
fruktansvärd: fruktansvärd
hamn: hamn, dörr
erfaren: att-uppleva, skicklig, expert-
motsatt: opposition, motsatt, mot, kontrasterande
fördrag: promemoria, avtal
inträffa: komma
sökande: tigga, Sök
praktiskt-taget: nästan, verkligt, praktisk
spår: markera, veto
gladlynt: lycklig, munter
arrangemang: beställa, disposition, organiserad, avtal
västra: väster
tryck: betoning, skriva-ut, skjuta-på, vikt
politik: politisk
vetenskaplig: vetenskap, forskare
merit: beröm, kvalificera, värde
intervju: besök, intervjuare
territorium: fält
sex: penis, sexuell, sex
skapelse: skapa, formulering, etablerad
spår: markera, val, sätt
utsikt: hoppas, sannolikhet, vision, scen
drift: drift, behandla, handling, kirurg
djupgående: djup
match: spelande, sammanfaller, tillfällighet, lopp
enhetlig: klä
skuld: skylla-på, religion, tull, kreditera
våga: äventyr, investering, företag
utförande: handling
humör: känsla, humör, disposition
besättning: personal
uppfatta: förstå, uppfattning, se
förklara: förklara
version: kopiera, cell
udda: konstig, ovanligt
tacksam: tacka
oändlig: evig, infinitiv
säkerhet: säker, bry-dig
förnuftig: klok, rationell, mottaglig
stuga: hydda, stuga
kapacitet: kunna, skicklighet, volym
bosätta-sig: bli-kvar
involverade: engagerade, ansluta-sig
råd: råd
undersökning: sond, kolla-upp, välja
stål: järn-
testa: kolla-upp, Prova
välgörenhet: kärlek
skjul: Häll-i, kasta
kommunikation: korrespondens, relationer
någon: vem-som-än, person, någon
rad: linje, ordningstal, uppsättning, regering, beställa
fattigdom: fattig
intensiv: kant, extrem, våldsam
gräl: bekämpa
tillgängliga: under-förutsättning, presentera
motstånd: opposition
ovanlig: ovanligt, gemensam
folktom: övergiven, öken-
rösta: välja, röst
härda-ut: björn, anhängare, sista, lida
lyckas: framgång
ben: fot, ben
bud: föreslå, begäran
interiör: inre
lätt: lätt, ljus
visa: show, utställning, skärm, scen, bevis
begränsad: begränsad, endast
syfte: syfte, fokus
kritisk: nödvändig, kritiker
väska: ficka, säck, korg
upprepa: upprepning, tillbaka, upprepad
spåra: övervaka, låt, sätt, Följ
bostad: skydd
gyckel: lycklig, munter, underhållning
försvara: skydda
kraftigt: vikt, allvarligt
grejer: innehåll, gods, sak
avsnitt: del, dissektion
lösning: avtal, skydd, reglering
tallrik: panel, disk, disko
betagen: klara, överstiga, slå
grunder: anledning, villkor, motiv
marmor-: sten
förmåga: kunna, skicklighet, talang
våg: tidvatten, vag
folk: en-personer, populär
möjlighet: sannolikhet, kunna
smör: olja
hat: förakt, hat
förföljande: Sök
dra: dra, sax
signal: gest, markera, lösenord
säkert: säker
bränna: bränd, rök
lektion: utbildning, ämne, kurs
årlig: år
kort: kartong, Karta, kort, papper
ansökan: använda-sig-av, programvara, begäran
intelligent: intellektuell, klok
grevskap: bojkotta, regional, stad, land
formatera: form, kasta
flöde: strömma
skada: ruin, skada, medlidande
dessutom: ytterligare, även, mer
handel: handel
sydlig: söder
yttre: ut
genomsnitt: sekundär, betyda
naken: skam
uppenbar: uppenbar, öppna, axiom
grund: bas, plattform
oro: bry-dig, angelägen, associerad, intressera, upptagenhet
magi: charm
kampanj: rörelse, expedition
liberal: generös
vanligen: gemensam, många-gånger, allmänt
jaga: jakt
lärare: författare
inom-kort: snart, kort, nästan
välsignelse: välsigna
mycket-liten: liten, mikro
skarpt: fart, skarp, allvarligt
bröst: bröst
djup: djup
prestanda: show, produktivitet
välstånd: frodas, framgång, välfärd
kontorist: anställd, officiell
besluta: beslut, bestämd, avgörande, löst-ämne
offer: jakt, offra, vägtull
motiv: avsikt, motiv, motor-, syfte, stimulans
bestämd: bestämd, uppenbar
tendens: karakteristisk, mile, disposition, drift
avsluta: färdiga, färg
flagga: baner, känna-till
administrering: regel, hantera
i-sällsynta-fall: sällsynt
äkta: virtuell, original-
utbildning: utbildning, undervisning
dåligt: fel, mycket, värre, ondska, sjuk
foder: äta, främja, mat
central: centrum, federal
kontrast: kontrasterande, opposition, konflikt
strukturera: byggnad, strukturell, organisation
betalning: betala
takt: fart
förfrågan: sond, begäran, Sök
vart-som-helst: var
skyldig: skyldig, tull
hantera: behandla, hantera, klara, manipulation
färd: besök, safari, sightsee, expedition
skjuta: skott, exil, avge
sysselsättning: arbetslös, upptagenhet, arbete
skärande: skära
motstå: opposition
bestämma: bestämmare, bestämd, avgörande, förelägga, fixera
köpman: -handlare, affärsperson, handel
livlig: bo
bris: luft
relativ: kusin
därigenom: således
bestämmelse: införa, under-förutsättning, välfärd, tilldelning, disposition
angående: handla-om, betrakta
plocka: välja, ta
förstörd: förstöra
leverera: ge, införa
oväntad: överraskning
skrivbord: tabell, kontor
körfält: linje, band
representera: representant, exempel
respektabel: ära
ansvar: tull, skylla-på
besviken: ambition, besvikelse
lämplig: sammanfaller, rätt
bero: beroende, bunden
jätte: bra, monster
grepp: förstå, ta-vara-på
anlända: komma, uppnå
enkelhet: enkel, ödmjukhet
höst: falla
frånvarande: frånvaro, bort
dysterhet: mörk
misstänka: gissning, tvivel, misstänksam
bestämning: bestämd, beslut, rapportera, definition
grund: bas, villkor
undersöka: observera, kolla-upp, analys
pris-: belöning, premie
inköp: köpa
någon: person, någon, fast
inse: uppnå, förstå
besegra: slå, halsband, misslyckas
kriminell: blod
dumbom: lura, okunnig
återkallande: kom-ihåg
ockupation: räd, yrke, yrkesmässig, aggressiv
samtala: modern, prata
hjälpa: hjälp, stöd, samarbete
försäljning: auktion, sälja, rabatt
inbjudan: inbjudan, ring-upp
sämre: otillräcklig, ner, värre
erkänna: erkänna, diagnos
porträtt: bild
föreslå: föreslå, anta
besvikelse: frustration, ambition, anticlimax, besvikelse, räkna
konstruktion: byggnad
iver: entusiasm, flit
ansvarig: tull
bota: terapi, läka, bry-dig
omfatta: inklusive, ange, integration, förstå, innehåll
uppfylla: träffa, nöjd, innehåll, unna-sig
vånda: bitter
dum: crackpot, okunnig, lura
njutning: njut-av
dölja: dölja
exakt: rätt, full
utgå-ifrån: tigga, anta, betrakta
uppskatta: värdering, gissning
rutt: sätt
besökare: resande, gäst, observatör
icke: inte
tråd: linje
för-det-mesta: i-synnerhet, i-stora-drag
medvetslös: svag
ömsesidig: varandra, gemensam
extern: ut, utländsk
universum: kosmos, värld
klocka: timme
instruktion: undervisning, riktning, manuell
öm: ulcus, sjuk, smärta
disciplin: ämne
introduktion: införa, under-förutsättning, främjande, primer, importera
vildmark: öken-
förvirrad: nervös, frustration
bröllop: gift
räkning: representant, sida, nåd, del
räkna: tro, beräkning, räkna
osäker: osäkerhet, ostadig, vag
engagemang: engagerade, utnämning
smutsig: utsläpp, brutto
läkare: läkare
beläggning: täckt, integration, tak, slå-in
uppriktig: ärlig, verkligt, veridical
känsla: känsla
specifik: i-synnerhet, privat, expert-
värdshus: hotell
styv: hård
följa: Följ
göra: markera, rapportera
oskuld: dotter
hunger: hungrig
favorit-: favorit
tull: tradition, tum, tull, beställnings-
imponerad: känsla
byte: jakt, plundra, offra
musikalisk: musik-, musiker
tillfredsställande: sjukdom
löjlig: okunnig, munter
ark: papper, blad, folder
skam: skam
ursprungligen: original-
lön: betala
omfattande: utbredd, djup
fritid: underhållning, tömma, gå-i-pension, avkoppling
haka: skägg
glöd: lysa-skarpt, ljus, strålning, flash
svartsjuka: svartsjuk
järnväg: järnväg, tåg
pund: boka
östra: öster
medborgare: civil
strand: kust
särdrag: element, karakteristisk, fast-egendom
boka: behålla, boka
ryta: buller
underligt: konstig
bark: bark, hud
reception: välkomna, mottagande
behaglig: obehaglig, snäll
vakna: vaken
forskning: analys, Sök
monark: kejsare, kung
kläder: tyg, klä, kläder
sjukdom: sjukdom, sjuk
skoj: skämt, ironi, skratta
kommentar: förklara
metall-: järn-, mineral-
lösning: fixera, beslut, svar
tobak: cigarett, rök
enhet: instrument, enhet, närvaro, organisation, företag, person
avvika: avresa, avvika, spricka, gå
bittert: bitter
fredlig: tyst
orolig: angelägen
lura: rekrytera, trampa, lura, manipulation, listig
finansiell: pengar, ekonomisk
förberedelse: förbereda
skal: pod, bark, hud
bo: bo, uttag
conceive: uppfattning, förstå, tror
utnämning: utnämning, löfte
hämta: ta-med, hämta, ta
ljus: ljus, vax-
anfall: ge-sig-på, brottslighet, massa
blandning: blandad
modell-: exempel
defekt: skylla-på, skrynkla, handikapp
invändning: oenighet, opposition, motsägelse
hantverk: konst, yrkesmässig, skicklighet
försummelse: bortse-från, övergiven, underlåtenhet, bojkotta
data: information
vapen: vapen, pistol
rosa: reste-sig
användare: handla-om, förmånstagare
farfar: förfader, farförälder
null: noll-, tömma
kraftfull: våldsam
blixt-: elektronisk, bult, flash
sport: rörelse, träning
pulver: mjöl, damm
målning: bild, panel
skrika: buller, kniv, gråta
slarvig: hänsynslös, likgiltighet
derivat: härleda
dörröppning: dörr
bekväm: enkel, praktisk, bekväm, lätt, rätt
brev: postkontor, brev
måla: färg
överlämna: tradition
slå-fast: införa, etablerad, fixera
mild: mjuk, ljus
omedelbart: en-gång, rätt
avdelning: del
förtjäna: värde, kvalificera
sluta: övergiven, uppstå, spricka, kasta
försäkran: försäkra, borgen
spegel: glas
tomt: konspiration, planera, berättelse
uppåt: mer
sorgligt-nog: ledsen, tyvärr
blygsam: gemensam, enkel, ödmjukhet, sparsam
maträtt: domstol, mat, äta
netto: web, veridical, helig
värme: entusiasm, värma
rastlös: angelägen
experimentera: pilot, att-uppleva, Prova
i-dag: dag
fantastisk: fruktansvärd, bra, massiv, mycket
förbättring: reformera, reparera, framsteg, återhämtning, läka
tvist: oenighet, argument
förslag: föreslå, mening
kanske: kanske, kunde
gevär: pistol
skydda: skydda
använda: hyra, använda-sig-av
till-skillnad-från: olika
hämta-sig: spara, hämta, återhämtning
para: spotta, kollega, vän
ordna: beställa, lagstifta, organiserad
utskott: panel, provision
åldrig: gammal
spöke: själ
uppenbarelse: uttryck
erkännande: erkänna, bekännelse
lera: lera, mol
trunk: stam, bagage, känga
förvaltning: hantera, körning
återställa: behålla, tillbaka, återhämtning, hämta
protest: opposition, Mars
lugg: dumpa, insats, skara
måttlig: sekundär, betyda
stava: charm, stavning
område: fält, regional, yta
formell: officiell
redaktör: författare, utgivare
erkänna: bekännelse, erkänna
avhjälpa: medicin, terapi, fixera
utöva: unna-sig, övervaka, spendera, Följ
pol: förlåt, kolumn, extrem, navel
avgörande: nödvändig, avgörande, nyckel-
president: huvud
avdelning: vinge, regional, del
Fröken: 
heja-på: hjärta, entusiasm
motiverat: rationell, höger, rättfärdiga
beundra: beröm
öppet: uttryckligen, öppna, öppning
modifiering: ändra, anpassning
dramatisk: drama, demonstrativ
en-trappa-upp: ovan, värre
varierande: olika
härkomst: natur
avundas: svartsjuk
ladda: vikt, anstränga, bar, stam
låtsas: hyckla, drama
inre: inre
gardin: slöja, skärm
friska: hälsa
skymma: vag, förmörkelse
centrum: centrum
tävling: lopp
ändra: konvertera, ändra, byta-ut
glimt: blick, vision
kontrakt: promemoria, beställa, håll, avtal
sparande: spara, lagring, ekonomi
sträng: rep, kedja, uppsättning
kombination: tillfällighet, blandad, uppsättning, ring-upp
arrestera: fästa, uppfattning
temperatur: värma
sträng: strikt, skarp, hård
professionell: yrke, yrkesmässig
skadade: sårad, skada
grannskap: omgivande, bo, miljö-
rökning: rök, cigarett
medicinsk: läkare
informera: tidning
framträdande: populär, minnesvärd, följd, nyckel-, välkänd
institution: organiserad, företag, organisation
packa: slå-in, stänga, förpackning
ångest: bitter, elände, smärta, sorg
tydligen: uppenbar, öppna, uttryckligen
ta-till-fånga: fängsla, ta, uppfattning
riklig: tillräckligt, otillräcklig
sovrum: rum
rent: endast, helt, helig
gemensam: gemensam, blandad, ring-upp
hänvisa: referential, rådfråga
identifiera: identitet, identifierbar, fixera
bänk: bank
rädda: återhämtning, spara
begränsa: bunden, förkorta
förväntan: förvänta
programmera: planera, dagordning
elektrisk: elektronisk
intervall: tillfällig, gå-sönder
jaga: jakt
uppta: ta, ta-vara-på
klänning: täcka, klä, kostym
låsa: slott
förslag: föreslå, mening, planera, slutsats
lyckligt: lycklig
senare: nästa
illa-till-mods: ostadig, obehaglig, angelägen, hård
glans: lysa-skarpt, flash
maskiner: mekanisk, maskin, mekanism
attraktiv: magnetisk, dra, önskvärd
produkt: gods
sjukdom: sjukdom
motor: motor-, maskin
deras: de
läder-: hud
subtil: mikro, tunn
sluttning: mile, doppa, böjd
oroa: angelägen, upptagenhet
våldsamt: hård
specificerade: bestämd
timmer: trä-, pinne, träd
beräkna: beräkning, räkna
dödande: döda
rolig: konstig, munter
förolämpning: förakt, skam
oförmögen: kunna
äta-middag: äta
känslig: mottaglig, nyckel-
aptit: önskan
artighet: artig, ära
sfär: fält, boll, regional
honorific: ära
skuld: skyldig, brottslighet, skylla-på, synd
utsökt: välsmakande, smak
vete: folklore, spannmål, majs
humör: humör
råka-ut-för: klara, träffa, datum
skymning: gryning
parkera: trädgård
ekonomi: ekonomisk, ekonomi
styra: hantera, regel, bemästra
bildning: utbildning, formulering
luta-sig: mile, tunn
slå: tveka, klappa, slå
enhet: förenad, enhet, solidaritet
större: pionjär, nyckel-, förälder, bra, häftklammer
preliminära: öppning, original-
gräns: bunden, kant
andas: andetag
befria: fri, befria, förlåta
rik: rik
inspiration: impuls, inspirera
alla: alla
riklig: rik
målare: konstnär
glasögon: glas
skytte: skott, jakt
vagn: tåg, vagn
låna: ge, kreditera, citationstecken
åta: början, do
täta: ringa
präster: präst
montera: installera, öka, kulle
array: kolumn, uppsättning, beställa
tidskrift: Tryck
hård: hård, strikt
trots: fast
stram: strikt
landskap: scenario, miljö-, vision
överge: övergiven
konstnärlig: konst
huvudsakligen: i-synnerhet, i-stora-drag
lojal: lojalitet, ärlig, trogen
lämpad: kongruent, sammanfaller, rätt
råda: råd, rådgivare
stabil: etablerad, bestämd, standard-
maximal: maximera, extrem
begå: löfte, do
påverka: effekt, imponera-på
bonde: jordbrukare
betydligt: mycket, följd
förlänga: detalj, bredda, sträcka
personligen: individuellt, privat, egen
moral: moralisk
uppror: rebell, rotation
gänga: linje, snurra
koppar: mässing
svar: reaktion, svar
kejserlig: kunglig
tom: tömma, ihålig, vit
mindre: sekundär, liten, gruvarbetare
förhandla: handel, tillfälle
trötthet: trött, anstränga
tycker-illa-om: förakt, hat, motvillighet
vanligt: gemensam
skiss: översikt, planera
dygdig: dygd
i-alla-fall: ändå, redan
förare: bilist, körning, dirigent
förklaring: a.d
överskott: ytterligare, redundans
separation: åtskiljande, avstånd, separerat
avsky: förakt, fobi, hat
med-rätta: samma, rätt
folkhop: skara, massa
onödig: avfall, måste
päls: hud, täcka
uppmuntra: inspirera, skjuta-på
hyllning: hyra
lindra: minska, befria, förlåta
lagstiftning: lagstifta, regel, lagstiftande-församling
projekt: planera
fe-: ängel, blå, villa
sluta: håll, slutsats
tur-: lycklig
knä: knä, förkläde, runda
skämma-bort: plundra, ruin, sophisticate
ansvarig: lätt, tendera, mottaglig
omtänksam: försiktig, angelägen, klok
gynnsam: kongruent, böja, önskvärd
tenn: bank
beroende: beroende, bifogad, anställd
motivera: försäkra, rättfärdiga, promemoria
klagomål: vit
konvent: promemoria, avtal
vinkel: hörn, polygon
allmänt: utbredd, mycket, allmänt, i-stora-drag
ko: nötkreatur
fördom: hat
veranda: hall, balkong
förvånande: konstig, förvåna, överraskning, slående
fontän: källa
lämplig: rätt, kostym, konsekvent
säker: mod, säker, tro
organ: instrument, medlem, element, kropp
urval: välja, utnämning, val
vördnad: fobi, rädsla
jämföra: jämförelse
relatera: fästa, krok, relationer, associerad
förmoda: tro, gissning, anta, betrakta
saknas: förlorat
modern: modern, elegant
positivt: positiv
resonemang: aning, argument
störa: nervös, aggressiv, blanda-sig-i, irriterande
partner: flickvän, gemensam, aktieägare
förening: samband, betrakta
niece: brorson, sondotter
kroppsligt: fysiologisk, kropp
fakultet: college, faktoriell
kanon: boll, artilleri, pistol
segling: fartyg, slöja
smart: klok
ringa: ringa, trivial, liten
försiktighet: varning, bry-dig
manuskript: fakturera
krigare: hjälte
flytande: vatten
begrepp: uppfattning, konnotation
speciellt: i-synnerhet
hoppa: flyga, dansa, häl, studsa
ovillig: avsikt
extra: ytterligare
tonhöjd: trottoar, tona, inte
besvärlig: otillräcklig, konstig
uppskatta: applådera, njut-av
överleva: bo, bli-kvar
kort: akronym, kort
ris: mässing
kille: person
beteende: karakteristisk, uppträdande
anta: anta, ta
regelbundet: många-gånger, upprepad, permanent, rätt
undersökning: sond, Sök
konstitutionell: konstitution
senast: sista
elev: student
totalt: helt
vriden: böjd
skilja-sig: separerat, skillnad, olika
katastrof: ruin
satsning: insats, skick, veto
rå: bo, källa, brutto, grön
logga: ange, registrering, klubb
gästfrihet: generös
vagn: tåg, vagn
robe: klä
förlova-sig: bifogad, använda-sig-av, hyra, behålla
besättning: flock
samla: samla
panorera: pott
överfall: ge-sig-på, räd
lura: lura, förråda
sorg-: sorg
dra-tillbaka: befria, dra, gå-i-pension
ställa-in: låt, harmoni
medlidande: empati, medlidande
dölja: dölja
transkription: kopiera
dokumentera: fil
granne: omgivande
blockera: förhindra, volym
skyldighet: tull
nedgång: förneka, falla
ambitiös: ambition
semester: semester, fest
knytnäve: först
örn: hök, slips
hedrande: ära
signifikant: nödvändig, följd, slående
tät: kompakt, tjock
fiktion: roman, fantasi, berättelse
rekommendera: föreslå, införa, råd
lärorikt: utbildning
uppåt: mer, ovan
horn: majs
fond: låda, huvudstaden
lodge: hydda, fil, stuga
kostym: klä, kostym, beställnings-
biljettpris: hyra, gå, Karta
applåder: applådera, godkännande
påminna: kom-ihåg, likna
kudde: flod
ingenstans: fläck
lik: kropp
väsen: cell, varelse
elevation: brant
rike: fält, värld
trappa: trappa, skala
bevilja: promemoria, kompakt, kostym, sammanfaller, avtal
spets: spika, inkomst
forskare: student, forskare
linjal: hertig, guvernör
galen: crackpot, lura
underhålla: välkomna, roa, underhållning
hälsning: välkomna, vykort
feminin: kvinnlig
monstruös: monster, fruktansvärd
anläggning: utrustning
råna: stjäla, plundra
stege: trappa, dirigent, skala, skola
slut: sista
dela-in: skillnad, distribuera
otrolig: konstig, ovanligt
båge: rosett
välja: val, välja
blyg: blyghet, skam
dimma: dimma
färgad: färg
varna: varning, inducera
grund: djup
uppmuntran: stimulans, bekvämlighet
oregelbunden: gemensam, ovanligt
troget: lojalitet, trogen, rätt
överföra: översättning
grundläggande: bas, häftklammer
bunt: stänga, fiber
tragisk: fruktansvärd
recension: revision, kritik
fruktansvärt: fruktansvärd, mycket, värre
matlagning: kock, kök
revolt: rebell, rotation
förbättra: fixera, läka
förstöra: förstöra
övertyga: övertyga,-övertala, försäkra
skål: kopp
illustration: exempel, bild
nerv: ven, mod, nervös
stirra: fixera
fastställa: känna-till, försäkra, bestämd, kolla-upp, fixera
löfte: försäkra, löfte, gisslan, borgen, pantsätta
tjäna: tjäna
Välj: välja
industriell: industrialisering, industri
tolkning: översättning
utmaning: ring-upp
förbjuda: förhindra, förneka
tema: motiv, ämne
tillträde: mottagande
slå-samman: simbassäng, grop
konferens: session, montering
jämlikhet: analogi, balansera, likvärdighet, ekvation
nytt: neo, nyligen, roman
miljö: miljö-, omgivande
invasion: ge-sig-på, räd
mönster: exempel, en-gång, standard-, form
avslöja: avslöja, förråda
lösa: lösa, fixera
predika: predikan
mormor: brud, farförälder
ull-: bomull
kommunicera: dialog, socialisera, relationer
väsentligen: villkor
motsätta: opposition
prov: exempel
dra: dra, sax
beskära: gröda, skörda, skära
exakt: rätt, mjöl, försiktig
tillflykt: ta, skydd, gå-sönder
vägran: förneka, avfall
obligation: nyckel-, borgen, copula
sympatisk: medlidande
lön: betala
kontinuerlig: Fortsätt
excitera: inducera, hetsa
vilt: vild, våldsam
sorg: sorg, tragedi
allierad: förenad, associerad
tak: filt, tak
mål: fokus, syfte
kontanter: pengar
ledig: öppna, fri, tömma, lösa, vag
förakta: förakt
gräsmatta: gräs, äng
kalkon: 
granne: omgivande
slutlig: sista, extrem, slutligen, häftklammer
underkastelse: lyda, skicka
inträde: ange
grundlig: djup, full
spännande: dra, nyfiken
vinnande: framgång
konservativ: ortodox, guvernör
entusiastisk: entusiasm, angelägen
nedre: ner
koka-upp: kock, ulcus
vackert: skönhet, vacker
i-morgon: i-går
obekväm: angelägen, obehaglig
anordning: utrustning
hävda: insistera
yttrande: uttala, uttryck
järnväg: järnväg, tåg
ofullständig: full, handikapp, bristfällig
förvärva: förvärv, härleda, köpa
offensiv: räd, ge-sig-på, aggressiv
kallt: kall
föreläsning: kurs
varigenom: var
uppfattning: känsla, blick, uppfattning
utveckla: utveckla
fungera: ceremoni, arbete, aktivitet
kula: tablett, skott, boll
binda: fästa, bunden
identisk: samma
väsentlig: demonstrativ, bra, följd, slående
bulk: massa, magnitud, volym, tumör
långvarig: lång, dröja-kvar
irriterad: irriterad, obehaglig
upprörd: nervös, ledsen
knippa: copula, band
hö: gräs, halm-
debatt: oenighet, argument
stillhet: tystnad
partiell: undantag, del
nötkött: kött
förena: solidaritet, sele, förena, ansluta-sig
blad: blad, svärd, kniv
fabrik: kvarn
null: noll-, tömma
tidning: tidning, Tryck
ärligt: lojalitet, ärlig
legitim: rättslig
accent: uttala, betoning, fokus
vänliga-hälsningar: allvarligt
liga: allians
godkänna: godkännande
lem: medlem, extrem
steward: chef, tjänare
evolution: reformera, evolutionära
undersökning: kolla-upp, Sök
samtida: modern
skandal: korruption
överväga: avsiktligt
symbol: notation, gest
tvättning: tvätta, tvätt
exakt: rätt, mjöl, försiktig
förekomst: incident, tillfälle
axel: dike, axel, träd
stam: torr, stam, rot
företag: företag, organisation
preferens: privilegium, föredra, fördel, välja
enträget-uppmana: inducera, impuls, önskan
avlägsnande: avstånd
påstående: godkännande, betoning
tillgänglig: besök, hittades
komedi: humör
spola: färg, spänning
koda: gård, koda
tillräcklig: tillräckligt, rätt
split: distribuera
historiker: historisk
intensitet: densitet, anstränga
demokrati: republik
bekännelse: bekännelse
attraktion: charm, allvar
konsert: festival
nedåt: ner
kanal: kanalisera, rör
prompt: snart, begäran, vig
brons: mässing, brun
plagg: kläder
ånger: ledsen, medlidande
exklusiv: monopol, privat
porter: Bär, bärare
rusa: linje
remsa: band
i-sista-hand: slutligen
team: kör
dyr: kär
huvudkontor: huvudkontor, centrum
akut: skarp
generad: nervös, skam
avkomma: barn
nätverk: web
plan: fågel, yta, maskin
delvis: del
stolt: stolthet
terrass: balkong, tak
grepp: håll, fälla
spränga: brista
trupp: armén, militär-
tätt: strikt
straff: medlidande, mening
smuts: fuktig, avföring, lera
epok: säsong
ambassadör: budbärare
ras: multiplicera, lopp
interferens: blanda-sig-i, irritation, oordning
bestå: passera, innehåll
godkännande: godtagbar, godkännande, mottagande
ingenjör: mekanisk
stanna: fot
alternativ: alternativ, byta-ut
stämpel: ringa
disk: disk, opposition, motsatt
venus: fredag
imaginär: fantasi
klättrande: stiga, krypa
dra-till-sig: dra, imponera-på
förvånande: överraskning, slående
konkurrens: rival
kristall-: glas
dusch: bad, regn
filosofiska: filosof, filosofi
bullrig: buller
anordning: utrustning
transport: trafik, transfer
så-småningom: slutligen
väldigt: mycket, fruktansvärd
begrundande: reflektera, reflexion
tillverkning: industri, producera
bekvämt: bekväm
utställning: utställning, rapportera
jordbruks-: lantbruk, odla
sökande: Sök
förlängning: detalj, bredda
kontrovers: motsägelse, argument
ungefär: nästan
över-huvudet: ovan
hålla-tillbaka: hämning, förhindra, återhållsamhet, behålla
bevarande: spara, bry-dig, behålla
pub: bar
handfat: dal, simbassäng, sjunka
melodi: tona
hyra: hyra
orolig: angelägen, nervös
äldre: gammal-ålder, gammal
universitet: college
försiktig: försiktig
tidigare: öster, före
komplicerad: komplex, hård, utveckla
ursäkt: be-om-ursäkt, förlåt
rädd: skrämd, rädsla
ersättning: alternativ, ersättning, byta-ut
användande: använda-sig-av
restaurering: reparera, återhämtning, hämta
häck: staket
primär: bemästra, bas, original-, häftklammer
balk: stråle
tur: besök, expedition
överdriven: salt-
behörig: gör-det-möjligt, kunna
brådskande: snart, fällning
varna: varning, larm, vaken
ugn: spis
avrundad: runda
konventionell: gemensam
åberopa: tigga, rättfärdiga
sladd: rep
vid-sidan-av: parallell, nästa, samband
extrahera: citationstecken, juice
ljusare: ljus
halvliter: öl
rör: rör
aveny: tillfälle
effektiv: skicklig, effektiv, effekt
blanda: blandad, uppståndelse
störning: oordning, irritation
verkställande: chef
tionde: tio
jämförande: jämförelse
A.M.: morgon-, glänsande
bur: slott, cell
fängelse: fängelse, kedja
skicklig: skicklig, listig, kunna
skrika: gråta
kompromiss: avtal, harmoni
ammunition: skott
assistent: anhängare, hjälp
sockerrör: pinne
argumentera: diskutera, insistera
logik: argument, rationell, rationalitet
panik: rädsla
omlopp: cykling, cykel, trafik, sightsee
stress: anstränga
konsumtion: använda-sig-av, konsumera, äta
sustain: stöd, behålla, håll, lida
krascha: falla, konflikt
saknas: otillräcklig, skära, bristfällig
gradvis: gradvis
krossa: förstöra, allvar, squash
fenomen: incident, sak
utföra: springa, handling
hälsa: hälsa, välkomna, hagel
monarki: kunglig, fast-egendom
bete-sig: bo
barriär: hinder, tröskel
kurva: rosett
lita: räkna
bekvämlighet: lätt, bekvämlighet
lamm: får, krypa
logisk: rationell
diet: mat
rättslig: domstol, rättslig
misstro: tvivel, lojalitet
fjäder: vår, medlidande
frivillig: volontär-
jacka: täcka, Tröja
simning: simma
imponerande: slående
under-: ner, efter
provinsiell: lantlig, provins
ersättning: kompensera, ersättning
servitör: tjänare
främja: acceleration, främjande, främja, skjuta-på, bidra
ägna: avsikt
fientlighet: fientlig
plantage: odla, barnkammare
översikt: översikt, avslöja, öppna
lappa: fläck, fastsättning
avbrott: gå-sönder, irritation
tumme: tum
revolutionerande: rotation
fantastiskt: konstig, förvåna
dricks: hemisfär, spika, extrem, skägg, toppmöte, råd
hot: hotfull, fara
djungel: skog
typisk: gemensam, karakteristisk
bränsle: olja
lugn: tyst
destination: upprepning, syfte, öde
stift: hemlighet, nål
mars: Mars
associera: associerad, kollega, samband, gemensam, parallell, bifogad
ond: omoralisk, ondska
bankett: fest
detaljerad: utveckla, djup, gångjärn, detalj, försiktig
garderob: skåp
lagstiftande: lagstifta, lagstiftande-församling
marginal: kant, fält
mästare: hjälte
puls: impuls
fly: springa, fly
klausul: strömma, stycke
förening: samband, komplex
knut: håll, sticka
relation: relationer, rapportera, betrakta
byrå: organisation, företag, kontor
flin: leende, grimas
demonstration: show, Mars
depression: sorg
fordon: maskin
låna: kreditera, citationstecken
svullnad: svälla
ämne: motiv, ämne, rubrik
dom: beslut, regel
sabbat: lördag
Identifiering: identifierbar, identitet, definition
fotografera: bild, skott
alliera: vän, vänskap, förenad
tarmkanalen: sätt, sträcka, argument
band: band, film
plus: mer
transparent: genomskinlighet, uppenbar
parfym: lukt
besvära-sig: problem, blanda-sig-i, irriterande, irritation
kvalificerad: kunna, kvalificera, skicklig
uppsats: artikel, rapportera
ryttare: riddare, ridning
ensamhet: ensam
handled: hand
fint: mjuk, tunn, slutligen
null: noll-, tömma
fördöma: mening
käke: tall
unik: förenad
oundvikligen: oundviklig
trumma: dansa, tömma
bin: låda, korg
varaktighet: tillfällig, permanent, tid, längd
väga: mäta, vikt
kloster: kloster
publicera: offentliggörande, distribuera, avslöja
insikt: vision
definitivt: uppenbar, strikt, kurs, verkligt, uttryckligen
flytta: ändra
i-kväll: dag
faktor: anledning, anställd, koefficient
röra: aggressiv, oordning, förvirring
öva: träning, handling
fristad: altare
krympa: akronym, samla
utgifter: bekostnad, använda-sig-av, spendera
uppmuntrande: hjärta, inspirera
exponering: uttryck, utställning, rapportera, effekt
rå: brutto, grön
biljett: baner, Karta
bakåt: tillbaka
sko: skor, känga
bedrägeri: illusion
explosion: brista
öppen-spis: skorsten
burk: glas, flaska, tillbringare, pott
sås: klä-på-sig
rutten: lat, omoralisk, fattig
beteende: karakteristisk, uppträdande
lån: kreditera, citationstecken
orimlig: rationell, dumheter
lusta: ambition
årligen: år
vätska: vatten
unge: barn
sinnessjuk: crackpot, lura
störta: Häll-i
prestation: framgång, rang, utnyttja
antagande: anta, fantasi, förment
humoristisk: humör, munter
extas: entusiasm
pensionering: gå-i-pension, resignation, pension
parlament: lagstiftande-församling, senat
nödsituation: angelägen, kris
paket: slå-in, del, stänga
låda: låda, trappa
bidrag: bidra, insats
länk: fastsättning
plocka: mod, pressa-ut
utskrift: offentliggörande, skriva-ut, Tryck
förespråkare: advokat, rättfärdiga, svarande
miljö: atmosfär, miljö-
bekräfta: bevisa, försäkra, förstärka
meddela: avslöja, offentliggörande
avgå: resignation, gå-i-pension
avvisa: förneka, veto
tuff: hård, grym
fragment: chips, munsbit, skrot, sträcka
meditation: bry-dig, reflektera
fläck: fläck
begravning: begravning, begrava
hypotes: anta
hypotetisk-humör: spekulativ-humör, assumptive-humör, villkorlig-humör
transaktion: aktivitet, handel
skandal: ilska, förakt, skam
variera: variabel, olika, byta-ut
advokat: advokat, representant
förolämpa: skyldig
paket: slå-in, ficka, stänga
klassisk: klassisk
ranch: odla
paj: tårta, pi
exakt: höger, noggrannhet, strikt
kasta: kasta
marin-: marin, hav
sångare: läsare
elektricitet: elektronisk, strömma
främmande: utländsk, gäst, utomjordisk
knäckt: brista, spricka
deprimerad: ledsen, sorg
tjockt: tjock
rimligen: anledning, rationell
kabel-: ihålig, böja
illustrera: förklara, reflektera
adoption: godkännande, mottagande
ökänd: välkänd
skada: skada
korrekt: noggrannhet, rätt, höger
bete: vide, äng
mask: mask, djup
uppskattning: värdering, gissning
utrusta: organisation, kläder, utrustning, klä
olycklig: olycklig, tyvärr
åttonde: åtta
avslappnad: bekvämlighet, avkoppling, tyst
intilliggande: nästan, omgivande
senior: veteran-, förälder, huvud
skrämma: larm
handledare: tränare
rån: plundra, stjäla
handel: handel, kommersiell
utdöd: försvinna
klump: massa, torus, buckla
tillfällig: slumpmässig, tillfällig, tillfällighet, överraskning
lokal: hus, fläck, byggnad, inomhus
leverans: införa
böjd: böjd, böja
produktiv: tillverkare, producera
svullen: svälla
odla: främja, odla
variation: ändra, skillnad
motståndare: rival, opposition
barnbarn: sondotter, brorson
spika: naglar, spika, bult
välvilja: generös, välfärd, dygd, nåd
precision: noggrannhet
indikation: markera
minskning: minska, skära
mage: mage, navel
äcklad: hat
komponera: skriva, skapa
passagerare: resande
sting: hugg, bitter, bita
samtidigt: under-tiden
episod: följd, del
beständig: konsekvent, Fortsätt, permanent
svälta: hungrig
samråd: rådfråga, råd
sur: syra
Understrykning: insistera, betoning
parad: Mars
hjälm: hatt
förkunna: propaganda, offentliggörande
logi: hotell
spray: medicin
formellt: officiell
störande: nervös, blanda-sig-i, angelägen, irriterande
förväntan: förväntad, förvänta
kvalitet: bro, koefficient, rang, värdering, grad
pall: avföring, stol
berättigande: rättfärdiga
utlänning: utländsk, gäst
transport: trafik, transfer
förståelse: förstå
direktör: chef, huvud
timlig: tillfällig, tid
fint: vacker
hävda: förelägga, tvinga, gör-det-möjligt, polis
omfattande: djup, full
hota: hotfull
progressiv: framsteg, radikal
resurs: källa
begränsa: begränsad, ta-vara-på, förkorta, minska
gratulera: beröm
försäkring: säker
utnämna: öga
avbryta: hinder, skära, blanda-sig-i, amputera, gå-sönder
dämpa: förtrycka, förhindra
lager: kolumn
ledtråd: bevis, nyckel-
tand: tänder, tandläkare, buckla
garanti: försäkra, borgen
procedur: behandla, mekanism, handling, närma-sig
rekommendation: råd
gap: gå-sönder, öppning
medföra: betyda
bifoga: bifogad, splitsa, fästa
hållning: gest, indikator, placera, stå
svit: vinge, uppsättning, lägenhet
juvel: skatt, frodas
emotionell: känsla, brinner-för, mottaglig
betong-: demonstrativ, konsekvent
kombinera: allians, samband
topp: toppmöte
valuta: pengar, mynt
mål: syfte, fokus
minnesmärke: minne, varning
separat: separerat, skillnad, individuellt, ensam
bricka: disk
horisontell: balansera
charter: konstitution, papper, hyra
punkt: gods, artikel, element, röst, snäll, placera
expansion: detalj, bredda
vrida: bult, snurra, ironi
traditionell: tradition, klassisk
engagera: inklusive, integration, innehåll
rutin-: gemensam, mekanism
lösa: plog, lösa, fixera
fresta: reta, inducera
misslyckad: misslyckas
politiker: politisk
lock: tak
överträdelse: skada
korsning: ordningstal, korsning
chef: ägare, chef, arbetsgivare, huvud, tjuv
hårdvara: utrustning
strand: kust, band
rand: kant, klippa, läpp
handelsvaror: handel, gods
på-avstånd: separerat, bort, avlägsen
asyl: sjukhus, skydd
bekräfta: bevisa, försäkra
schema: tabell, kalender, Diagram, disposition
dike: dike
kommunal: stad
upplopp: uppståndelse
vittna: bevisa
moderlig: gravid, mamma
skulptur: staty
smak: smak
stämpla: manuell, markera
bagage: bagage
skräp: dumheter, skrot, dumpa
verktyg: instrument
kaos: oordning, förvirring
åtal: kostym
spänd: nervös, tid
höna: kyckling
trim: prydnad, minska, skära
diskret: klok
sörja: gråta
dialekt: polska
elementär: bas
frakt: bagage, bar, lastbil
torka: sopa
avslag: förneka
underground-: hemlighet
mellanliggande: kolla-upp
formel: ekvation, Tryck
fuska: lura, manipulation
förfölja: tveka, fobi
registrera: lista, registrering
obestämd: vag, aorist
överskott: ytterligare
darrning: darra
vävnad: organisation, web, tyg
förslag: översikt
leksak: docka, spela, spelande
trappsteg: trappa, skala
övergång: infektion, ändra, transitiv, korsning
knapp: nyckel-
ovänlig: ohyfsad
program: planera, dagordning
tillverkning: industrialisering, kvarn, producera
zon: fält, regional, band
nionde: nio
alkohol: vin
girig: ambition, girighet
styra: hantera
inflytelserik: effektiv, penetrera
omge: krage, belägring
drunkna: sjunka, hörn
glida: glida
sugga: stiga, bröd, gris
dominerande: bra, räd
ledarskap: hierarki, manuell
dagbok: tidning, kalender
fira: övertyga,-övertala
väsen: spänning, buller, irriterande, förvirring
vice: representant, alternativ
bil: motor-
ändring: revision, ändra
vertikal: stå, longitudinell
otillräcklig: otillräcklig, tillräckligt
jäkla: tunn
slutledning: gissning, slutsats
inferential-humör: induktiv-humör
annons: a.d, kommersiell, propaganda
stöld: stjäla, plagiera
spontan: instinkt, godtycklig
nytta: organisation, använda-sig-av, instrument
ansluta: fästa, krok, splitsa, ansluta-sig
nedåt: ner
intervention: blanda-sig-i
väckelse: återuppliva, återhämtning
internet: handel
fysiskt: fysik, kropp
punkt: fläck
upprörande: chock
plumpt: ohyfsad
balanserad: konsekvent
index: exponent, lista, indikator
överföra: skicka, distribuera
till: ovan, ut, fram-
chat: prata, statistik
bärnsten: gul
ton: tona
mjukt: bekväm
spänning: anstränga, spänning
val: val
giftig: förgifta
koncession: röra-sig-ur fläcken, privilegium, rabatt
arbetstagare: anställd
lutning: doppa, konjugat
toalett: skåp
anfall: ge-sig-på, brottslighet
agg: hat, hämnd
mod: tålamod, mod
förutse: hoppas, förvänta
rytm: slå
råtta: mus
motsvarar: korrespondens, kostym, rätt, svar
internera: förhindra, ta-vara-på, behålla
tolka: förklara
salong: hall
fungera: manipulation, arbete, springa, handling
dränera: ränna, springa
lön: betala
otäck: hat, ondska, obehaglig, besvikelse, ful
kyrkogård: begravning
plåster: krita
knacka: rör, mjölk
avfärda: säck, bortse-från, förneka, veto, skilja, redundans, förlåta
provocera: spänning, irriterad
vistas: bli-kvar, bo
dekoration: prydnad
tå: tå, fot, finger, tass
oförmåga: handikapp, svaghet
uppfinna: uppfinning
definiera: bestämmare, utveckla, beskriva
begränsad: begränsad, bunden
skåp: skåp, hylla
kuggstång: hylla
föreståndare: dirigent, inspektör
presentation: införa, show, utställning, främjande
gummi-: boll, elastisk
utesluta: beröva, radera, skilja
privilegierad: privilegium
eremit: asket
repa: skrapa, början
skruva: bult
utforska: observera, utnyttja
försäkra: försäkra
cylinder: disk
sammanfattning: översikt, abstrakt
osannolik: sannolikhet
svärm: flock, son
systematisk: mekanism
i-stort-sett: verkligt, nästan, praktisk
klient: beställnings-, gäst
katalog: lista, tabell
kemi: kemisk
baka: bröd, kock
pierce: hugg, penetrera, borra, perforera
ryck: riva, ta-vara-på, kidnappa
lansera: avge, kasta
jordbruk: lantbruk
skådespelerska: skådespelare
teater: teater, hall
läkemedel: medicin
ogynnsam: värre, nackdel, omvänd, negativ, skadlig
godis: mynta, choklad, ljuv
klistra: uppsättning, halsband
fälla: fälla, straffa, skyldig
undersöka: sond, observera, kolla-upp
paket: slå-in, uppsättning, stänga
krypa: krypa, krypa-ihop
knäppa: pop-, klick, bild, tidvatten, snart
trötta: embryo, ringa
märkbar: slående, uppenbar
kärna: bas
företrädare: förfader
liknande: likaledes, samma
damm: damm
hal: glida
omvandling: ändra
frans: kant
plats: placera, fläck
klunga: konglomerat, massa, band
citat: citationstecken
vårdnad: flit, bry-dig
rimlig: godtagbar
kasta: kasta
ringt: trampa
koncentration: ackumulation, fokus
praktisk: praktisk, bekväm
bete: smak, primer
olika: olika
skiva: chips, disk, munsbit
borra: borra, gräva
svara: reaktion, återbetalning, svar
dödlighet: död
ogräs: gräs
relativt: volym
matematisk: matematik, idrotts-
moraliskt: moralisk
flämtning: suck, andetag
racing: lopp
isolering: åtskiljande, separerat
nån-gång: ibland
vuxen: mogna
strapats: bitter, elände, problem, irritation
rykte: skvaller, röst
motstå: behålla, björn, sista
junior: ung
stickning: sticka
indirekt: direkt
prejudikat: exempel
gång: stråle, hall, korsning
motsäga: motsägelse, förneka
lösa-in: spara, kompensera
väg: sätt, övergångsställe
redskap: utrustning, tänder, revben, springa
firande: fest
ombonad: värma, bekväm
publishing: offentliggörande, distribuera
kund: gäst, köpare
matta: matta, golv, filt
dela: räkna
syn: blick, vision
estetisk: skönhet
harmas-över: hat
pose: föreslå, inducera, stå
belåtenhet: nöjd
organism: varelse
obegriplig: förstå
eftertrycklig: betoning
middagstid: eftermiddag, söder
lilja: läsa
substantiv: nominalization, namn
hopfällbar: vika-ihop, böjd
hjälpsam: hjälp
envisas: insistera, Fortsätt, sista
utlopp: går-ut, uttag, avresa
ärva: arvinge
hastighet: fart, fällning
förolämpande: verbal
brist: otillräcklig, skära, underlåtenhet, bristfällig
försäkra: försäkra
orättvis: höger
sub: byta-ut
hink: fat, sked
organisation: organisation
först-och-främst: i-synnerhet
ritual: ceremoni, dyrkan
lår: skinka, fot
garderob: kläder, skåp
konsistens: organisation
turbulent: våldsam
kärr: träsk
omedveten: okunnig
första: öppning, original-, början, först, primitiv
minimum: minst
korrektion: reformera, revision, reparera
förbise: bortse-från, glömma
enhällig: förenad
kol: kol
spole: fil, rulla, lockig
knaprig: ömtålig, skarp
ordförråd: lexikon
promenad: vandra
kondition: träning, gymnastik, skick
nationalitet: nationalism, nationell
smak: smak
oviktig: nödvändig, trivial, irrelevant
stansa: slå
kliva: framsteg, trampa
axel: axel, skriva-ut
tillfredsställande: sjukdom, nöjd
pålitlig: trogen
äcklig: hat, ful
etisk: moralisk
falla-ihop: falla
dämpa: flod
förbrylla: förfalska, förstöra, förvåna, misslyckas, besvära
myt: berättelse, legend
äganderätt: fast-egendom
skrämma: skrämd, fruktansvärd, rädsla
broms: gå-sönder
mutter: böna, utsäde
förstora: svälla, öka
sol-: solsken
näbb: läpp, enhet
hyra: koppel, hyra
förhållande: relationer, jämförelse, skala, rapportera, analogi
kamma: borsta, axel, ås
översätta: översättning, flip
rekreation: underhållning, semester, avkoppling
infall: färg
prov: exempel, Prova
flertal: massa
initiativ: planera, Prova
gelé: sylt, mjölk
anarki: oordning
profil: översikt, fil, webbplats
finansiera: pengar
grundläggande: bas, häftklammer
förvisa: dumpa, räd
elektrisk: elektronisk
ört: gräs
blomstra: frodas
likhet: analogi, likna, solidaritet
privatliv: privat
arena: fält
resande: resande
partikel: atom, utsäde
medfödd: original-
invånare: bosatt
flöjt: vissla
fortplantning: fertilitet
spänna: längd
sallad: sallad, driva
färga: färg
demonstrera: bevisa
etik: moralisk
officiellt: officiell
förarga: blanda-sig-i, irriterande, reta, hetsa, borra
glida: glida
drag: karakteristisk, fast-egendom, sträcka
kompositör: musiker
fotboll: sparka
partnerskap: samarbete, allians, bidra
fortsättning: Fortsätt
onormal: ovanligt, crackpot
sekvens: kedja
pressa: skjuta-på
tackla: ta-vara-på, klara, utrustning
trottoarkant: hämning, trottoar, återhållsamhet
reklam-: a.d, propaganda
uttag: regression, uttag, slutsats
inteckning: gisslan, kreditera, pantsätta
tålamod: tålamod, björn
förtränga: förhindra, förtrycka
make: man
giltig: effektiv
ventil: skåpbil
konstruera: skapa, byggnad, formulering, fas
ånga: ånga, par
slagträ: pinne, klubb, fram-
motsägande: motsägelse, irrelevant, kontrasterande
automatisk: direkt
explicit: öppna, genomskinlighet, axiom
effektivt: effektiv, effekt
beroende: beroende
inspektera: observera, kolla-upp, sightsee, analys
underligt: konstig, ovanligt
dra: dra, plundra
pinsam: skam, besvära
inaktiverad: handikapp, passiv
arrogant: stolthet
ringla: lockig, ringa
pärla: sten, frodas
årsdag: födelsedag
prestige: kreditera
oaktsamhet: underlåtenhet, förakt, likgiltighet
själv-: privat
diskriminering: undantag, skilja
kontinental: kontinent
mål: syfte
bås: handla, stå
investera: investering
kryssning: fartyg
rally: solidaritet, handling
rykte: skvaller, röst
aktivt: allvarligt
kolla-upp: kolla-upp
fack: lägenhet
speciellt: i-synnerhet
smäll: pop-, brista, skott
aggregat: brutto, gemensam
fraktion: del, insats
olaglig: olaglig, vild
lösa-upp: radera, löslig, lösningsmedel
jämvikt: balansera
utforskning: sond, analys
lök: rosett
affinitet: analogi, solidaritet, beroende
oärlig: trogen
kollidera: konflikt, chock, blanda-sig-i
fåtölj: stol, soffa
deg: mjöl, massa, jäst, tårta
gå-ombord: ansluta-sig
trance: vision
avslag: förneka, avfall
variation: skillnad, rätt, motsägelse
absorption: hud
kollektiv: massa
i-god-tid: tid
invadera: ge-sig-på
uppsägning: säck, redundans
signifikant: i-stora-drag
experimentell: pilot
filma: film, tv, bild
publicitet: propaganda, främjande, a.d
bygga-ut: bredda, detalj
tumla: snubbla, falla, doppa, kläder
smedja: skapa, förfalska
fossil: olja, arkeologisk
tvång: hinder, reglering, återhållsamhet
krydda: entusiasm, krydda, att-uppleva, smak, hud
kräsen: irriterande
liten-by: förort, by
bom: frodas, studsa, brista
reproducera: kopiera, imitera
kongress: montering
druva: vin
verkstad: studio, seminarium
minska: minska, skära, falla
uttal: uttala
dom: beslut, mening, regel, bedöma, jurisdiktion, kris
koncentrera: försiktig, fokus
ångra: avslöja, tillbaka
färja: yacht, fartyg
enkel: enkel, direkt, lätt, genomskinlighet, linjär
höjd-över-havet: längd
beteckna: show, betyda
exportera: går-ut
lagbrytare: komet, skyldig
ogillande: opposition, veto
par: par, balansera
avskaffa: radera
anpassa-sig: revision, fixera, anpassning
medlemskap: medlem
mätare: mäta, skala, magnitud, tunn, indikator
tolerera: förlåta
höft: rumpa, midja
vidhäfta: Följ, ansluta-sig, pinne, behålla
slå-tillbaka: förhindra
oro: oordning
kyskhet: noggrannhet, renhet
slak: avkoppling, lösa
kontraktion: blyghet
journalist: reporter
symptom: utställning
cykel: cykling, cykel
tjära: trottoar
spiral-: snurra
kommentar: vaccin, definition
överföring: infektion
valsedel: röst, val
potential: kunna
berättigad: kunna, höger, kvalificera, rätt
slinga: cykling, gångjärn, ringa
arbetare: anställd
åtala: skylla-på
licens: tillstånd
avstå: ansvarsfrihet
ego: dem-själva, andetag
jet: mata-ut, fågel, strömma
kränka: inte-lyda, skära
beroende: beroende
överlevnad: livstid, vokal
frysa: frusen
väva: sticka
sittande: etablerad, förmånstagare
apati: likgiltighet
organisera: organisation, förbereda, lagstifta, organiserad
förmodligen: kanske, förment
ackord: avtal
blöda: blod, blodig
upptäckt: hittades, Sök, avslöja
smash: förstöra, gå-sönder
främja: acceleration, främja, bidra
frekvens: cykel, tveka
sy: sömnad
katalog: bevis
hugga: bita, skära, stek
uppvärmning: värma
deprimerande: besvikelse, ledsen
kupp: rotation, skott, stroke
medlidsam: medlidande
tänkare: intellektuell
budget: balansera
medborgerlig: civil, urban
föra-in: ange, öka
meditera: reflektera, tror
flexibel: enkel, böja, elastisk
platta: panel, tablett, spis
kompetens: talang, kvalificera
växla: omvänd, konvertera, nyckel-
handduk: tyg
årtionde: tio, håll
flera-olika: olika, mer
bandage: klä-på-sig, fästa
städa: propert
klappa: klappa, applådera
lönn: palm
räfsa: sopa
tomhet: tömma
märg: olja, hjärna, kalebass
slida: täcka, kuvert, pod
absorbera: utnyttja, suga, omfamning
förutsägelse: förutsägbar, gissning
utbilda: utbildning, tåg, undervisning
förfrågan: sond, begäran, Sök
herravälde: regel
föräldra: förälder
delta: delta, ansluta-sig, engagerade
hiss: hiss
lateral: sida
skjuta-upp: dröjsmål
avsky: förakt, hat
nucleus: nukleär, cell, embryo
liknelse: exempel
diminutiv: liten, mikro
bomba: pump
kritiskt: djup, kritiker
rost: passera
bokning: behålla, ta-vara-på
sy: sömnad
kemist: kemisk
vardagsrum: gå-sönder, hall
början: början, räd, ge-sig-på
dyka: doppa
ovänlig: fientlig
folkräkning: beräkning
fördöma: anklaga, mening
lin: linne-
uppskjuta: förhindra
slag: slå
koppla-av: avkoppling
uppvaktning: gård
råvara: gods
kontinuitet: samband
ömsesidig: utbyta, inversion
recept: medicin, kopiera
bubbla: skumma
skotta: tång, åra
utnyttja: utnyttja, använda-sig-av, spendera, sele, konsumera
hållbar: lång
härstamning: bekant
zink: sjunka
beroende-på-vad som: vad-som-helst, som
ändlig: begränsad, slutligen, färdiga
extra: anhängare, aids
förvränga: förvränga, bekämpa, stroke
akademisk: utbildning
trötta: embryo, ringa
konsument: använda-sig-av
giltighet: värde, kreditera
cirka: nästan, ungefärlig
stickad: sticka
mikroskop: teleskop
civil: civil
rem: koppel, rep
symbolisk: gest, identitet
anpassa: anpassning, klara, transkribera
sannolikhet: sannolikhet, kunna
subjektiv: mentalt
pronomen: samvete
felaktigt: fel, missbruk
avskräcka: besvära, ambition
nykomling: gäst
oändlighet: infinitiv
grafisk: Diagram
fikon: formad, bild
nisch: konsekvent, nyckel-
svika: besvikelse, förråda, misslyckas
utsprång: planera, show
befrielse: ansvarsfrihet, frälsning
recept: stimulans
franchise: privilegium
motsägelsefull: dumheter, irrelevant, otillräcklig
rotation: cykel, rotation, snurra
knopp: knopp
meter: mäta
begränsning: bunden, återhållsamhet, reglering
kategori: gemenskap, rang
ras-: lopp, rasism
utbyte: i-stället, byta-ut, ändra
innovation: uppfinning
konfrontera: klara
förbjuda: förneka
dekorativ: prydnad
lobby: inducera, hall
kasta: kasta, lockig
rulla: boka, rulla, lockig
mekaniker: mekanisk, hantverkare
aggression: ge-sig-på, aggressiv, överstiga
Hallå: Hallå, välkomna
mått: mäta
konkurrera: brottas, rival
akademi: college
nybörjare: rekrytera, färsk
skild: äktenskapsskillnad
mejeri: mjölk
reservoar: tank
handla: handla, handel
implicit: konsekvent
strategisk: strategi
forma: modulo, form, skriva-ut, kasta
repetition: träning, upprepning
krav: insistera
föregå: före
mitten: medeltida, halvvägs, midja
turist: resande, turism
dryck: dryck
uppmärksam: försiktig
artikulera: förklara, uttryck
re-: sedan, tillbaka
ändra: revision, ändra, byta-ut, splitsa, reformera
diagram: Diagram, Karta
deduktiv--humör: induktiv-humör
överösa: förtrycka
mobil: telefon, cell
upphöja: främjande, hiss
paradox: motsägelse
överdriva: salt-, maximera
blond: gul
cue: markera, lösenord, pinne
löpare: hall
förhandla: prata, diskutera
regim: regel
tolerans: tolerant, björn
alternativ: alternativ, gurka
korståg: rörelse
epidemi: tragedi, översättning
teknik: teknisk, närma-sig, teknik, utrustning
terminal: slutligen
examen: passera
produktion: bekostnad, slutsats, offentliggörande, avresa, produktivitet, går-ut
lokalisera: fläck
standard: underlåtenhet, standard-
sammanhang: miljö-, scen, konnotation
koalition: allians
fel: skylla-på, fel, handikapp, nackdel
medge: erkänna
utsända: offentliggörande, skicka
ringa: välja, ringa, samla
utbredning: populär
alltmer: alla
omvandla: ändra, konvertera
drake: drake
tvetydig: vag, motsägelse
kafé: kaffe, bar
tilldela: belöning, premie, erkänna
märka: studio, markera
godkännande: godkännande, erkänna
släktskap: analogi, socialistisk
realistisk: verkligt
reptil: orm
utomhus-: ut, öppna
politiskt: politisk
återstod: ligger-kvar, avfall
tejpa: kassett, band, film
mild: mjuk, ljuv
oral: verbal, läpp
spekulera: gissning
driva-ut: mata-ut, ansvarsfrihet
fläck: fläck, handikapp
hoppa: dansa, spendera
mugg: kopp, grimas
kil: spika, insats, hörn
befrielse: rabatt, undantag, redundans
bärbar: liten
omslag: förpackning, slå-in
briljans: talang, skönhet, lysa-skarpt
fena: åra, balett
mumla: viska
bär: bukt
invandring: migration
hacka: plog
kirurgi: kirurg
ackumulera: ackumulation, deposition, samla
bajs: avföring, rör
buk: mage
inblandning: konnotation, integration, slutsats
incitament: stimulans
rycka: skruvmejsel, nyckel-
landsbygden: lantlig, förort, fält, by
degradera: förstöra, minska
inhemsk: natur, original-, bosatt
stack: dumpa, ås, skorsten
skiva: disk
trend: uppträdande, riktning, böjd, disposition, drift
företags-: företag, gemensam
frikänna: befria
instabil: ostadig, obeständighet
kompatibel: konsekvent, parallell, kongruent
telefon: telefon
vakuum: tömma
hugg: hugg, ta, ta-vara-på
konvulsion: jordbävning, brista
tråkig: uttråkad, borra, irriterande
portfölj: uppsättning, plånbok
skreva: spricka
komplikation: problematisk, vägtull
ingripa: blanda-sig-i
polär: polaritet, extrem
delegera: representant, budbärare
vilja: viljestyrka, önskan
förutspå: förutsägbar, gissning
optimism: hoppas, tro
skal: hud, pod, bark
tälja: bita
sväva: flyta, sväva, tveka
sektor: fält, industri, regional, del
efternamn: namn, de
inleda: organiserad, företag, organisation
brådskande-karaktär: angelägen
trevlig: snäll
avskräcka: förhindra
negation: förneka
vinnare: framgång
sammansatt: blandad
inverkan: effekt, konflikt
fiber: fiber
smutta: svälja
visuell: optisk, scen
klo: tass
kärande: skådespelare, bärare, anledning
djupt-beklaga: medlidande
vilse: förvränga, förvåna, lura
förbjuda: hämning, förhindra, förneka
aktör: skådespelare, konstnär, spelare
turnering: lopp
krav: begäran, skick
minus-: minst
ovårdad: hänsynslös
infektiös: infektion
betona: insistera, betoning
byxor: byxor
blanda-ihop: pussel, förvåna, besvära
ägna: volontär-, avsikt
kirurgisk: kirurg
Sanning: faktum, noggrannhet
hundradel: hundra
lutande: brant, doppa, böjd
närliggande: nästan, snart, omgivande
i-vanliga-fall: gemensam, många-gånger, allmänt, tendera
förvirrande: motsägelse, pussel, förvirring
proportionell: jämförbar, balansera
instämmer-inte-alls: oenighet
irritera: ilska, blanda-sig-i, reta, irriterad
utestående: bättre, slående
initiering: början
utfällning: fällning
skrämma: larm
hobby: underhållning
grammatisk: grammatik
numerisk: antal, digital
kriterium: standard-
prognos: förutsägbar, gissning
ogilla: förneka
exotisk: utländsk, konstig
glödlampa: lampa
öka: bredda, öka, maximera, läka
fusion: smälta, ring-upp
röstning: val
begåvad: talang, skicklig
tina: smälta
räta-ut: sträcka, fixera
dekorera: prydnad
president-: ordförandeskap
stöta: för-tidig, multiplicera, sparka, buckla, tumör
lyckönskan: beröm
avsöka: sopa
berättiga: gör-det-möjligt, höger
vadhållning: skick
tekniskt: teknisk, teknik
empirisk: att-uppleva
dominera: bemästra
annonsera: a.d, propaganda
diffusion: distribuera, offentliggörande
beta: skrapa
utrustning: utrustning, låda, uppsättning
praktiker: läkare, tränare
blöta: suga, doppa
bevarande: skydda, spara, bry-dig
slem: lera, trottoar, dribbla
utmanande: hård
förorening: förorena, korruption
kemikalier: kemisk
sats: flock, impuls, volym
mamma: mamma
skrämmande: fruktansvärd, hotfull
specialist: expert-
längta: önskan
badrum: bad
spela: spelande, spela, äventyr
väsentlig: nödvändig, integrerad
eliminera: befria, radera
ärta: böna
bilaga: fastsättning, ytterligare, ersättning
cirkulera: distribuera
inclusive: förenad
säljare: -handlare
plåga: nervös, blanda-sig-i, besatthet
explodera: brista
bända: nyfikenhet, spak
spill: läcka, Häll-i
gratis: fri
ingrediens: element
underskott: öppna
upprörande: nervös, irriterande, obehaglig, ledsen, oordning
hus: hus
fotografisk: fas, bild, fotograf
skadedjur: insekt
piller: tablett
för-närvarande: presentera
media: Tryck
haveri: ruin
corpus: kropp, uppsättning
meny: lista
fraktur: spricka
forum: plattform, borra, domstol
drivkraft: fart, impuls
luta: luta, böjd
bricka: tegel
bokhylla: bibliotek, bokhandel
beräkning: beräkning
producent: tillverkare
monetär: pengar
skildra: beskriva, reflektera, införa
inflation: svälla
marginell: kant
fantasi: fantasi
underminera: förstöra
sammanhängande: strikt, samband, konsekvent
fundamentalt: villkor
avsiktlig: avsiktligt
efterlevande: familj
flöde: flod, strömma
konkurrenskraftig: rival
smycke: prydnad
alkoholhaltig: berusad, vin
diskriminera: skilja
militant: radikal, terrorist, militär-
avväpna: vapen
avgörande: nödvändig, avgörande
uppdrag: arbete, träning, tull, tilldelning
kvot: privilegium, tilldelning, kvant
utgrävning: grop, gräva
kalcium: sparka
fira: övertyga,-övertala
historiskt: historisk
Hej: Hallå, välkomna, frälsning
eliminering: befria, underlåtenhet, radera
spänd: propert
avkopplande: bekvämlighet, bekväm, avkoppling
effektivitet: effektiv, effekt, skicklighet
sårbar: mottaglig
idrottsman: idrotts-
rand: randig, linje, band, film
fasad: mask, vision
klämma: häftklammer, tång
prototyp: exempel, original-
offset: klara, kompensera, avvikelse
null: noll-, tömma
begränsa: förhindra, förkorta, minska
bock: markera, lus
moms: tank
våldta: överstiga
null: noll-, tömma
villkorlig: bifogad
kulturell: kultur
teknologi: teknisk, utrustning
marknadsföring: handel
slips: slips
ekonomiskt: ekonomisk
administratör: chef, förvaltare
porträttera: beskriva, införa
barnbarn: sondotter, brorson
dubbel: två, par, tvilling-
syntes: original-, installera, uppsättning
specialitet: yrkesmässig, karakteristisk
bisarr: konstig
sökande: kandidat
språklig: språk, lingvistik
svamp-: kork, svamp
pumpa: squash, kalebass
lyfta: hiss, stiga, framsteg
fenomenal: ovanligt, solo-, super
dynamisk: driva
revidera: revision, fixera, kolla-upp
bryta-ner: åtskiljande, falla, analys
tröttsam: trött
campus: college, skola
avhandling: avhandling
statistisk: statistik, statistiskt
formulera: förbereda, formulering
smörgås: bröd
null: noll-, tömma
stimulering: acceleration, spänning, irriterad
censur: censurera, reglering
utrusta: komplement
nominera: utnämning, föreslå
annullera: radera, skrot, frustration
meter: mäta
sänka: förtrycka
mister: sir, bemästra
rekonstruera: reparera, återhämtning
domare: regel, bedöma
atom-: atom, nukleär
kontroversiell: motsägelse
sofistikerad: komplex, modern
rycka-till: rycka-på-axlarna
olämplig: irrelevant, otillräcklig
sediment: fällning
nonchalera: förakt, skylla-på
variant: olika
klandra: kritik
leda: uttråkad, irritation, elände
samarbeta: samarbete, samband
analysera: analys, analytiker
regn: regn
gro: knopp
flygplan: fågel
kryddad: skarp
flexibilitet: elasticitet
raket: missil
adverb: kuvert
instabilitet: ostadig
berövande: beröva, nackdel
huka: sitta-på-huk
generera: producera, skapa
approximation: ungefärlig, närma-sig, konvergens
moral: vaken, moralisk, mentalt
optimistisk: hoppas, tro
klassificera: klassificering, distribuera
läroplan: kurs, dagordning
utomhus: ut
reagera: reaktion, verb
manus: scenario, linje, skriften
utpressning: pressa-ut
bonus: belöning, premie
tillgång: fast-egendom, närvaro, fördel, huvudstaden
variabilitet: skillnad
tvetydighet: vag, motsägelse, osäkerhet
null: noll-, tömma
kastrera: neutral
handikapp: besvära, hinder, handikapp, nackdel
fotografi: bild
brist: skära, frånvaro
förflyttning: byta-ut
svamp: bakterier, svamp, kork
lydelse: formulering, text
diplomat: diplomatisk, budbärare
inleda: införa
sammanfoga: sele
splittra,-krossa: gå-sönder
andas-in: inspirera
remskiva: roll
mager: tunn
väljare: valkrets
federation: federal
rörlighet: rörelse
lasta-av: ansvarsfrihet
habitat: skydd
framkalla: uppståndelse, inducera
utspädd: tunn
adjö: hejdå, farväl
förstöra: förstöra
syntax: pension
hästsko: häst
förvrängning: avvikelse, förvränga
slam: slå
relevant: konsekvent, rätt, associerad
funktionell: praktisk, arbete
förflytta: byta-ut, mata-ut, röra-sig-ur fläcken
autonomi: oberoende
stank: lukt
differentiering: skilja
tillgänglighet: förvärv
grund: student
graf: Diagram, Karta
fascinera: fängsla, reta
söt: vacker, ljuv
abdominal: mage
läskunnighet: utbildning
syntetisk: artificiell
tränare: tränare
bevara: lagring, spara, skydda, behålla
skräp: skrot, dumpa, avfall
bild: bild, skott
lärobok: manuell, boka
konsolidera: förstärka
begränsa: tvinga, begränsad, pressa-ut
ekonom: ekonomisk
friidrott: idrotts-, träning
slingra-sig: grimas
jod: mineral-
infektera: infektion, förorena
designer: bestämd
utsöndra: utsöndring, dölja, mata-ut, hemlighet, skilja
spenat: främja, sallad
intensiv: extrem, våldsam
övertygande: demonstrativ
debut: först, början
tusendel: tusen
inomhus-: inre, djup, inomhus, täckt
återkalla: beröva
amplitud: magnitud
dimensionera: riktning, efter, dimensionell, nästa
bibel: skriften
affisch: baner, web
accelerera: fällning
intensifiera: förstärka, intensifierings
abort: missfall
typiskt: allmänt, gemensam, många-gånger, tendera
engagemang: löfte
Kö: svans, beställa
konsol: häftklammer, armbåge, krok, anhängare, stöd
ex-: gammal
omvänd: omvänd, inversion
avdunsta: smälta, gäspa
flyg: atmosfär, luft, flyga
jämförelse: jämförelse
etnisk: nationalist, nationell
snedstreck: skära, minska
knepig: listig, utveckla, komplex, hård
karakterisering: beskriva, karakteristisk
affix: splitsa, parallell
molekyl: molekyl-
konfiguration: disposition, strukturell, montering
interaktion: prata, överlappning
kvantitativ: volym
introspektion: retrospektiv
orientera: öster
sperma: utsäde
stödja: stöd, erkänna, godkännande
icke-: inte-heller, inte
trovärdighet: lojalitet, pålitlighet, kreditera
omstörtning: ruin
böjning: drift, avvikelse
injektion: nål
sandal: toffel, skor
bit: chips, stycke, sträcka
tv: tv
sädesslag: spannmål, böna
behållare: instrument, tank, pott
flytta: migration, vandra
terminologi: villkor
väljarkår: valkrets
radera: radera, förstöra
medla: förena
kapitalism: kapitalist
åka-skidor: skridsko
spel: spelande, tillstånd
selektiv: välja
statisk: standard-
konvergera: träffa, konvergens, fokus
alfabetisk: alfabet
global: internationell, värld
olycka: offra
ok: samma, fixera, mycket
pragmatisk: praktisk
referens: regel, bedöma
differentiell: skillnad
andas-ut: avge, andetag
vattendelare: vatten
fixtur: anpassning, utrustning
installera: installera, etablerad, stänga
resonans: vibration
traditionellt: tradition
klassrum: bana
protokoll: avtal
calculus: beräkning, fakturera
gram: värma, gräs
bensin: bensin
galax: konstellation
tonåring: ung
knåda: problem
radium: radio
rarefied: tunn
flygplan: fågel
trampa: trampa
cirka: nästan, handla-om
ficklampa: lins
resväska: låda, bagage
byta: utbyta
frivillig: beställnings-
matris: mage
skildring: axel, bild
pre: öster, före, äng
annons: a.d
bedöva: förvåna
frekvens: incident, doppa
störta: Häll-i, hjärta
sensorisk: känsla, brinner-för
samstämmighet: avtal
övervaka: hantera, övervaka, polis
transplantation: alternativ
aluminium: aluminium
fluktuation: svängning
simulera: imitera, hyckla
komplicera: komplex
mentor: rådgivare, tränare
spår: öppning
råka: gala, torn, slott, pistol
manipulera: manipulation, uppståndelse
vegetarian: vegetabilisk
norm: specifikation, standard-, regel
tunnelbana: tunnel
respiratorisk: andetag
simulering: imitera
spruta: nål
mutation: ändra, konvertera
underkläder: kalsonger, linne-
vagina: bukt
skilja: skilja, skillnad
säsong-: säsong
bybo: lantlig
sesam: mol
koma: kommatecken
invertera: inversion, omvänd
handledare: observatör, manuell
kasta-ut: mata-ut
granska: kolla-upp, revision
vandra: sväva, vandra, hiss
ställe: fläck
lågkonjunktur: ekonomi
plundring: plundra
slogan: lösenord
foster: embryo
integration: samarbete, integration
magenta: lila, cyan
minimera: minst, minska
bostads-: skydd
siffra: digital, antal
salt: salt-
null: noll-, tömma
teoretiker: teori
akvarium: fisk
dragning: veto
fallskärm: paraply
viktigt: nödvändig
total: allmänt, alla, gemensam
försämras: ruttna
null: noll-, tömma
sexualitet: sexuell
spole: volym, slå-in
övervägande: i-stora-drag
viskös: klibbig
tarm: gut
arkeologi: arkeologisk
jordnöt: böna
apposition: ersättning
spis: spis, kök
trouser: byxor
kriterier: standard-, indikator
översikt: översikt
kvalitativ: karakteristisk
glasögon: glas
genetisk: morfologiska, genetik, gen
deltagare: ansluta-sig, roll, particip
repertoar: talang, programvara
rotera: cykel, snurra
layout: organisation, planera, disposition
kupong: plugg, mottagande
sats: mening, teori, axiom
kognitiv: diagnos
klargöra: utveckla, förklara
toxisk: förgifta
betonade: betoning
nål: nål
svacka: kris
tillgodose: tjäna, under-förutsättning, försäkra
anti-: opposition
resistent: kronisk, opposition, immun
mellanmål: rostat-bröd
bio: film, biograf
kran: rör
markör: markera
kringutrustning: omgivande, regional
bestämd: bestämd, predicative, aggressiv, avgörande, envis
nod: sticka
fet: tjock
subtrahera: mata-ut, minska, dra, beröva
intransitiv: nödvändig
helix: snigel, lockig
kaka: kex, tårta
blåsa-upp: svälla
elektronik: elektronisk
skriva-om: transkribera
labb: laboratorium
yrkesmässig: yrke, kommersiell, yrkesmässig, arbete
lutning: mile, doppa
färgrik: färg
rapportering: täckt, vaccin, bry-dig, filt, tak, betrakta, volym
engagemang: ansluta-sig, integration
orientering: riktning
tillverka: skapa, producera
termisk: olja
stereotyp: undantag
tech: teknisk
resterande: ligger-kvar, redundans
lastbil: lastbil
stadion: fält
samordning: samordna
bakteriell: bakterier
gränssnitt: närma-sig
kisel: pi
memorera: minne, spara, kom-ihåg
diagnostisk: diagnos
kursplan: abstrakt
ledning: linje, kidnappa
miljonte: miljon
återförsäljare: -handlare
barium: bar
vanliga: nyckel-, sekundär
meningsfull: betyda, följd
audio: röst
konceptuell: uppfattning
rutnät: web
rumslig: atmosfär, dimensionell
examen: frågesport
mitten-: sekundär, midja
smink: kompensera
separat: separerat, solo-
hämma: hämning, förhindra
mång: olika, mer, mycket
kvav: fuktig, värma
morfologi: morfologiska
diagnostisera: diagnos
influensa: influensa
grafik: Diagram
koronar: sjukdom
skinka: rumpa, skinka
arkiv: fil
konfrontation: bekämpa, konflikt, jämförelse
fraktfartyg: lastbil
optimal: optimal, bra
i-grund-och botten: villkor
motivering: stimulans
testikel: ägg
svavel: svavel
operativ: manipulation, handling
bana: bana, sätt
relevans: associerad, betydelse, relationer
cykel: cykling, cykel, hjul
direktiv: demonstrativ
flygbolag: fågel, luft
liter: liter
bakslag: frustration, chock, regression, misslyckas, hinder
förena: sele, förena
ställning: stå, placera, stycke
minimal: minst
cyklisk: cykling, periodisk
substrat: molekyl-
under-vattnet: u-båt
expertis: att-uppleva, skicklighet
null: noll-, tömma
elektron: elektronisk
interaktiv: överlappning
initialt: original-
sabotage: förstöra
påverka-varandra: prata, socialisera
matematik: matematik
foster-: embryo
modernisera: modern, uppdatera
extremist: radikal, extrem
piss: urin
gosa: omfamning
Okej: fixera, mycket
hårt-slag: stjäla
målmedveten: avsiktligt
semi: halvvägs, sälja, slipa, bredd
neurala: nervös
anti: opposition
lins: lins
proximala: nästan
näringsämne: mineral-, mat
oklar: vag, uppenbar
trauma: chock, skada, ulcus
BYTE: utbyta
vektor: bärare
taktik: närma-sig
utvärdera: värdering
null: noll-, tömma
klona: kopiera
livskraftig: fördel, effektiv
replikation: kopiera
reaktiv: reaktion
tidtabell: kalender, tid, disposition
syntaktisk: öde
stabilisera: tyst
dissident: rival
feed-back: reaktion
frågeformulär: frågesport
oxidera: ring-upp
millimeter: millimeter
psykiatrisk: intellektuell
syndrom: sjukdom
paradigm: exempel
aktivera: gör-det-möjligt, do, handling
slumpvis: slumpmässig, tillfällighet, till-fall
ostracized: separerat, bojkotta
delmängd: del
metodik: sätt, närma-sig, en-gång
konstverk: arbete
sekventiell: konsekvent, ordningstal
beslagta: håll, ta-vara-på, stänga
kilometer: kilometer
multinationell: internationell
planerare: hyresgäst, randig, planera
exponentiell: exponent
felplacera: förlora
forskare: forskare
stormarknad: köpcenter
fördela: tilldelning, skilja, distribuera, dissektion
null: noll-, tömma
fotboll: sparka
rätt: höger, rätt
matrester: ligger-kvar, avfall
hållbar: standard-
rymdskepp: transfer
erfarenhets: att-uppleva
semantisk: konnotation, ämne
insider: inre, medlem
ton: tona
modul: modulo, enhet, volym
enzym: jäst
livsstil: livstid
pasta: massa
dorm: skydd
tonåring: ung
markera: markera
förneka: förneka, förstöra
pojkvän: flickvän, vän
beteende: uppträdande
tack: tacka
mastermind: hjärna, själ
ekologisk: ekologi, miljö-
invandrare: flykting
bädda-in: integration, doppa, begrava
fotokopia: kopiera, bild
aktivist: handling
t-shirt: skjorta
terapeut: läkare, terapi
pamp: kung
upphetsning: spänning
synkronisera: synkronisera
surt: syra
lexikalisk: lexikon, ord
inbrott: gå-sönder
klassificerare: klassificering
avantgarde-: pionjär
ordförande: huvud
handout: folder
karismatiska: charm
skandium: tellur
riktlinje: manuell
hypothesize: anta, förment
kylskåp: kylskåp
omstart: omstart
brain: skaka, aning
replikera: kopiera, imitera, upprepning
ångest: rädsla
eldupphör: stillestånd
tabbe: underlåtenhet, fel
industrialisera: industrialisering, industri
syskon: bror
talesman: högtalare, representant
kapa: kidnappa, plog
icke-metall: metalloid
rinnande: influensa, fuktig, springa
aspekt: riktning, formad, sida
från-fall: 
godhet: dygd, fördel
löst: lösa, fri
efteråt: framtida, sedan, efter
svårighet: problem
trupp: band
brett: bredd, bredda, allmänt
korrelat: associerad, krok
enligt: tillbaka
null: noll-, tömma
bulletin: folder, information
ogillande: godkännande, oacceptabel
badkar: bad
underhållande: underhållning, roa, munter
Förutom: bortsett-från
uppkomst: uppstå, går-ut, stiga
null: noll-, tömma
kind: spela
måste: måste, tull
procent: procent
rättstvist: kostym
null: noll-, tömma
via: passera, ovan
sopran-: barnslig
rolig: munter
e.m.: eftermiddag, natt
äggvita: protein
blodsutgjutelse: blodig
tulium-atom: torium-atom
böja: böjd, böja
linker: samband
uppmanande: MANANDE
terbium-atom: torium-atom
hyrs: hyra
smink: kompensera
wisecrack: skämt
config: strukturell
de-dåtid: sista
att-dela: skilja, distribuera
professor: bemästra
rodium-atom: torium-atom
ange-markör: 
utrymme-markör: 
byråkratisk: byråkrati
bälte: band, sele
null: noll-, tömma
försäljare: -handlare
null: noll-, tömma
lantan: tellur
ämne-fall: ämne-fall
konstruktiv: skapa, formulering, tillverkare
null: noll-, tömma
feminin: kvinnlig
revisor: inspektör, revisor
mikrofon: mikro
utanför: ut, bortsett-från
inspelning: integration, registrering
pekfinger: indikator
sponsorskap: stipendium, bry-dig
okunnig: okunnig
null: noll-, tömma
standardisera: specifikation, standard-
Klockan: fläck, timme
hyresvärd: ägare
forskare: bestämmare, forskare, detektiv-
utsvängd: bränd
null: noll-, tömma
godkänna: gör-det-möjligt
försvar: bry-dig
hall: hall
förhandling: prata
uppdateras: färsk, uppdatera
slingrande: böjd
framåt: först, nästa, fram-
andas: immun, andetag
null: noll-, tömma
progression: framsteg
intransitiv: nödvändig
eufori: entusiasm
bred: bredda, bredd, utbredd
intransitiv: nödvändig
kontrastiv: kontrasterande, klara
förvånad: överraskad
remiss: införa
ättling: bekant, sondotter, generation
glass: grädde
radie: stråle
alternativt: annat
grannskap: omgivande, bo, miljö-
brukade: beställnings-
förlägenhet: skam, oordning
i-huvudsak: i-stora-drag
nyligen: färsk, nyligen, rot
dans-: spela, dansa
null: noll-, tömma
belopp-markör: 
social-markör: 
kritik: kritik
rubidium-atom: torium-atom
kamp: bekämpa, konflikt, krig
klaga: handla-om
null: noll-, tömma
vanadin-atom: torium-atom
kastrera-kön: maskulin-kön
fluor-atom: torium-atom
resa: besök, safari, expedition
maskulin: manlig
null: noll-, tömma
utvecklings: evolutionära, framsteg
applicerad: praktisk
att-stänga: stänga
skryta: splurge
bakåt: tillbaka
de-presentera: presentera
null: noll-, tömma
randomisera: slumpmässig
kooperativ: kollega
pensionerad: gå-i-pension
null: noll-, tömma
roat: lycklig, munter, roa
approximativ: ungefärlig
dyadisk: binär
kompletterande: komplement, ytterligare
kommunikativ: korrespondens, pratsam
null: noll-, tömma
på-fall: till-fall
polonium-atom: torium-atom
bryta-ner: åtskiljande, analys
solbränna: brun
problem: problematisk, problem
översätta: översättning, flip
null: noll-, tömma
tallium-atom: torium-atom
klick: konglomerat, klick
enkel: lätt, enkel
moderator: facilitator, chef
socialt: social
motsvarande: kostym, sammanfaller
olycka: incident
det-som: som
intressant: dra
upp-och-ner: omvänd
herbicid: förgifta
null: noll-, tömma
deltagare: particip
till-exempel: exempel
tumör: tumör
förfall: ruttna
null: noll-, tömma
webbplats: webbplats
enormt: massiv, mycket, super
kommer-vara: 
relativ-fall: relativ-fall
mål-fall: destination-fall
ersätta: kompensera, betala
BEHANDLA-ILLA: fel
fläta: ås, sticka
istället-för: i-stället
arkeologi: arkeologisk
kontakt: copula, plugg, fastsättning, uttag
null: noll-, tömma
generalisering: generalisera
strontium-atom: torium-atom
rutenium-atom: torium-atom
exklusive: bortsett-från
null: noll-, tömma
reträtt: avvika, regression, gå-i-pension
retiree: gå-i-pension
varandra: varandra, andra
bred: utbredd
datoranvändning: beräkning, dator, kalkylator
företag-person: affärsperson
varmkorv: korv
dominans: effekt, driva, fördel
unquote: citationstecken
possessiv-fall: genitiv--fall, possessiv-fall
genetiskt: gen, genetik
förmånliga: röra-sig-ur fläcken, mjuk
indirekt-objekt: direkt-objekt
hindrande-humör: hindrande-humör
träna: träning, arbete, utveckla
avgränsas: begränsad, separerat
motsats: omvänd, opposition, motsatt, inversion, kontrasterande
klättra: stiga
oerhört: ovanligt, super
null: noll-, tömma
stängning: stänga, vävstol
billigt: billig
duk: tyg, web
utbildad: utbildning, artig
djurliv: natur, vild
motsatt: opposition, motsatt, mot
null: noll-, tömma
gräva: gräva
smittad: infektion
null: noll-, tömma
väpnad: vapen
d.v.s.: nämligen
ingen: ingenting
svära: svära, svordom
avsmalnande: tunn, kon
underhållare: underhållning, konstnär
etc.: 
Förutom: bortsett-från
kontur: översikt, miljö-, form
mobiltelefon: mobiltelefon, cell
Fröken: skära, förlora, spendera
oroväckande: fruktansvärd, angelägen
de-framtida: framtida
konjunktiv-humör: villkorlig-humör, OPTATIV-humör
borde: måste
motorcykel: motorcykel, motor-
kreditkort: kreditera
null: noll-, tömma
de-offentlig: offentlig
mobiltelefon: mobiltelefon, cell
null: noll-, tömma
tarmar: gut
distribuera: distribuera, sprida-ut, konsumera
deportera: mata-ut
andel: insats, del, kvant
kompetens: skicklighet, jurisdiktion
jordägare: ängel
prepositional-fall: 
tilldelning: tilldelning, utdelning, ersättning
oroande: angelägen
okej: samma, mycket
tillämpning: tvinga
pro-fras: pro-mening
receptor: catcher
injicera: införa
fantastisk: förvåna, slående
hosta: hosta
bredvid: nästa
