infinitiv: oändlig, oändlighet
nominativ-fall: 
ackusativ-fall: 
ämne-fall: ämne-fall
förälder: föräldra, större, senior
pappa: far
mamma: mamma, mor, moderlig
Hallå: bye, Hej, Hallå
förfader: företrädare, farfar
farförälder: farfar, mormor
hungrig: hunger, svälta
genitiv--fall: possessiv-fall
adjektiv: 
och: belopp, av
mig: jag-själv, jag, min, vi
dig: dem, dig, du
oss: vi, vår, vår
Det: han, att, hon, detta, dessa
destination-fall: mål-fall
dativ-fall: 
interiör-sammanhang: 
person-sammanhang: 
beroende-klausul: 
perfektiv-aspekt: 
dåtid-spänd: 
maskulin-kön: kastrera-kön
comitative-fall: 
presentera-spänd: 
benefactive-fall: 
essive-fall: 
inte: Nej, icke, knappast, oförmögen, icke-, tonhöjd
dess: deras, hans, hennes, Hej-M, de, hennes, av
yta-sammanhang: 
adpositional-fall: 
plats-fall: 
utrymme-sammanhang: 
sätt-fall: 
instrumental-fall: 
som: som, som, vars, några, varken, att, vem, det-som, vad, varje, beroende-på-vad som
frågande-humör: 
och-eller: 
exeller--eller: 
källa-fall: 
ablativ-fall: 
demonstrativ: fast, väsentlig, betong-, övertygande, direktiv, dramatisk
men: än, dock
alla: alla, alla, total, hel, total, hela, allt, några, alltmer
feminin-kön: 
de: dem, hon, de, deras, deras, efternamn, dessa
flertal-antal: 
en: enda, en, in-i, ensam
framtida-spänd: 
social-sammanhang: 
när: närhelst
imperfective-aspekt: 
det: 
villkorlig-humör: konjunktiv-humör, hypotetisk-humör
mer: över, mest, ytterligare, bortom, uppåt, uppåt, mång, än, snarare, också, dessutom, plus, fortfarande, än, annan, flera, flera-olika
ut: utanför, yttre, extern, utomhus-, utomhus, av, utanför, bortom, upp, på, till
relativ-fall: relativ-fall
SLUT--fall: 
do: gör, utföra, åta, göra, aktivera, gjorde, begå
direktiv-humör: indikativ-humör
deontic-humör: 
fråga-ord: 
copula: kontakt, obligation, knippa
person: man, personer, enskild, någon, någon, kille, mänsklig, ansikte, mun, enhet
manlig: maskulin, nämna, herre, man
kunde: Kan, makt, eventuellt, kanske
andra: annan, resten, andra, en-annan, olik, varandra
antal: belopp, belopp, figur, numerisk, siffra, kvantitet
mycket: mycket, ytterst, väldigt, mycket, för, fruktansvärt, allmänt, i-hög-grad, verkligen, dåligt, fantastisk, betydligt, massa, mång, enormt, mest, ganska, ganska, långt, ganska, ok, Okej, okej
tid: medan, ögonblick, under, i-god-tid, varaktighet, timlig, spänd, tidtabell, period, väder
tid-sammanhang: 
timlig-fall: 
handla-om: angående, rörande, nästan, cirka, av, av, än, runt, för, användare, klaga, på
epistemisk-humör: 
endast: precis, endast, helt-enkelt, punkt, ren, rent, begränsad
liten: små, mycket-liten, lätt, lätt, bit, mindre, ringa, diminutiv, bärbar, ett-fåtal
sedan: igen, re-, ya, sedan, sedan, senare, efteråt
MANANDE-humör: 
retrospektiv-aspekt: 
bra: stor, stor, ädel, allvarlig, omfattande, högt, enorm, jätte, fantastisk, dominerande, bra, bra, betydande, enorm, väsentlig, underbar, excellent, optimal, stor, större, perfekt, anmärkningsvärd, lysande
volitive-humör: 
före: tidigare, pre, sedan, föregå, fram-tills, främre, förr, mot
måste: skall, nödvändigtvis, onödig, måste, behov, skall, borde, brist, till
två: dubbel, både
se: se, se, syn, få-syn-på, uppfatta, kolla-på
känna-till: fastställa, medveten, lära, flagga, synlig
ner: nedåt, nedåt, under, Nedan, under, under-, mindre, botten, sämre, nedre
efter: bak-, på, posta, dimensionera, senare, efteråt, efteråt, följande, dåtid, under, under-
först: debut, första, sedan, framåt, knytnäve
egen: han-själv, själv, besitter, personligen, hans, sig, själv
oförytterlig-besittning: 
aldrig: någonsin
omistlig-besittning: 
gammal: Begagnade, gammal, åldrig, äldre, före-detta, ex, ex-, ålder
deliberativ-humör: 
dag: dagligen, i-dag, i-kväll
var: vart-som-helst, varigenom, plats
komma: till, nå, ankomst, anlända, bli, mode, inträffa
sätt: metod, metodik, betyder, väg, rutt, tarmkanalen, väg, spår, sätt, väg, gata, socker, spåra, bana, vana
arbete: jobb, uppdrag, aktiv, uppgift, arbetskraft, arbetskraft, karriär, fungera, fungera, funktionell, företag, handling, träna, sysselsättning, yrkesmässig, arbetssätt, konstverk
vokal: känd, liv, överlevnad
gå: gå, biljettpris, avvika
perlative-fall: 
progressiv-aspekt: 
lång: långvarig, hållbar, lång, längs
säga: talad, berätta, tala
hur: tycka-om, som, än
även: också, antingen, fram-tills, dessutom, för
tillbaka: Bakom, bak-, bakåt, bakåt, komma-tillbaka, re-, återställa, ångra, igen, upprepa, sedan, enligt
här: 
tror: tänkande, trodde, fundera-på, tänka, conceive, meditera, skulle, heter, sinne
samma: identisk, liknande, lika, ekvivalent, med-rätta, ok, okej, han-själv, lika, liknande
sista: avsluta, senare, slutlig, slutlig, en-annan, annan, senast, nyligen, slut, dåtid, de-dåtid, härda-ut, motstå, sätta, envisas
bort: långt, avlägsen, av, isär, på-avstånd, vänster, lämna, frånvarande
under-sammanhang: 
ta: tillflykt, uppta, hämta, anta, hugg, skaffa-sig, ta-emot, plocka, fånga, ta-till-fånga, acceptera, erhålla, avgift
hittades: hitta, upptäcka, upptäckt, upptäckt, tillgänglig
hand: ärm, handled
ung: ungdom, junior, tonåring, tonåring, ny
fast: även-om, ändå, fast, fast, fast, fast, trots, dock, någon
ge: låna, förse, bjuda-på, tillhandahålla, leverera, göra, bildning, sätta, donera, låta
gud: 
delative-fall: 
ingenting: något, objekt, ingen, något, ingen, ingen
höger: par, rätta, exakt, rättvis, rättvisa, motiverat, orättvis, berättigad, rätt, lag, korrekt, sann, viss, Säker, berättiga, väl
en-gång: omedelbart, omedelbart, metod, mönster, metodik, igen
semelfactive-aspekt: 
del: avsnitt, delvis, del, delvis, paket, fraktion, del, bit, bit, passage, delmängd, kapitel, avdelning, episod, partiell, division, avdelning, sektor, andel, räkning
fick-syn-på: 
hus: hem-, lokal, tempel, hus, hushåll
värld: rike, global, universum
huvud: titel, huvud, chef, kapitel, ledare, president, ordförande, direktör, chef, senior, penna
tre: tredje
neo: ny, nytt
fokus: avsedd, syfte, mål, mål, koncentrera, uppmärksamhet, koncentration, accent, konvergera
kärlek: tillgivenhet, välgörenhet, tycka-om
alltid: evigt, ständigt, någonsin, vanliga
natt: kväll, middag, e.m.
varje: per, varje, några
kung: regera, lord, monark, pamp
mellan: bland, bland, av
hjärta: heja-på, uppmuntrande, störta
paucal-antal: 
därför-att: på-grund-av, sedan, fall, ge-upphov-till
orsaks-fall: 
sak: materia, affär, fenomen, grejer, vad
uppsättning: grupp, sätta, ha-kvar, lägga, klistra, samling, kombination, array, svit, paket, portfölj, syntes, med-varandra, serie, sväng, räckvidd, rad, sträng, utrustning, corpus
namn: efternamn, substantiv
rätt-substantiv: 
MANANDE: uppmanande
land: nation, landa, jord, ange, jord, grevskap, jord, part
bad: 
synlig-bevis: 
bättre: överlägsen, bäst, excellent, idealisk, utestående
sida: lateral, förmån, förmån, räkning, sväng, sida, aspekt, halv, aspekt
kurs: läroplan, lektion, föreläsning, säkert, säkert, definitivt, hastighet
kvinnlig: lady, feminin, feminin, kvinnor, flicka, fru
tillräckligt: tillräcklig, tillräckligt, tillräcklig, riklig, ganska, massor, otillräcklig, ganska, ganska
snart: inom-kort, snabbt, prompt, snabbt, snabb, omedelbar, snabb, skynda, brådskande, så, omedelbart, lätt, närliggande, tidigt, knäppa
full: fullt, tillräckligt, absolut, komplett, ofullständig, hela, exakt, exakt, uttala, exakt, grundlig, hel, omfattande, storlek
rum: kammare, fjärde, sovrum, fred
nästan: nästan, praktiskt-taget, cirka, cirka, nära, runt, på-nära-håll, intilliggande, i-stort-sett, närliggande, inom-kort, proximala, ungefär, knappast
kan-ej: oförmögen
vatten: flytande, vätska, vattendelare
desiderative-humör: 
ljus: glöd, ljus, ljus, lätt, stil, lätt, mild, ljusare, påle, klar
inte-heller: varken, icke-, än, vad, hända, eller
ord: lexikalisk
dörr: gate, dörröppning, ingång, kapitel, hamn
använda-sig-av: utnyttja, användande, konsumtion, utgifter, konsument, förlova-sig, ansökan, nytta, tillämpas, använda
morgon-: A.M., frukost
terminative-fall: 
driva: styrka, energi, makt, stark, tvinga, kraftfull, dynamisk, sallad, dominans, myndighet
dem-själva: oss-själva, själv, han-själv, jag-själv, henne-själv, sig, själv, ego, kapitel
presentera: nuvarande, de-presentera, nu, för-närvarande, gåva, existera, tillgängliga
röst: ljud, högt, valsedel, audio, rösta, punkt, rykte, rykte
vit: tom, klagomål
pengar: rikedom, silver-, finansiell, kontanter, valuta, finansiera, monetär
nästa: bredvid, vid-sidan-av, bredvid, följande, senare, dimensionera, framåt, senare
fattig: ärm, fattigdom, dålig, värst, rutten, svag
död: dödlighet, döende, död
form: form, forma, formatera, kontur, mönster
inessive-fall: 
snäll: klass, sortera, arter, mängd, typ, vänlig, punkt, bra, trevlig, behaglig, trevlig
många-gånger: ofta, ständigt, regelbundet, frekvent, vanligen, i-vanliga-fall, typiskt
år: årlig, årligen, fem
vän: alliera, pojkvän, kollega, para
beställa: system, arrangemang, ordna, kontrakt, array, kommando, sväng, rad, Kö
nödvändigt-humör: 
runda: avrundad, cirkel, knä
tro: förtroende, räkna, förmoda, tro, tro, förtroende, säker, optimism, optimistisk
offentlig: de-offentlig, allmän, publik
ange-sammanhang: 
son: svärm, pojke
hundra: hundradel, ansikte, cent
barn: unge, avkomma, barn, barn
således: därigenom, så, därav, sådan, ja
hoppas: önskar, utsikt, förutse, optimism, optimistisk
ovan: upp, över, en-trappa-upp, hög, högst-upp, avancerad, övre, tvärs-över, rörande, via, på, över-huvudet, till, framåt, uppåt
kär: älskare, dyr
läsa: läsning, sjunga, lilja
stad: stad, kommunal, grevskap
redan: redo, beredd, villig, i-alla-fall
faktum: sanning, verklighet, Sanning, sann, verklig, faktisk, verkligen, verkligen, faktiskt, gjorde
factive-bevis: 
höra: lyssna, hörsel, känna
minst: minimal, minimum, minimera, minus-, mindre
kanske: förmodligen, kanske, förmodligen, makt, eventuellt, möjlig, troligt, sannolik
öppna: klar, enkel, helt-klart, bar, tydligen, ledig, explicit, uppenbar, utomhus-, underskott, påle, öppet, översikt
kropp: kött, kroppsligt, fysisk, fysiskt, corpus, organ, lik
luft: vind, bris, flyg, väder, flygbolag
natur: naturlig, inföding, naturligtvis, ursprung, härkomst, inhemsk, djurliv, karaktär
hjälp: hjälpa, hjälpsam, hjälpa, bistånd, assistent, lägga
brev: brev, handstil
fyra: fjärde
OPTATIV-humör: konjunktiv-humör
brand: varm, flamma, feber
därför: därav
timme: klocka, Klockan, klocka
fri: frihet, frihet, befria, gratis, fåfäng, fritt, ledig, löst, Släpp
krig: slåss, kamp
om: om, sig
anledning: ge-upphov-till, konto, faktor, rimligen, ursäkt, grunder, spridning, kärande
förenad: singularis, enhet, inclusive, union, allierad, alliera, unik, enhällig
ring-upp: utmaning, oxidera, överklagande, på, förbindelse, kombination, gemensam, fusion, inbjudan
varför: 
förlorat: förlust, saknas
tusen: tusendel
familj: hushåll, efterlevande
själ: anda, spöke, mastermind
fråga: problem, efterfrågan, läsning, materia
bry-dig: bekymrad, oro, uppmärksamhet, meditation, service, sponsorskap, skydda, säkerhet, skydd, säkerhet, bevarande, bevarande, rapportering, försvar, försiktighet, bota, behandling, vårdnad
Realis-humör: 
betyda: medföra, känsla, menande, meningsfull, beteckna, mitten, ombud, medium, genomsnitt, måttlig
potential-humör: 
mot: mot, mot, motsatt, motsatt, per, respektera, för
allative-fall: 
antropiska-kön: 
kort: mindre, låg, kort, inom-kort, kort, kort, smal, lätt
kunna: Kan, kvalificerad, berättigad, kapabel, kapacitet, förmåga, oförmögen, behörig, potential, möjlighet, sannolikhet, stark, kraftfull, skicklig, Maj
bo: liv, överleva, bete-sig, levande, bo, distrikt, grannskap, grannskap, Levande, livlig, rå, vistas
ämne: disciplin, tema, ämne, lektion, ämne, problem, objekt, menande, material, semantisk, materia, affär, titel
samma-ämne-markör: 
olik-ämne: 
svar: norr, svar, svar, lösning, motsvarar, svara
hav: hav, marin-
rädsla: fruktan, rädd, skräck, vördnad, rädd, panik, ångest, ångest, fasa, skrämma
förstå: förståelse, förståelse, uppfatta, grepp, conceive, obegriplig, omfatta, inse
hård: svår, styv, komplicerad, hård, högt, våldsamt, våldsam, tuff, sträng, utmanande, knepig, tung, grav, svår, illa-till-mods
villkor: termin, terminologi, problem, baserad, grunder, grund, väsentligen, fundamentalt, i-grund-och botten
tvivel: misstanke, misstro, misstänka
tvivelaktig-humör: 
be: be, behöva, lyssna, snälla-du
vapen: vapen, avväpna, väpnad, ärm
svart: 
ta-med: hämta, bära, skulle, bly
vacker: bra, fin, härlig, vackert, fint, ganska, lust, Häftigt, söt
mörk: dysterhet
håll: ha-kvar, upprätthålla, fånga, grepp, kontrakt, sluta, knut, årtionde, beslagta, vänta, tycka-om, sustain
tio: årtionde, tionde, rättvis
show: visa, utföra, prestanda, demonstration, presentation, ange, beteckna, händelse, utsprång
berättelse: myt, historia, fiktion, tomt
gemensam: allmän, vanliga, rutin-, vanligtvis, vanlig, ovanlig, vanligen, blygsam, vanligt, oregelbunden, konventionell, typisk, i-vanliga-fall, typiskt, gemensam, partner, associera, aggregat, total, ömsesidig, företags-
boka: rulla, boka, pund, lärobok
elektronisk: elektronik, elektron, blixt-, elektrisk, elektricitet, elektrisk
prata: konversation, chat, förhandla, interaktion, påverka-varandra, förhandling, tala, tal, talad, samtala
markera: markör, spår, spår, göra, markera, bock, skylt, signal, indikation, cue, stämpla, karaktär, märka
intressera: blomma, intresserad, oro
skriva: komponera, handstil, typ, skriven
säng: 
nödvändig: grundläggande, viktig, användbar, kritisk, avgörande, signifikant, oviktig, väsentlig, avgörande, viktigt, behov, nödvändigtvis, intransitiv, intransitiv, intransitiv
aning: trodde, hänsyn, resonemang, åsikt, begrepp, brain
konst: hantverk, konstnärlig
Vialis-fall: 
bror: syskon, syster
ibland: sällan, ibland, nån-gång
linje: tråd, gänga, rad, körfält, ledning, rusa, rand, beskatta, manus
tabell: skrivbord, schema, katalog
flod: kudde, dämpa, flöde
öga: utnämna, runt
information: meddelande, förklaring, beskrivning, bulletin, kunskap, data
plötsligt: plötslig
konstig: underligt, förvånande, underligt, udda, undra, underbar, anmärkningsvärd, utöver-det-vanliga, otrolig, fantastiskt, bisarr, rolig, främling, exotisk, besvärlig
djup: djupt, djup, omfattande, grund, grundlig, detaljerad, omfattande, kritiskt, djupgående, inom, inne-i, inomhus-, mask
ändra: modifiering, variation, omvandling, omvandla, mutation, flytta, ändra, ändra, övergång, ändring, utbyte
känsla: känna, känsla, uppfattning, intryck, känsla, humör, imponerad, emotionell, sensorisk, känsla, känsla, passion, medveten, medvetande
träffa: skaffa-sig, konvergera, råka-ut-för, följa, uppfylla, möte
syfte: objekt, syfte, mål, mål, destination, avsikt, avsedd, motiv, mål
lycklig: gladlynt, roat, nöje, glad, glädje, lycka, glädje, förtjust, gyckel, lyckligt, tur-, nöjd
verka: utseende, synas, tydligen
blod: blöda, kriminell
reste-sig: rosa
söder: sydlig, middag, middagstid
kall: vinter-, Häftigt, kallt
fram-: ytterligare, längre, framåt, syn, främre, avancerad, sedan, slagträ, till, framåt
placera: plats, situation, status, chans, möjlighet, utrymme, ställning, hållning, plats, posta, punkt
sent: långsamt, avsluta
stå: station, vertikal, attityd, ställning, sluta, hållning, pose, bås
anta: antagande, hypotes, utgå-ifrån, anta, förmoda, hypothesize, föreslå
dotter: flicka, oskuld
mina: min
skära: brist, saknas, minskning, brist, minska, brist, Fröken, skärande, avbryta, hugga, snedstreck, beskära, trim, bruten, kränka
kopiera: reproducera, replikation, replikera, transkription, fotokopia, klona, version, recept
man: man, make
sex: sex
kom-ihåg: Notera, återkallande, påminna, memorera
effekt: inflytande, påverka, intryck, inverkan, dominans, effektiv, effektivt, effektivitet, följd, resultat, exponering
falla: höst, fall, belägen, krascha, tumla, bryta-ner, falla-ihop, släppa, nedgång, minska
bortsett-från: såvida-inte, utanför, utanför, Förutom, isär, exklusive, bredvid, åt-sidan, Förutom
hår: 
passera: av, genom-, godkänd, via, nära, bredvid, bestå, examen, rost, korsa, passage, Fortsätt
upphovsrätt: 
armén: soldater, trupp, värd, soldat
springa: fly, dränera, spring, utföra, fungera, kör, rinnande, redskap
häst: hästsko, på
framtida: de-framtida, senare, efteråt, efteråt
väster: västra
betala: lön, lön, lön, sticka, betalning, ersätta, avgift, kosta
röd: 
guld-: 
önskan: vilja, ivrig, aptit, önskar, längta, enträget-uppmana
spela: dans-, spela, spel, kind, leksak
bemästra: lord, primär, huvud, professor, dominera, styra, herr, herre, ledande, mister
kontor: byrå, skrivbord
regering: ange, rad
kyrka: 
längd: höjd, höjd-över-havet, spänna, längs, varaktighet
företag: fast, företag, samhälle, företag, företags-, enhet, institution, byrå, inleda, våga
papper: ark, kort, charter
sannolikhet: möjlighet, sannolikhet, troligt, eventuellt, osannolik, utsikt, chans
i-synnerhet: särskild, speciellt, speciellt, särskilt, särskild, exakt, huvudsakligen, för-det-mesta, först-och-främst, specifik
björn: bära, härda-ut, motstå, tålamod, tolerans, ha, besitter, bildning
fönster: 
avtal: protokoll, lösning, kompromiss, samstämmighet, fördrag, enas, handla, bevilja, anbud, ackord, kontrakt, konvent, arrangemang
skönhet: vackert, briljans, estetisk
tull: ansvar, ansvar, skyldighet, ansvarig, tull, uppgift, uppdrag, skuld, skyldig, måste
skicka: överföra, underkastelse, posta, utsända, e-post
avstånd: avlägsnande, räckvidd, separation
tystnad: stillhet
fot: ben, stanna, lår, tå, fjärdedel, gå, gående
vild: vilt, olaglig, våldsam, djurliv
dö: död, döende
spara: sparande, bevarande, hämta-sig, bevara, bevarande, memorera, lagra, lösa-in, rädda, spela-in
grön: rå, rå
problem: besvära-sig, problem, problem, strapats, svårighet, knåda, lidande
leende: flin
fel: misstag, fel, felaktig, dåligt, BEHANDLA-ILLA, falsk, fel, fel, fel, felaktigt, tabbe
olika: olik, varierande, flera-olika, räckvidd, olika, mång, till-skillnad-från, variant, skilja-sig, variera, mängd
sova: sovande, dröm
quotative-fall: 
början: börja, start, åta, repa, början, tidigt, första, initiering, debut, princip
handling: uppgift, punkt, steg, etapp, handling, procedur, aktiv, drift, operativ, aktivera, aktivist, flytta, öva, öva, fungera, stock, rally, utförande, utföra
besök: få-tillgång-till, intervju, tillgänglig, resa, färd, resa, tur
Följ: överensstämmelse, vidhäfta, följande, utöva, spåra, följa
Prova: försök, försök, ansträngning, initiativ, experimentera, testa, prov
närvaro: existens, existera, enhet, tillgång
ljuv: godis, mild, mild, söt
rik: massor, riklig, rik
fiendens: 
fartyg: båt, segla, flotta, segling, fartyg, kryssning, färja
skick: satsning, vadhållning, ange, situation, omständighet, status, förmögenhet, etapp, nivå, kondition, krav
inklusive: innehålla, omfatta, engagera, tillhöra
inclusive-person: 
hemlighet: mystisk, mysterium, stift, underground-, utsöndra
BEDJANDE-humör: 
artig-registrera: 
ondska: skada, otäck, ond, dålig, dåligt
Mars: parad, protest, demonstration, mars
vad-som-helst: något, beroende-på-vad som
bli-kvar: förbli, sitta, bosätta-sig, överleva, vistas, vänta
i-stället: istället-för, snarare, ersättning, utbyte
blå: fe-
omöjlig: 
skola: campus, stege
tillfälle: möjlighet, händelse, förekomst, chans, aveny, förhandla
gift: äktenskap, gifta-sig, bröllop
mat: måltid, diet, maträtt, foder, näringsämne
tjugo: 
tyst: lugna, lugn, stabilisera, tyst, fredlig, långsam, avslappnad, mjukt
lätt: troligt, lätt, ansvarig, enkel, bekvämlighet, lätt, lätt, lätt, bekväm, enkel
blivande-aspekt: 
språk: språklig, tunga
uttryck: uttrycka, påstående, fras, artikulera, uppenbarelse, exponering, yttrande
vecka: söndag
hall: veranda, teater, hall, utrymme, kammare, salong, vardagsrum, gång, löpare, lobby
fara: farlig, risk, respektera, hot
fast-egendom: tillgång, tillhöra, äganderätt, monarki, besittning, särdrag, drag, egendom, förmögenhet, rikedom
född: födelse
domstol: rättslig, maträtt, forum, rättegång
allmänt: vanliga, typiskt, allmän, total, allmänt, vanligtvis, vanligen, i-vanliga-fall, brett
gnomic-aspekt: 
värde: förtjäna, värde, värde-, giltighet, merit
enkel: enkelhet, enkel, bekväm, flexibel, enkel, precis, helt-enkelt, enkel, blygsam, endast, ren, rakt, vanlig
träd: plantera, trä, axel, timmer
bekämpa: kamp, slåss, konfrontation, gräl, förvränga
vägg: 
himmel: sky
inchoative-aspekt: 
jussive-humör: 
tona: tonhöjd, melodi, ton, ton, skugga
betrakta: respektera, utgå-ifrån, förmoda, uppmärksamhet, hänsyn, fundera-på, relation, förening, relation, rörande, angående, anmärkning, rapportering
förväntad: förväntan
månad: måne
att-uppleva: empirisk, erfarenhets, erfaren, expertis, krydda, experimentera
helt: totalt, perfekt, fullt, fullständigt, ganska, sammanlagt, absolut, absolut, hel, noggrant, ganska, rent, exakt
färsk: nyligen, ren, rena, uppdateras, ny, nybörjare
hertig: linjal, prins
täckt: beläggning, rapportering, av, stängd, inomhus-
bunden: utsträckning, begränsning, begränsa, gräns, begränsning, begränsad, ansluten, bero, binda
öster: östra, sedan, tidigare, tidigare, pre, orientera
sten: marmor-, sten, pärla
något: något, något, några, ganska, snarare, lätt, delvis, på-något-sätt
riktning: orientering, dimensionera, trend, aspekt, instruktion
stol: sittplats, fåtölj, pall
stöd: sustain, stödja, bistånd, hjälpa, konsol, hjälpa
datum: historia, råka-ut-för
by: liten-by, landsbygden
fält: sfär, rike, område, territorium, område, zon, sektor, domän, arena, stadion, utrymme, marginal, landsbygden, läger
tillstånd: tillåta, öra, tillåta, spel, lämna, licens, licens, samtycke, utgåva
tolerant-humör: 
framgång: framgångsrik, lyckas, välstånd, prestation, seger, vinna, slog-till, vinnande, vinnare
rätt: ordentligt, rätta, rimlig, lämplig, exakt, exakt, rätt, exakt, exakt, omedelbart, troget, med-rätta, korrekt, variation, få-plats, lämplig, bekväm, lämpad, motsvarar, berättigad, relevant, perfekt, tillräcklig, regelbundet
kulle: berg, montera
musik-: musikalisk
distala-demonstrativ: 
eftermiddag: e.m., middag, middagstid, kväll
gråta: sörja, skrika, skrika
ära: ära, respektera, värdighet, respektabel, hedrande, honorific, artighet, härlighet, hastighet, pris
sju: 
privat: personlig, själv, personligen, själv-, särskild, privatliv, specifik, exklusiv
nyheter: meddelande
scen: plats, syn, sammanhang, visa, visuell, etapp, se, utsikt, tält
trädgård: parkera
lopp: ras-, racing, spring, tävling, turnering, anbud, ras, match
distributiv-fall: 
lär-dig: läsa-på, lära
politisk: politik, politiskt, politiker, politik
lögn: falsk
kasta: kasta, kasta, kasta, kasta, formatera, forma, lansera, skjul, sluta
äta: måltid, foder, maträtt, äta-middag, konsumtion
golv: matta, jord, botten, jord, gå, hög, lång
sjuk: sjuk, patient, öm, sjukdom, falsk, dåligt
original-: ursprung, ursprungligen, preliminära, första, syntes, initialt, inföding, äkta, medfödd, inhemsk, huvud, primär, prototyp
sommar: värme
religion: religiös, skuld
bild: porträtt, målning, bild, fotografera, fotografisk, fotografi, bild, fotokopia, ritning, knäppa, filma, illustration, skildring, fikon, figur
fly: fly
författare: författare, lärare, redaktör
brun: grå, grå, solbränna, brons
bestämd: bestämning, besluta, bestämma, bestämd, bestämd, designer, specificerade, fastställa, stabil, viss
smärta: ont, ångest, smärtsam, sorg, öm
vår: fjäder, vår, vår
århundrade: ålder
mjuk: förmånliga, jämna, fint, anbud, försiktigt, mjukt, mild, mild, mild
hörn: vinkel, kil, drunkna
producera: produktion, generera, produktiv, tillverka, tillverkning, tillverkning
skratta: skoj
glömma: förbise
europa: 
åtta: åttonde
klä: kostym, kläder, klänning, robe, klädd, enhetlig, utrusta
fruktansvärd: förfärlig, fruktansvärd, fruktansvärt, skrämmande, fantastisk, tragisk, oroväckande, skrämma, monstruös, väldigt
andetag: respiratorisk, andas, andas, andas-ut, ego, flämtning
klok: rimlig, förnuftig, diskret, omtänksam, duktig, smart, intelligent
possessiv-markör: 
minne: memorera, hänvisa-till, minnesmärke
modern: samtida, sofistikerad, modernisera, modern, nyligen, samtala
fläck: punkt, punkt, Klockan, plats, fläck, fläck, lappa, plats, ingenstans, lokal, ställe, plats, lokal, lokalisera, skylt, jord
stiga: plantera, klättrande, sugga, klättra, upp, styrelse, rida, lyfta, uppstå, höja, uppkomst, växa
gå-sönder: inbrott, broms, tillflykt, vardagsrum, avbrott, intervall, gap, smash, splittra,-krossa, sluta, paus, avbryta
femtio: 
ö: 
Rör: kontakta
löfte: begå, engagemang, löfte, utnämning
commissive-humör: 
grad: lika, utsträckning, kvalitet, kvalitet
planera: schema, handla, programmera, program, initiativ, planerare, förslag, projekt, tomt, skiss, utsprång, layout, platt, ritning, design
uppträdande: trend, beteende, beteende, beteende
överraskning: förvånande, oväntad, tillfällig, förvånande
minut: 
skott: skjuta, skytte, kula, ammunition, fotografera, bild, blåsa, smäll, kupp, kasta, ram
värre: dålig, värst, grov, ogynnsam, dåligt, fruktansvärt, sämre, upp, en-trappa-upp
glas: spegel, kristall-, burk, glasögon, glasögon
exempel: exempel, illustration, modell-, mönster, liknelse, prototyp, som, representera, prov, fall, prejudikat, prov, paradigm, till-exempel
säker: säkra, säkerhet, säkerhet, säkert, säker, försäkring
läkare: läkare, terapeut, praktiker, medicinsk
completive-aspekt: 
upprepad: ofta, regelbunden, konstant, ständigt, ibland, frekvent, regelbundet, upprepa
militär-: trupp, militant
värma: varm, ombonad, värme, värme, temperatur, uppvärmning, gram, kvav
dryck: dryck
frågor: 
ilska: arg, rasa, skandal, irritera, trots
direkt: rakt, direkt, indirekt, automatisk, enkel, omedelbar
hatt: lock, hjälm
hund: 
tjänare: steward, servitör, hembiträde
stolthet: arrogant, stolt, stolt
skara: rusa, fullt-med-folk, folkhop, belopp, kvantitet, befolkning, värd, lugg
tåg: transport, bil, vagn, vagn, järnväg, järnväg, utbilda
moralisk: moral, moraliskt, etisk, etik, moral, andlig
associerad: associera, relevans, korrelat, släkt, bekymrad, oro, relevant, längs, ansluten, relatera, allierad
ange: logga, inträde, ange, ange, föra-in, omfatta
regel: administrering, herravälde, regim, dom, dom, dom, domare, referens, styra, lag, lagstiftning, norm
svärd: blad
ge-sig-på: invasion, invadera, aggression, anfall, överfall, anfall, strejk, början, offensiv
hälsa: friska, hälsa
stycke: vers, klausul, bit, punkt, attityd, ställning
social: samhälle, socialt
återbetalning: svar, svara, komma-tillbaka
förlåt: ångra, pol, förlåta, ursäkt, ursäkt
mod: plocka, djärv, säker, nerv, mod, våga
nåd: förmån, förmån, barmhärtighet, vänlighet, välvilja, räkning, förlåta
officiell: formell, formellt, officiellt, officer, kontorist
under-förutsättning: förse, bjuda-på, tillhandahålla, introduktion, tillgängliga, förse, bestämmelse, tillgodose, om
begäran: bön, efterfrågan, krav, behöva, krav, förfrågan, förfrågan, prompt, bud, ansökan
blick: glimt, se, attityd, uppfattning, syn, syn, se
rörelse: rörelse, kampanj, sport, korståg, handling, flytta, rörlighet, företag, rör-på-sig
förvänta: förväntan, förväntan, förutse, vänta
motsatt: främre, motsatt, motsats, motsatt, tvärs-över, disk
tolv: 
engagerade: engagemang, upptagen, involverade, delta, ockuperade
vin: druva, alkohol, alkoholhaltig
smak: smak, smak, utsökt, bete, krydda
järn-: stål, metall-
distribuera: överföra, distribuera, publicera, publishing, diffusion, cirkulera, distribution, fördela, del, dela-in, split, att-dela, klassificera
handel: handel, företag, handel, handelsvaror, internet, förhandla, transaktion, köpman, handla, marknadsföring
fördel: få, vinst, dra-nytta, livskraftig, godhet, tillgång, preferens, dominans
kläder: garderob, trasa, kläder, utrusta, plagg, tumla
bedöma: dom, dom, domare, referens
skillnad: differentiell, skilja, olik, separat, distinkt, skilja-sig, variation, separat, variabilitet, variation, dela-in
angelägen: nödsituation, brådskande-karaktär, bekymrad, orolig, orolig, ångest, oro, oroa, omtänksam, obekväm, oroande, rädd, angelägen, störande, oroväckande, entusiastisk, ivrig, rastlös, illa-till-mods
kapten: 
färdiga: avsluta, avsluta, ändlig, redo
upphörande-aspekt: 
nyfiken: ivrig, intressant, spännande
utländsk: utomlands, främmande, utlänning, exotisk, främling, extern
intensifierings: intensifiera
betydelse: nödvändighet, relevans, menande, värde
slutligen: i-sista-hand, så-småningom, ändlig, slutlig, slutlig, terminal, fint
fakturera: handling, manuskript, konto, calculus
bevisa: bevis, bekräfta, bekräfta, demonstrera, vittna
förhindra: upphöra, förbjuda, internera, förtränga, begränsa, hämma, blockera, hålla-tillbaka, avskräcka, förbjuda, undvika, slå-tillbaka, dämpa, uppskjuta
hals: hals
rättslig: rättslig, lag, legitim, ram
torr: stam
tjäna: service, tjäna, tillgodose, bjuda-på
förlora: Fröken, felplacera
bevis: bevis, bevis, guide, ledtråd, katalog, visa, bevittna
bevis-fall: 
framsteg: kliva, progression, utveckling, progressiv, utvecklings, förskott, Fortsätt, förbättring, lyfta
byggnad: bygga, strukturera, konstruera, konstruktion, lokal
Sök: hitta, upptäcka, upptäckt, sökande, upptäckt, sökande, sträva-efter, forskning, undersökning, förföljande, förfrågan, undersökning, förfrågan
ledsen: deprimerad, sorgligt-nog, eländig, upprörande, upprörd, ånger, deprimerande
synd: skuld
trettio: 
ärlig: uppriktig, lojal, ärligt, frank
stänga: på-nära-håll, stängd, stängning, av, installera, att-stänga, packa, bunt, paket, paket, paket, beslagta
bank: bänk, tenn
öde: förmögenhet, lycka, syntaktisk, destination, massa
skog: djungel
mäta: mätare, mått, väga, meter, meter
annat: alternativt
strömma: flöde, klausul, nuvarande, elektricitet, flöde, jet
bröd: baka, sugga, smörgås
ytterligare: extra, skona, dessutom, överskott, överskott, ytterligare, tillägg, kompletterande, Lägg-till, bilaga
välja: val, urval, Välj, selektiv, plocka, välja, ringa, rösta, undersökning, preferens
djur-: 
Zoic-kön: 
eventive-humör: 
samma-händelse-markör: 
multiplikativ-fall: 
tjock: fet, tjockt, tät, fett
varelse: organism, väsen
regn: våt, regn, dusch
yta: ansikte, nivå, plan, område
helig: helig, netto, rent
juli: 
rapportera: bestämning, påstående, förhållande, relation, relation, rättvis, utställning, uppsats, exponering, göra
kust: strand, strand
fil: dokumentera, spole, lodge, profil, arkiv
axel: axel, axel, skildring, kamma, ärm
överraskad: förvånad, undra
kunglig: kejserlig, monarki, rike, imperium, verklig, faktisk
låt: ställa-in, spåra, sång, dikt
bekvämlighet: lätthet, avslappnad, avkopplande, uppmuntran, bekvämlighet, resten, lättnad
någon: vem-som-helst, någon, någon, ingen, alla
gräs: hö, ogräs, ört, gräsmatta, gram
dra: dra, dra, dra, intressant, överklagande, attraktiv, dra-tillbaka, spännande, dra-till-sig, intressant, ritning, avlägsna, subtrahera
öppning: preliminära, första, upptäckt, gap, spår, öppet
juni: 
fisk: akvarium
huvudstaden: kapitel, fond, tillgång
bröst: bröst
snö: is
utbildning: utbilda, lektion, lärorikt, läskunnighet, bildning, utbildning, utbildad, akademisk
skarp: ljus, våldsam, sträng, skarpt, kryddad, spetsig, akut, angelägen, knaprig
medlidande: barmhärtighet, medlidande, sympati, sympatisk, medlidsam, förfärlig, straff, fjäder, olycklig, djupt-beklaga, skada, skada, ånger
bekostnad: avgift, utgifter, kosta, utgåva, produktion, avgift
din: din
miljon: miljonte
trött: trötthet, tröttsam
döda: mörda, dödande
skugga: skugga
vikt: ladda, tung, kraftigt, väga, tryck
massa: kvalitet, kollektiv, kvantitet, bulk, flertal, massa, klump, klunga, folkhop, anfall, deg, pasta
etablerad: installera, fast, fast, stabil, skapelse, slå-fast, sittande
modig: djärv
tunn: mager, utspädd, avsmalnande, smal, luta-sig, bra, subtil, fint, lätt, jäkla, rarefied, delikat, mätare
nöjd: nöjd, tillfredsställelse, belåtenhet, glad, uppfylla, tillfredsställande
kolla-upp: kolla-upp, se, kolla-på, val, undersöka, inspektera, undersökning, testa, granska, mellanliggande, undersökning, undersöka, fastställa, revidera, kontrollera
dygd: vänlighet, dygdig, godhet, välvilja
nationell: nation, nationalitet, etnisk, inhemsk
gudomlig: helig
dal: handfat
gissning: slutledning, misstänka, förmoda, uppskatta, uppskattning, förutsägelse, förutspå, prognos, spekulera
spekulativ-humör: hypotetisk-humör
gul: påle, bärnsten, blond
ligger-kvar: återstod, resterande, återstående, matrester, resten
böjd: böjd, böja, slingrande, trend, vriden, sluttning, lutande, luta, hopfällbar
låda: resväska, låda, fond, utrustning, Kan, bin
säsong: säsong-, kapitel, station, epok
vetenskap: vetenskaplig
borra: hål, borra, tråkig, tråkig, pierce, förarga, forum
farbror: 
lista: index, katalog, meny, registrera
augusti: 
populär: utbredning, känd, framträdande, folk
okänd: främling
bekant: bekantskap, härstamning, ättling
bekant-registrera: 
läsare: sångare
närma-sig: nå, få-tillgång-till, teknik, taktik, metodik, attityd, sätt, metod, mode, procedur, approximation, gränssnitt
dubbelt: dubbel
intellektuell: sinne, intelligens, mental, intelligent, psykiatrisk, tänkare, visdom, andlig
verkligt: verkligen, verkligen, exakt, faktiskt, praktiskt-taget, i-stort-sett, sann, uppriktig, realistisk, perfekt, definitivt, Säker, säkert, säkert
präst: präster
sårad: skadade, sår, ont
sorg: sorg, sorg, depression, deprimerad, sorg-, ångest
palats: 
slå: besegra, stansa, slag, slå, slam, rytm, betagen
va?: 
lura: dumbom, lura, lura, fuska, dum, dåraktig, galen, galen, sinnessjuk, vilse
kant: rand, frans, marginell, intensiv, gräns, marginal, styrelse
nio: nionde, ny
brista: spränga, explosion, explodera, knäckt, bom, konvulsion, smäll
lida: härda-ut, sustain
buller: bullrig, skrika, väsen, ryta
litteratur: litterär
råd: råd, rekommendera, rekommendation, råda, samråd, styrelse, dricks
tömma: tom, ledig, trumma, fritid, null, tomhet, vakuum, fåfäng
rang: posta, kvalitet, prestation, kategori, värde, klass
storm: 
ficka: väska, paket
fantasi: lust, tänka, antagande, fantasi, fiktion, imaginär
mening: dom, dom, förslag, sats, förslag, förslag, bestraffning, övertygelse, fras, fördöma, fördöma, straff
november: 
december: 
frånvaro: frånvarande, brist, brist
tacka: tacksamhet, tacksam, tack, tack
adress: 
fågel: flyg, plan, jet, flygplan, flygplan, flygbolag
ägare: chef, hyresvärd
täcka: klänning, slida, täcka, jacka, päls
förbereda: redo, beredd, organisera, förberedelse, formulera
relationer: relation, relation, förhållande, relevans, relatera, affär, kommunikation, kommunicera
rök: rökning, tobak, bränna
januari: 
maskin: maskiner, motor, plan, fordon
innehåll: material, grejer, följa, uppfylla, innehålla, omfatta, bestå, engagera
tänder: tand, redskap
skam: skam, skamsen, blyg, generad, pinsam, förlägenhet, bar, naken, förolämpning, skandal
bukt: bär, vagina
hjärna: mastermind, märg
ringa: ringa, ringa, ringla, slinga, trötta, trötta, täta, stämpel
fras-markör: 
fyrkant: 
frukt: 
te: 
förklara: förklaring, illustrera, uttrycka, artikulera, förklara, klargöra, tolka, kommentar
välkomna: hälsning, reception, underhålla, Hallå, Hej, hälsa
poesi: dikt, vers
köpa: inköp, förvärva, bildning, marknadsföra
trogen: oärlig, lojal, troget, hängiven, rätta, pålitlig
spänning: stimulering, upphetsad, väsen, spänning, provocera, glädje, upphetsning, spola, ångest
fyrtio: 
april: 
vänligt: snälla-du, vänlig, försiktigt
oktober: 
bitter: strapats, vånda, ångest, bittert, lidande, smärtsam, sting
slav: slaveri
lösa: oberoende, löst, lösa, lösa, slak, ledig, fritt
text: lydelse
kreditera: inteckning, kreditkort, skuld, låna, låna, lån, prestige, giltighet, trovärdighet
femton: 
grym: våldsam, tuff
ansluta-sig: delta, delta-i, involverade, gå-ombord, vidhäfta, deltagare, engagemang, förena, ansluta
behandla: hantera, procedur, behandla, drift, rättegång
brottslighet: skuld, anfall, anfall
damm: damm, pulver
praktisk: funktionell, pragmatisk, praktiskt-taget, bekväm, i-stort-sett, praktisk, applicerad
färg: färg, måla, infall, färga, påle, färgad, färgrik, spola, avsluta
förstöra: förstöra, underminera, sabotage, degradera, förstöra, krossa, smash, förstörd, förbrylla, radera, förneka, förstörelse
öka: Fortsätt, öka, montera, höja, Lägg-till, föra-in, tillväxt, förstora
näsa: 
erkänna: erkännande, medge, acceptera, erkänna, erkänna, godkännande, stödja, bevilja, tilldela
i-går: i-morgon
hesternal-spänd: 
misslyckas: fel, misslyckad, besegra, bakslag, oförmögen, förbrylla, svika
Fortsätt: Fortsätt, kontinuerlig, beständig, fortsättning, ständigt, envisas
Bär: bära, porter
blind: 
dussin: flera
flyga: flygande, hoppa, flyg, flyg
beröm: beundran, beundra, rykte, merit, gratulera, lyckönskan, härlighet, berömmelse
jäkel: 
gradvis: långsamt, gradvis
offra: offer, byte, olycka
träning: friidrott, träna, uppdrag, öva, öva, sport, kondition, repetition
samvete: pronomen, medvetande
teori: princip, teoretiker, sats
minister: 
hat: otäck, äcklig, hat, tycker-illa-om, fördom, agg, harmas-över, äcklad, avsky, avsky
sjö: 
centrum: central, centrum, station, huvudkontor
svag: medvetslös, förtvivlan, desperat, svag, påle
rationell-kön: 
försiktig: omtänksam, uppmärksam, koncentrera, försiktig, exakt, exakt, exakt, detaljerad
njut-av: njutning, uppskatta
dyrkan: ritual
gods: produkt, punkt, handelsvaror, råvara, grejer
hud: läder-, absorption, bark, skal, skal, päls, krydda
tak: terrass, tak, beläggning, rapportering, lock
krona: 
slott: bur, råka, låsa
tron: 
bifogad: förlova-sig, villkorlig, bifoga, ansluten, beroende, associera
mile: tendens, sluttning, luta-sig, lutning, villig
extrem: maximal, slutlig, pol, polär, extremist, allvarlig, intensiv, intensiv, lem, dricks
fängelse: fängelse
kopp: mugg, skål
medlem: organ, medlemskap, lem, insider
civil: inhemsk, medborgare, medborgerlig, civil
överallt: genom-hela, någonstans
uppenbar: uppenbar, tydligen, bevis, direkt, skenbar, definitivt, bestämd, klar, helt-klart, transparent, oklar, märkbar
par: par, par, dubbel, dubbel, ett-fåtal, flera, ånga
volym: spole, mycket, utsträckning, belopp, relativt, kvantitativ, blockera, sats, modul, bulk, kapacitet, rapportering
beställnings-: klient, frivillig, kostym, tull, öva, vana, brukade
rosett: båge, lök, kurva
kostym: få-plats, kostym, lämplig, bevilja, motsvarar, motsvarande, fall, åtal, rättstvist, klänning, krav
kött: kött, nötkött
mjölk: mejeri, knacka, gelé
vegetal-kön: 
vision: syn, trance, insikt, fasad, se, glimt, utsikt, landskap, syn
sällsynt: i-sällsynta-fall, knappast
kusin: relativ
bro: kvalitet, däck
skydda: skydd, bevarande, skydda, skydda, försvara, bevara, upprätthålla, bevara, säkra
salt-: överdriven, överdriva, salt
oskyldig: 
drottning: 
räkna: dela, räkna, beräkna, lita, besvikelse, konto
nyfikenhet: bända
dansa: trumma, dans-, hoppa, hoppa
hotell: logi, värdshus
fylla: 
fånge: 
handla: lagra, bås, företag, handla, handla
trappa: trappa, trappsteg, stege, låda
tigga: sökande, utgå-ifrån, åberopa
sand: 
våldsam: våld, våldsam, turbulent, underbar, svår, stark, intensiv, kraftfull, vilt, intensiv
september: 
avresa: lämna, avvika, utlopp, produktion
ruin: förstörelse, omstörtning, skada, skämma-bort, katastrof, haveri
skicklighet: förmåga, kapabel, kapacitet, effektivitet, kompetens, hantverk, expertis
nötkreatur: ko
utrustning: anordning, anordning, utrustning, redskap, utrusta, tackla, hårdvara, teknik, teknologi, anläggning, fixtur
kök: matlagning, spis
sälja: försäljning, semi
fart: hastighet, takt, drivkraft, skarpt
slutsats: slutledning, uttag, produktion, inblandning, upplösning, resultat, följd, samling, sluta, förslag
dator: datoranvändning
evig: någonsin, evigt, oändlig
begränsad: ändlig, begränsad, begränsa, avgränsas, begränsad, begränsa
bibliotek: bokhylla
bas: grund, grund, baserad, grundläggande, primär, elementär, kärna, grundläggande, botten
förvirring: röra, kaos, väsen, förvirrande
härlig: lysande, härlig, ädel
likaledes: liknande, också, lika
skrämd: rädd, rädd, fruktan, skrämma
olycklig: olycklig, olycklig, eländig
artikel: uppsats, punkt
kock: matlagning, baka, koka-upp
band: bälte, band, tejpa, trupp, grupp, remsa, rand, zon, strand, knippa, klunga, körfält
öken-: vildmark, folktom
kyss: 
boll: gummi-, sfär, kanon, kula
pinne: stock, sockerrör, vidhäfta, trä, timmer, slagträ, cue
argument: logik, flytta, resonemang, kontrovers, diskussion, debatt, tvist, tarmkanalen
observera: inspektera, undersöka, utforska, undersöka, observation
välsignelse-humör: 
slående: utestående, fantastisk, strejk, betydande, signifikant, väsentlig, märkbar, imponerande, förvånande, förvånande, klar, ljus
skyldig: skuld, skyldig, förolämpa, lagbrytare, fälla
pistol: gevär, vapen, kanon, råka
polis: hävda, övervaka
dölja: dölja, utsöndra, dölja
expedition: kampanj, kör, färd, resa, resa, tur
okunnig: okunnighet, omedveten, okunnig, dåraktig, dumbom, dum, löjlig
generös: liberal, gästfrihet, välvilja
moln: 
avfall: onyttig, onödig, vägra, vägran, avslag, återstod, matrester, skräp
februari: 
sjukdom: sjukdom, sjukdom, koronar, tillfredsställande, tillfredsställande, syndrom
spendera: blomma, utnyttja, utgifter, utöva, hoppa, Fröken
källa: resurs, rå, fontän
initiativ-fall: 
moster: 
dröjsmål: skjuta-upp
försenad-nödvändigt: 
rapporterad-bevis: 
midnatt: norr
hjälte: krigare, mästare
filosofi: filosofiska
finger: tå
bekväm: väl, noggrant, ordentligt, mjukt, bekvämt, bekväm, avkopplande, trevlig, ombonad, praktisk
någonstans: någonstans
Tryck: media, tidskrift, tidning, utskrift, typ, formel
personal: besättning, personlig
belöning: pris-, gåva, tilldela, bonus
skylla-på: fel, defekt, fel, skuld, skuld, nonchalera, åtala, ansvar, ansvar
elände: strapats, lidande, ångest, eländig, leda
panna: 
a.d: annons, reklam-, annonsera, annons, meddelande, publicitet, få-syn-på, förklaring
ängel: jordägare, fe-
singularis-antal: 
gryning: skymning
kommersiell: yrkesmässig, annons, handel, företag
förlåta: ursäkt, förlåta, tolerera, befria, lindra, avfärda
får: lamm
tålamod: mod, tålamod
odla: ranch, odla, plantage, jordbruks-
referential: hänvisa-till, hänvisa
majs: vete, horn
nyckel-: obligation, knapp, rycka, växla, huvud, avgörande, framträdande, känslig, större, nisch, vanliga, ledtråd
majoritet: många, mest
svaghet: oförmåga
atmosfär: miljö, sky, flyg, rumslig
suck: flämtning
humanitet: mänsklig
opposition: motsatt, motsätta, motsatt, kontrast, motstå, protest, motsats, motstånd, disk, motståndare, ogillande, anti-, resistent, anti, invändning
disk: skiva, skiva, disk, cylinder, tallrik, spela-in, bricka, kör
ensam: ensam, ensamhet, separat, enda, endast
konstnär: aktör, målare, underhållare
riddare: ryttare
charm: karismatiska, attraktion, magi, stava
beslut: besluta, dom, dom, dom, bestämning, upplösning, lösning
guvernör: konservativ, linjal
gren: 
disposition: arrangemang, konfiguration, tendens, trend, bestämmelse, layout, humör, schema, tidtabell
entusiasm: iver, värme, entusiastisk, krydda, eufori, passion, extas, heja-på
induktiv-humör: inferential-humör, deduktiv--humör
gemenskap: samhälle, kategori, personer
olja: fett, bränsle, fossil, märg, termisk, smör
rör: rör, knacka, kran, bajs, kanal
skriva-ut: utgåva, tryck, utskrift, axel, forma, intryck
åh: ya
samtala-sammanhang: 
vokativ-fall: 
stuga: stuga, tält, lodge
larm: klocka, varna, skrämma, skrämma
nervös: spänd, förvirrad, störa, upprörd, generad, störande, plåga, upprörande, neurala, orolig, nerv
permanent: varaktighet, ofta, regelbundet, beständig, konstant, fast, stadig
kniv: skrika, blad
silke: 
förakt: förakta, hat, tycker-illa-om, avsky, avsky, nonchalera, förolämpning, skandal, oaktsamhet
Helvete: 
separerat: separat, åt-sidan, isär, distinkt, skilja-sig, separat, på-avstånd, separat, isolering, ostracized, avgränsas, separation
allvarligt: allvarlig, vänliga-hälsningar, tung, kraftigt, skarpt, aktivt
blandad: blandning, kombination, sammansatt, blanda, gemensam
trä-: trä, timmer
föredra: preferens
varning: försiktighet, varna, varna, minnesmärke, få-syn-på
förmaning-humör: 
impuls: inspiration, puls, sats, enträget-uppmana, drivkraft, sticka
ambition: besviken, besvikelse, lusta, girig, avskräcka, ambitiös
förneka: vägran, avvisa, avslag, avslag, negation, vägra, förneka, nedgång, ogilla, avfärda, förbjuda, förbjuda, förbjuda, motsäga
konstitution: charter, konstitutionell
instrument: verktyg, fartyg, enhet, organ, behållare, nytta
kontinuerlig-aspekt: 
tidvatten: våg, knäppa
college: fakultet, akademi, campus, universitet
svans: Kö
generation: ättling
katt: 
direkt-bevis: 
övergiven: försummelse, lämna, folktom, sluta, överge
elva: 
instinkt: spontan
karakteristisk: drag, specialitet, karaktär, vana, tendens, beteende, beteende, särdrag, karakterisering, kvalitativ, typisk
stam: trunk, stam, ladda
orolig-humör: 
skydd: tillflykt, bostad, lösning, habitat, bostads-, skydd, dorm, asyl
ohyfsad: plumpt, grov, ovänlig
ridning: rida, ryttare
skaka: brain
industri: sektor, tillverkning, industriell, industrialisera
yrke: yrkesmässig, karriär, ockupation, professionell
lampa: glödlampa
kaffe: kafé
lyda: underkastelse, följa, lyssna
norra: norr
sjuksköterska: 
försäkra: försäkran, motivera, löfte, garanti, försäkra, försäkra, fastställa, bekräfta, förse, tillgodose, Säker, övertyga, bekräfta, säkra
kedja: sekvens, serie, sträng, fängelse
undervisning: instruktion, utbilda, utbildning
skor: sko, sandal
gård: koda, sida, uppvaktning
vag: tvetydighet, skymma, tvetydig, oklar, mystisk, osäker, obestämd, våg, ledig
någon-annanstans: annan
lägenhet: platt, cirkel, fack, svit
aktivitet: transaktion, fungera
lördag: sabbat
solsken: sol-
änka: 
element: aspekt, särdrag, punkt, ingrediens, organ
reflexion: begrundande
organisation: vävnad, organisation, organisera, utrusta, företag, nytta, byrå, enhet, system, strukturera, konsistens, layout, institution, inleda
stjärna: 
incident: händelse, förekomst, fenomen, frekvens, olycka, fall
gäst: främling, besökare, främmande, utlänning, nykomling, klient, kund, värd
bar: bar, pub, ladda, frakt, kafé, barium
flaska: burk
välsigna: välsignelse
uppståndelse: manipulera, blanda, framkalla, upplopp
inre: inom, inne-i, interiör, inre, lokal, inhemsk, inomhus-, mental, insider
fixera: fast, anpassa-sig, revidera, lösning, lösa, lösa, avhjälpa, förbättra, räta-ut, ok, Okej, konstant, stadig, stirra, rätta, bestämma, slå-fast, identifiera, fastställa
härleda: erhålla, förvärva, derivat, skaffa-sig, ta-emot
ihålig: enkel, bar, tom, kabel-
provins: provinsiell
civilisation: 
hänga: 
chock: blåsa, bakslag, trauma, upprörande, kollidera
undantag: partiell, diskriminering, stereotyp, befrielse
anstränga: stress, spänning, ladda, trötthet, ansträngning, intensitet
standard-: kriterium, kriterier, hastighet, nivå, standard, norm, fast, konstant, stadig, stabil, statisk, hållbar, standardisera, mönster
körning: kör, förare, guide, förvaltning, rida
befria: avlägsna, dra-tillbaka, eliminera, eliminering, befria, lindra, frikänna
svära: svära
skatt: juvel
utsäde: sperma, mutter, partikel
torn: råka
favorit: favorit-
nyligen: nyligen, nyligen, nytt
nyligen-dåtid-spänd: 
vaken: medveten, moral, vakna, varna
Möbler: 
rep: sladd, sträng, rem
äventyr: våga, spela
royalty: regera
fest: part, firande, bankett, semester
beskriva: beskrivning, karakterisering, skildra, porträttera, definiera
sextio: 
skala: ram, mätare, förhållande, stege, trappa, trappsteg
ceremoni: ritual, fungera
jakt: jaga, offer, byte, jaga, skytte
viska: mumla
i-stora-drag: i-huvudsak, signifikant, mest, huvudsakligen, för-det-mesta, mycket, allmänt, övervägande
kristendom: 
advokat: advokat, förespråkare
detalj: spridning, förlänga, förlängning, expansion, bygga-ut, djupt, detaljerad
prinsessa: 
altare: fristad
web: nätverk, netto, rutnät, vävnad, duk, affisch
lila: magenta
samla: samla, ackumulera, krympa, ringa
val: val, välja, spår, röstning, val, urval, valsedel
uppfattning: begrepp, begrepp, conceive, uppfattning, uppfatta, konceptuell, design, fånga, arrestera, ta-till-fånga
berusad: alkoholhaltig
Häll-i: störta, skjul, spill, störta
hiss: hiss, upphöja, lyfta, höja, vandra
gest: skylt, signal, symbol, symbolisk, attityd, hållning
hantera: förvaltning, övervaka, hantera, administrering, styra, styra, kontrollera
utbyta: byta, ömsesidig, BYTE, ersättning
bestämd-artikel: 
kejsare: monark
avlägsen: avlägsen, långt, på-avstånd
ful: otäck, äcklig
ofarlig: 
rulla: rulla, spole
tum: tull, tumme
tidning: tidning, informera, dagbok
skägg: dricks, haka
riva: ryck
provision: utskott, styrelse
medan: medan, under
korsning: korsa, korsning, passage, godkänd, övergång, gång
oberoende: oberoende, frihet, fritt, frihet, autonomi
lukt: stank, parfym
arton: 
historisk: historiskt, historia, historiker
brutto: total, aggregat, smutsig, rå, rå
rot: stam, nyligen
lera: jord, slem, lera, smuts, blomma
brud: mormor
slöja: gardin, segla, segling
teater: teater
jämförelse: jämföra, jämförande, jämförelse, förhållande, konfrontation
rival: motståndare, dissident, konkurrens, konkurrenskraftig, konkurrera
balansera: jämvikt, lika, jämlikhet, horisontell, proportionell, par, budget
tränare: tränare, praktiker, handledare, mentor
humör: humör, humoristisk, humör, komedi
roman: fiktion, ny, nytt
hämnd: agg
svartsjuk: svartsjuka, avundas
hjul: cykel, cirkel
bränd: bränna, utsvängd
flash: blixt-, glöd, glans
skapa: skapelse, bygga, konstruera, konstruktiv, gör, tillverka, komponera, smedja, generera
konflikt: kollidera, kamp, konfrontation, kontrast, krascha, inverkan
förbannelse: 
FÖRBANNANDE-humör: 
hjälplös: eländig
positiv: positivt
klubb: slagträ, logga
översvämning: 
spannmål: sädesslag, vete
likgiltighet: apati, slarvig, oaktsamhet
horisont: 
assumptive-humör: hypotetisk-humör
brant: elevation, lutande
harmoni: kompromiss, ställa-in
åska: 
barndom: 
knä: knä
programvara: ansökan, repertoar
skada: ont, skada, skada, skada, sår, trauma, skadade, överträdelse
mottagande: ta-emot, ingång, reception, tillträde, godkännande, kupong, adoption
gör-det-möjligt: kapabel, behörig, aktivera, tillåta, berättiga, bära, hävda, låta, godkänna
Protasis: 
glida: hal, glida, glida
rotation: revolutionerande, kupp, rotation, revolt, uppror
jordbrukare: bonde
stroke: blåsa, kupp, rusa, förvränga
plattform: etapp, forum, grund
budbärare: delegera, ambassadör, diplomat
privilegium: privilegierad, preferens, kvot, franchise, bjuda-på, koncession
organiserad: institution, organisera, inleda, arrangemang, ordna
student: elev, forskare, grund
grotta: 
tradition: traditionell, traditionellt, tull, överlämna
tragedi: epidemi, sorg
farväl: adjö, bye
kritik: klandra, kritik, recension
bomull: ull-
sjukhus: asyl
hyra: biljettpris, hyra, beskatta, hyllning, hyra, använda, förlova-sig, hyrs, charter
gas: 
oundviklig: oundvikligen
dödligt: 
blad: ark, blad
offentliggörande: publicera, publishing, utskrift, förkunna, utsända, Släpp, produktion, diffusion, utgåva, meddela
fientlig: ovänlig, fientlighet
översättning: översätta, översätta, tolkning, epidemi, överföra
begravning: begravning, kyrkogård
mjöl: pulver, deg, exakt, exakt, exakt, måltid
korrespondens: motsvarar, kontakta, kommunikation, kommunikativ
romantisk: 
hydda: stuga, lodge
föreslå: pose, bjuda-på, rörelse, förslag, förslag, föreslå, rekommendera, förslag, bud, nominera
mimetiska: 
dollar: 
dagsljus: 
sexton: 
montering: möte, konferens, kongress, konfiguration
koloni: 
vinge: avdelning, svit
lejon: 
kultur: kulturell
kolumn: array, lager, pol, passage
listig: knepig, lura, skicklig
drama: låtsas, dramatisk
skämt: skoj, wisecrack
dimma: dimma
medicin: läkemedel, avhjälpa, spray, recept
fjorton: 
syra: sur, surt
nämligen: några, d.v.s., särskild
inkomst: spets
biskop: 
orange: 
bad: badrum, dusch, badkar
primitiv: tidigt, första
korg: bin, väska
sekreterare: 
halm-: hö
otålig: ivrig
frälsning: säkerhet, befrielse, Hej
hodiernal-spänd: 
avsikt: avsedd, avsikt, intresserad, angelägen, motiv, ovillig, ägna, ägna
ånga: ånga
förgifta: giftig, toxisk, herbicid
talang: briljans, begåvad, kompetens, förmåga, repertoar
klimat: väder
effektiv: giltig, effektivt, effektiv, effektivitet, inflytelserik, användbar, livskraftig
skilja: skilja, diskriminera, diskriminering, differentiering, fördela, att-dela, avfärda, utesluta, utsöndra
tvätta: tvättning
bekännelse: erkänna, bekännelse, erkännande
dumheter: skräp, orimlig, motsägelsefull
kol: kol
kanot: 
tillfällig: intervall, varaktighet, timlig, tillfällig, medan
delimitative-aspekt: 
ben: ben
måndag: 
tisdag: tredje
onsdag: fjärde
federal: federation, central
önskvärd: attraktiv, gynnsam
representant: representera, räkning, delegera, advokat, vice, talesman
linne-: lin, underkläder
sjunka: drunkna, handfat, zink
brorson: niece, barnbarn, barnbarn
blodig: blodsutgjutelse, blöda
belägring: omge, sittplats
mage: mage, buk, abdominal, matris
mässing: brons, koppar, ris
toppmöte: topp, högst-upp, dricks
femte: fem
billig: billigt, låg
exklusiv-person: 
ta-vara-på: tackla, begränsa, internera, bokning, ryck, ockuperade, uppta, beslagta, hugg, grepp
staket: häck
staty: skulptur
artilleri: kanon
omfamning: absorbera, gosa
omgivande: runt, grannskap, granne, granne, grannskap, kringutrustning, miljö, intilliggande, närliggande
strikt: sträng, sammanhängande, exakt, stram, svår, säkert, absolut, definitivt, tätt, hård
rådjur: 
buske: 
järnväg: järnväg, järnväg
ansvarsfrihet: befrielse, lasta-av, Släpp, avstå, driva-ut
arvinge: ärva
ek: 
obehaglig: glädje, behaglig, illa-till-mods, irriterad, upprörande, otäck, obekväm
uppfinning: uppfinna, upptäckt, innovation
piano: 
övertyga,-övertala: övertyga, fira, fira
osynlig: mystisk
välkänd: känd, ökänd, framträdande
grymhet: 
frestelse: 
Telic-aspekt: 
ekonomisk: ekonomi, ekonomiskt, ekonom, finansiell
internationell: global, multinationell
blanda-sig-i: interferens, intervention, ingripa, störa, besvära-sig, störande, avbryta, förarga, irritera, plåga, kollidera
filosof: filosofiska
elegant: modern, delikat
välfärd: välvilja, välstånd, bestämmelse
fiske: 
stjäla: stöld, råna, rån, hårt-slag
läpp: näbb, oral, rand
gå-i-pension: pensionering, pensionerad, retiree, reträtt, resten, fritid, dra-tillbaka, avgå
sträcka: räta-ut, förlänga, tarmkanalen, drag, bit, passage, fragment, bit
galleri: samling
parallell: vid-sidan-av, kompatibel, associera, affix
atelic-aspekt: 
kontinent: kontinental
hindrande-humör: hindrande-humör
slips: slips, örn
cell: väsen, nucleus, bur, version, mobil, mobiltelefon, mobiltelefon
ägg: testikel
artificiell: syntetisk
under-tiden: samtidigt
kris: svacka, dom, dom, nödsituation
artig: artighet, utbildad
lunch: frukost, middag
tall: käke
skjuta-på: pressa, kör, uppmuntra, främja, sticka, tryck
allians: union, liga, koalition, kombinera, partnerskap
midja: höft, liv, levande, mitten, mitten, mitten-
mirakel: undra
sjöman: 
renhet: kyskhet
republik: demokrati
telefon: telefon, mobil
piska: 
skjorta: t-shirt
införa: introduktion, presentation, slå-fast, inleda, göra, bestämmelse, rekommendera, remiss, injicera, leverera, leverans, skildra, porträttera
soffa: fåtölj
sopa: torka, räfsa, avsöka
tjuv: chef
behålla: bevara, boka, bokning, återställa, ha-kvar, hålla-tillbaka, internera, motstå, förlova-sig, bevarande, sustain, bevara, upprätthålla, vidhäfta
kanalisera: kanal
personlighet: karaktär
reformera: förbättring, korrektion, evolution, ändra
hotfull: hot, hota, farlig, skrämmande
palm: lönn
högtalare: talesman
tröskel: barriär
inducera: lobby, enträget-uppmana, ge-upphov-till, varna, excitera, pose, bly, fresta, framkalla
spjut: skona
propert: städa, rena, spänd
session: möte, konferens
tortyr: lidande
fuktig: smuts, våt, rinnande, kvav
ås: högst-upp, fläta, stack, kamma
resande: besökare, resande, turist, passagerare
kvarn: fabrik, tillverkning, plantera
Karta: kort, diagram, graf, biljettpris, biljett
krage: omge
byta-ut: ersättning, förflytta, skona, alternativ, ersättning, utbyte, förflyttning, ändra, variera, ändra, sub
avsiktligt: avsiktlig, överväga, medveten, medveten, målmedveten
öl: halvliter
sammet: 
allvar: attraktion, krossa
predikan: predika
missbruk: felaktig, felaktigt
flock: grupp, besättning, sats, svärm
tretton: 
rättfärdiga: motivera, åberopa, förespråkare, berättigande, motiverat
fredag: silver-, venus
borsta: kamma
ladda-ner: 
grädde: glass
klippa: sten, rand
jury: 
monster: jätte, monstruös
frusen: frysa
pott: panorera, burk, behållare
penny: cent
insistera: högt, sticka, hävda, Understrykning, betona, envisas, krav, behöva, argumentera
äpple: 
diskutera: diskussion, förhandla, argumentera
bakgrund: 
transkribera: anpassa, skriva-om
periodisk: regelbunden, cyklisk
underhållning: rekreation, underhållare, fritid, underhållande, underhålla, gyckel, hobby
virus: 
barnslig: sopran-
reflektera: begrundande, meditation, meditera, illustrera, skildra
konvertera: ändra, omvandla, växla, mutation
översikt: profil, kontur, sammanfattning, skiss, översikt, översikt, förslag
opera: 
godkännande: godkännande, ogillande, samtycke, godkännande, påstående, godkänna, stödja, adoption, applåder
förråda: avslöja, lura, svika
straffa: fälla
armbåge: konsol
fastsättning: bilaga, förbindelse, lappa, länk, kontakt
reparera: restaurering, förbättring, rekonstruera, korrektion
misstänksam: misstanke, misstänka
sjuttio: 
skriften: bibel, manus
grop: hål, utgrävning, slå-samman
oordning: kaos, anarki, oro, störning, röra, upprörande, interferens, förlägenhet
binär: dyadisk
kloster: kloster
pil: 
tendera: ansvarig, vanligtvis, i-vanliga-fall, typiskt
utveckla: detaljerad, definiera, klargöra, utveckla, komplicerad, knepig, träna
lojalitet: hängiven, lojal, förtroende, troget, ärligt, misstro, trovärdighet, tro, tro
mynt: valuta
darra: darrning
exil: skjuta, utomlands
mekanisk: maskiner, mekaniker, ingenjör
fälla: grepp, fälla
tårta: paj, kaka, deg
sir: herr, mister, lord, herre
tveka: slå, förfölja, frekvens, sväva
sjutton: 
honung: 
insats: satsning, andel, kil, lugg, del, fraktion, bidrag
trampa: flytta, lura, gå, gående, trampa, steg, kliva, ringt
tegel: bricka
åttio: 
tyvärr: olycklig, olycklig, sorgligt-nog
rådfråga: samråd, hänvisa
legend: myt
skörda: beskära
främjande: upphöja, främja, introduktion, presentation, publicitet
spis: spis, platta, ugn
rebell: revolt, uppror
gammaldags: gammal
svälla: blåsa-upp, svullen, inflation, svullnad, förstora
träsk: kärr
klä-på-sig: sås, bandage
asket: eremit
chef: steward, chef, chef, administratör, direktör, moderator, ledare, verkställande
kör: kör, team
rationell: motiverat, logik, logisk, orimlig, förnuftig, rimligen, rimlig
bearbetning: 
varg: 
matta: matta
antiken: 
bördig: 
vissla: flöjt
ost: 
bita: hugga, tälja, sting
inbjudan: inbjudan
katedral: tempel
hamn: hamn
vandra: promenad, flytta, vandra
gröda: beskära
marin: marin-, flotta
mask: fasad, mask
penna: penna
vegetabilisk: vegetarian
utställning: utställning, bjuda-på, visa, presentation, symptom, exponering
byxor: trouser, byxor
korruption: skandal, förorening
skåp: skåp, garderob, garderob, toalett
soppa: 
kirurg: kirurgi, kirurgisk, drift
ersättning: ersättning, ersättning, ersättning, apposition, tilldelning, bilaga
spionera: 
hänsynslös: slarvig, ovårdad
skvaller: rykte, rykte
tecken: 
abstrakt: sammanfattning, kursplan
torsdag: 
trafik: omlopp, transport, transport
arkitektur: 
spricka: skreva, knäckt, avvika, sluta, fraktur
prydnad: dekoration, dekorativ, dekorera, smycke, trim
omvänd: motsats, omvänd, växla, invertera, ogynnsam, upp-och-ner, bak-
roa: underhålla, underhållande, roat
återhämtning: restaurering, rädda, förbättring, väckelse, hämta-sig, återställa, rekonstruera
trottoar: trottoarkant, tonhöjd, tjära, slem, täcka
avgörande: avgörande, avgörande, bestämma, besluta, bestämd
negativ: ogynnsam
festival: konsert
minska: minskning, minska, lätthet, lindra, minimera, degradera, snedstreck, trim, subtrahera, begränsa, begränsa
förräderi: 
jägare: 
orm: reptil
batteri: 
vax-: ljus
detektiv-: forskare
analys: analysera, forskning, läsa-på, undersöka, inspektera, utforskning, upplösning, bryta-ner, bryta-ner
betoning: eftertrycklig, tryck, Understrykning, betona, betonade, accent, påstående, uppmärksamhet
simma: simning
kuvert: omständighet, adverb, slida
vem-som-än: som, någon, vem, vem-som-helst
cigarett: rökning, tobak
motor-: bil, motor, motiv, motorcykel
volontär-: ägna, frivillig
reaktion: reaktiv, svar, svara, reagera, feed-back
bagage: bagage, frakt, trunk, resväska
döv: 
juice: extrahera
ödmjukhet: enkelhet, blygsam
departement: 
sexuell: sex, sexualitet
diameter: 
yxa: 
diamant-: 
alternativ: skona, alternativ, ersättning, alternativ, vice, ersättning, transplantation
eko: 
återhållsamhet: hålla-tillbaka, trottoarkant, begränsning, begränsning, tvång
identitet: identifiera, Identifiering, symbolisk
skärm: visa, gardin
lat: rutten
momentane-aspekt: 
kompakt: bevilja, fast, tät
drift: drift, böjning, tendens, trend
försvinna: utdöd
stråle: balk, gång, radie
bläck: 
massiv: stor, stor, enorm, enorm, fantastisk, stor, enormt
källare: 
minnesvärd: framträdande
lysa-skarpt: glöd, glans, briljans
senat: parlament
kista: 
förlåtelse: 
svälja: smutta
unna-sig: utöva, uppfylla
svänga: 
äng: bete, pre, gräsmatta
komplex: komplicerad, komplicera, sofistikerad, förening, knepig
resignation: avgå, pensionering
ödmjuk-registrera: 
konspiration: tomt
peppar: 
ponny: 
kandidat: sökande
räv: 
skorsten: öppen-spis, stack
jurisdiktion: myndighet, dom, dom, kompetens
lantbruk: jordbruk, jordbruks-
noggrannhet: precision, kyskhet, exakt, korrekt, Sanning
före-detta-den avlidne: 
demokratisk: 
knopp: knopp, gro
filt: tak, täcka, matta, rapportering
hagel: ockuperade, hälsa
gris: sugga
formad: figur, form, fikon, aspekt
elfenben: 
klassisk: klassisk, traditionell
observatör: handledare, besökare
elefant: 
naglar: spika
bi: 
begrava: begravning, bädda-in
skådespelare: skådespelerska, aktör, kärande
svettas: 
polska: dialekt
illusion: bedrägeri
osäkerhet: osäker, tvetydighet
sekundär: mindre, medium, genomsnitt, måttlig, vanliga, mitten-
vika-ihop: hopfällbar
lantlig: provinsiell, landsbygden, bybo
stöna: 
likna: liknande, likhet, påminna
citationstecken: extrahera, citat, unquote, låna, låna, lån
säck: avfärda, uppsägning, väska
irritation: störning, interferens, avbrott, strapats, leda, besvära-sig
nål: injektion, spruta, nål, stift
kontrollerade: kontrollera
kyckling: höna
konsekvent: beständig, kompatibel, betong-, implicit, lämplig, nisch, relevant, sammanhängande, sekventiell, balanserad, stadig
fat: hink
vanlig-aspekt: 
expert-: specialist, erfaren, särskild, specifik
imponera-på: påverka, intryck, dra-till-sig
oliv: 
skåpbil: ventil
hinder: avbryta, tvång, handikapp, barriär, bakslag
nicka: 
främja: odla, spenat, främja, främja, foder, förmån, förmån
definition: kommentar, Identifiering, beskrivning, bestämning
födelsedag: årsdag
hammare: 
doftande: 
upprepning: tung, destination, upprepa, replikera, repetition
trivial: ringa, oviktig
sparka: slog-till, stöta, fotboll, kalcium, fotboll, blåsa
gräva: gräva, borra, utgrävning
sällskapsdjur: 
kranium: 
lagstiftande-församling: parlament, lagstiftande, lagstiftning
häl: hoppa
rynka-pannan: 
patent: 
miljard: 
kemisk: kemi, kemikalier, kemist
pilot: experimentera, experimentell
imitera: simulera, simulering, replikera, reproducera
kjol: sten
ovanligt: ovanlig, onormal, udda, anmärkningsvärd, utöver-det-vanliga, otrolig, oregelbunden, fenomenal, oerhört, ytterst, underligt
varje-vecka: 
teknisk: teknik, teknologi, tekniskt, tech
vegetation: 
gala: råka
soluppgång: 
livstid: liv, överlevnad, livsstil, levande
bidra: bidrag, donera, partnerskap, främja, främja
krok: relatera, ansluta, korrelat, konsol
tiger: 
penetrera: pierce, genom-, inflytelserik
ärm: ärm
motorväg: väg
milis: 
dike: dike, axel
integritet: 
nitton: 
organisk: 
teologi: 
flyta: båt, sväva, flotta
häxa: 
uttråkad: tråkig, leda
diplomatisk: diplomat
studio: märka, verkstad, läsa-på
överstiga: aggression, våldta, betagen, korsa
champagne: 
inspirera: uppmuntra, inspiration, uppmuntrande, andas-in
baner: flagga, affisch, biljett
äktenskapsskillnad: skild
bult: blixt-, spika, vrida, skruva
ven: nerv
passiv: publik, inaktiverad
skumma: bubbla
grus: 
förkläde: knä
planet: 
hylla: kuggstång, skåp
Fan: 
tropisk: 
fas: fotografisk, etapp, period, konstruera, steg
godtycklig: spontan
uttala: uttal, accent, yttrande, uttala
kvicksilver: 
krypa: krypa, klättrande, lamm
självmord: 
reporter: journalist
beröva: berövande, återkalla, utesluta, subtrahera
skicklig: skicklig, effektiv, kapabel, begåvad, erfaren, kvalificerad, duktig
balkong: terrass, veranda
gaffel: 
anställd: arbetstagare, arbetare, arbetssätt, faktor, beroende, kontorist
arbetsgivare: chef
bredd: brett, förse, bred, semi
irriterad: irriterad, upphetsad, irritera, provocera, stimulering
anklaga: fördöma
pension: pensionering, syntax
verb: handling, reagera
apa: 
godtagbar: acceptera, godkännande, rimlig
signatur: 
ortodox: konservativ
ironi: skoj, vrida
barnkammare: plantage
motvillighet: tycker-illa-om
importera: introduktion
fackla: 
grammatik: grammatisk
deposition: ackumulera
kolonial: 
yacht: färja, båt
följd: följd, episod, viktig, betydande, ledande, framträdande, betydligt, signifikant, väsentlig, meningsfull
kupol: 
tjocklek: 
envis: bestämd
muskel: 
magnitud: storlek, bulk, amplitud, mätare, kvantitet
gnugga: 
feg: 
sele: förena, sammanfoga, förena, utnyttja, bälte
rostat-bröd: mellanmål
mus: råtta
stavelse: 
klappa: klappa, slå
dialog: kommunicera, konversation
neutral: kastrera
flit: iver, vårdnad
motsägelse: motsägande, kontrovers, tvetydig, förvirrande, kontroversiell, tvetydighet, paradox, motsäga, variation, invändning
uppnå: inse, nå, anlända
get: 
frodas: välstånd, blomstra, bom, juvel, pärla
förelägga: tvinga, hävda, bestämma
anonym: 
formell-registrera: 
kalv: skynda
manuell: guide, riktlinje, stämpla, ledarskap, lärobok, instruktion, ledare, handledare
smälta: avdunsta, tina, fusion
radera: radera, lösa-upp, annullera, avlägsna, utesluta, avskaffa, eliminera, eliminering
paraply: fallskärm
känga: sko, trunk
mineral-: jod, näringsämne, metall-
stillestånd: eldupphör
anka: 
planering: 
tvål: 
docka: barn, leksak
skelett: 
villa: fe-
sömnad: sy, sy
förena: medla, förena, förena
vattenkokare: 
mogna: vuxen
kanin: 
dirigent: stege, föreståndare, förare, ledare
beroende: bero, beroende, beroende, beroende, affinitet, attityd
spelare: aktör
insekt: skadedjur
restaurang: 
uggla: 
radikal: militant, extremist, progressiv
bosatt: invånare, inföding, inhemsk, inhemsk
drake: drake
auditiv-bevis: 
törstig: 
dröja-kvar: långvarig
beräkning: beräkna, beräkning, datoranvändning, calculus, räkna, konto, folkräkning
reglering: censur, kontrollera, tvång, begränsning, lösning
borgmästare: 
minoritet: 
förvärv: erhålla, få, förvärva, få-tillgång-till, tillgänglighet
veteran-: senior
orkester: 
bacon: 
nackdel: förlust, berövande, ogynnsam, fel, handikapp
tyg: trasa, kläder, handduk, duk, vävnad
musiker: kompositör, musikalisk
mentalt: andlig, mental, moral, mana, subjektiv
samband: samarbeta, förbindelse, förening, förening, associera, kombinera, sammanhängande, vid-sidan-av, kontinuitet, linker
otillräcklig: saknas, otillräcklig, brist, eländig, sämre, besvärlig, riklig, olycklig, motsägelsefull, olämplig
arkitekt: 
citron-: 
hosta: hosta
huvudvärk: 
hyresgäst: planerare
fertilitet: fortplantning
läka: bota, förbättra, öka, förbättring, behandla
nittio: 
slumpmässig: slumpvis, randomisera, tillfällig
sked: hink
ballong: 
krita: plåster
inferential-bevis: 
utgivare: redaktör
vinäger: 
aska: grå, grå
svordom: svära
återuppliva: väckelse
mottaglig: sårbar, känslig, förnuftig, emotionell, ansvarig
tunnel: tunnelbana
pussel: blanda-ihop, förvirrande
mekanism: procedur, rutin-, systematisk, maskiner
matematik: matematik, matematisk
blekna: 
lever: 
sublative-fall: 
doppa: dyka, bädda-in, släppa, tumla, frekvens, sluttning, lutning, lutande, lutning, blöta
enhet: enhet, enhet, modul, näbb, singularis
monopol: exklusiv
spelande: spela, spel, match, spel, leksak
u-båt: under-vattnet
jordbävning: konvulsion
laboratorium: labb
kork: svamp-, svamp, lock
själv-kontrollera: 
buddha: 
sticka: stickning, väva, sticka, stickad, knut, nod, fläta
ambassad: 
längst: 
deklarativ-humör: 
stimulans: uppmuntran, incitament, recept, motivering, motiv
choklad: godis
tillfällighet: chans, kombination, olycklig, slumpvis, tillfällig, match
handske: 
knäböja: 
geografi: 
investering: investera, våga
verbal: talad, oral, förolämpande
analogi: jämlikhet, likhet, affinitet, släktskap, förhållande
sekulär: lägga
hök: örn
psykologi: 
fästa: relatera, binda, ansluta, bandage, arrestera, bifoga
skrot: annullera, skräp, skräp, fragment
roll: remskiva, del, stock, deltagare
dos: kvantitet
lax: 
pudding: 
magnetisk: attraktiv
pump: bomba
syre: 
certifikat: 
medalj: 
retorik: 
skrapa: repa, beta
åra: skotta, fena
teleskop: mikroskop
halsband: besegra, klistra
stavning: stava
whisky: 
vide: bete
kamel: 
amatör-: 
går-ut: exportera, utlopp, uppkomst, produktion
biografi: 
åsna: 
en-gång-i månaden: 
bortse-från: försummelse, förbise, avfärda, okunnighet
semester: lämna, semester, rekreation, resten
klick: klick, knäppa
oval: 
elastisk: gummi-, flexibel
lexikon: lexikalisk, ordförråd
skinka: lår, skinka
regnbåge: 
konsumera: konsumtion, utnyttja, distribuera
spotta: para, tunga
tank: reservoar, behållare, moms
kollega: kooperativ, kollega, para, associera
fjäril: 
Diagram: diagram, graf, grafisk, grafik, schema, schema
tvilling-: dubbel, dubbel
oberoende-av: oberoende, fritt, isär
bambu: 
-handlare: återförsäljare, säljare, försäljare, köpman
ackumulation: ackumulera, samling, koncentration
inspektör: revisor, föreståndare
munsbit: fragment, skiva, bit
mardröm: dröm
sylt: gelé
museum: 
alfabet: alfabetisk
sprida-ut: distribuera, spridning
räd: ockupation, invasion, överfall, offensiv, början, dominerande, förvisa
avslöja: meddela, avslöja, upptäckt, översikt, ångra, publicera, upptäcka
ruttna: förfall, försämras
aggressiv: störa, röra, ockupation, aggression, offensiv, bestämd
friktion: 
pir: 
spindel: 
potatis: 
revision: anpassa-sig, ändring, revidera, korrektion, ändra, recension, granska
girighet: girig
för-tidig: tidigt, stöta
multiplicera: slog-till, ras, stöta
snurra: rotera, rotation, spiral-, gänga, vrida
statistik: statistisk, figur, chat
kalender: schema, tidtabell, dagbok, se
utnämning: nominera, utnämning, urval, engagemang
biljon: 
vind: vind
jakande-humör: 
tillämpningar: 
nominell: 
missnöje: 
infektion: infektera, smittad, övergång, överföring, infektiös
tillbringare: burk
rycka-på-axlarna: rycka-till
pionjär: större, avantgarde-
underlåtenhet: standard, tabbe, brist, oaktsamhet, försummelse, eliminering
kål: 
idrotts-: friidrott, matematisk, idrottsman
fylleri: socker
idiofoner: 
spak: bända
senator: 
iris: 
myra: 
insekt: 
gravid: moderlig
fällning: utfällning, sediment, hastighet, brådskande, accelerera
vrist: 
klassificering: sortera, klassificera, klassificerare
variabel: variera
slå-in: packa, paket, paket, paket, spole, omslag, täcka, beläggning
lockig: ringla, kasta, spole, rulla, helix
svavel: svavel, bruten
diktera: 
uppstå: synas, utseende, uppstå, uppkomst, sluta
groda: 
överdriven-fall: 
svamp: svamp, svamp-
irriterande: upprörande, störa, besvära-sig, väsen, förarga, tråkig, kräsen, störande
ekorre: 
slipa: halv, semi
irrealis-humör: 
vulkan: 
inomhus: inomhus-, inne-i, inom, lokal
utnyttja: utnyttja, absorbera, prestation, utforska
geologisk: 
pass: 
omoralisk: ond, rutten
kex: kaka
samarbete: samarbeta, partnerskap, integration, hjälpa
tablett: kula, piller, platta
avkoppling: slak, avslappnad, fritid, koppla-av, avkopplande, rekreation
atom: atom-, partikel, enskild
aids: hjälpa, lättnad, extra
pyramid: 
cykel: cirkel, omlopp, frekvens, rotation, rotera, cykel, cykel
nap: 
olaglig: olaglig
tass: klo, tå
blyghet: blyg, kontraktion
förmörkelse: skymma
luta: luta
kvast: 
panel: tallrik, platta, målning, styrelse, grupp, utskott
astronomi: 
labyrint: 
stipendium: sponsorskap
sköldpadda: 
rådgivare: mentor, råda
fiber: fiber, bunt
syrsa: 
duva: 
anpassning: anpassa, fixtur, överensstämmelse, modifiering, anpassa-sig
triangel: 
skattmästare: 
väte: 
ömtålig: delikat, knaprig
skrivare: 
sätta-i-halsen: 
kronisk: resistent
klara: råka-ut-för, anpassa, konfrontera, offset, betagen, tackla, kontrastiv, hantera
dilemma: 
teknik: teknik, tekniskt
kamera: kammare
be-om-ursäkt: ursäkt, förlåta
slicka: 
dansare: 
migration: flytta, invandring
tennis: 
ryggrad: 
steka: 
vävstol: stängd, stängning
hugg: sting, pierce, hugg, försök, försök
lösenord: signal, cue, slogan
hemisfär: spetsig, dricks
strategi: strategisk
kvarts: 
sax: dra, dra
patrullera: 
glaciär: 
halvvägs: halv, delvis, semi, mitten, mitten
promemoria: fördrag, kontrakt, konvent, bevilja, motivera
kon: avsmalnande
symmetri: 
tillverkare: produktiv, producent, konstruktiv
svarande: förespråkare
moské: 
schack: 
vägtull: avgift, avgift, offer, figur, komplikation
körsbär: 
utbredd: omfattande, allmänt, spridning, bred, bred
snubbla: tumla
lastbil: lastbil, frakt, fraktfartyg
senap: 
procent: procent, cent
auktion: försäljning
sikt: 
ostadig: instabil, instabilitet, osäker, illa-till-mods
magnet: 
suga: absorbera, blöta
islam: 
tå: tå, redo, villig
membran: 
rakning: 
gitarr: 
glänsande: ljus, A.M., lysande
alm: 
sväva: vandra, sväva, hals, flyg
pronomen-markör: 
häftklammer: klämma, konsol, grundläggande, grundläggande, grundläggande, huvud, större, slutlig, primär
krydda: krydda
borgen: obligation, försäkran, löfte, garanti
bärare: vektor, kärande, porter
vibration: resonans
reta: fresta, förarga, irritera, fascinera
plog: lösa, hacka, kapa
fysiologisk: kroppsligt
ränna: dränera
komet: lagbrytare
medeltida: mitten
Sparv: 
kompensera: ersätta, ersättning, offset, lösa-in, smink, smink
plast: 
fotnot: 
bana: klass, klassrum, bana
sparsam: blygsam
golf: 
noll-: null
chips: bit, fragment, skiva, bit
förtrycka: dämpa, förtränga, sänka, överösa
gäspa: avdunsta
olikhet: 
mol: sesam, lera
krukmakeri: 
hemmafru: 
råg: 
inte-lyda: kränka
tolerant: tolerans
embryo: trötta, trötta, foster-, foster, nucleus
gruvarbetare: mindre
applådera: uppskatta, applåder, klappa
jäst: enzym, deg
premie: bonus, pris-, tilldela
plommon: 
konkurs: fel
bevattning: 
mynta: godis
kapitalist: kapitalism
elasticitet: flexibilitet
haj: 
rekrytera: lura, nybörjare
lagring: bevara, bevara, lagra, sparande
realism: 
ingefära: 
ambulans: 
jämförbar: proportionell, liknande
plånbok: portfölj
grimas: mugg, flin, slingra-sig
forskare: vetenskaplig, forskare, forskare, forskare
gut: tarmar, tarm
jämnmod: 
radio: radium
irrelevant: motsägande, olämplig, motsägelsefull, oviktig
böna: mutter, ärta, jordnöt, sädesslag
informell: 
sondotter: barnbarn, barnbarn, niece, ättling
oenighet: invändning, debatt, tvist, instämmer-inte-alls
stek: hugga
kväve: 
rakkniv: 
kontrasterande: kontrast, kontrastiv, motsägande, motsatt, motsats
propaganda: förkunna, publicitet, annons, reklam-, annonsera
fyrverkeri: 
pop-: knäppa, smäll
klä-av-sig: 
fåra: 
skadlig: skada, farlig, ogynnsam
judendom: 
komplement: kompletterande, utrusta, tillägg
lins: lins, ficklampa
pegative-fall: 
cancer: 
pantsätta: inteckning, soldat, löfte
föreläsare: 
läcka: spill, förlust, släppa
kvalificera: berättigad, merit, förtjäna, kvalificerad, kompetens
densitet: fullt-med-folk, intensitet
induktion: 
tugga: 
pratsam: kommunikativ
hummer: 
rabatt: befrielse, försäljning, koncession
taxi: 
hierarki: ledarskap, system
jade: 
morra: 
ödla: 
vattenfall: 
besvikelse: deprimerande, besvikelse, svika, besviken, otäck
veto: vägra, spår, avvisa, avfärda, ogillande, satsning, dragning
ordförandeskap: president-
köpare: kund
gallon: 
mygga: 
avvikelse: böjning, förvrängning, offset
brottas: konkurrera
mosaik-: 
plugg: kontakt, kupong
sitta-på-huk: huka
matvaror: 
kommunist: 
förvåna: förvånande, fantastiskt, fantastisk, vilse, blanda-ihop, bedöva, förbrylla
prosecutive-fall: 
konstellation: galax
diktator: 
upptagenhet: sysselsättning, ångest, oroa, oro
satellit: 
toffel: sandal
konsonant: 
ungefärlig: approximation, cirka, approximativ
arbetslös: sysselsättning
anhängare: assistent, extra, härda-ut, konsol
lotus: 
sallad: sallad, spenat
klorid: 
bakterier: svamp, bakteriell
klibbig: viskös
komponent: 
kärna: 
hyckla: låtsas, simulera
bitgrupp: 
utsöndring: utsöndra
uttryckligen: helt-klart, öppet, tydligen, tydligen, definitivt
sammanfaller: match, lämplig, lämpad, bevilja, motsvarande
balett: fena
urin: piss
vitlök: 
förflutit: dåtid, godkänd
ekonomi: ekonomi, lågkonjunktur, sparande
medelklass: 
vig: snabb, snabbt, snabb, prompt
tång: skotta, klämma
tvätt: tvättning
jordgubbe: 
urban: medborgerlig
besvära: avskräcka, handikapp, pinsam, förbrylla, blanda-ihop
Anteckningsblock: 
album: 
baseball: 
Sniff: 
buffé: 
particip: deltagare, deltagare
garage: 
diagnos: diagnostisk, diagnostisera, kognitiv, erkänna
krycka: 
pressa-ut: utpressning, plocka, begränsa
registrering: spela-in, registrera, inspelning, logga
löslig: lösa-upp
fosfor: 
strukturell: strukturera, konfiguration, config
lim: 
avhandling: avhandling
hantverkare: mekaniker
banan: 
axiom: sats, frank, skenbar, uppenbar, explicit, princip
revben: redskap
nickel: ingen
pi: bye, paj, kisel
buss: låta
censurera: censur
missil: raket
korv: varmkorv
manipulation: fungera, manipulera, operativ, lura, fuska, hantera
tomat: 
förstärka: konsolidera, intensifiera, bekräfta
uttag: uttag, utlopp, kontakt, bo
kalium: 
hämta: hämta, hämta-sig, återställa, restaurering
virtuell: verklig, faktisk, äkta
algebra: 
tandläkare: tand
optisk: visuell
röra-sig-ur fläcken: koncession, förmånliga, flytta, rör-på-sig, förflytta
biologi: 
arbetslöshet: 
larv: 
solo-: separat, fenomenal, separat, jord, ensam
webbläsare: 
avlägsen-dåtid-spänd: 
historisk-spänd: 
nukleär: nucleus, atom-
spektrum: 
natrium: 
hysteri: 
förvaltare: administratör
gisslan: inteckning, löfte
kalebass: pumpa, märg
skrynkla: defekt
genomskinlighet: transparent, explicit, enkel
spika: kil, spets, dricks, spika
prioritet: uppmärksamhet
fotgängare: gående
ateism: 
övervaka: spåra, övervaka, kolla-på, utöva
valkrets: väljare, väljarkår
okontrollerad: 
sond: undersökning, förfrågan, undersökning, undersöka, förfrågan, utforskning, rättegång
platina: 
dubbel-antal: 
lunga: 
super: fenomenal, enormt, oerhört
vagn: transport, vagn, vagn
lokalt: lokal
hetsa: excitera, förarga
bensin: bensin
njure: 
plundra: rån, plundring, byte, skämma-bort, råna, dra
värdering: uppskatta, uppskattning, utvärdera, kvalitet
arsenik: 
snigel: helix
gräshoppa: 
ekvation: formel, jämlikhet
socialistisk: släktskap
filtrera: 
sensorisk-bevis-humör: 
bredda: bygga-ut, bred, Lägg-till, höja, öka, förlänga, brett, upplösning, förlängning, expansion
avge: lansera, kasta, andas-ut, skjuta, låta
koppel: hyra, rem
mandarin: 
jockey: 
lunginflammation: 
solidaritet: förena, rally, affinitet, enhet, likhet
gångjärn: detaljerad, slinga
longitudinell: vertikal
utdelning: tilldelning
skridsko: åka-skidor
exponent: index, exponentiell
handikapp: handikapp, oförmåga, defekt, ofullständig, inaktiverad, fel, fläck
besatthet: plåga
tilldelning: tilldelning, fördela, bestämmelse, kvot, uppdrag
fotograf: fotografisk
delta: delta
digital: figur, siffra, numerisk
tik: 
ögonlock: 
diagonal: 
undermedvetna: 
ögonbryn: 
nysa: 
munter: gladlynt, gyckel, glad, rolig, underhållande, rolig, roat, humoristisk, löjlig
hinduism: 
flykting: invandrare
transfer: rymdskepp, transport, transport, transport
protein: äggvita
dumpa: lugg, stack, förvisa, skräp, skräp
förfina: 
kräkas: 
gen: genetiskt, genetisk
förstaårselev: 
sociologi: 
squash: pumpa, krossa
fiskare: 
regional: grevskap, område, zon, avdelning, sfär, sektor, kringutrustning
rörelse-uppför: 
retrospektiv: dåtid, introspektion
tornado: 
inversion: invertera, motsats, ömsesidig, omvänd
tv: tv, filma
kub: 
produktivitet: prestanda, produktion
morot: 
molekyl-: molekyl, substrat
konglomerat: klick, grupp, klunga
revisor: revisor
gurka: alternativ, hals
orgie: 
lösningsmedel: lösa-upp
fosfat: 
primer: bete, bekantskap, introduktion
alkalisk: 
gymnastik: kondition
kommatecken: koma, part
rörelse-utför: 
missfall: abort, låg, fel
pod: skal, slida, skal
givare: 
mangan: 
psykolog: 
klor: 
tangentbord: 
elit: 
parentes: 
rugby: 
ulcus: öm, sår, trauma, koka-upp
varierad-lutning: 
knapra: 
kvant: belopp, kvantitet, kvot, andel
Tröja: jacka
evolutionära: utvecklings, evolution
notation: skylt, symbol, Notera
studsa: bom, hoppa
dissektion: fördela, avsnitt
cache: 
linjär: enkel
antimon: 
superessive-fall: 
tumör: tumör, bulk, stöta
erosion: 
alfa: 
navel: mage, pol
immun: andas, resistent
influensa: influensa, rinnande, feber, inflytande
bryggeri: 
förenkla: 
förkorta: begränsa, begränsa, begränsa
buckla: klump, stöta, tand
fängsla: ta-till-fånga, fascinera
tvinga: begränsa, tvinga, hävda, tillämpning
socka: 
film: filma, bio, band, tejpa, rand
kosmos: universum
förorena: förorening, infektera
sällskaplig: 
penis: sex
skogsbruk: 
aluminium: aluminium
svängning: fluktuation
horoskop: 
mata-ut: jet, driva-ut, kasta-ut, deportera, utsöndra, förflytta, subtrahera
integration: inspelning, integration, bädda-in, täcka, omfatta, beläggning, inblandning, engagera, engagemang
förmånstagare: sittande, användare
delfin: 
mördare: 
däggdjur: 
indikator: hållning, index, kriterier, pekfinger, mätare
dioxid: 
kolon: 
byråkrati: byråkratisk
förvränga: vilse, förvränga, förvrängning
kylskåp: kylskåp
arkeologisk: arkeologi, arkeologi, fossil
oacceptabel: ogillande
specifikation: norm, standardisera
folder: bulletin, handout, ark
antropologi: 
välsmakande: utsökt
transitiv: ursäkt, övergång
krypa-ihop: krypa
solros: 
lus: bock, bit
Jon: 
turism: turist, resa
modem: 
acceleration: främja, främja, stimulering
förfalska: förbrylla, smedja
utsläpp: smutsig, problem
kidnappa: kapa, ledning, ryck
överlappning: interaktion, interaktiv
frisör: 
folklore: vete
kapillär: 
nationalism: nationalitet
rumpa: höft, skinka
motiv: tema, ämne, motiv, grunder
sublimera: 
frustration: bakslag, förtvivlan, besvikelse, förvirrad, annullera
kobolt: 
havre: 
rörelse-uppför-floden: 
anus: 
bovint: 
flip: översätta, översätta
redundans: massor, resterande, överskott, avfärda, uppsägning, befrielse
video-: 
bojkotta: grevskap, ostracized, försummelse
frågesport: försök, examen, frågeformulär
hockey: 
gerilla-: 
magnesium: 
radar: 
schimpans: 
pålitlighet: trovärdighet
rektangel: 
kelp: 
generalisera: generalisering
utegångsförbud: 
homosexuell: 
scenario: manus, landskap
formulering: bygga, konstruera, konstruktiv, lydelse, skapelse, bildning, formulera
reinkarnation: 
antända: 
uran: 
catcher: receptor
samordna: samordning
skattebetalaren: 
integrerad: väsentlig
menade: se, åsikt, anmärkning
gamma: 
safari: rida, resa, färd, resa
rörelse-nedströms: 
koefficient: kvalitet, faktor
rubrik: titel, ämne
analytiker: analysera
schackmatt: 
köpcenter: stormarknad
vismut: 
vykort: hälsning
konvergens: approximation, konvergera
avvika: reträtt, avvika
aktieägare: partner
mikrob: 
genital: 
morfologiska: genetisk, morfologi
beta: 
jeans: 
databas: 
kalkylator: datoranvändning
röntgen: 
parse: 
miljö-: landskap, miljö, miljö, sammanhang, ekologisk, grannskap, grannskap, kontur
sigma: 
åtskiljande: isolering, separation, bryta-ner, bryta-ner
dagordning: programmera, program, läroplan
visum: 
infrastruktur: 
eldfluga: 
detektor: 
adaptiv: 
biolog: 
splitsa: affix, ändra, bifoga, ansluta
brom: 
palladium: 
hicka: 
pastell: påle
Zoo: 
klinik: 
konnotation: inblandning, menande, semantisk, begrepp, begrepp, känsla, sammanhang
yoga: belopp
bokhandel: bokhylla
terapi: behandling, behandla, bota, avhjälpa, terapeut
nationalist: etnisk
halshugga: 
ja: ja
problematisk: problem, problem, komplikation
jazz: 
volfram: 
terrorist: militant, skräck
dribbla: slem
metabolism: 
underhållsbidrag: 
helgen: 
krysantemum: 
vaccin: kommentar, rapportering
motorcykel: motorcykel
mantra: 
termin: termin
heroin: 
mapp: 
katod: 
ideologi: trodde
parkering: 
theta: 
anticlimax: besvikelse
selen: 
cykling: omlopp, slinga, cyklisk, cykel, cykel
bark: bark, skal, skal
likvärdighet: jämlikhet
nuvarande-relevans-markör: 
flygplats: 
amputera: avbryta
basketboll: 
bedragare: 
kackerlacka: 
krom: 
liter: liter
ändå: ändå, än, dock, i-alla-fall
hormon: 
bristfällig: brist, brist, ofullständig, felaktig, falsk, saknas
perforera: pierce
animism: 
polygon: vinkel
feminist: 
konjugat: lutning, ansluten
euro: 
ginseng: 
algoritm: 
laser: 
apotek: 
millimeter: millimeter
böja: böja, böjd, flexibel, gynnsam, kabel-
anod: 
nyans: skugga
deltid: 
känslighet: 
demonstrant: 
helium: 
tvåspråkig: 
akronym: kort, kort, krympa
Förkortning: 
gerundium: 
plasma: 
kromosom: 
ordningstal: korsning, rad, regelbunden, sekventiell
kilometer: kilometer
fax: 
genetik: genetisk, genetiskt
fräkne: 
skruvmejsel: rycka
broccoli: 
preteritum: 
vitamin: 
kadmium: 
bombplan: 
grafiska: 
titan: 
splurge: skryta
lambda: 
flickvän: partner, pojkvän, älskare, flicka
kopulera: 
timglas: 
empati: sympati, medlidande, förståelse
bor: 
helikopter: 
tellur: skandium, lantan
deadline: termin
rikta: 
centimeter: 
molybden: 
litium: 
multimedia: 
uppdatera: modernisera, uppdateras
kalori: 
robot: 
läxor: 
logaritm: 
bönsyrsa: 
installera: montera, installera, syntes
amino: 
glyph: lättnad
aorist: obestämd
ekologi: ekologisk
sophisticate: skämma-bort
marijuana: 
mikro: subtil, små, mycket-liten, diminutiv, mikrofon
kilogram: 
äta-för-mycket: 
förutsägbar: förutsägelse, förutspå, prognos
pizza: 
tjuvlyssna: 
lingvistik: språklig
frisyr: 
iridium: 
rasism: ras-
optimal: högst-upp, optimal
industrialisering: industrialisera, industriell, tillverkning
huvudkontor: huvudkontor, sittplats
cerium: 
kongruent: vänlig, lämpad, gynnsam, kompatibel, liknande
partitiv-fall: 
kassett: tejpa
viljestyrka: vilja, vilja
dimensionell: storlek, form, dimensionera, rumslig
parameter: 
synkronisera: synkronisera
maximera: maximal, öka, överdriva
seminarium: verkstad
disko: tallrik
neon: 
osmium: 
uppenbarelse: 
plagiera: stöld
artefakt: 
reaktor: 
oregano: 
plutonium: 
yttrium: 
augmentative: 
användarnamn: 
doktorand: 
högra-vingen: 
argon: 
fobi: fruktan, vördnad, förfölja, avsky
socialisera: kommunicera, påverka-varandra
globaliseringen: 
våglängd: 
koda: koda
återvinna: Begagnade
omstart: omstart
hepatit: 
torus: klump
kemoterapi: religiös
modulo: forma, modul
proton: 
diskett: 
milligram: 
pixel: 
tantal: 
löst-ämne: besluta
folkmord: 
rovdjur: våldsam
gallium: 
zirkonium: 
bestämmare: bestämma, definiera, forskare
icke-linjär: 
pesticid: 
beryllium: 
neuron: 
predicative: bestämd
kalsonger: underkläder
faktoriell: fakultet
neutron: 
niob: 
germanium: 
metalloid: icke-metall
sätta-på: 
prolative-fall: 
biologisk-mångfald: 
joystick: 
antibiotikum: 
aktinium: 
astronaut: utrymme
utomjordisk: främmande
crackpot: dum, galen, galen, sinnessjuk, onormal
maraton-: 
ytterbium: 
autism: 
jonisera: 
radon: 
Nerium: 
epidemiologi: 
gammal-ålder: äldre
camping: läger
randig: rand, schema, planerare
indium: 
veridical: uppriktig, ren, netto
webbplats: webbplats, plats, profil
koran: 
bestick: 
n:-te--root: 
lawrencium: 
medborgerliga-rättigheter: 
mobiltelefon: mobiltelefon, mobiltelefon
lam: 
protaktinium: 
strålning: glöd
bero-på: 
torium-atom: tulium-atom, terbium-atom, rodium-atom, rubidium-atom, vanadin-atom, fluor-atom, polonium-atom, tallium-atom, strontium-atom, rutenium-atom
blå---jean: 
krukväxt: 
individuellt: personligen, enskild, personlig, separat
flödesström: 
trippelpunkt: 
människokropp: 
fysik: fysisk, fysiskt
detaljhandeln-lagra: 
cesium: 
lång-sedan: 
kalkylark: 
enhet--of-- massa: 
sammanställa: 
binary--värde: 
mänsklig-varelse: 
av-betyder-av: 
depan-dari: 
praseodym: 
kartong: kort
ändlig-verb: 
rättegång-antal: 
pro-mening: pro-fras
kritiker: kritisk, kritiskt
förpackning: omslag, packa
obeständighet: instabil
på-mest: 
deskriptor: beskrivning
neodym: 
vänskap: vänlig, alliera
läsa-endast: 
grundlägger: 
gnomic-humör: 
fonem: 
rationalitet: medvetande, logik
fonologiska: 
dining-rum: 
levande-rum: 
centrerad-fall: 
pre-hodiernal: 
patient-fall: 
sned-fall: 
lantlig-område: 
recurse: 
mitten-röst: 
meitnerium: 
brevbärare: 
noncommittal: platt
stock-marknadsföra: 
identifierbar: Identifiering, identifiera
mål-avtryckare: 
en---sekund: 
mulativa-fall: 
ransonera: del
icke-mänsklig: 
levande-sak: 
för-liten: 
biograf: bio
hassium: 
attenuative: 
multal-antal: 
mjölkig-sätt: 
neptunium: 
spökskrivare: 
trans-siffra: 
larva-sig: 
americium: 
morgon--härlighet: 
brandman: 
berkelium: 
galax-kön: 
nobelium: 
hejdå: bye, adjö, fram-tills
buddhism: 
fermium: 
cyan: magenta
soja: 
distributör: 
strejkbrytare: 
processor: 
abessive-fall: 
adessive-fall: 
till-fall: på-fall, slumpvis
agentive-fall: 
rutherfordium: 
antikropp: 
som-mycket-som: 
ombud-avtryckare: 
skådespelare-roll: 
etidium: 
gemensam-kön: 
accompanier: 
safflor: 
francium: 
erbium: 
passiv-röst: 
astat: 
tugga-gummi: 
stjärna-kön: 
citat-form: 
curium: 
tecknad-serie: 
färgblind: 
euler's---nummer: 
se-på: 
övergångsställe: väg
slagfält: 
bilist: förare
kortslutning: 
verbal-substantiv: 
gråta-ut: 
statistiskt: statistisk
yoghurt: 
xenon: 
hypnotisera: 
ta-av: 
klausul--tail: 
direkt-objekt: indirekt-objekt
matvaror-lagra: 
bestå-av: 
ergative-fall: 
i---språk: 
första-hand: direkt
locative-fall: 
simbassäng: slå-samman, handfat
adverbial-fall: 
sightsee: färd, inspektera, omlopp
tv-uppsättning: 
slutlig-partikel: 
evitative-fall: 
rehabilitering: 
regression: komma-tillbaka, uttag, reträtt, bakslag
blockera-av-flats: 
vakna-upp: 
polis-officer: 
svär--in: 
intervjuare: intervju
renium: 
aerosol: 
possessiv-fall: possessiv-fall
nominalization: substantiv
besatt-fall: 
överpris: 
extra-verb: 
primär-objekt: 
datorvirus: 
affärsperson: företag-person, köpman
en-personer: personer, folk
antessive-fall: 
premiärminister: 
lutetium: 
europium: 
emote: 
folkmusik: 
poet: 
postkontor: posta, brev
förment: antagande, hypothesize, förmodligen, tydligen, troligt
animera-kön: 
subessive-fall: 
gas---pedal: 
polaritet: polär
fordon-kön: 
mineral--kön: 
verb---suffix: 
brinner-för: känsla, emotionell, sensorisk
samarium: 
facilitator: moderator
imaginär---enhet: 
ljusets-hastighet: 
flygvapen: 
empathetic-glädje: 
kritisk-punkt: 
heltid: 
hafnium: 
hämning: hålla-tillbaka, trottoarkant, hämma, förbjuda
ändra-av-händelse: 
holmium: 
olik-händelse: 
universum-kön: 
lokalitet-kön: 
virtuell-maskin: 
forskning-kön: 
konstnärlig-kön: 
crastinal-spänd: 
abstrakt-kön: 
exocentric-fall: 
transitiv-verb: 
morfem: 
chauvinist: 
dåtid-perfektiv: 
yrkesmässig: specialitet, yrkesmässig, ockupation, hantverk, professionell
indirekt-tal: 
andra-språk: 
till-vara: 
kyrkogård-flytta: 
kollektiv-substantiv: 
absolutive-fall: 
patient-avtryckare: 
själv-förtroende: 
avföring: pall, bajs, smuts
reflexiv-röst: 
opersonlig-verb: 
seaborgium: 
blank: 
modal-fall: 
livlös-kön: 
orsakande: 
propositive-humör: 
elektrisk-nuvarande: 
associativ-fall: 
superlativ-fall: 
för-mycket: 
planet-kön: 
animerad-tecknad-serie: 
ömsesidig-röst: 
lagstifta: lagstiftning, lagstiftande, ordna, organisera
på-minst: 
grammatisk-fall: 
användare: 
kärna-benefactive: 
målvakt: 
:-except-for: 
nämnare: 
Else--om: 
sidled: åt-sidan
varandra: varandra, ömsesidig
på-varandra-följande klausul: 
slita-ut: 
shorts: 
dysprosium: 
snart-framtida-spänd: 
si-enheter: 
krypton: 
mendelevium: 
applikativ-röst: 
antipassive-röst: 
continuative-aspekt: 
strålningssjuka: 
necessitative-humör: 
enda-handling-verb: 
rälsbuss: 
superlativ-grad: 
existentiell-klausul: 
californium: 
presentera-particip: 
lysande-intensitet: 
singulative-antal: 
grammatisk---objekt: 
passiv-particip: 
överdriven-varaktighet: 
kritisk-fluid: 
belopp-av-ämne: 
postpositional-fall: 
valfri-kvantifierare: 
gadolinium: 
epenthetic-morfem: 
Negatory-kvantifierare: 
einsteinium: 
artificiell-språk: 
connective-partikel: 
avlägsen-framtida-spänd: 
frequentative-aspekt: 
distributiv-pronomen: 
allocution-avtal: 
skallig: bar
förort: liten-by, landsbygden
universell-kvantifierare: 
dator-programmering: 
tv-program: 
flyttal--nummer: 
existentiell-kvantifierare: 
de-dag-efter i morgon: 
alternativ-kvantifierare: 
PÅ-DÅLIGT-HUMÖR: grov
dåtid-passiv-particip: 
de-dag-innan i går: 
locative-riktnings-fall: 
kontra-villkorlig: 
