infinitiv: hnit
nominativ-fall: hnak
ackusativ-fall: hkak
ämne-fall: htak
förälder: hmat
pappa: hpap
mamma: hmam
Hallå: hnat
förfader: htat
farförälder: hyat
hungrig: hcac
genitiv--fall: hnik
adjektiv: hcit
och: hwan
mig: hmic
dig: hnan
oss: hnam
Det: hyic
destination-fall: htas
dativ-fall: htik
interiör-sammanhang: htis
person-sammanhang: hpak
beroende-klausul: htan
perfektiv-aspekt: htap
dåtid-spänd: hkat
maskulin-kön: hsan
comitative-fall: hmik
presentera-spänd: hyan
benefactive-fall: hpik
essive-fall: swik
inte: hnic
dess: hsis
yta-sammanhang: hsak
adpositional-fall: hpan
plats-fall: hwak
utrymme-sammanhang: hnos
sätt-fall: hrak
instrumental-fall: hsik
som: hkan
frågande-humör: hnim
och-eller: htam
exeller--eller: hkit
källa-fall: hsok
ablativ-fall: hlak
demonstrativ: hdit
men: hlan
alla: hsut
feminin-kön: hnin
de: hwin
flertal-antal: hlun
en: hyik
framtida-spänd: hwet
social-sammanhang: hson
när: hkap
imperfective-aspekt: hmap
det: hkac
villkorlig-humör: hcan
mer: hdoc
ut: htac
relativ-fall: hrik
SLUT--fall: hlik
do: hkas
direktiv-humör: hden
deontic-humör: hdim
fråga-ord: hwac
copula: hkok
person: hpon
manlig: hman
kunde: kwat
andra: hcon
antal: hnoc
mycket: tcac
tid: htim
tid-sammanhang: htos
timlig-fall: hmak
handla-om: hkam
epistemisk-humör: hsim
endast: htun
liten: hcak
sedan: pcan
MANANDE-humör: hton
retrospektiv-aspekt: hrip
bra: hcat
volitive-humör: hlim
före: hsec
måste: pcic
två: htut
se: tcan
känna-till: hsat
ner: hcin
efter: hcas
först: hpas
egen: hpun
oförytterlig-besittning: hlic
aldrig: hnac
omistlig-besittning: hkic
gammal: hwat
deliberativ-humör: hcim
dag: htin
var: hnap
komma: hlat
sätt: hyas
arbete: hkaf
vokal: hwaf
gå: hkun
perlative-fall: pwik
progressiv-aspekt: hpip
lång: hlac
säga: hsac
hur: hkin
även: hpit
tillbaka: hwap
här: hcic
tror: hcik
samma: hsam
sista: kcac
bort: twan
under-sammanhang: hnas
ta: htit
hittades: hfan
hand: cyat
ung: hyac
fast: hyap
ge: hkik
gud: hmac
delative-fall: lwak
ingenting: hmin
höger: hyit
en-gång: hyam
semelfactive-aspekt: fwip
del: hpat
fick-syn-på: htic
hus: hfas
värld: tcat
huvud: hcaf
tre: tyin
neo: hnon
fokus: hcok
kärlek: hpac
alltid: hsit
natt: hwit
varje: hmit
kung: hyak
mellan: hsin
hjärta: cyin
paucal-antal: plom
därför-att: hyok
orsaks-fall: ksak
sak: hkis
uppsättning: swat
namn: hnem
rätt-substantiv: hran
MANANDE: hrat
land: hlit
bad: hput
synlig-bevis: crit
bättre: pcac
sida: psac
kurs: hkus
kvinnlig: hfin
tillräckligt: kyat
snart: hpuc
full: hcun
rum: hfac
nästan: hlap
kan-ej: nyat
vatten: hwik
desiderative-humör: hdin
ljus: lyak
inte-heller: hnun
ord: slat
dörr: tyan
använda-sig-av: hpus
morgon-: hsap
terminative-fall: twik
driva: hkuk
dem-själva: hmis
presentera: hyin
röst: hwas
vit: hpis
pengar: tlan
nästa: kyak
fattig: hyis
död: hmut
form: hfam
inessive-fall: nwik
snäll: tyac
många-gånger: tsan
år: nwan
vän: myat
beställa: hyut
nödvändigt-humör: hpim
runda: hcut
tro: hban
offentlig: hpin
ange-sammanhang: hsas
son: psat
hundra: hmas
barn: hcis
således: tyak
hoppas: hcap
ovan: hyip
kär: pyin
läsa: pyac
stad: hsic
redan: hpic
faktum: hfat
factive-bevis: hfit
höra: hsun
minst: hmim
kanske: pyat
öppna: kcat
kropp: tcic
luft: cwac
natur: nyit
hjälp: mlat
brev: lyat
fyra: ksat
OPTATIV-humör: hpam
brand: hfak
därför: hyif
timme: hcam
fri: tyit
krig: syat
om: hsaf
anledning: kyan
förenad: hnut
ring-upp: hkuc
varför: hwam
förlorat: hkut
tusen: tsas
familj: hfic
själ: twam
fråga: swac
bry-dig: kcan
Realis-humör: hlin
betyda: mwit
potential-humör: hten
mot: cyan
allative-fall: lwik
antropiska-kön: hrin
kort: kyut
kunna: hyuk
bo: hkip
ämne: hsek
samma-ämne-markör: hcek
olik-ämne: hfek
svar: tsat
hav: mwat
rädsla: hcoc
förstå: pcat
hård: kyin
villkor: tyut
tvivel: hdac
tvivelaktig-humör: twin
be: psan
vapen: tcas
svart: clis
ta-med: tyat
vacker: ksis
mörk: tcak
håll: psak
tio: htaf
show: pyan
berättelse: hkif
gemensam: kwan
boka: hkup
elektronisk: lyin
prata: plak
markera: myac
intressera: nyis
skriva: kcit
säng: pwat
nödvändig: syis
aning: hwis
konst: klat
Vialis-fall: hlas
bror: pyak
ibland: ksas
linje: lyan
tabell: tlas
flod: nwit
öga: kyac
information: fyin
plötsligt: tfan
konstig: hgan
djup: ksan
ändra: hrit
känsla: nwac
träffa: mlit
syfte: htuc
lycklig: hcuc
verka: syit
blod: cyac
reste-sig: kwas
söder: swan
kall: tlat
fram-: myik
placera: psis
sent: tyam
stå: syan
anta: nlas
dotter: pyit
mina: myan
skära: hkim
kopiera: hfap
man: hgat
sex: hlis
kom-ihåg: twat
effekt: hyaf
falla: htuk
bortsett-från: hsip
hår: hpaf
passera: pyas
upphovsrätt: pcit
armén: cyit
springa: kcak
häst: kcas
framtida: hwic
väster: pcak
betala: plit
röd: hyun
guld-: tcun
önskan: hdan
spela: plin
bemästra: mwas
kontor: hfus
regering: syak
kyrka: kyas
längd: hlen
företag: ksin
papper: kyis
sannolikhet: hbin
i-synnerhet: cyas
björn: pcas
fönster: cyak
avtal: hgac
skönhet: syac
tull: tfac
skicka: fyan
avstånd: htif
tystnad: slan
fot: fyat
vild: kyik
dö: myam
spara: pfan
grön: kcin
problem: mlan
leende: myak
fel: clat
olika: pcin
sova: slit
quotative-fall: kwik
början: cwan
handling: kfan
besök: fwat
Följ: nlan
Prova: tcis
närvaro: psit
ljuv: tlit
rik: tcin
fiendens: tcam
fartyg: hcip
skick: kyit
inklusive: hkum
inclusive-person: hlon
hemlighet: kwit
BEDJANDE-humör: pwim
artig-registrera: hbit
ondska: pwac
Mars: myas
vad-som-helst: kwac
bli-kvar: hlam
i-stället: plat
blå: plan
omöjlig: psap
skola: hsuk
tillfälle: ksac
gift: nwat
mat: hcuk
tjugo: tsis
tyst: tcit
lätt: hnis
blivande-aspekt: hrap
språk: lyac
uttryck: syas
vecka: hsus
hall: hcum
fara: kcic
fast-egendom: myit
född: nyan
domstol: kcut
allmänt: tyap
gnomic-aspekt: hmip
värde: tyas
enkel: syap
träd: pyic
bekämpa: pyap
vägg: twit
himmel: cwak
inchoative-aspekt: htip
jussive-humör: hjin
tona: twun
betrakta: klan
förväntad: pcik
månad: hmaf
att-uppleva: nyap
helt: nyac
färsk: tsac
hertig: hnuk
täckt: kwak
bunden: hyim
öster: tyuk
sten: pwan
något: kfat
riktning: tlac
stol: kwis
stöd: syut
datum: tyic
by: klac
fält: clit
tillstånd: nwin
tolerant-humör: hmom
framgång: slak
rätt: hric
kulle: clin
musik-: ksik
distala-demonstrativ: hdat
eftermiddag: htup
gråta: hyuc
ära: hnaf
sju: swit
privat: pfat
nyheter: nwas
scen: slac
trädgård: cyam
lopp: htus
distributiv-fall: twak
lär-dig: clan
politisk: syik
lögn: kcun
kasta: tsak
äta: kcam
golv: hlaf
sjuk: pwin
original-: mlin
sommar: kyam
religion: tlam
bild: ksit
fly: plap
författare: hlut
brun: pyun
bestämd: htem
smärta: hdon
vår: psin
århundrade: syic
mjuk: mwan
hörn: kyun
producera: psas
skratta: cyaf
glömma: flat
europa: hyup
åtta: lwat
klä: lwac
fruktansvärd: cyap
andetag: syaf
klok: hbas
possessiv-markör: srak
minne: myin
modern: fwan
fläck: tcap
stiga: hyus
gå-sönder: pyik
femtio: hfis
ö: tlap
Rör: hsuc
löfte: pcam
commissive-humör: mwin
grad: tfat
planera: plac
uppträdande: nyak
överraskning: cran
minut: hmun
skott: hwut
värre: pcap
glas: klak
exempel: tlin
säker: hsif
läkare: tsit
completive-aspekt: hmep
upprepad: tyun
militär-: slin
värma: nyam
dryck: pfin
frågor: pcaf
ilska: nran
direkt: tyik
hatt: hcup
hund: kwap
tjänare: hnuc
stolthet: hram
skara: tcuc
tåg: nyin
moralisk: myut
associerad: kyim
ange: fyak
regel: nyas
svärd: cwat
ge-sig-på: kfak
hälsa: clac
stycke: pyaf
social: hsum
återbetalning: tfit
förlåt: hpec
mod: krac
nåd: hnen
officiell: hfaf
under-förutsättning: tsik
begäran: pwit
blick: klas
rörelse: hyon
förvänta: cwit
motsatt: psam
tolv: tyaf
engagerade: nyut
vin: hwun
smak: swut
järn-: fyac
distribuera: syin
handel: myap
fördel: twac
kläder: kfip
bedöma: fwak
skillnad: tfaf
angelägen: kcis
kapten: kwin
färdiga: nlat
upphörande-aspekt: hsep
nyfiken: kyic
utländsk: kwic
intensifierings: hnif
betydelse: myun
slutligen: hfim
fakturera: fwin
bevisa: hpuk
förhindra: flan
hals: cyun
rättslig: hfik
torr: swak
tjäna: syam
förlora: pcut
bevis: pyut
bevis-fall: hdak
framsteg: pyis
byggnad: klit
Sök: syuc
ledsen: hrac
synd: psip
trettio: tfis
ärlig: tsin
stänga: kyap
bank: pcun
öde: cyik
skog: hfun
mäta: mlac
annat: htoc
strömma: lyam
bröd: hpup
ytterligare: tfak
välja: twas
djur-: nwam
Zoic-kön: hzin
eventive-humör: hwim
samma-händelse-markör: hcom
multiplikativ-fall: tlak
tjock: hmus
varelse: hyum
regn: myic
yta: pfas
helig: swis
juli: clim
rapportera: hfut
kust: pwas
fil: hfif
axel: cwut
överraskad: kran
kunglig: klik
låt: hkuf
bekvämlighet: kfaf
någon: nyic
gräs: kcap
dra: cwik
öppning: cyic
juni: cwun
fisk: mlic
huvudstaden: klin
bröst: cyut
snö: hcif
utbildning: tlik
skarp: tcaf
medlidande: hdam
bekostnad: fyas
din: hmuc
miljon: mlun
trött: tcik
döda: ksam
skugga: cwap
vikt: plas
massa: mlas
etablerad: tlip
modig: pyam
tunn: plic
nöjd: srat
kolla-upp: kcik
dygd: hdet
nationell: nyaf
gudomlig: swin
dal: clak
gissning: kwam
spekulativ-humör: hken
gul: clas
ligger-kvar: mwac
böjd: nlac
låda: pwak
säsong: tsim
vetenskap: slas
borra: kcuc
farbror: hmuk
lista: lyit
augusti: ksut
populär: hlup
okänd: fyit
bekant: flak
bekant-registrera: krit
läsare: tsut
närma-sig: pcuc
dubbelt: tsap
intellektuell: tfik
verkligt: tsam
präst: pcis
sårad: fran
sorg: hpom
palats: kfas
slå: clap
va?: hnec
lura: myuk
kant: pfac
nio: nwun
brista: psut
lida: tfas
buller: hcus
litteratur: lyic
råd: swas
tömma: kcuk
rang: psik
storm: tcut
ficka: kyip
fantasi: nlin
mening: cwas
november: nwap
december: tsip
frånvaro: psic
tacka: ryak
adress: tyis
fågel: pyuc
ägare: mlik
täcka: kwut
förbereda: tyip
relationer: lwan
rök: htum
januari: nwak
maskin: clic
innehåll: nyik
tänder: tlis
skam: hcet
bukt: kcaf
hjärna: pyuk
ringa: klic
fras-markör: frak
fyrkant: ksap
frukt: fyut
te: tsic
förklara: slam
välkomna: cwam
poesi: pwis
köpa: klam
trogen: hdic
spänning: hcen
fyrtio: klis
april: pyip
vänligt: kfit
oktober: kfap
bitter: kyuc
slav: tlaf
lösa: hluk
text: tsus
kreditera: cyip
femton: pfit
grym: kcim
ansluta-sig: cluc
behandla: hpif
brottslighet: kyaf
damm: tsuc
praktisk: plik
färg: nlak
förstöra: nyuc
öka: lyas
näsa: hnus
erkänna: tyim
i-går: kfac
hesternal-spänd: tlen
misslyckas: slap
Fortsätt: tcim
Bär: pwam
blind: nlit
dussin: tsun
flyga: fyap
beröm: cwin
jäkel: cwaf
gradvis: twic
offra: kyif
träning: cyis
samvete: tfin
teori: tlic
minister: myis
hat: hnet
sjö: cwic
centrum: syun
svag: pfic
rationell-kön: hron
försiktig: fwac
njut-av: nlam
dyrkan: pwap
gods: twap
hud: twaf
tak: tlut
krona: gyan
slott: klap
tron: tcus
bifogad: nlaf
mile: mlim
extrem: krim
fängelse: fyis
kopp: kcip
medlem: mlam
civil: syim
överallt: tsaf
uppenbar: tfic
par: pwaf
volym: clam
beställnings-: ksaf
rosett: ksun
kostym: slut
kött: mwak
mjölk: hluc
vegetal-kön: hwen
vision: slic
sällsynt: nlap
kusin: ksic
bro: pwut
skydda: pfak
salt-: swam
oskyldig: hwus
drottning: kwim
räkna: kcus
nyfikenhet: hras
dansa: tyus
hotell: clut
fylla: flin
fånge: psun
handla: hjan
trappa: sric
tigga: hmen
sand: sran
våldsam: hgit
september: hsem
avresa: prac
ruin: crin
skicklighet: krin
nötkreatur: hwec
utrustning: hwip
kök: hkon
sälja: hbak
fart: hsot
slutsats: clon
dator: hkot
evig: hsen
begränsad: mrit
bibliotek: hbek
bas: hbac
förvirring: hrun
härlig: cris
likaledes: hjic
skrämd: hbic
olycklig: prin
artikel: hrek
kock: kfin
band: hbat
öken-: hget
kyss: hbun
boll: hbot
pinne: hpot
argument: hrut
observera: nrak
välsignelse-humör: hbim
slående: hrim
skyldig: hdis
pistol: hgin
polis: plis
dölja: hzan
expedition: srin
okunnig: nrin
generös: drac
moln: blan
avfall: htek
februari: frif
sjukdom: hren
spendera: bwan
källa: sron
initiativ-fall: hnok
moster: hbam
dröjsmål: dlic
försenad-nödvändigt: hlip
rapporterad-bevis: prat
midnatt: dyit
hjälte: nrac
filosofi: hfof
finger: hjit
bekväm: hzat
någonstans: hmoc
Tryck: bran
personal: hraf
belöning: rwan
skylla-på: dlac
elände: krat
panna: htec
a.d: glan
ängel: htet
singularis-antal: hgam
gryning: hbon
kommersiell: krak
förlåta: pran
får: hcec
tålamod: hpen
odla: crac
referential: hrec
majs: mran
nyckel-: kcif
majoritet: hmot
svaghet: hdut
atmosfär: traf
suck: tcoc
humanitet: mlis
opposition: pric
disk: hdik
ensam: hket
konstnär: nrat
riddare: cwis
charm: tran
beslut: drin
guvernör: gran
gren: rwac
disposition: hsoc
entusiasm: tsum
induktiv-humör: hdum
gemenskap: hmum
olja: hyen
rör: hbap
skriva-ut: trat
åh: dyoc
samtala-sammanhang: hros
vokativ-fall: hwok
stuga: ksen
larm: plam
nervös: hnes
permanent: hset
kniv: ksuk
silke: slik
förakt: grin
Helvete: nrik
separerat: plen
allvarligt: mrat
blandad: mrik
trä-: mrak
föredra: hpet
varning: trin
förmaning-humör: htom
impuls: hmos
ambition: mrac
förneka: hnek
konstitution: swic
instrument: srit
kontinuerlig-aspekt: hnip
tidvatten: hgas
college: klen
svans: hkek
generation: nric
katt: blat
direkt-bevis: hret
övergiven: trac
elva: hyec
instinkt: nlik
karakteristisk: trit
stam: hgik
orolig-humör: pcim
skydd: crat
ohyfsad: hruc
ridning: hris
skaka: hmon
industri: hdot
yrke: hres
lampa: hdap
kaffe: kfif
lyda: htot
norra: nrit
sjuksköterska: nris
försäkra: hjat
kedja: ryin
undervisning: cric
skor: hgut
gård: mram
vag: hmec
någon-annanstans: hlet
lägenhet: pret
aktivitet: twot
lördag: cram
solsken: hduc
änka: hwuc
element: hlem
reflexion: hfen
organisation: hgis
stjärna: tram
incident: hgon
gäst: hgip
bar: brap
flaska: hbet
välsigna: blak
uppståndelse: crak
inre: trik
fixera: krik
härleda: prit
ihålig: hcot
provins: hpos
civilisation: srac
hänga: hgak
chock: crok
undantag: swap
anstränga: tren
standard-: ryan
körning: dran
befria: hruk
svära: kses
skatt: zran
utsäde: hbis
torn: tras
favorit: fwit
nyligen: hcem
nyligen-dåtid-spänd: hrot
vaken: srik
Möbler: mrin
rep: hkos
äventyr: hdas
royalty: ryit
fest: dyat
beskriva: dras
sextio: hses
skala: hkem
ceremoni: srec
jakt: clik
viska: psus
i-stora-drag: ryat
kristendom: ksim
advokat: hwif
detalj: drit
prinsessa: hrus
altare: dlat
web: hwes
lila: brin
samla: hkoc
val: hben
uppfattning: kren
berusad: crik
Häll-i: brac
hiss: hlif
gest: hjis
hantera: rwin
utbyta: tcen
bestämd-artikel: hdek
kejsare: mras
avlägsen: hroc
ful: clup
ofarlig: cras
rulla: hrof
tum: nlic
tidning: grat
skägg: dric
riva: srim
provision: kson
medan: grak
korsning: kcoc
oberoende: htes
lukt: hwon
arton: hdec
historisk: tris
brutto: krut
rot: hrok
lera: hbik
brud: dlan
slöja: pras
teater: tret
jämförelse: kras
rival: rwis
balansera: slen
tränare: kron
humör: hnum
roman: rwas
hämnd: hbaf
svartsjuk: ryut
hjul: hlok
bränd: glat
flash: flac
skapa: hkec
konflikt: hnot
förbannelse: hlos
FÖRBANNANDE-humör: pram
hjälplös: hces
positiv: hzit
klubb: klup
översvämning: nras
spannmål: gwan
likgiltighet: hdun
horisont: crim
assumptive-humör: hsom
brant: htop
harmoni: mron
åska: hgot
barndom: htok
knä: hgun
programvara: pwen
skada: kram
mottagande: ryis
gör-det-möjligt: nlim
Protasis: hpoc
glida: slok
rotation: hrif
jordbrukare: hjim
stroke: trak
plattform: hpof
budbärare: hmes
privilegium: hpek
organiserad: hyot
student: clen
grotta: hgec
tradition: rwat
tragedi: tses
farväl: hjap
kritik: ryik
bomull: krap
sjukhus: slot
hyra: kris
gas: hges
oundviklig: pwic
dödligt: hgim
blad: glit
offentliggörande: plun
fientlig: tsup
översättning: dwan
begravning: jran
mjöl: mrun
korrespondens: ryon
romantisk: hrom
hydda: clun
föreslå: psot
mimetiska: hmet
dollar: dlon
dagsljus: hjac
sexton: hsos
montering: hzac
koloni: klon
vinge: gyin
lejon: hles
kultur: klut
kolumn: hkom
listig: glak
drama: dram
skämt: hjuc
dimma: hdus
medicin: dwas
fjorton: hkes
syra: sram
nämligen: hyet
inkomst: hmok
biskop: hbip
orange: tron
bad: byan
primitiv: rwit
korg: ksek
sekreterare: sris
halm-: prak
otålig: pfif
frälsning: slon
hodiernal-spänd: dlin
avsikt: zrin
ånga: tcip
förgifta: hwoc
talang: tlon
klimat: lwim
effektiv: fric
skilja: tcif
tvätta: dwac
bekännelse: kfis
dumheter: hjas
kol: kyon
kanot: kwon
tillfällig: tric
delimitative-aspekt: hdip
ben: hcos
måndag: nwic
tisdag: glac
onsdag: bwac
federal: frin
önskvärd: hzic
representant: ryic
linne-: lwin
sjunka: swuk
brorson: bwin
blodig: kric
belägring: cren
mage: hpem
mässing: pcon
toppmöte: hzik
femte: pfik
billig: brat
exklusiv-person: kwen
ta-vara-på: zrat
staket: hzas
staty: tfam
artilleri: tlep
omfamning: mrap
omgivande: sren
strikt: srot
rådjur: hluf
buske: hbuc
järnväg: hrep
ansvarsfrihet: hduk
arvinge: mris
ek: blun
obehaglig: pren
uppfinning: hgic
piano: pyon
övertyga,-övertala: swen
osynlig: gric
välkänd: ryun
grymhet: kluk
frestelse: hyoc
Telic-aspekt: hlep
ekonomisk: kfik
internationell: troc
blanda-sig-i: tcek
filosof: flif
elegant: gyit
välfärd: kyen
fiske: mlak
stjäla: truc
läpp: hloc
gå-i-pension: ryac
sträcka: sras
galleri: glen
parallell: zlan
atelic-aspekt: htep
kontinent: trap
hindrande-humör: nrim
slips: dwat
cell: slep
ägg: dyan
artificiell: jrat
under-tiden: nwis
kris: ksot
artig: sloc
lunch: lyon
tall: pwon
skjuta-på: hcef
allians: lyen
midja: hkop
mirakel: hmek
sjöman: slis
renhet: prut
republik: hguk
telefon: tfen
piska: krip
skjorta: cyim
införa: ryas
soffa: hsof
sopa: hsup
tjuv: ksif
behålla: nrec
kanalisera: kcen
personlighet: klim
reformera: kfam
hotfull: hzim
palm: plim
högtalare: hzak
tröskel: dwic
inducera: pris
spjut: bzak
propert: syec
session: cwen
tortyr: crot
fuktig: tcum
ås: grit
resande: hyek
kvarn: mwik
Karta: jrac
krage: klok
byta-ut: klif
avsiktligt: drat
öl: hbif
sammet: hwem
allvar: gwit
predikan: hpum
missbruk: glas
flock: hgen
tretton: tres
rättfärdiga: jyit
fredag: crum
borsta: broc
ladda-ner: dlas
grädde: krem
klippa: klaf
jury: jrin
monster: ksos
frusen: hgoc
pott: pfot
penny: psen
insistera: srut
äpple: hpep
diskutera: drak
bakgrund: prun
transkribera: trim
periodisk: prik
underhållning: nren
virus: bris
barnslig: blit
reflektera: flit
konvertera: kcet
översikt: kluc
opera: hpop
godkännande: nron
förråda: rwak
straffa: hzen
armbåge: kcon
fastsättning: tcet
reparera: hrop
misstänksam: cyec
sjuttio: swet
skriften: srip
grop: grac
oordning: dlak
binär: byin
kloster: bjan
pil: tcec
tendera: trec
utveckla: frat
lojalitet: hlot
mynt: syip
darra: tcem
exil: gwin
mekanisk: myim
fälla: crap
tårta: kyek
sir: cyes
tveka: sret
sjutton: syet
honung: myon
insats: dzat
trampa: hjam
tegel: brit
åttio: hpes
tyvärr: pcen
rådfråga: kcot
legend: lwen
skörda: hfos
främjande: pfon
spis: hsop
rebell: bric
gammaldags: hnom
svälla: cron
träsk: swot
klä-på-sig: hdes
asket: pces
chef: mren
kör: cros
rationell: tson
bearbetning: pson
varg: blaf
matta: hgap
antiken: hjak
bördig: frut
vissla: slif
ost: twis
bita: byat
inbjudan: jwan
katedral: kyet
hamn: brak
vandra: djan
gröda: tsos
marin: nlen
mask: mrok
penna: pses
vegetabilisk: sroc
utställning: hzet
byxor: tlun
korruption: hrup
skåp: nram
soppa: srup
kirurg: syon
ersättning: tcot
spionera: gyas
hänsynslös: hlec
skvaller: gyic
tecken: hzon
abstrakt: srok
torsdag: cwim
trafik: ryaf
arkitektur: ryek
spricka: rwaf
prydnad: rwon
omvänd: lwas
roa: mwun
återhämtning: ksus
trottoar: plut
avgörande: dyin
negativ: nraf
festival: hfec
minska: hrum
förräderi: zyan
jägare: djin
orm: syen
batteri: bret
vax-: flam
detektiv-: dlit
analys: nlis
betoning: hzot
simma: twen
kuvert: lwaf
vem-som-än: hgek
cigarett: jrit
motor-: mrot
volontär-: hwot
reaktion: ryif
bagage: blam
döv: hboc
juice: hjus
ödmjukhet: jlit
departement: mret
sexuell: hjon
diameter: dyam
yxa: blac
diamant-: dlam
alternativ: hlek
eko: hgus
återhållsamhet: swon
identitet: hdaf
skärm: krun
lat: lwis
momentane-aspekt: hmop
kompakt: kfot
drift: hdif
försvinna: hgaf
stråle: ryen
bläck: mwic
massiv: mraf
källare: dyac
minnesvärd: nrun
lysa-skarpt: klek
senat: slet
kista: tfap
förlåtelse: frac
svälja: nlun
unna-sig: nlot
svänga: swun
äng: gram
komplex: klos
resignation: hzis
ödmjuk-registrera: nret
konspiration: swim
peppar: prip
ponny: pron
kandidat: hzam
räv: flik
skorsten: tcon
jurisdiktion: drik
lantbruk: rwic
noggrannhet: tcuk
före-detta-den avlidne: brim
demokratisk: mrek
knopp: hbos
filt: bwat
hagel: hgep
gris: srus
formad: krek
elfenben: craf
klassisk: ksok
observatör: nwet
elefant: lwit
naglar: nwus
bi: hmif
begrava: dzan
skådespelare: bzat
svettas: zwan
polska: ploc
illusion: hlus
osäkerhet: pcet
sekundär: syif
vika-ihop: tsot
lantlig: grun
stöna: nyen
likna: slec
citationstecken: hzun
säck: cyek
irritation: fren
nål: hjun
kontrollerade: nroc
kyckling: truk
konsekvent: kwot
fat: bras
vanlig-aspekt: hcep
expert-: ksec
imponera-på: blin
oliv: zlin
skåpbil: myen
hinder: bwak
nicka: kcec
främja: plaf
definition: fyic
födelsedag: gjin
hammare: hcof
doftande: hfon
upprepning: trun
trivial: twut
sparka: hjik
gräva: kwaf
sällskapsdjur: plot
kranium: hcop
lagstiftande-församling: dlik
häl: cruk
rynka-pannan: crun
patent: plet
miljard: blim
kemisk: fyik
pilot: pyot
imitera: mlot
kjol: kwet
ovanligt: srap
varje-vecka: jwik
teknisk: tfip
vegetation: tset
gala: kraf
soluppgång: sruc
livstid: glin
bidra: hyom
krok: hdok
tiger: blic
penetrera: crut
ärm: slun
motorväg: jras
milis: mlip
dike: kroc
integritet: kret
nitton: dzin
organisk: rwik
teologi: flic
flyta: flut
häxa: byac
uttråkad: hwuk
diplomatisk: dyik
studio: twos
överstiga: kcok
champagne: cyen
inspirera: crif
baner: hbes
äktenskapsskillnad: lwon
bult: hbut
ven: jyan
passiv: psif
skumma: hgum
grus: grik
förkläde: tyen
planet: gren
hylla: claf
Fan: flon
tropisk: hjip
fas: fwas
godtycklig: rwen
uttala: kfun
kvicksilver: krok
krypa: hrem
självmord: tcos
reporter: prot
beröva: hpok
skicklig: klun
balkong: blik
gaffel: fras
anställd: mlek
arbetsgivare: myot
bredd: jrak
irriterad: djit
anklaga: klot
pension: pyen
verb: kres
apa: mwon
godtagbar: hwek
signatur: tlim
ortodox: rwos
ironi: fron
barnkammare: nrap
motvillighet: jlan
importera: tyot
fackla: croc
grammatik: gjak
deposition: gyat
kolonial: plon
yacht: jyat
följd: kwec
kupol: kwun
tjocklek: hfot
envis: cyon
muskel: hmup
magnitud: ryam
gnugga: ryos
feg: rwam
sele: gwac
rostat-bröd: tros
mus: myus
stavelse: slim
klappa: prap
dialog: dlaf
neutral: nrot
flit: dwin
motsägelse: trot
uppnå: kfic
get: byak
frodas: hfet
förelägga: mlon
anonym: nwim
formell-registrera: frit
kalv: hbof
manuell: mwut
smälta: hjec
radera: flas
paraply: gras
känga: bzut
mineral-: mrim
stillestånd: crus
anka: hbok
planering: pfam
tvål: hsuf
docka: gwak
skelett: klet
villa: blis
sömnad: jlin
förena: dyak
vattenkokare: kset
mogna: mruc
kanin: kruc
dirigent: nwot
beroende: djat
spelare: jlic
insekt: pset
restaurang: cret
uggla: lwun
radikal: djik
bosatt: zwin
drake: dron
auditiv-bevis: drot
törstig: kyos
dröja-kvar: dren
beräkning: glun
reglering: ryim
borgmästare: mlap
minoritet: mric
förvärv: dwon
veteran-: bren
orkester: ryes
bacon: bjin
nackdel: zwat
tyg: frap
musiker: gzik
mentalt: hnep
samband: nyon
otillräcklig: nrip
arkitekt: tsek
citron-: nyim
hosta: kcos
huvudvärk: crek
hyresgäst: ryet
fertilitet: srun
läka: hfoc
nittio: nwon
slumpmässig: hbec
sked: kcek
ballong: blon
krita: hfip
inferential-bevis: nlet
utgivare: pcot
vinäger: sruk
aska: fyec
svordom: slek
återuppliva: nrut
mottaglig: kfim
tunnel: tfun
pussel: hpef
mekanism: mwim
matematik: gzit
blekna: frun
lever: jwin
sublative-fall: bwik
doppa: dris
enhet: twim
monopol: hnop
spelande: hgup
u-båt: bzin
jordbävning: hbem
laboratorium: brot
kork: kruk
själv-kontrollera: syot
buddha: hbus
sticka: bjat
ambassad: blas
längst: sres
deklarativ-humör: drim
stimulans: tyuc
choklad: clot
tillfällighet: tyon
handske: gwat
knäböja: hjek
geografi: hjif
investering: nwes
verbal: mrec
analogi: nlip
sekulär: srek
hök: blap
psykologi: nloc
fästa: gjan
skrot: krep
roll: cyum
dos: hdos
lax: slom
pudding: pwun
magnetisk: gyik
pump: pcom
syre: ksip
certifikat: tfot
medalj: hmem
retorik: trok
skrapa: rwap
åra: dyas
teleskop: trip
halsband: clek
stavning: prif
whisky: hwos
vide: hwof
kamel: hlum
amatör-: myet
går-ut: crec
biografi: brif
åsna: gzac
en-gång-i månaden: mwis
bortse-från: nruk
semester: byit
klick: lyik
oval: twon
elastisk: lyet
lexikon: kfon
skinka: gzam
regnbåge: rwun
konsumera: kcum
spotta: tcup
tank: trek
kollega: clok
fjäril: trif
Diagram: graf
tvilling-: jwat
oberoende-av: trem
bambu: hbum
-handlare: jlat
ackumulation: kles
inspektör: nyet
munsbit: hyos
mardröm: hbom
sylt: gjam
museum: mrem
alfabet: lwam
sprida-ut: zras
räd: crip
avslöja: clus
ruttna: fraf
aggressiv: gris
friktion: mroc
pir: gyac
spindel: brik
potatis: trut
revision: cwon
girighet: jlac
för-tidig: ryot
multiplicera: gzan
snurra: pcip
statistik: tsok
kalender: klem
utnämning: nwen
biljon: tlos
vind: tlok
jakande-humör: rwim
tillämpningar: pfen
nominell: nlon
missnöje: sraf
infektion: hfok
tillbringare: krot
rycka-på-axlarna: cyok
pionjär: gzin
underlåtenhet: nlif
kål: glic
idrotts-: tlet
fylleri: mrut
idiofoner: hdof
spak: lwek
senator: syem
iris: nrif
myra: mwam
insekt: hbop
gravid: grim
fällning: hjet
vrist: tcok
klassificering: glik
variabel: prim
slå-in: ryap
lockig: krec
svavel: hsef
diktera: dwik
uppstå: brun
groda: fram
överdriven-fall: twek
svamp: hjen
irriterande: djon
ekorre: slip
slipa: zyin
irrealis-humör: flim
vulkan: glam
inomhus: gron
utnyttja: kloc
geologisk: jlik
pass: psop
omoralisk: mlet
kex: hbuk
samarbete: kros
tablett: tlot
avkoppling: kces
atom: trom
aids: hzip
pyramid: psim
cykel: swok
nap: hnup
olaglig: hjaf
tass: pfap
blyghet: crom
förmörkelse: klip
luta: lwap
kvast: srum
panel: mwen
astronomi: tcom
labyrint: blen
stipendium: bwit
sköldpadda: kfuc
rådgivare: dwak
fiber: fwic
syrsa: jrik
duva: ksom
anpassning: dyon
triangel: tfon
skattmästare: tsen
väte: jron
ömtålig: hfuk
skrivare: pyet
sätta-i-halsen: tcof
kronisk: gzon
klara: slaf
dilemma: dlim
teknik: jyin
kamera: hkef
be-om-ursäkt: pluc
slicka: lwet
dansare: dret
migration: mres
tennis: tces
ryggrad: clip
steka: zrac
vävstol: tfuc
hugg: twuc
lösenord: psaf
hemisfär: praf
strategi: zrit
kvarts: krus
sax: jris
patrullera: proc
glaciär: lwic
halvvägs: dwam
promemoria: mwap
kon: kwuc
symmetri: hzut
tillverkare: zrak
svarande: fwik
moské: djis
schack: cres
vägtull: htof
körsbär: tref
utbredd: kfen
snubbla: tfok
lastbil: ryok
senap: mros
procent: pfet
auktion: jlam
sikt: srif
ostadig: swoc
magnet: gjat
suga: syus
islam: slum
tå: twip
membran: mlen
rakning: clet
gitarr: gjit
glänsande: bzan
alm: hyem
sväva: kcom
pronomen-markör: ryec
häftklammer: pcus
krydda: zlat
borgen: jlas
bärare: zyac
vibration: bron
reta: trus
plog: hlom
fysiologisk: zlik
ränna: hgok
komet: cyet
medeltida: dyic
Sparv: grec
kompensera: twet
plast: psuk
fotnot: cyot
bana: rwot
sparsam: twum
golf: hgof
noll-: zrun
chips: tcep
förtrycka: prok
gäspa: gjac
olikhet: gwas
mol: tloc
krukmakeri: frik
hemmafru: hgif
råg: rwem
inte-lyda: hyes
tolerant: glon
embryo: brec
gruvarbetare: jren
applådera: zlac
jäst: lyim
premie: pfim
plommon: plem
konkurs: byas
bevattning: rwif
mynta: nyun
kapitalist: glis
elasticitet: hlef
haj: gyak
rekrytera: drut
lagring: zren
realism: cles
ingefära: djic
ambulans: blus
jämförbar: kwip
plånbok: bjap
grimas: glim
forskare: gyis
gut: grot
jämnmod: hwum
radio: href
irrelevant: zlit
böna: bwam
informell: frim
sondotter: gyut
oenighet: dloc
stek: tfek
kväve: zron
rakkniv: hjut
kontrasterande: krom
propaganda: pcoc
fyrverkeri: fris
pop-: pcop
klä-av-sig: crop
fåra: cruc
skadlig: hzaf
judendom: hjum
komplement: pluk
lins: lyes
pegative-fall: pwek
cancer: kfes
pantsätta: pyek
föreläsare: zyat
läcka: hzuk
kvalificera: krif
densitet: djot
induktion: dyis
tugga: htuf
pratsam: bzit
hummer: hgos
rabatt: dyut
taxi: tsuk
hierarki: crem
jade: gyec
morra: glaf
ödla: lyis
vattenfall: crof
besvikelse: djak
veto: frot
ordförandeskap: ryip
köpare: mrif
gallon: jlen
mygga: mruk
avvikelse: dwen
brottas: lyut
mosaik-: myok
plugg: plok
sitta-på-huk: pcuk
matvaror: ksoc
kommunist: myos
förvåna: mwek
prosecutive-fall: rwuk
konstellation: nlos
diktator: dwit
upptagenhet: tyet
satellit: tlec
toffel: hlop
konsonant: fyon
ungefärlig: tsif
arbetslös: byet
anhängare: sros
lotus: lwot
sallad: sles
klorid: lwok
bakterier: bwic
klibbig: pcek
komponent: bwon
kärna: klec
hyckla: bjak
bitgrupp: bzet
utsöndring: sruf
uttryckligen: pres
sammanfaller: mloc
balett: blet
urin: mrus
vitlök: lyun
förflutit: hguc
ekonomi: kcem
medelklass: hdom
vig: gjic
tång: htef
tvätt: lyoc
jordgubbe: srem
urban: pcos
besvära: mlaf
Anteckningsblock: tfut
album: zlam
baseball: hbep
Sniff: sluc
buffé: hbuf
particip: rwip
garage: grek
diagnos: djas
krycka: ksuc
pressa-ut: srom
registrering: psuc
löslig: jlun
fosfor: psof
strukturell: rwut
lim: glum
avhandling: twes
hantverkare: clif
banan: bwas
axiom: kyom
revben: psos
nickel: nyek
pi: pyim
buss: bwos
censurera: swes
missil: mlus
korv: slos
manipulation: nlut
tomat: tfet
förstärka: kfut
uttag: syok
kalium: tsom
hämta: prup
virtuell: zwit
algebra: gjas
tandläkare: dzit
optisk: pcok
röra-sig-ur fläcken: bzen
biologi: bwim
arbetslöshet: byim
larv: krum
solo-: slof
webbläsare: bjac
avlägsen-dåtid-spänd: nyot
historisk-spänd: crep
nukleär: nluk
spektrum: pyem
natrium: syom
hysteri: syes
förvaltare: tyos
gisslan: byik
kalebass: gluk
skrynkla: kwuk
genomskinlighet: tfif
spika: swip
prioritet: pcif
fotgängare: dyen
ateism: tsem
övervaka: mwot
valkrets: nlec
okontrollerad: hkof
sond: grok
platina: plip
dubbel-antal: dlun
lunga: pcep
super: syup
vagn: trop
lokalt: lyot
hetsa: gzat
bensin: plif
njure: grif
plundra: bzac
värdering: dlen
arsenik: syek
snigel: nrok
gräshoppa: tsec
ekvation: fwen
socialistisk: swos
filtrera: flot
sensorisk-bevis-humör: hxin
bredda: kyot
avge: mwet
koppel: pwet
mandarin: drun
jockey: hjok
lunginflammation: hnof
solidaritet: gret
gångjärn: cyif
longitudinell: nruc
utdelning: dwun
skridsko: hkep
exponent: slop
handikapp: dlif
besatthet: bwen
tilldelning: pfun
fotograf: trof
delta: dlet
digital: djim
tik: brut
ögonlock: hyop
diagonal: dyun
undermedvetna: byon
ögonbryn: bruc
nysa: pcec
munter: dlis
hinduism: nwum
flykting: nyif
transfer: cwot
protein: pwot
dumpa: hdop
förfina: flen
kräkas: hwom
gen: gyen
förstaårselev: hdem
sociologi: syoc
squash: kwoc
fiskare: hfuc
regional: jyen
rörelse-uppför: hvok
retrospektiv: hxik
tornado: gyon
inversion: nwos
tv: twif
kub: kfet
produktivitet: pwuk
morot: krop
molekyl-: mwuk
konglomerat: glet
revisor: ksum
gurka: kyok
orgie: drok
lösningsmedel: jlet
fosfat: psef
primer: gwik
alkalisk: flis
gymnastik: jyas
kommatecken: kwom
rörelse-utför: hvat
missfall: jwac
pod: tcop
givare: dzon
mangan: hzem
psykolog: syos
klor: clos
tangentbord: kyoc
elit: zyit
parentes: pfaf
rugby: rwoc
ulcus: jlon
varierad-lutning: hxit
knapra: nres
kvant: fwam
Tröja: swek
evolutionära: fwis
notation: nyoc
studsa: tcuf
dissektion: drec
cache: kcep
linjär: lyec
antimon: trum
superessive-fall: psek
tumör: twom
erosion: cyos
alfa: flaf
navel: nwip
immun: myip
influensa: flun
bryggeri: bjit
förenkla: slef
förkorta: bram
buckla: djen
fängsla: dwim
tvinga: brok
socka: bzas
film: fyim
kosmos: klom
förorena: hpuf
sällskaplig: gjen
penis: zyis
skogsbruk: lyif
aluminium: lwum
svängning: zlon
horoskop: ksop
mata-ut: dlek
integration: nluc
förmånstagare: byic
delfin: dlip
mördare: cyus
däggdjur: myaf
indikator: swif
dioxid: dwis
kolon: zlen
byråkrati: brus
förvränga: jric
kylskåp: frip
arkeologisk: cluk
oacceptabel: kwok
specifikation: pfis
folder: pfut
antropologi: nlom
välsmakande: kyec
transitiv: txit
krypa-ihop: kwus
solros: hzuc
lus: glus
Jon: lyos
turism: tyum
modem: myom
acceleration: jrun
förfalska: tsoc
utsläpp: hmef
kidnappa: drap
överlappning: hwep
frisör: pfes
folklore: floc
kapillär: plek
nationalism: nlum
rumpa: nros
motiv: hmuf
sublimera: slem
frustration: xras
kobolt: kwos
havre: gwam
rörelse-uppför-floden: trup
anus: gyam
bovint: bwun
flip: flip
redundans: dzun
video-: hwop
bojkotta: bjik
frågesport: cwif
hockey: cwok
gerilla-: grip
magnesium: hgem
radar: drek
schimpans: hzif
pålitlighet: kwif
rektangel: tyec
kelp: klep
generalisera: jlak
utegångsförbud: kfec
homosexuell: mlok
scenario: srop
formulering: flus
reinkarnation: nrom
antända: zlak
uran: ryum
catcher: kwes
samordna: kyop
skattebetalaren: nwaf
integrerad: trep
menade: hzap
gamma: hxam
safari: fwim
rörelse-nedströms: ht6n
koefficient: kfus
rubrik: zlic
analytiker: nles
schackmatt: hzes
köpcenter: hmof
vismut: bzim
vykort: psok
konvergens: bros
avvika: djet
aktieägare: ksem
mikrob: mrip
genital: jwit
morfologiska: mluk
beta: byot
jeans: gjis
databas: tles
kalkylator: klus
röntgen: ksef
parse: zram
miljö-: zyen
sigma: zyim
åtskiljande: hxon
dagordning: gres
visum: bzis
infrastruktur: nyuk
eldfluga: gyun
detektor: tyek
adaptiv: dyip
biolog: byis
splitsa: pyec
brom: brom
palladium: plum
hicka: kfok
pastell: psec
Zoo: zwac
klinik: lyok
konnotation: nwoc
yoga: hjoc
bokhandel: byun
terapi: grap
nationalist: zlis
halshugga: zlet
ja: swec
problematisk: byam
jazz: dzas
volfram: tsof
terrorist: gwis
dribbla: droc
metabolism: tlem
underhållsbidrag: lyaf
helgen: hfom
krysantemum: gzim
vaccin: byap
motorcykel: tyok
mantra: dyot
termin: myes
heroin: gwon
mapp: flap
katod: kfoc
ideologi: dlec
parkering: prek
theta: fret
anticlimax: hxis
selen: clem
cykling: blek
bark: pros
likvärdighet: swaf
nuvarande-relevans-markör: hxak
flygplats: cwoc
amputera: gyet
basketboll: bwet
bedragare: mwip
kackerlacka: tlek
krom: hgom
liter: hl6t
ändå: nwec
hormon: cwom
bristfällig: tluc
perforera: prec
animism: nyom
polygon: cloc
feminist: hfes
konjugat: kcop
euro: dros
ginseng: hjes
algoritm: hlof
laser: lwes
apotek: dlot
millimeter: mlem
böja: flek
anod: nlok
nyans: hzus
deltid: prem
känslighet: nyec
demonstrant: drom
helium: clum
tvåspråkig: dzic
akronym: hqim
Förkortning: nl6m
gerundium: gros
plasma: psem
kromosom: rwom
ordningstal: rwok
kilometer: klum
fax: tfes
genetik: nwek
fräkne: frek
skruvmejsel: dres
broccoli: blok
preteritum: xrit
vitamin: tyem
kadmium: kyem
bombplan: bwoc
grafiska: gjik
titan: dyim
splurge: clec
lambda: lwem
flickvän: pcem
kopulera: kyuk
timglas: tlus
empati: mlif
bor: bres
helikopter: cwet
tellur: tlum
deadline: jyic
rikta: gwic
centimeter: hfem
molybden: mlom
litium: tfim
multimedia: myum
uppdatera: dyet
kalori: clom
robot: ryoc
läxor: groc
logaritm: grom
bönsyrsa: gzas
installera: nwut
amino: myoc
glyph: glif
aorist: pyos
ekologi: plec
sophisticate: flok
marijuana: bjam
mikro: mrom
kilogram: lwom
äta-för-mycket: jrot
förutsägbar: dzik
pizza: zyas
tjuvlyssna: zris
lingvistik: bwis
frisyr: braf
iridium: ryom
rasism: gwim
optimal: gyim
industrialisering: drif
huvudkontor: krup
cerium: zrim
kongruent: nrum
partitiv-fall: pxik
kassett: ksep
viljestyrka: blot
dimensionell: dzen
parameter: rwet
synkronisera: nrop
maximera: dzim
seminarium: mwec
disko: dyok
neon: nyok
osmium: hzom
uppenbarelse: hp6n
plagiera: lyap
artefakt: rwek
reaktor: fyet
oregano: ryop
plutonium: pwum
yttrium: tyom
augmentative: hxat
användarnamn: mrum
doktorand: zrot
högra-vingen: dwaf
argon: jros
fobi: hxot
socialisera: sluk
globaliseringen: bluc
våglängd: hnef
koda: kfom
återvinna: psoc
omstart: nrek
hepatit: pyes
torus: fros
kemoterapi: myep
modulo: mwok
proton: zwot
diskett: dwet
milligram: mlum
pixel: psep
tantal: twem
löst-ämne: hjot
folkmord: nyos
rovdjur: rwes
gallium: glem
zirkonium: hzum
bestämmare: txin
icke-linjär: nlem
pesticid: pyif
beryllium: brem
neuron: nrus
predicative: pxit
kalsonger: tlif
faktoriell: kref
neutron: zrut
niob: nwom
germanium: hjem
metalloid: tlop
sätta-på: dlap
prolative-fall: hl6k
biologisk-mångfald: jwic
joystick: jyok
antibiotikum: twok
aktinium: gjim
astronaut: srof
utomjordisk: tyes
crackpot: hwup
maraton-: mrof
ytterbium: zwim
autism: tyif
jonisera: nlof
radon: cwos
Nerium: nrem
epidemiologi: pwip
gammal-ålder: lyuc
camping: kyep
randig: drip
indium: nyum
veridical: hvik
webbplats: bwes
koran: kwek
bestick: fwet
n:-te--root: tfec
lawrencium: lyem
medborgerliga-rättigheter: glip
mobiltelefon: mlof
lam: twoc
protaktinium: prum
strålning: hd6n
bero-på: pxin
torium-atom: hxim
blå---jean: bjun
krukväxt: hxas
individuellt: dvit
flödesström: lwuk
trippelpunkt: ht6t
människokropp: hn6n
fysik: bzik
detaljhandeln-lagra: hxan
cesium: hs6m
lång-sedan: hqan
kalkylark: hxet
enhet--of-- massa: hn6m
sammanställa: ml6n
binary--värde: vrim
mänsklig-varelse: nyus
av-betyder-av: hvan
depan-dari: pxat
praseodym: pyom
kartong: kxat
ändlig-verb: hqik
rättegång-antal: hr6n
pro-mening: hr6t
kritiker: hk6k
förpackning: pxas
obeständighet: pxan
på-mest: txas
deskriptor: drop
neodym: nyem
vänskap: hvit
läsa-endast: xyak
grundlägger: xwan
gnomic-humör: kxin
fonem: hxom
rationalitet: xlit
fonologiska: xlin
dining-rum: hxac
levande-rum: hxic
centrerad-fall: zrik
pre-hodiernal: hx6n
patient-fall: hqak
sned-fall: bwok
lantlig-område: hqat
recurse: hr6s
mitten-röst: dyos
meitnerium: hm6m
brevbärare: hvak
noncommittal: kxit
stock-marknadsföra: xrak
identifierbar: hxap
mål-avtryckare: krof
en---sekund: hxen
mulativa-fall: dvak
ransonera: hr6c
icke-mänsklig: hg6n
levande-sak: hvic
för-liten: hxut
biograf: hvin
hassium: xyim
attenuative: ty6t
multal-antal: ml6m
mjölkig-sätt: txam
neptunium: nwem
spökskrivare: txik
trans-siffra: ts6s
larva-sig: hqun
americium: myem
morgon--härlighet: txan
brandman: xran
berkelium: blem
galax-kön: kxan
nobelium: blum
hejdå: hvac
buddhism: hfum
fermium: frem
cyan: xyan
soja: syof
distributör: qrit
strejkbrytare: txak
processor: ples
abessive-fall: bvak
adessive-fall: dvik
till-fall: kxak
agentive-fall: dvek
rutherfordium: hr6m
antikropp: txip
som-mycket-som: hjos
ombud-avtryckare: hg6t
skådespelare-roll: xram
etidium: txim
gemensam-kön: hk6n
accompanier: kl6n
safflor: kxam
francium: fyam
erbium: ry6m
passiv-röst: xyis
astat: hqit
tugga-gummi: hqam
stjärna-kön: hqin
citat-form: ht6m
curium: jrim
tecknad-serie: kxis
färgblind: hqon
euler's---nummer: hl6m
se-på: kxas
övergångsställe: pwok
slagfält: txat
bilist: vrit
kortslutning: txok
verbal-substantiv: hvis
gråta-ut: hk6t
statistiskt: xyit
yoghurt: txot
xenon: hs6n
hypnotisera: hxif
ta-av: hxaf
klausul--tail: hxok
direkt-objekt: dwot
matvaror-lagra: kxun
bestå-av: hm6t
ergative-fall: gvik
i---språk: txic
första-hand: pxam
locative-fall: hqok
simbassäng: slup
adverbial-fall: vlak
sightsee: hqas
tv-uppsättning: ht6s
slutlig-partikel: xlik
evitative-fall: hvek
rehabilitering: xlat
regression: xris
blockera-av-flats: kxot
vakna-upp: hxup
polis-officer: ps6s
svär--in: vran
intervjuare: qrat
renium: ryem
aerosol: xres
possessiv-fall: kxik
nominalization: mlec
besatt-fall: dzak
överpris: pxak
extra-verb: xyik
primär-objekt: mlut
datorvirus: prus
affärsperson: hqis
en-personer: hqen
antessive-fall: ts6k
premiärminister: pxis
lutetium: lyum
europium: rwum
emote: xrot
folkmusik: zyik
poet: vwit
postkontor: pxot
förment: hvas
animera-kön: hven
subessive-fall: bvik
gas---pedal: glep
polaritet: pr6t
fordon-kön: vlin
mineral--kön: xrin
verb---suffix: hvif
brinner-för: pc6n
samarium: sr6m
facilitator: hs6t
imaginär---enhet: xyin
ljusets-hastighet: kxac
flygvapen: hxes
empathetic-glädje: pfec
kritisk-punkt: qyit
heltid: hxem
hafnium: xyam
hämning: hn6s
ändra-av-händelse: qrin
holmium: xlim
olik-händelse: hf6t
universum-kön: hvip
lokalitet-kön: kxen
virtuell-maskin: hvim
forskning-kön: txen
konstnärlig-kön: ts6n
crastinal-spänd: sl6t
abstrakt-kön: srep
exocentric-fall: zrek
transitiv-verb: txif
morfem: tfom
chauvinist: dvis
dåtid-perfektiv: xrat
yrkesmässig: hy6n
indirekt-tal: tyoc
andra-språk: draf
till-vara: txis
kyrkogård-flytta: vrak
kollektiv-substantiv: hxos
absolutive-fall: bvuk
patient-avtryckare: tr6t
själv-förtroende: hs6s
avföring: hzos
reflexiv-röst: hf6s
opersonlig-verb: hxek
seaborgium: br6m
blank: hxep
modal-fall: dlok
livlös-kön: hj6n
orsakande: qran
propositive-humör: psom
elektrisk-nuvarande: tr6n
associativ-fall: nwok
superlativ-fall: tluk
för-mycket: xyut
planet-kön: pxen
animerad-tecknad-serie: nwuk
ömsesidig-röst: vrik
lagstifta: hqaf
på-minst: vlas
grammatisk-fall: qrak
användare: pxut
kärna-benefactive: kfef
målvakt: hgop
:-except-for: kcef
nämnare: dvan
Else--om: lyek
sidled: hx6s
varandra: dles
på-varandra-följande klausul: lyuk
slita-ut: hxun
shorts: ht6k
dysprosium: prom
snart-framtida-spänd: rwec
si-enheter: vyin
krypton: kxon
mendelevium: dlem
applikativ-röst: hp6s
antipassive-röst: tsef
continuative-aspekt: ht6p
strålningssjuka: hr6k
necessitative-humör: hn6t
enda-handling-verb: hqek
rälsbuss: xlak
superlativ-grad: tlup
existentiell-klausul: hs6k
californium: kf6n
presentera-particip: vrat
lysande-intensitet: hc6t
singulative-antal: slus
grammatisk---objekt: hy6t
passiv-particip: vris
överdriven-varaktighet: kxic
kritisk-fluid: sr6t
belopp-av-ämne: ks6t
postpositional-fall: pxok
valfri-kvantifierare: lwif
gadolinium: dl6n
epenthetic-morfem: hp6m
Negatory-kvantifierare: nwif
einsteinium: ny6n
artificiell-språk: txac
connective-partikel: qrik
avlägsen-framtida-spänd: twec
frequentative-aspekt: hfep
distributiv-pronomen: bvin
allocution-avtal: hk6m
skallig: blos
förort: syum
universell-kvantifierare: vlit
dator-programmering: mr6m
tv-program: tr6m
flyttal--nummer: hvun
existentiell-kvantifierare: tl6t
de-dag-efter i morgon: dwek
alternativ-kvantifierare: lw6t
PÅ-DÅLIGT-HUMÖR: hdup
dåtid-passiv-particip: hp6t
de-dag-innan i går: txet
locative-riktnings-fall: tc6k
kontra-villkorlig: ht6c
