nauni: usio, infinity
nominative-kesi: 
accusative-kesi: 
mada-kesi: somo-kesi
mzazi: wazazi, kuu, mwandamizi
baba: baba
mama: mama, mama, wajawazito
hodi: bye, hi, hey
babu: mtangulizi, babu
grandparent: babu, bibi
njaa: njaa, njaa
genitive-kesi: kutochukua-kesi
kivumishi: 
na: Jumla, na
mimi: mimi-mwenyewe, i, yangu, sisi
wewe: nao, nawe, nawe
sisi: sisi, yetu, zetu
ni: yeye, kuwa, yeye, huu, hizi
marudio-kesi: lengo-kesi
dative-kesi: 
mambo-ya-ndani mazingira: 
mtu-mazingira: 
tegemezi-kifungu: 
perfective-kipengele: 
siku-za-nyuma uliopo: 
masculine-jinsia: neuter-jinsia
comitative-kesi: 
sasa-uliopo: 
benefactive-kesi: 
essive-kesi: 
si: hakuna, zisizo, vigumu, hawawezi, wasio, lami
wake: yao, yake, yake, naye, wale, kwake, ya
uso-mazingira: 
adpositional-kesi: 
eneo-kesi: 
nafasi-mazingira: 
njia-kesi: 
instrumental-kesi: 
ambayo: ambao, kama, ambao, yoyote, wala, kuwa, ambaye, kuwa---ambayo, nini, kila, kwa-namna-yoyote
interrogative-mood: 
na-au: 
kipekee---au: 
chanzo-kesi: 
ablative-kesi: 
demonstrative: imara, kikubwa, thabiti, cogent, agizo, kishindo
lakini: lakini, Hata-hivyo
zote: kila-mtu, kila-mtu, jumla, nzima, ujumla, zima, kila-kitu, yoyote, inazidi
kike-jinsia: 
wao: nao, yeye, wale, yao, yao, jina, hizi
wingi-idadi: 
moja: single, a, katika, peke-yake
baadaye-uliopo: 
kijamii-mazingira: 
lini: wakati-wowote
imperfective-kipengele: 
kuna: 
masharti-mood: subjunctive-mood, hypothetical-mood
zaidi: zaidi, zaidi, zaidi, zaidi, zaidi, zaidi, mbalimbali, kuliko, badala, pia, zaidi-ya-hayo, plus, bado, lakini, kingine, kadhaa, nyingi
nje: nje, nje, nje, nje, nje, mbali, nje---ya, zaidi, up, juu-ya, kwenye
jamaa-kesi: jamaa-kesi
illative-kesi: 
kufanya: kufanya, kufanya, kufanya, atatoa, kuamsha, alifanya, kutenda
agizo-mood: dalili-mood
deontic-mood: 
swali-neno: 
copula: kontakt, dhamana, rundo
mtu: mtu, watu, mtu-binafsi, mtu, mtu, guy, binadamu, uso, kinywa, chombo
kiume: masculine, kutaja, muungwana, mtu
naweza: Unaweza, nguvu, uwezekano, labda
wengine: kingine, wengine, pili, mwingine, tofauti, mmoja-mwingine
idadi: kiasi, Jumla, takwimu, namba, numeral, wingi
sana: sana, sana, awfully, kiasi, pia, sana, sana, yenye, kweli, vibaya, kubwa, mno, mengi, mbalimbali, enormously, zaidi, kabisa, uungwana, mbali, pretty, sawa, okay, sawa
wakati: wakati, wakati, wakati, wakati, muda, muda, uliopo, ratiba, kipindi, hali-ya-hewa
wakati-mazingira: 
muda-kesi: 
kuhusu: kuhusu, habari-za, karibu, circa, ya, na, kuliko, karibu, kwa, user, kulalamika, juu-ya
epistemic-mood: 
tu: tu, tu, tu, hatua, mere, rena, wamefungwa
kidogo: ndogo, vidogo, kidogo, kidogo, bit, madogo, ndogo-ndogo, diminutive, portable, chache
kisha: tena, re-, ya, tangu, iliyopita, baadaye, baadaye
hortative-mood: 
retrospective-kipengele: 
kubwa: kubwa, kubwa, vyeo, kubwa, kubwa, kubwa, kubwa, kubwa, kubwa, kubwa, nzuri, faini, makubwa, mkubwa, kikubwa, ajabu, bora, optimum, grand, kuu, kamilifu, ajabu, kipaji
volitive-mood: 
kabla: kabla, kabla, iliyopita, kutanguliza, mpaka, mbele, zamani, dhidi-ya
lazima: lazima, lazima, lazima, lazima-uwe, haja, ataona, mnapaswa--to, wanataka, kwa
mbili: mbili, wote
ona: kuangalia, mtazamo, mbele, ilani, naona, kuangalia
kujua: kujua, ufahamu, kufundisha, bendera, inayoonekana
chini: kushuka, kwenda-chini, chini-ya, chini, chini-ya, chini, chini, chini, duni, downstairs
baada-ya: nyuma, juu-ya, baada, mwelekeo, baadaye, baadaye, baadaye, zifuatazo, siku-za-nyuma, chini-ya, chini
kwanza: kwanza, awali, tangu, na-kuendelea, ngumi
mwenyewe: mwenyewe, mwenyewe, wamiliki, binafsi, yake, yenyewe, binafsi
alienable-milki: 
kamwe: milele
inalienable-milki: 
umri-wa: kutumika, kale, wenye-umri-wa miaka, wazee, zamani, ex, ex-, umri
taamali-mood: 
siku: siku, leo, usiku-wa-leo
ambapo: popote, ambapo, mahali
kuja: kwa, kufikia, kuwasili, kuwasili, kuwa, mtindo, kutokea
njia: njia, mbinu, njia, njia, njia, njia, njia, uchaguzi, namna, barabara, mitaani, sukari, kufuatilia, trajectory, tabia
kazi: kazi, zoezi, kazi, kazi, kazi, kazi, kazi, kazi, kazi, kazi, biashara, kitendo, Fanya-mazoezi, ajira, taaluma-ya, kufanya-kazi, mchoro
vowel: maarufu, maisha, maisha
kwenda: kutembea, nauli, aondoke
perlative-kesi: 
maendeleo-kipengele: 
muda-mrefu: muda-mrefu, muda-mrefu, tall, pamoja
kusema: amesema, kuwaambia, kusema
jinsi: kama, kama, kuliko
hata: pia, ama, mpaka, zaidi-ya-hayo, pia
nyuma: nyuma, nyuma, nyuma, nyuma, kurudi, re-, kurejesha, tengua, tena, kurudia, iliyopita, kulingana-na
hapa: 
kufikiri: kufikiri, wazo, kufikiria, kufikiria, mimba, kutafakari, ingekuwa, aitwaye, akili
sawa: kufanana, sawa, sawa, sawa, sawa, sawa, sawa, mwenyewe, usawa, vile-vile
mwisho: mwisho, mwisho, mwisho, mwisho, mwingine, kingine, karibuni, hivi-karibuni, kuishia, siku-za-nyuma, the-siku-za nyuma, kuvumilia, kuhimili, kuweka, yanaendelea
mbali: mbali, mbali, mbali, mbali, aloof, kushoto, kuondoka, watoro
chini-ya-mazingira: 
kuchukua: mapumziko, kuchukua, kuchota, kupitisha, kunyakua, kupata, kupokea, pick, kukamata, kukamata, kukubali, kupata, malipo
kupatikana: kupata, kugundua, ugunduzi, kugundua, kupatikana
mkono: mkono, mkono
vijana: vijana, junior, adolescent, kijana, mpya
ingawa: ingawa, hata-hivyo, fasta, kampuni, imara, imara, licha-ya, Hata-hivyo, mtu
kutoa: kuwakopesha, kutoa, kutoa, kutoa, kutoa, atatoa, kumudu, kuweka, kuchangia, basi
mungu: 
delative-kesi: 
kitu: kitu, kitu, hakuna-mtu, chochote, hakuna, hakuna
haki: jozi, sahihi, usahihi, haki, haki, haki, haki, haki, haki, sheria, usahihi, kweli, baadhi, uhakika, kustahili, vizuri
mara-moja: mara-moja, mara-moja, njia, mfano, mbinu, tena
semelfactive-kipengele: 
sehemu: kifungu-cha, sehemu, sehemu, sehemu, sehemu, sehemu, kushiriki, bit, kipande, kifungu, subset, sura, idara-ya, episode, ubaguzi, mgawanyiko, wodi, sekta, uwiano, niaba
msumeno: 
nyumba: nyumbani, majengo, nyumba, nyumba, kaya
dunia: ulimwengu, kimataifa, ulimwengu
kichwa: kichwa, kuu, mkuu, sura, kiongozi, rais, mwenyekiti, mkurugenzi, bosi, mwandamizi, kalamu
tatu: tatu
mamboleo: mpya, wapya
lengo: lengo, lengo, lengo, lengo, makini, kipaumbele, mkusanyiko, lafudhi, hukutana
upendo: upendo, upendo, kama
daima: milele, mara-kwa-mara, milele, kawaida
usiku: jioni, chakula-cha-jioni, p.m.
kila: per, kila, yoyote
mfalme: kutawala, bwana, Mfalme, Tycoon
kati-ya: miongoni-mwa, miongoni-mwa, ya
moyo: moyo, moyo, kuipindua
paucal-idadi: 
kwa-sababu: kutokana, tangu, kesi, sababu
causal-kesi: 
jambo: jambo, jambo, jambo, mambo, nini
kuweka: kundi, kuweka, kuweka, kuweka, kuweka, mkusanyiko, mchanganyiko, safu, suite, mfuko, kwingineko, awali, pamoja, mfululizo, upande, mbalimbali, mstari, kamba, kit, corpus
jina: jina, noun
sahihi-noun: 
hortative: exhortative
nchi: taifa, nchi, nchi, hali, ardhi, kata, udongo, chama
aliuliza: 
inayoonekana-evidential: 
bora: bora, bora, bora, bora, bora
upande: lateral, neema, neema, niaba, upande, ukurasa, kipengele, nusu, facet
Bila-shaka: mtaala, somo, hotuba, hakika, hakika, dhahiri, kiwango-cha
kike: mwanamke, kike, kike, wanawake, msichana, mke
kutosha: kutosha, kutosha, kutosha, kutosha, uungwana, mengi, hayatoshi, kabisa, pretty
haraka: muda-mfupi, haraka, haraka, haraka, haraka, haraka, haraka, haraka, haraka, hivyo, mara-moja, urahisi, karibu, mapema, snap
kamili: kikamilifu, kutosha, kabisa, kamili, kamili, zima, hasa, halisi, yazua, just, kina, nzima, kina, ukubwa
chumba: chumba, nne, chumba-cha-kulala, amani
karibu: karibu, kivitendo, takriban, circa, karibu, karibu, karibu, karibu, karibu, karibu, muda-mfupi, kupakana, takribani, vigumu
hawawezi: hawawezi
maji: maji, maji, maji
desiderative-mood: 
mwanga: mwanga, mkali, mshumaa, kidogo, style, lightly, kali, nyepesi, rangi, wazi
wala: wala, wasio, lakini, nini, kutokea, au
neno: lexical
mlango: lango, mlango, mlango, sura, bandari
matumizi: kutumia, matumizi, matumizi, matumizi, matumizi, kushirikisha, maombi, shirika, kuomba, kuajiri
asubuhi: lokal-tid-i, kifungua-kinywa
terminative-kesi: 
nguvu: nguvu, nishati, nguvu, nguvu, nguvu, nguvu, nguvu, saladi, kuhodhi, mamlaka
wenyewe: wenyewe, mwenyewe, mwenyewe, mimi-mwenyewe, yeye-mwenyewe, yenyewe, binafsi, ego, sura
sasa: sasa, the-sasa, sasa, sasa, zawadi, kuwepo, inapatikana
sauti: sauti, sauti, kura, redio, kura, bidhaa, uvumi, uvumi
nyeupe: tupu, malalamiko
fedha: utajiri, fedha, fedha, fedha, fedha, fedha, fedha
ijayo: kando, sambamba, karibu-na, zifuatazo, baadaye, mwelekeo, na-kuendelea, baadae
maskini: mkono, umaskini, mbaya, mbaya, bovu, dhaifu
kifo: vifo, kufa, wafu
fomu: sura, mold, format, contour, mfano
inessive-kesi: 
aina: tabaka-la, aina, aina, aina, aina-ya, kirafiki, bidhaa, nzuri, mazuri, kupendeza, kufurahisha
mara-nyingi: mara-kwa-mara, mara-kwa-mara, mara-kwa-mara, mara-kwa-mara, kawaida, kawaida, kawaida
mwaka: mwaka, mwaka, tano
rafiki: mshirika, mpenzi, wenzake, mate
ili: mfumo, mpangilio, kupanga, mkataba, safu, amri, upande, mstari, foleni
muhimu-mood: 
pande-zote: rounded, mzunguko, Lap
kuamini: uaminifu, hesabu, presume, imani, imani, kujiamini, ujasiri, matumaini, matumaini
umma: the-umma, ujumla, watazamaji
hali-mazingira: 
mwana: swarm, mvulana
mia: mia, uso, cent
watoto: mtoto, watoto, mtoto, mtoto
hivyo: hivyo, hivyo, hivyo, kama, ndiyo
matumaini: napenda, matarajio, wanatarajia, matumaini, matumaini
juu: up, zaidi, ghorofani, juu, juu, juu, juu, hela, habari-za, kupitia, juu-ya, Rudia, kwenye, mbele, zaidi
wapenzi: lover, ghali
kusoma: kusoma, kuimba, lily
mji: mji, manispaa, kata
tayari: tayari, tayari, tayari, anyway
ukweli: ukweli, ukweli, ukweli, kweli, halisi, halisi, hakika, kweli, kweli, alifanya
factive-evidential: 
kusikia: kusikiliza, kusikia, kuhisi
angalau: ndogo, kiwango-cha-chini, kupunguza, bala, chini
labda: pengine, labda, labda, nguvu, uwezekano, inawezekana, uwezekano, kinachowezekana
wazi: wazi, wazi, wazi, wazi, wazi, wazi, wazi, dhahiri, nje, nakisi, rangi, hadharani, kuwafichua
mwili: mwili, mwili, kimwili, kimwili, corpus, chombo, maiti
hewa: upepo, breeze, anga, hali-ya-hewa, ndege
asili: asili, asili, asili, asili, asili, asili, wanyamapori, tabia
kusaidia: kusaidia, kusaidia, misaada, msaada, msaidizi, kuweka
barua: barua-pepe, kuandika
nne: nne
optative-mood: subjunctive-mood
moto: moto, moto, homa
Kwa-hiyo: hivyo
saa: saa, saa, kengele
bure: uhuru, uhuru, msamaha, bure, bure, uhuru, wazi, loosely, kutolewa
vita: vita, mapambano
iwapo: kama, yenyewe
sababu: sababu, akaunti, sababu, sababu, kisingizio, viwanja-vya, kuenea, mdai
umoja: umoja, umoja, umoja, muungano, washirika, mshirika, kipekee, usiojulikana
wito: changamoto, oxidize, rufaa, juu-ya, uhusiano, mchanganyiko, pamoja, fusion, mwaliko
kwa-nini: 
waliopotea: hasara, kukosa
elfu: elfu
familia: kaya, survivor
nafsi: roho, roho, mastermind
swali: suala, mahitaji, kusoma, jambo
huduma: wasiwasi, wasiwasi, kipaumbele, kutafakari, huduma, udhamini, walinzi, usalama, ulinzi, usalama, utunzaji, uhifadhi, chanjo, ulinzi, tahadhari, tiba, matibabu, chini-ya-ulinzi
realis-mood: 
maana: kuashiria, maana, maana, maana, kuashiria, katikati, wakala, kati, wastani, wastani
uwezo-mood: 
kuelekea: kuelekea, dhidi-ya, kinyume, kupinga, per, heshima, kwa
allative-kesi: 
anthropic-jinsia: 
short: chini, Asili, kifupi, muda-mfupi, kwa-ufupi, kadi, nyembamba, kidogo
uwezo: Unaweza, waliohitimu, haki, uwezo, uwezo, uwezo, uwezo, uwezo, uwezo, uwezekano, uwezekano, nguvu, nguvu, ustadi, may
kuishi: maisha, kuishi, kuishi, hai, kiota, wilaya, jirani, jirani, hai, kusisimua, mbichi, wanaishi
somo: nidhamu, mandhari, mada, somo, Dutu, suala, kitu, maana, vifaa, semantic, jambo, jambo, kichwa
sawa-somo-marker: 
tofauti-somo: 
jibu: kaskazini, kujibu, majibu, ufumbuzi, yanahusiana, kujibu
bahari: bahari, baharini
hofu: hofu, hofu, hofu, hofu, hofu, hofu, wasiwasi, Angst, horror, scare
kuelewa: uelewa, ufahamu, naona, kufahamu, mimba, meguka, pamoja-na, kutambua
ngumu: ngumu, ngumu, ngumu, kali, kubwa, ukali, mkali, mgumu, mkali, changamoto, gumu, nzito, kaburi, kali, uneasy
suala: mrefu, istilahi, suala, msingi, viwanja-vya, msingi, kimsingi, kimsingi, kimsingi
shaka: tuhuma, uaminifu, mtuhumiwa
dubitative-mood: 
kuuliza: omba, zinahitaji, kusikiliza, tafadhali
silaha: silaha, silaha, silaha, mkono
nyeusi: 
kuleta: kuchota, kubeba, ingekuwa, kusababisha
nzuri: nzuri, nzuri, lovely, uzuri, nicely, pretty, dhana, baridi, cute
giza: viza
kushikilia: kuweka, kudumisha, kukamata, mtego, mkataba, kuhitimisha, fundo, muongo, impound, kusubiri, kama, kuendeleza
kumi: muongo, kumi, haki
show: kuonyesha, kufanya, utendaji, maandamano, kuwasilisha, zinaonyesha, kuashiria, tukio, makadirio
hadithi: hadithi, historia, fiction, njama
kawaida: ujumla, kawaida, utaratibu, kawaida, kawaida, kawaida, kawaida, kawaida, kawaida, kawaida, kawaida, kawaida, kawaida, kawaida, pamoja, mpenzi, mshirika, jumla-ya-mabao, ujumla, kuheshimiana, ushirika
kitabu: kitabu, hifadhi, pound, vitabu-vya-kiada
umeme: umeme, Electron, umeme, umeme, umeme, umeme
majadiliano: mazungumzo, kuzungumza, kujadili, mwingiliano, kuingiliana, majadiliano, kusema, hotuba, amesema, mjadala
alama: marker, kuwaeleza, uchaguzi, alama, kuonyesha, Jibu, ishara, ishara, dalili, cue, brand, tabia, studio
maslahi: ua, nia, wasiwasi
kuandika: kutunga, kuandika, aina-ya, imeandikwa
kitanda: 
muhimu: muhimu, muhimu, muhimu, muhimu, muhimu, muhimu, muhimu, muhimu, muhimu, muhimu, haja, lazima, intransitive, intransitive, intransitive
wazo: wazo, maanani, hoja, maoni, dhana, wachangie
sanaa: hila, kisanii
vialis-kesi: 
kaka: ndugu, dada
wakati-mwingine: mara-chache, mara-kwa-mara, wakati-mwingine
mstari: waya, thread, mstari, mstari, upitishaji, dash, stripe, kodi, Muswada
meza: dawati, ratiba, catalog
mto: mto, mto, flux
jicho: kuteua, karibu
maelezo: ujumbe, maelezo, maelezo, bulletin, maarifa, data
ghafla: ghafla
ajabu: strangely, inashangaza, oddly, isiyo-ya-kawaida, ajabu, ajabu, ajabu, ajabu, ajabu, ajabu, ajabu, funny, mgeni, kigeni, Awkward
kina: undani, kina, kina, kina, kina, kina, kina, kina, kushangaza, ndani-ya, ndani-ya, ndani, mdudu
mabadiliko: muundo, tofauti, mabadiliko, kubadilisha, mutation, mabadiliko, kubadilisha, marekebisho, mpito, marekebisho, badala
hisia: kuhisi, hisia, mtazamo, hisia, hisia, hisia, hisia, hisia, hisia, kutokuwa, maana, shauku, fahamu, fahamu
kukutana: kupata, hukutana, kukutana, kuzingatia, kukidhi, mkutano
madhumuni: kitu, lengo, lengo, lengo, marudio, nia, lengo, nia, Lengo
furaha: kwa-moyo-mkunjufu, amused, furaha, furaha, furaha, furaha, furaha, furaha, furaha, furaha, bahati, radhi
kuonekana: kuonekana, itaonekana, inaonekana
damu: damu, jinai
kufufuka: pink
kusini: kusini, saa-sita-mchana, majira-ya-mchana
baridi: baridi, baridi, coldly
mbele: zaidi, mbali-zaidi, mbele, mbele, mbele, juu, iliyopita, bat, kwenye, na-kuendelea
nafasi: eneo, hali, hadhi, nafasi, nafasi, nafasi, msimamo, mkao, mahali, baada, bidhaa
marehemu: polepole, mwisho
kusimama: kituo-cha, wima, mtazamo, msimamo, kuacha, mkao, pose, duka
kudhani: dhana, hypothesis, kudhani, kupitisha, presume, hypothesize, kupendekeza
binti: msichana, bikira
yangu: yangu
kukata: ukosefu, anakosa, kupunguza, upungufu, kupunguza, uhaba, miss, kukata, kupinga, kuwakata, kufyeka, mazao, trim, iliyovunjika, kukiuka
nakala: kuzaliana, replication, kuiga, transcription, nakala, Clone, toleo-la, dawa
mume: mtu, mke
sita: ngono
kumbuka: kumbuka, wanakumbuka, kuwakumbusha, kukariri
athari: ushawishi, kuathiri, hisia, athari, kuhodhi, ufanisi, ufanisi, ufanisi, matokeo, matokeo-yake, yatokanayo
kuanguka: vuli, kesi, iko, ajali, kuporomoka, kuvunja, kuanguka-kwa, kushuka, kushuka, kupunguza
isipokuwa: isipokuwa, nje, nje---ya, mbali-na, mbali, Bila, kando, kando, kando---kutoka
nywele: 
kupita: na, kupitia, kupita, kupitia, karibu, kando, wajumbe, Hitimu, kutu, kuvuka, kifungu, kuendelea
hati-miliki: 
jeshi: askari, askari, jeshi, askari
kukimbia: kukimbia, kukimbia, mbio, kutekeleza, kazi, gari, mafua, gia
farasi: farasi, katika
baadaye: the-baadaye, baadaye, baadaye, baadaye
magharibi: magharibi
kulipa: mshahara, mshahara, mshahara, kutia, malipo, remunerate, ada, gharama
nyekundu: 
dhahabu: 
hamu: hiari, hamu, hamu, napenda, wanatamani, kuwaomba
kucheza: kucheza, kamari, mchezo, shavu, toy
bwana: bwana, msingi, kuu, profesa, kutawala, zinazoongoza, Bwana, muungwana, kuongoza, mister
ofisi: wakala, dawati
serikali: hali, mstari
kanisa: 
urefu: urefu, urefu, span, pamoja, muda
kampuni: kampuni, shirika, jamii, biashara, ushirika, chombo, taasisi, wakala, taasisi, mradi
karatasi: karatasi, kadi, katiba
uwezekano: uwezekano, uwezekano, uwezekano, uwezekano, uwezekano, matarajio, nafasi
hasa: maalum, hasa, hasa, hasa, hasa, hasa, hasa, wengi-wao-wakiwa, kimsingi, maalum
kubeba: kubeba, kuvumilia, kuhimili, uvumilivu, kuvumiliana, kuwa, wamiliki, kumudu
dirisha: 
makubaliano: itifaki, makazi, maelewano, makubaliano, mkataba, kukubaliana, mpango, mkataba, zabuni, chord, mkataba, mkataba, mpangilio
uzuri: uzuri, uzuri, aesthetic
wajibu: dhima, wajibu, wajibu, wajibu, mila, kazi, zoezi, madeni, deni, lazima-uwe
kutuma: kusambaza, kuwasilisha, baada, matangazo, email
umbali: kuondolewa, mbalimbali, kujitenga
ukimya: mapumziko-na-utulivu
mguu: mguu, mguu, mguu, toe, robo, kutembea, kutembea
porini: wildly, haramu, mkali, wanyamapori
kufa: wafu, kufa
kuokoa: kuokoa, utunzaji, kuokoa, kuhifadhi, uhifadhi, kukariri, duka, kuwakomboa, kuwaokoa, rekodi
kijani: mbichi, ghafi
shida: kujisumbua, suala, tatizo, ugumu-wa-maisha, ugumu, kanda, mateso
tabasamu: grin
vibaya: makosa, makosa, potofu, vibaya, vibaya, uongo, kosa, kushindwa, flaw, kimakosa, gaffe
mbalimbali: tofauti, mbalimbali, nyingi, mbalimbali, mbalimbali, mbalimbali, tofauti-na, lahaja, tofauti, kutofautiana, aina
usingizi: amelala, ndoto
quotative-kesi: 
mwanzo: kuanza, mwanzo, kufanya, mwanzo, mwanzo, mapema, awali, uanzishwaji, kwanza, kanuni
hatua: kazi, hatua, hatua, hatua, kitendo, utaratibu, kazi, operesheni, uendeshaji, kuamsha, mwanaharakati, hoja, mazoezi, mazoezi, kazi, hisa, mkutano-wa-hadhara, utekelezaji, kutekeleza
ziara: upatikanaji, mahojiano, kupatikana, kusafiri, safari, safari, ziara
kufuata: kufuata, kuambatana, zifuatazo, kujiingiza, kufuatilia, kuongozana
kujaribu: jaribio, ilijaribu, juhudi, mpango, majaribio, mtihani, sampuli
uwepo: kuwepo, kuwepo, chombo, mali
tamu: pipi, mpole, bland, cute
tajiri: mengi, tele, tajiri
adui: 
meli: mashua, meli, meli, meli, chombo, cruise, kivuko
hali: bet, betting, hali, hali, hali, hadhi, bahati, hatua, kiwango-cha, fitness, mahitaji
Ikiwa-ni-pamoja na: vyenye, pamoja-na, kuhusisha, mali
umoja-mtu: 
siri: siri, siri, siri, chini-ya-ardhi, secrete
precative-mood: 
polite-kusajili: 
mabaya: madhara, nasty, matata, mbaya, vibaya
maandamano: gwaride, maandamano, maandamano, mars
chochote: chochote, kwa-namna-yoyote
kukaa: kubaki, kukaa, kukaa, kuishi, wanaishi, kusubiri
badala: badala-ya, badala, badala, badala
bluu: Fairy
haiwezekani: 
shule: chuo, ngazi
tukio: nafasi, tukio, tukio, nafasi, avenue, mapatano
ndoa: ndoa, kuoa, harusi
chakula: mlo, mlo, sahani, kulisha, madini
ishirini: 
utulivu: shwari, tranquil, utulivu, kimya, amani, polepole, walishirikiana, softly
urahisi: uwezekano, urahisi, kutozwa, rahisi, urahisi, kidogo, kidogo, lightly, rahisi, moja-kwa-moja
wanaotazamiwa-kipengele: 
lugha: lugha, ulimi
kujieleza: kueleza, kauli, maneno, kueleza, ufunuo, yatokanayo, kutamka
wiki: Jumapili
ukumbi: ukumbi, ukumbi, barabara-ya-ukumbi, nafasi, chumba, saluni, mapumziko, aisle, mwanariadha, kushawishi
hatari: hatari, hatari, heshima, tishio
mali: mali, mali, umiliki, kifalme, milki, kipengele, bainishi, isiyohamishika, bahati, utajiri
aliyezaliwa: kuzaliwa
mahakama: mahakama, sahani, jukwaa, kesi
ujumla: kawaida, kawaida, ujumla, ujumla, sana, kawaida, kawaida, kawaida, upana
gnomic-kipengele: 
thamani: stahili, thamani, thamani, uhalali, sifa
rahisi: unyenyekevu, moja-kwa-moja, rahisi, rahisi, rahisi, tu, tu, wazi, kawaida, tu, mere, moja-kwa-moja, kawaida
mti: kupanda, kuni, shimoni, mbao
mapambano: mapambano, vita, mapambano, ugomvi, kinyang'anyiro
ukuta: 
mbinguni: anga
inchoative-kipengele: 
jussive-mood: 
tone: lami, melody, tani, tani, kivuli
kujali: heshima, kudhani, presume, kipaumbele, maanani, kufikiria, uhusiano, chama, uhusiano, habari-za, kuhusu, remark, chanjo
inatarajiwa: kutarajia
mwezi: moon
uzoefu: empirical, uzoefu, uzoefu, utaalamu, zest, majaribio
kabisa: kabisa, kikamilifu, kikamilifu, kabisa, kabisa, kabisa, kabisa, kabisa, nzima, vizuri, uungwana, rena, hasa
safi: freshly, safi, safi, nishati, mpya, novice
duke: mtawala, mkuu
kufunikwa: kufunika, chanjo, mbali, kufungwa, ndani
amefungwa: kiasi, kiwango-cha-juu, kikomo, mpaka, kizuizi, vikwazo, kushikamana, wanategemea, kumfunga
mashariki: mashariki, iliyopita, uliopita, kabla, kabla, kuelekeza
jiwe: jiwe, mwamba, gem
kiasi-fulani: kitu, chochote, baadhi, kabisa, badala, kidogo, sehemu, namna-fulani
mwelekeo: Mwelekeo, mwelekeo, mwenendo, facet, maelekezo
kiti: kiti, armchair, kinyesi
msaada: kuendeleza, kuidhinisha, msaada, kusaidia, bracket, misaada
tarehe: historia, kukutana
kijiji: kitongoji, mashambani
uwanja: nyanja, ulimwengu, mkoa, wilaya, eneo, zone, sekta, uwanja, uwanja, uwanja, nafasi, margin, mashambani, kambi
ruhusa: kuruhusu, sikio, kibali-cha, kibali, kuondoka, leseni, leseni, ridhaa, toleo
permissive-mood: 
mafanikio: mafanikio, kufanikiwa, mafanikio, mafanikio, ushindi, ushindi, kugonga, kushinda, mshindi
sahihi: vizuri, sahihi, busara, sahihi, sahihi, sahihi, haki, halisi, just, mara-moja, uaminifu, sawa, usahihi, ugomvi, fit, mzuri, rahisi, inafaa, yanahusiana, haki, husika, kamilifu, kutosha, mara-kwa-mara
kilima: mlima, mlima
muziki: kimuziki
distal-demonstrative: 
alasiri: p.m., saa-sita-mchana, majira-ya-mchana, jioni
kilio: kuomboleza, kelele, kupiga-kelele
heshima: heshima, heshima, heshima, heshima, heshima, honorific, hisani, utukufu, kiwango-cha, bei
saba: 
binafsi: binafsi, binafsi, binafsi, binafsi, maalum, faragha, maalum, kipekee
habari: ujumbe
eneo-la-tukio: tovuti, mbele, mazingira, kuonyesha, Visual, hatua, mtazamo, matarajio, hema
bustani: Hifadhi
mbio: ubaguzi-wa-rangi, racing, mbio, mashindano, mashindano, zabuni, kuzaliana, mechi
distributive-kesi: 
kujifunza: utafiti, kufundisha
kisiasa: siasa, kisiasa, mwanasiasa, sera
uongo: uongo
kutupwa: hurl, kutupa, fling, toss, format, mold, uzinduzi, kumwaga, kujiondoa
kula: mlo, kulisha, sahani, nitakula, matumizi
sakafu: sakafu, ardhi, chini, udongo, kutembea, juu, tall
mgonjwa: wagonjwa, mgonjwa, kidonda, ugonjwa, uongo, vibaya
awali: asili, awali, awali, awali, awali, awali, asili, halisi, innate, asili, kuu, msingi, mfano
majira: joto
dini: kidini, madeni
picha: portrait, uchoraji, picha, picha, picha, picha, picha, nakala, kuchora, snap, filamu, mfano, portrayal, mitini, takwimu
kutoroka: kukimbia
mwandishi: mwandishi, mwalimu, mhariri
brown: gray, gray, suntan, shaba
kuamua: uamuzi, kuamua, kuamua, uhakika, assertive, designer, maalum, kujua, imara, baadhi
maumivu: kuumiza, uchungu, chungu, huzuni, kidonda
spring: feather, yetu, zetu
karne: umri
laini: concessive, laini, laini, zabuni, upole, softly, mpole, bland, kali
kona: angle, kabari, kuzama
kuzalisha: uzalishaji, kuzalisha, uzalishaji, ihakikishe, utengenezaji, viwanda
kicheko: mzaha
kusahau: waache
Ulaya: 
nane: nane
mavazi: Costume, mavazi, kanzu, vazi, wamevaa, sare, outfit
kutisha: kutisha, kutisha, sana, kutisha, kubwa, kutisha, kutisha, scare, monstrous, awfully
pumzi: kupumua, kupumua, kinga, exhale, ego, gasp
busara: busara, busara, busara, wasiwasi, wajanja, smart, akili
kutochukua-marker: 
kumbukumbu: kukariri, kumbukumbu, kumbukumbu
kisasa: kisasa, kisasa, kisasa, mtindo, hivi-karibuni, mjadala
doa: hatua, dot, saa, eneo, doa, dosari, kiraka, mahali, mahali-pa, majengo, locus, tovuti, ndani, Machapisho, ishara, ardhi
kupanda: kupanda, kupanda, kupanda, kupanda, up, bodi, safari, kuinua, kutokea, kuongeza, kuibuka, kukua
mapumziko: vunja, kuvunja, mapumziko, mapumziko, usumbufu, muda, pengo, smash, kuwavunja, kuacha, pause, kupinga
hamsini: 
kisiwa: 
kugusa: mawasiliano
ahadi: kutenda, dhamira, ahadi, uteuzi
commissive-mood: 
shahada: sawa, kiasi, daraja, ubora
mpango: mpango, mpango, mpango, mpango, mpango, mpangaji, pendekezo, mradi, njama, mchoro, makadirio, mpangilio, gorofa, kuchora, kubuni
mwenendo: mwenendo, tabia, tabia, kitabia
mshangao: kushangaza, isiyotarajiwa, ajali, inashangaza
dakika: 
risasi: risasi, risasi, risasi, risasi, picha, picha, pigo, bang, mapinduzi, kutupa, sura
mbaya: mbaya, mbaya, mbaya, mbaya, vibaya, sana, duni, up, ghorofani
kioo: kioo, kioo, jar, glasi, miwani
mfano: mfano, mfano, mfano, mfano, mfano, mfano, kama, kuwakilisha, specimen, kesi, historia, sampuli, dhana, kwa-mfano
salama: kupata, usalama, usalama, salama, ujasiri, bima
daktari: daktari, mtaalamu, daktari, matibabu
completive-kipengele: 
mara-kwa-mara: mara-kwa-mara, mara-kwa-mara, mara-kwa-mara, mara-kwa-mara, mara-kwa-mara, mara-kwa-mara, mara-kwa-mara, kurudia
kijeshi: askari, wapiganaji
joto: moto, snug, joto, joto, joto, joto, gramu, muggy
kunywa: kinywaji
maswali: 
hasira: hasira, hasira, hasira, kuiudhi, licha
moja-kwa-moja: moja-kwa-moja, moja-kwa-moja, moja-kwa-moja, moja-kwa-moja, moja-kwa-moja, haraka
kofia: cap, kofia
mbwa: 
mtumishi: wakili, waiter, msichana
kiburi: kiburi, fahari, kujigamba
umati: kukimbilia, msongamano, kundi-la-watu, kiasi, wingi, idadi-ya-watu, jeshi, rundo
treni: inasimamia, gari, wagon, gari, reli, reli, kuelimisha
maadili: maadili, kimaadili, kimaadili, maadili, ari, kiroho
kuhusishwa: mshirika, umuhimu, correlate, kuhusiana-na, wasiwasi, wasiwasi, husika, pamoja, kushikamana, yanahusiana, washirika
kuingia: kuingia, kuingia, hali, zinaonyesha, kuingiza, pamoja-na
utawala: utawala, utawala, utawala, hukumu, uamuzi, hukumu, mwamuzi, mwamuzi, zinazoongoza, sheria, sheria, suala-la-kawaida
upanga: blade
mashambulizi: uvamizi, kuvamia, uchokozi, kosa, shambulio, kosa, mgomo, mwanzo, kukera
afya: afya, kusalimiana
aya: aya, kifungu, chunk, hatua, mtazamo, msimamo
kijamii: jamii, kijamii
refund: kujibu, kujibu, kurudi
pole: majuto, pole, msamaha, kisingizio, kuomba-msamaha
ujasiri: kukwanyua, ujasiri, ujasiri, ujasiri, ujasiri, kuthubutu
neema: neema, neema, huruma, wema, ukarimu, niaba, msamaha
rasmi: rasmi, rasmi, rasmi, afisa, karani
zinazotolewa: kutoa, kutoa, kutoa, kuanzishwa, inapatikana, usambazaji, utoaji, kuhudumia, kama
ombi: maombi, mahitaji, madai, zinahitaji, mahitaji, uchunguzi, uchunguzi, haraka, jitihada, maombi
mtazamo: glimpse, mtazamo, mtazamo, mtazamo, mtazamo, mbele, kuangalia
harakati: mwendo, kampeni, michezo, kampeni, kitendo, hoja, uhamaji, biashara, kusonga
kutarajia: matarajio, kutarajia, wanatarajia, kusubiri
kinyume: mbele, kinyume, kinyume, kupinga, hela, counter
kumi-na-mbili: 
wanaohusika: ushiriki, busy, wanaohusika, kushiriki, ulichukua
mvinyo: zabibu, pombe, pombe
ladha: ladha, ladha, ladha, chambo, zest
chuma: chuma, chuma
kusambaza: kusambaza, kupeleka, kuchapisha, kuchapisha, utbredningen, kusambaa, usambazaji, kutenga, kushiriki, mgawanyiko, mgawanyiko, to--kupasuliwa, kuainisha
biashara: biashara, biashara, commerce, bidhaa, biashara, mapatano, shughuli, mfanyabiashara, ununuzi, masoko
faida: faida, faida, faida, faida, wema, mali, upendeleo, kuhodhi
nguo: WARDROBE, nguo, mavazi, outfit, vazi, kuporomoka
hakimu: hukumu, hukumu, mwamuzi, mwamuzi
tofauti: tofauti, kutofautisha, tofauti, tofauti, tofauti, tofauti, tofauti, tofauti, tofauti, ugomvi, mgawanyiko
wasiwasi: dharura, uharaka, wasiwasi, wasiwasi, wasiwasi, wasiwasi, wasiwasi, wasiwasi, wasiwasi, wasiwasi, wasiwasi, hofu, nia, disturbing, kutisha, shauku, hamu, anahangaika, uneasy
nahodha: 
kumaliza: kumaliza, mwisho, finite, tayari
kukoma-kipengele: 
curious: hamu, kuvutia, kusisimua
kigeni: nje-ya-nchi, mgeni, mgeni, kigeni, mgeni, nje
intensifier: kuimarisha
umuhimu: umuhimu, umuhimu, maana, thamani
hatimaye: hatimaye, hatimaye, finite, mwisho, mwisho, terminal, laini
muswada: kitendo, muswada, akaunti, calculus
kuthibitisha: ushahidi, kuthibitisha, kuthibitisha, kuonyesha, kushuhudia
kuzuia: kusitisha, kukataza, kizuizini, kukandamiza, kuzuia, kuzuia, kuzuia, kuzuia, kuzuia, kuzuia, kuepuka, kurudisha, kukandamiza, kuahirisha
shingo: koo
kisheria: mahakama, sheria, halali, sura
kavu: shina
kutumikia: huduma, kulipwa, kuhudumia, kutoa
kupoteza: miss, misplace
ushahidi: evidential, ushahidi, kuongoza, fununu, directory, kuonyesha, shahidi
evidential-kesi: 
maendeleo: stride, maendeleo, maendeleo, maendeleo, maendeleo, kuendeleza, kuendelea, uboreshaji, kuinua
jengo: kujenga, muundo, kujenga, ujenzi, majengo
search: kupata, kugundua, ugunduzi, jitihada, kugundua, kutafuta, kutafuta, utafiti, utafiti, kutekeleza-azma, uchunguzi, uchunguzi, uchunguzi
kusikitisha: huzuni, cha-kusikitisha, duni, upsetting, kasirika, majuto, depressing
dhambi: hatia
thelathini: 
waaminifu: kweli, waaminifu, uaminifu, frank
kufunga: karibu, kufungwa, kufungwa, mbali, kufunga, to--karibu, pakiti, kifungu, sehemu, pakiti, mfuko, impound
benki: benchi, bati
hatma: bahati, bahati, kisintaksia, marudio, mengi
msitu: jungle
kupima: kupima, kipimo, kupima, mita, mita
vinginevyo: matumizi-mengine
mkondo: kati-yake, kifungu, sasa, umeme, flux, ndege
mkate: bake, kupanda, sandwich
ziada: ziada, vipuri, zaidi-ya-hayo, ziada, ziada, zaidi, Aidha, nyongeza, kuongeza, appendix
kuchagua: uchaguzi, uteuzi, teua, kuwachagua, pick, wateule, piga, kura, uchunguzi, upendeleo
wanyama: 
Zoic-jinsia: 
eventive-mood: 
sawa-tukio-marker: 
multiplicative-kesi: 
nene: feta, thickly, mnene, mafuta
kiumbe: viumbe, kiini
mvua: mvua, mvua, kuoga
uso: uso, kiwango-cha, ndege, eneo
takatifu: takatifu, wavu, rena
Julai: 
ripoti-hiyo: uamuzi, kauli, uwiano, uhusiano, uhusiano, haki, maonyesho, insha, yatokanayo, alama
pwani: strand, beach
faili: hati, coil, nyumba-ya-kulala wageni, profile, archive
bega: shimoni, mhimili, portrayal, comb, mkono
kushangaa: inafanyika, ajabu
kifalme: kifalme, kifalme, Utawala, himaya, halisi, halisi
wimbo: tune, kufuatilia, kuimba, shairi
faraja: kupunguza, walishirikiana, kufurahi, faraja, urahisi, wengine, misaada
mtu-yeyote: mtu-yeyote, mtu, mtu, hakuna, kila-mtu
nyasi: nyasi, kupalilia, mimea, lawn, gramu
kuteka: Drag, kuvuta, haul, kuvutia, rufaa, kuvutia, kuondoa, kusisimua, kuvutia, kuvutia, kuchora, kuondoa, Ondoa
ufunguzi: awali, awali, ugunduzi, pengo, yanayopangwa, hadharani
Juni: 
samaki: aquarium
mji-mkuu: sura, mfuko, mali
matiti: kifua
theluji: barafu
elimu: kuelimisha, somo, elimu, elimu, malezi, mafunzo, walioelimika, kitaaluma
mkali: mkali, mkali, mkali, kasi, spicy, ncha, papo-hapo, nia, crisp
huruma: huruma, huruma, huruma, huruma, huruma, kutisha, adhabu, feather, bahati-mbaya, juta, madhara, uharibifu, majuto
gharama: ada, matumizi, gharama, toleo, pato, malipo
lenu: yako
milioni: milioni
uchovu: uchovu, chovu
kuua: mauaji, mauaji
kivuli: kivuli
uzito: mzigo, nzito, akishiriki, kupima, shinikizo
wingi: ubora, pamoja, wingi, wingi, wingi, mengi, donge, nguzo, kundi-la-watu, kosa, unga, pasta
imara: kufunga, imara, imara, imara, viumbe, kuanzisha, madarakani
jasiri: ujasiri
nyembamba: skinny, kuondokana, tapered, nyembamba, konda, faini, hila, laini, kidogo, damn, rarefied, delicate, kupima
kuridhika: radhi, kuridhika, ridhaa, furaha, kukidhi, kuridhisha
kuangalia: kuangalia, kuangalia, kuangalia, uchaguzi, kuchunguza, kukagua, uchunguzi, mtihani, ukaguzi, kati, utafiti, kuchunguza, kujua, kurekebisha, kudhibiti
wema: wema, wema, wema, ukarimu
kitaifa: taifa, utaifa, kikabila, ndani
Mungu: takatifu
bonde: bonde
nadhani: inference, mtuhumiwa, presume, makisio, kukadiria, utabiri, kutabiri, utabiri, kubashiri
mapema-mno-mood: hypothetical-mood
njano: rangi, amber, blonde
mabaki: mabaki, mabaki, iliyobaki, leftovers, wengine
bent: ikiwa, bend, meandering, mwenendo, inaendelea, mteremko, sloped, slant, folding
sanduku: sanduku, droo, mfuko, kit, Unaweza, bin
msimu: msimu, sura, kituo-cha, era
sayansi: kisayansi
kuzaa: shimo, drill, wepesi, boring, kutoboa, waudhi, jukwaa
mjomba: 
orodha: ripoti, catalog, orodha, kusajili
Agosti: 
maarufu: kiwango-cha-maambukizi, maarufu, maarufu, watu
haijulikani: mgeni
ukoo: marafiki, ukoo, ukoo
ukoo-kusajili: 
msomaji: muimbaji
mbinu: kufikia, upatikanaji, mbinu, mbinu, mbinu, mtazamo, namna, njia, mtindo, utaratibu, makadirio, interface
mara-mbili: mara-mbili
akili: akili, akili, akili, akili, akili, thinker, hekima, kiroho
kweli: kweli, hakika, hasa, kweli, kivitendo, karibu, kweli, kweli, kweli, kikamilifu, dhahiri, uhakika, hakika, hakika
kuhani: viongozi-wa-dini
waliojeruhiwa: kujeruhiwa, jeraha, kuumiza
huzuni: huzuni, huzuni, huzuni, huzuni, maombolezo, uchungu
ikulu: 
kuwapiga: kushindwa, ngumi, kofi, kubisha, slam, dansi, kuondokana-na
eh?: 
kumdanganya: silly, hila, kudanganya, kudanganya, kijinga, wajinga, wazimu, mambo, mwendawazimu, kupotosha
makali: ukingoni, pindo, pembezoni, makali, mpaka, margin, bodi
tisa: tisa, mpya
kupasuka: mlipuko, mlipuko, kulipuka, kupasuka, boom, tetemeko, bang
kuteseka: kuvumilia, kuendeleza
kelele: kelele, kelele, fuss, kishindo
fasihi: fasihi
ushauri: baraza, kupendekeza, mapendekezo, kushauri, kushauriana, bodi, ncha
tupu: tupu, wazi, ngoma, burudani, null, utupu, utupu, bure
cheo: baada, daraja, mafanikio, jamii, thamani, tabaka-la
dhoruba: 
mfukoni: mfuko, pakiti
mawazo: dhana, kufikiria, dhana, Ndoto, fiction, imaginary
hukumu: hukumu, hukumu, pendekezo, theorem, pendekezo, pendekezo, adhabu, kutiwa-hatiani, maneno, kulaani, kukemea, adhabu
Novemba: 
Desemba: 
kukosekana: watoro, ukosefu, uhaba
kuwashukuru: shukrani, kushukuru, shukrani, Asante
anuani: 
ndege: ndege, ndege, ndege, ndege, ndege, ndege
mmiliki: bosi, mwenye-nyumba
kanzu: kanzu, ala, cover, koti, fur
kuandaa: tayari, tayari, kuandaa, maandalizi, kuunda
mahusiano: uhusiano, uhusiano, uwiano, umuhimu, yanahusiana, jambo, mawasiliano, kuwasiliana
moshi: sigara, tumbaku, kuchoma
Januari: 
mashine: mashine, injini, ndege, gari
yaliyomo: vifaa, mambo, kuzingatia, kukidhi, vyenye, pamoja-na, wajumbe, kuhusisha
meno: jino, gia
aibu: aibu, aibu, aibu, aibu, aibu, aibu, wazi, uchi, tusi, hasira
bay: berry, uke
ubongo: mastermind, mafuta
pete: ndogo-ndogo, piga, curl, kitanzi, tairi, tairi, muhuri, muhuri
maneno-marker: 
mraba: 
matunda: 
chai: 
kueleza: maelezo, kuonyesha, kueleza, kueleza, kutangaza, kufafanua, kutafsiri, maoni
kuwakaribisha: salamu, mapokezi, kuwakaribisha, hey, hi, kusalimiana
mashairi: shairi, aya
kununua: kununua, kupata, kumudu, soko
mwaminifu: mwaminifu, waaminifu, uaminifu, kujitoa, sahihi, kuaminika
msisimko: kusisimua, msisimko, fuss, mvutano, kumfanya, furaha, arousal, flush, wasiwasi
arobaini: 
Aprili: 
kindly: tafadhali, kirafiki, upole
Oktoba: 
uchungu: ugumu-wa-maisha, uchungu, uchungu, kwa-uchungu, mateso, chungu, kuumwa
mtumwa: utumwa
huru: huru, loosely, kutatua, kutatua, slack, wazi, uhuru
Nakala: maneno
mikopo: mikopo, mikopo-kadi, madeni, kuwakopesha, kukopa, mkopo, ufahari, uhalali, uaminifu
kumi-na-tano: 
kikatili: mkali, mgumu
kujiunga: kushiriki, kuhudhuria, wanaohusika, panda, kuambatana, mshiriki, ushiriki, kuunganisha, kuungana
mchakato: kushughulikia, utaratibu, kutibu, operesheni, kesi
uhalifu: hatia, kosa, kosa
vumbi: bwawa, unga
vitendo: kazi, pragmatic, kivitendo, rahisi, karibu, Handy, kutumiwa
rangi: rangi, rangi, whim, rangi, rangi, rangi, rangi, flush, kumaliza
kuharibu: ikaanguka, kudhoofisha, hujuma, kuharibu, kubomoa, kuponda, smash, kuharibiwa, kuwashangaza, kufuta, yanatofautiana, uharibifu
Ongeza: kuendelea, kuongeza, mlima, kuongeza, kuongeza, kuingiza, ukuaji, kupanua
pua: 
kukubali: kutambua, concede, kukubali, kutambua, kukiri, kuidhinisha, kuidhinisha, ruzuku, tuzo
jana: kesho
hesternal-uliopo: 
kushindwa: kushindwa, aliyeshindwa, kushindwa, setback, hawawezi, kuwashangaza, disappoint
kuendelea: kuendelea, kuendelea, kuendelea, muendelezo, mara-kwa-mara, yanaendelea
kuvaa: kubeba, mbeba-mizigo
kipofu: 
kadhaa: kadhaa
kuruka: kuruka, kuruka, ndege, anga
sifa: Pongezi, admire, sifa, sifa, kumpongeza, pongezi, utukufu, umaarufu
shetani: 
hatua-kwa-hatua: polepole, taratibu
sadaka: muathirika, nyara, majeruhi
zoezi: riadha, Fanya-mazoezi, zoezi, mazoezi, mazoezi, michezo, fitness, rehearsal
dhamiri: pronoun, fahamu
nadharia: kanuni, nadharia, theorem
waziri: 
chuki: nasty, disgusting, chuki, chuki, chuki, chuki, atapewa, kuchukizwa, uchukivu, unyarafu
ziwa: 
kituo-cha: kati, kituo-cha, kituo-cha, makao-makuu
kukata-tamaa: fahamu, kukata-tamaa, kukata-tamaa, dhaifu, rangi
mantiki-jinsia: 
makini: wasiwasi, kukumbuka, makini, tahadhari, halisi, sahihi, sahihi, kina
kufurahia: starehe, kufahamu
ibada: ibada
bidhaa: bidhaa, bidhaa, bidhaa, bidhaa, mambo
ngozi: ngozi, ngozi, maganda, ganda, peel, fur, zest
paa: mtaro, dari, kufunika, chanjo, mfuniko
taji: 
ngome: ngome, Rook, kufuli
kiti-cha-enzi: 
masharti: kushirikisha, masharti, ambatisha, kushikamana, tegemezi, mshirika
maili: tabia, mteremko, konda, gradient, tayari
uliokithiri: upeo, mwisho, pole, polar, msimamo-mkali, kubwa, makali, intensive, kiungo, ncha
gerezani: jela
kikombe: mug, bakuli
mwanachama: chombo, taarifa, kiungo, Go
kiraia: ndani, raia, kiraia, raia
kila-mahali: katika, mahali-popote
dhahiri: dhahiri, wazi, evidential, moja-kwa-moja, dhahiri, dhahiri, uhakika, wazi, wazi, uwazi, Haieleweki, liko
wanandoa: jozi, par, mara-mbili, mbili, chache, kadhaa, mvuke
kiasi: spool, kiasi, kiasi, kiasi, kiasi, kiasi, kuzuia, kundi, moduli, wingi, uwezo, chanjo
desturi: mteja, hiari, Costume, mila, mazoezi, tabia, inatumika-kwa
upinde: upinde, kitunguu, Curve
suti: fit, Costume, sahihi, mkataba, yanahusiana, vinavyolingana, kesi, upande-wa-mashtaka, madai, kanzu, madai
nyama: mwili, nyama
maziwa: maziwa, bomba, jelly
vegetal-jinsia: 
maono: mbele, maono, ufahamu, facade, mtazamo, glimpse, matarajio, mazingira, mtazamo
nadra: mara-chache, vigumu
binamu: jamaa
daraja: daraja, staha
kulinda: ulinzi, uhifadhi, walinzi, ngao, kutetea, kuhifadhi, kudumisha, kuhifadhi, kupata
chumvi: chumvi, chumvi, chumvi
wasio-na-hatia: 
malkia: 
kuhesabu: kuhesabu, hesabu, mahesabu-ya, kutegemea, tamaa, akaunti
udadisi: tafiti
ngoma: ngoma, kucheza, kuruka, ruka
hoteli: malazi, nyumba-ya-wageni
kujaza: 
mfungwa: 
duka: duka, duka, biashara, mpango, ununuzi
ngazi: staircase, stair, ngazi, droo
naomba: kutafuta, kudhani, kuwasihi
mchanga: 
vurugu: vurugu, mkali, misukosuko, ajabu, kali, nguvu, makali, kraftfulla, wildly, intensive
Septemba: 
kuondoka: kuondoka, aondoke, outlet, pato
uharibifu: uharibifu, subversion, uharibifu, nyara, maafa, wreckage
ujuzi: uwezo, uwezo, uwezo, ufanisi, umahiri, hila, utaalamu
ng'ombe: ng'ombe
vifaa-vya: vifaa-vya, kifaa, kit, gia, outfit, kukabiliana-na, vifaa, mbinu, teknolojia, kituo, fixture
jikoni: kupikia, jiko-la
kuuza: kuuza, nusu
kasi: kasi, kasi, kasi, kasi
hitimisho: inference, uondoaji, pato, Kidokezo, azimio, matokeo-yake, matokeo, mkusanyiko, kuhitimisha, pendekezo
kompyuta: kompyuta
milele: milele, milele, usio
mdogo: finite, wamefungwa, kuunda, delimited, vikwazo, kuwalazimisha
maktaba: bookcase
msingi: msingi, msingi, msingi, msingi, msingi, msingi, msingi, msingi, chini
mkanganyiko: fujo, machafuko, fuss, utata
tukufu: kipaji, lovely, vyeo
vivyo-hivyo: vile-vile, pia, usawa
kutishika: hofu, hofu, hofu, scare
ole: bahati-mbaya, unlucky, duni
makala: insha, bidhaa
mpishi: kupikia, bake, jipu
band: ukanda, Ribbon, mkanda, kikosi, kundi, strip, stripe, zone, strand, rundo, nguzo, mstari
jangwa: nyika, faragha
busu: 
mpira: mpira, nyanja, kanuni, risasi
fimbo: hisa, miwa, kuambatana, kuni, mbao, bat, cue
hoja: mantiki, hoja, hoja, utata, mjadala, mjadala, mzozo, njia
kuchunguza: kukagua, kuchunguza, kuchunguza, kuchunguza, uchunguzi
baraka-mood: 
fora: bora, stunning, mgomo, makubwa, muhimu, kikubwa, liko, kuvutia, inashangaza, kushangaza, wazi, mkali
hatia: hatia, deni, kumkosea, mkosaji, hatiani
gun: bunduki, silaha, kanuni, Rook
polisi: kutekeleza, kusimamia
kujificha: kuficha, secrete, kujificha
msafara: kampeni, gari, safari, safari, safari, ziara
wajinga: ujinga, hawajui, wajinga, wajinga, silly, kijinga, ujinga
ukarimu: kiliberali, ukarimu, ukarimu
wingu: 
taka: haina-maana, lazima, kukataa, kukataa, kukataliwa, mabaki, leftovers, takataka
Februari: 
ugonjwa: ugonjwa, ugonjwa, ugonjwa, kuridhisha, kuridhisha, syndrome
kutumia: ua, kutumia, matumizi, kujiingiza, ruka, miss
chanzo: rasilimali, mbichi, kisima
mpango-kesi: 
shangazi: 
kuchelewa: kuahirisha
kuchelewa-muhimu: 
taarifa-evidential: 
usiku-wa-manane: kaskazini
shujaa: shujaa, bingwa
falsafa: falsafa
kidole: toe
vizuri: vizuri, vizuri, vizuri, vizuri, raha, rahisi, kufurahi, mazuri, snug, Handy
mahali-fulani: mahali-popote
vyombo-vya-habari: vyombo-vya-habari, magazine, jarida, uchapishaji, aina-ya, formula
wafanyakazi: wafanyakazi, binafsi
zawadi: tuzo, zawadi, tuzo, bonus
lawama: kosa, kasoro, flaw, madeni, hatia, ofarlig, mashitaka, dhima, wajibu
taabu: ugumu-wa-maisha, mateso, uchungu, duni, boredom
paji-la-uso: 
tangazo: matangazo, matangazo, kutangaza, tangazo, tangazo, utangazaji, ilani, tamko
angel: mwenye-nyumba, Fairy
umoja-idadi: 
alfajiri: jioni
kibiashara: taaluma-ya, matangazo, biashara, biashara
kusamehe: kisingizio, msamaha, kuvumilia, msamaha, kupunguza, kumfukuza
kondoo: kondoo
uvumilivu: ujasiri, uvumilivu
shamba: ranchi, kulima, mashamba, kilimo
rejea: kumbukumbu, rejea
mahindi: ngano, pembe
ufunguo: dhamana, button, bisibisi, kubadili, kuu, muhimu, maarufu, nyeti, kuu, niche, tawala, fununu
wengi: wengi, zaidi
udhaifu: kukosa-uwezo
anga: mazingira, anga, anga, anga
sigh: gasp
ubinadamu: binadamu
upinzani: kinyume, kupinga, kupinga, Tofauti, kupinga, maandamano, kinyume, upinzani, counter, mpinzani, kukasirika, kupambana, sugu, kupambana-na, pingamizi
disk: disc, kipande, counter, silinda, sahani, rekodi, tray, gari
upweke: peke-yake, upweke, tofauti, single, tu
msanii: Performer, mchoraji, mburudishaji
knight: mpanda
charm: charismatic, kivutio, uchawi, uchawi
uamuzi: kuamua, hukumu, uamuzi, hukumu, uamuzi, azimio, ufumbuzi
gavana: kihafidhina, mtawala
tawi: 
disposition: mpangilio, Configuration, tabia, mwenendo, utoaji, mpangilio, hisia, ratiba, ratiba
shauku: bidii, joto, shauku, zest, euphoria, shauku, ecstasy, moyo
kufata-mood: inferential-mood, deductive-mood
jamii: jamii, jamii, watu
mafuta: mafuta, mafuta, mafuta, mafuta, mafuta, siagi
bomba: tube, bomba, bomba, kinyesi, mfereji
magazeti: toleo, shinikizo, uchapishaji, mhimili, mold, hisia
oh: ya
mjadala-mazingira: 
vocative-kesi: 
cabin: Cottage, hema, nyumba-ya-kulala wageni
kengele: kengele, tahadhari, kuitisha, kuwatisha
neva: uliopo, kuchanganyikiwa, fujo, kasirika, aibu, disturbing, kumnyanyasa, upsetting, neural, wasiwasi, ujasiri
kudumu: muda, mara-kwa-mara, mara-kwa-mara, kuendelea, mara-kwa-mara, fasta, steady
kisu: kelele, blade
hariri: 
dharau: kumdharau, chuki, chuki, unyarafu, uchukivu, ofarlig, tusi, hasira, uzembe
kuzimu: 
kutengwa: tofauti, kando, mbali, tofauti, tofauti, tofauti, aloof, Diskret, kutengwa, kutengwa, delimited, kujitenga
umakini: kubwa, dhati, nzito, akishiriki, kasi, kikamilifu
mchanganyiko: mchanganyiko, mchanganyiko, Composite, kuchanganya, pamoja
mbao: kuni, mbao
kupendelea: upendeleo
onyo: tahadhari, kuwaonya, tahadhari, kumbukumbu, ilani
mawaidha-mood: 
msukumo: msukumo, mapigo, kundi, kuwaomba, kasi, kutia
tamaa: tamaa, tamaa, tamaa, tamaa, tamaa, kabambe
kukataa: kukataa, kukataa, kunyimwa, kukataliwa, kukanusha, kukataa, yanatofautiana, kushuka, kuyakataa, kumfukuza, kukataza, marufuku, kuzuia, kinyume-na
katiba: katiba, kikatiba
chombo: chombo, chombo, chombo, chombo, chombo, shirika
kuendelea-kipengele: 
tide: wimbi, snap
chuo: Kitivo, chuo-cha, chuo, chuo-kikuu
mkia: foleni
kizazi: ukoo
paka: 
moja-kwa-moja evidential: 
kutelekezwa: kutelekezwa, kuondoka, faragha, kujiondoa, kuachana-na
kumi-na-moja: 
Instinct: hiari
tabia: bainishi, specialty, tabia, tabia, tabia, tabia, tabia, kipengele, Tabia, ubora, kawaida
kabila: shina, shina, mzigo
apprehensive-mood: 
makazi: mapumziko, makazi, makazi, makazi, makazi, ulinzi, Dorm, hifadhi
rude: juu-kwa-juu, mbaya, unkind
wanaoendesha: safari, mpanda
kuitingisha: wachangie
sekta: sekta, utengenezaji, viwanda, industrialize
taaluma: taaluma-ya, kazi, uvamizi, mtaalamu
taa: bulb
kahawa: cafe
kutii: kuwasilisha, kuzingatia, kusikiliza
kaskazini: kaskazini
muuguzi: 
kuwahakikishia: uhakika, kibali, ahadi, kuhakikisha, kuhakikisha, kuhakikisha, kujua, kuthibitisha, kutoa, kuhudumia, uhakika, kuwashawishi, kuthibitisha, kupata
mlolongo: mlolongo, mfululizo, kamba, jela
mafundisho: maelekezo, kuelimisha, mafunzo
viatu: kiatu, viatu
yadi: kificho, ukurasa, uchumba
hazieleweki: utata, Obscure, utata, Haieleweki, siri, uhakika, muda-usiojulikana, wimbi, wazi
mahali-pengine: kingine
ghorofa: gorofa, mzunguko, compartment, suite
shughuli: shughuli, kazi
Jumamosi: Sabato
mwanga-wa-jua: nishati-ya-jua
mjane: 
kipengele: kipengele, kipengele, bidhaa, kingo, chombo
tafakari: kutafakari
shirika: tishu, shirika, kuandaa, outfit, shirika, shirika, wakala, chombo, mfumo, muundo, texture, mpangilio, taasisi, taasisi
nyota: 
tukio-hilo: tukio, tukio, jambo, matukio, ajali, kesi
mgeni: mgeni, mgeni, mgeni, mgeni, mgeni, mteja, mteja, jeshi
bar: wazi, baa, mzigo, mizigo, cafe, barium
chupa: jar
awabariki: baraka
koroga: kuendesha, kuchanganya, evoke, kutuliza-ghasia
ndani: ndani-ya, ndani-ya, mambo-ya-ndani, ndani, ndani, ndani, ndani, akili, Go
kurekebisha: fasta, kurekebisha, kurekebisha, ufumbuzi, kutatua, kutatua, dawa, kuboresha, kunyoosha, sawa, okay, mara-kwa-mara, steady, staré, sahihi, kuamua, kuanzisha, kutambua, kujua
unatokana: kupata, kupata, derivative, kupata, kupokea
mashimo: wazi, wazi, tupu, cable
jimbo: mkoa
ustaarabu: 
hutegemea: 
mshtuko: pigo, setback, kiwewe, kushtua, clash
ubaguzi: ubaguzi, ubaguzi, ubaguzi, msamaha
mzigo: msongo, mvutano, mzigo, uchovu, juhudi, kiwango
kiwango-cha: kigezo, vigezo, kiwango-cha, kiwango-cha, chaguo-msingi, suala-la-kawaida, fasta, mara-kwa-mara, steady, imara, tuli, endelevu, standardize, mfano
kuendesha-gari: gari, dereva, kuongoza, usimamizi, safari
kuondoa: kuondoa, kuondoa, kuondoa, kuondoa, msamaha, kupunguza, acquit
kuapa: kuapishwa
hazina: kito
mbegu: mbegu, mbegu-za-mafuta, chembe
mnara: Rook
favorite: favorite
hivi-karibuni: hivi-karibuni, freshly, wapya
hivi-karibuni-siku za nyuma uliopo: 
ari: fahamu, ari, kuamka, tahadhari
samani: 
kamba: kamba, kamba, kamba
adventure: mradi, kamari
mrahaba: kutawala
sikukuu: chama, maadhimisho, karamu, likizo
kuelezea: maelezo, Tabia, depict, kuonyesha, kufafanua
sitini: 
wadogo: sura, kupima, uwiano, ngazi, staircase, stair
sherehe: ibada, kazi
uwindaji: kuwinda, muathirika, nyara, baada, risasi
whisper: kunong'ona
kwa-kiasi-kikubwa: kikubwa, kwa-kiasi-kikubwa, zaidi, hasa, wengi-wao-wakiwa, sana, sana, unategemea
ukristo: 
Mwanasheria: wakili, wakili
undani: kuenea, kupanua, ugani, upanuzi, kupanua, undani, kina
princess: 
madhabahuni: patakatifu
mtandao: mtandao, wavu, gridi-ya-taifa, tishu, turubai, bango
zambarau: magenta
kukusanya: kukusanya, kujilimbikiza, kuogopa, piga
uchaguzi: uchaguzi, wateule, uchaguzi, uchaguzi, nyangumi, uteuzi, kura
mimba: dhana, dhana, mimba, mtazamo, naona, dhana, kubuni, kukamata, kuwakamata, kukamata
mlevi: pombe
kumwaga: kuipindua, kumwaga, kumwagika, kuangushwa
kuinua: lifti, kuinua, kuinua, kuongeza, kuongezeka
ishara: ishara, ishara, ishara, ishara, mtazamo, mkao
kusimamia: usimamizi, kusimamia, kushughulikia, utawala, zinazoongoza, Bad, kudhibiti
kubadilishana: wabadilishane, kubadilishana, Swop, badala
uhakika-makala: 
Kaizari: Mfalme
kijijini: mbali, mbali, aloof
ugly: nasty, disgusting
wapole: 
roll: kitabu, coil
inch: mila, thumb
gazeti: jarida, kuwajulisha, diary
ndevu: ncha, kidevu
machozi: kuwatoa
tume: kamati, bodi
ilhali: wakati, wakati
kuvuka: kuvuka, makutano, kifungu, kupita, mpito, aisle
uhuru: huru, uhuru, uhuru, uhuru, uhuru
harufu: uvundo, perfume
kumi-na-nane: 
kihistoria: kihistoria, historia, historia
pato-la: jumla, jumla-ya-mabao, chafu, mbichi, ghafi
mzizi: shina, freshly
matope: udongo, lami, udongo, uchafu, ua
bibi: bibi
pazia: pazia, meli, meli
ukumbi-wa-michezo: ukumbi
kulinganisha: kulinganisha, kulinganisha, uwiano, uwiano, mapambano
mpinzani: mpinzani, mpinzani, ushindani, ushindani, kushindana
usawa: msawazo, usawa, usawa, usawa, sawia, par, bajeti
kocha: mkufunzi, daktari, mkufunzi, mshauri
ucheshi: ucheshi, humorous, hisia, comedy
riwaya: fiction, mpya, wapya
kisasi: chuki
wivu: wivu, wivu
gurudumu: baiskeli, mzunguko
kuteketezwa: kuchoma, flared
flash: umeme, mwanga, uangaze
kujenga: viumbe, kujenga, kujenga, kujenga, kufanya, ihakikishe, kutunga, yazua, kuzalisha
migogoro: clash, mapambano, mapambano, Tofauti, ajali, athari
laana: 
imprecatory-mood: 
wanyonge: duni
chanya: vyema
klabu: bat, kuingia
mafuriko: 
nafaka: nafaka, ngano
kutojali: kutojali, kutojali, uzembe
upeo-wa-macho: 
assumptive-mood: hypothetical-mood
mwinuko: mwinuko, sloped
maelewano: maelewano, tune
radi: 
utoto: 
goti: Lap
programu: maombi, Répertoire
kuumia: kuumiza, madhara, uharibifu, kuwadhuru, jeraha, kiwewe, kujeruhiwa, ukiukaji
kupokea: kupokea, mlango, mapokezi, uandikishaji, kukubalika, vocha, kupitishwa
kuwawezesha: uwezo, uwezo, kuamsha, kuruhusu, kustahili, kubeba, kutekeleza, basi, kuidhinisha
protasis: 
kuingizwa: slippery, slide, glide
mapinduzi: mapinduzi, mapinduzi, mzunguko, uasi, uasi
mkulima: mkulima
kiharusi: pigo, mapinduzi, kukimbilia, kinyang'anyiro
jukwaa: hatua, jukwaa, msingi
mjumbe: mjumbe, balozi, mwanadiplomasia
upendeleo: upendeleo, upendeleo, upendeleo, franchise, kutoa, mawaidha
iliyoandaliwa: taasisi, kuandaa, taasisi, mpangilio, kupanga
mwanafunzi: mwanafunzi, msomi, shahada-ya-kwanza
pango: 
mila: jadi, jadi, mila, kujisalimisha
janga: janga, huzuni
kuaga: kwaheri, bye
kukosolewa: kukosoa, kukosoa, mapitio
pamba: pamba
hospitali: hifadhi
kodi: nauli, kuajiri, kodi, kodi, kukodisha, kuajiri, kushirikisha, kukodi, katiba
gesi: 
kuepukika: inevitably
mauti: 
jani: karatasi, blade
uchapishaji: kuchapisha, kuchapisha, uchapishaji, kutangaza, matangazo, kutolewa, pato, utbredningen, toleo, kutangaza
uhasama: pabaya, uadui
tafsiri: kutafsiri, kutafsiri, tafsiri, janga, uhamisho
mazishi: mazishi, makaburi
unga: unga, unga, halisi, sahihi, sahihi, mlo
mawasiliano: yanahusiana, mawasiliano, mawasiliano, mawasiliano
kimapenzi: 
kibanda: Cottage, nyumba-ya-kulala wageni
kupendekeza: pose, kutoa, mwendo, pendekezo, pendekezo, kupendekeza, kupendekeza, pendekezo, jitihada, kuteua
mimetic: 
dola: 
mchana: 
kumi-na-sita: 
mkutano: mkutano, mkutano, mkutano, Configuration
koloni: 
mrengo: wodi, suite
simba: 
utamaduni: utamaduni
safu: safu, safu, pole, kifungu
ujanja: gumu, hila, ustadi
mchezo-wa-kuigiza: kujifanya, kishindo
utani: mzaha, wisecrack
ukungu: ukungu
dawa: madawa-ya-kulevya, dawa, dawa, dawa
kumi-na-nne: 
acid: sour, acidic
yaani: yoyote, k.v., hasa
mapato: lace
askofu: 
machungwa: 
umwagaji: bafuni, kuoga, bathtub
primitive: mapema, awali
kikapu: bin, mfuko
katibu: 
majani: nyasi
papara: hamu
wokovu: usalama, ukombozi, hi
hodiernal-uliopo: 
nia: lengo, nia, nia, nia, nia, nia, kujishughulisha, kujitolea
mvuke: mvuke
sumu: sumu, sumu, sumu
vipaji: uzuri, vipaji, kufuzu, uwezo, Répertoire
hali-ya-hewa: hali-ya-hewa
ufanisi: halali, ufanisi, ufanisi, ufanisi, ushawishi-mkubwa, muhimu, faida
kutofautisha: kutofautisha, kubagua, ubaguzi, upambanuzi, kutenga, to--kupasuliwa, kumfukuza, kuwatenga, secrete
osha: kuosha
kukiri: kukiri, imani, kutambua
yasiyo-na-msingi: takataka, mantiki, incongruous
makaa-ya-mawe: carbon
mtumbwi: 
muda: muda, muda, muda, ajali, wakati
delimitative-kipengele: 
mfupa: mguu
Jumatatu: 
Jumanne: tatu
Jumatano: nne
shirikisho: shirikisho-la, kati
kuhitajika: kuvutia, mazuri
mwakilishi: kuwakilisha, niaba, mjumbe, wakili, naibu, msemaji
sanda: lin, chupi
kuzama: kuzama, bonde, zinc
mpwa: mpwa, mjukuu, mjukuu
umwagaji-damu: umwagaji-damu, damu
kuzingirwa: surround, kiti
tumbo: tumbo, tumbo, tumbo, tumbo
shaba: shaba, shaba, mchele
mkutano-wa-kilele: kilele, juu, ncha
tano: tano
nafuu: kwa-bei-nafuu, Asili
kipekee-mtu: 
kumtia: kukabiliana-na, kuunda, kizuizini, reservation, kuwatoa, ulichukua, kuchukua, impound, kunyakua, kufahamu
uzio: ua
sanamu: uchongaji
artillery: kanuni
kukumbatia: kunyonya, snuggle
jirani: karibu, jirani, jirani, jirani, jirani, pembeni, mazingira, karibu, karibu
madhubuti: mkali, madhubuti, usahihi, tight, kali, hakika, kabisa, dhahiri, kukazwa, kali
kulungu: 
kichaka: 
reli: reli, reli
kutokwa: ukombozi, kupakua, kutolewa, kuachia, kufukuza
mrithi: kurithi
mwaloni: 
unpleasant: furaha, kupendeza, uneasy, annoyed, upsetting, nasty, wasiwasi
uvumbuzi: mzulia, ugunduzi, innovation
piano: 
kuwashawishi: kuwashawishi, kusherehekea, kuadhimisha
asiyeonekana: siri
vizuri-inayojulikana: maarufu, sifa-mbaya, maarufu
ukatili: 
majaribu: 
telic-kipengele: 
kiuchumi: uchumi, kiuchumi, mchumi, fedha
kimataifa: kimataifa, kimataifa
kuingilia-kati: kuingiliwa, kuingilia, kuingilia-kati, fujo, kujisumbua, disturbing, kupinga, waudhi, kuiudhi, kumnyanyasa, clash
mwanafalsafa: falsafa
kifahari: mtindo, delicate
ustawi: ukarimu, mafanikio, utoaji
uvuvi: 
kuiba: wizi, kuwaibia, wizi, swipe
mdomo: mdomo, mdomo, ukingoni
kustaafu: kustaafu, mstaafu, retiree, mafungo, wengine, burudani, kuondoa, kujiuzulu
kunyoosha: kunyoosha, kupanua, njia, bainishi, kipande, kifungu, fragment, chunk
nyumba-ya-sanaa: mkusanyiko
sambamba: sambamba, sambamba, mshirika, bandika
atelic-kipengele: 
bara: bara
kikwazo-mood: kikwazo-mood
tai: necktie, tai
kiini: kiini, kiini, ngome, toleo-la, simu, simu-ya-mkononi, simu-ya-mkononi
yai: koko
bandia: yalijengwa
wakati-huo-huo: wakati-huo-huo
mgogoro: kushuka, hukumu, hukumu, dharura
polite: hisani, walioelimika
chakula-cha-mchana: kifungua-kinywa, chakula-cha-jioni
pine: taya
kushinikiza: itapunguza, gari, kuhamasisha, kukuza, kutia, shinikizo
muungano: muungano, ligi, muungano, kuchanganya, ushirikiano
kiuno: hip, maisha, hai, katikati, katikati, katikati
miujiza: ajabu
baharia: 
usafi: usafi-wa-moyo
jamhuri: demokrasia
simu: simu, simu
mjeledi: 
shati: fulana
kuanzisha: kuanzishwa, kuwasilisha, kuanzisha, kuanzisha, atatoa, utoaji, kupendekeza, rufaa, kuingiza, kutoa, utoaji, depict, kuonyesha
sofa: armchair
sweep: kuifuta, tafuta, Scan
mwizi: bosi
kurejesha: kuhifadhi, hifadhi, reservation, kurejesha, kuweka, kuzuia, kizuizini, kuhimili, kushirikisha, utunzaji, kuendeleza, kuhifadhi, kudumisha, kuambatana
channel: mfereji
utu: tabia
mageuzi: uboreshaji, marekebisho, mageuzi, marekebisho
kutishia: tishio, kutishia, hatari, kutisha
palm: maple
msemaji: msemaji
kizingiti: kizuizi
kushawishi: kushawishi, kuwaomba, sababu, kuwaonya, Excite, pose, kusababisha, asije, evoke
mkuki: vipuri
nadhifu: tidy, safi, taut
kikao: mkutano, mkutano
mateso: mateso
uchafu: uchafu, mvua, mafua, muggy
ridge: juu, braid, stack, comb
msafiri: mgeni, msafiri, utalii, abiria
kinu: kiwanda, viwanda, kupanda
ramani: kadi, mchoro, graph, nauli, tiketi
collar: surround
kuchukua-nafasi-ya: badala, hubadilisha, vipuri, mbadala, mbadala, badala, makazi-yao, kubadilisha, kutofautiana, marekebisho, ndogo
makusudi: kukusudia, makusudi, ufahamu, fahamu, purposive
bia: painti
velvet: 
mvuto: kivutio, kuponda
mahubiri: kuhubiri
matumizi-mabaya: potofu, kimakosa
kundi: kundi, kundi, kundi, swarm
kumi-na-tatu: 
kuhalalisha: kibali, kuwasihi, wakili, uhalali, haki
Ijumaa: fedha, venus
brush: comb
download: 
cream: ice-cream
cliff: mwamba, ukingoni
jury: 
monster: kubwa, monstrous
waliohifadhiwa: kufungia
sufuria: sufuria, jar, chombo
senti: cent
kusisitiza: kubwa, kutia, kudai, kusisitiza, kusisitiza, yanaendelea, msisitizo, zinahitaji, wanasema
apple: 
kujadili: mjadala, kujadili, wanasema
background: 
nukulu: kukabiliana, rewrite
upimaji: mara-kwa-mara, cyclic
burudani: burudani, mburudishaji, burudani, burudani, kuwakaribisha, furaha, hobby
virusi: 
kitoto: kitoto
kutafakari: kutafakari, kutafakari, kutafakari, kuonyesha, depict
kubadilisha: kubadilisha, kubadilisha, kubadili, mutation
muhtasari: profile, contour, muhtasari, mchoro, kuwafichua, maelezo-ya-jumla, rasimu
opera: 
idhini: kuidhinisha, disapproving, ridhaa, kukubalika, madai, kupitisha, kuidhinisha, kupitishwa, applause
kumsaliti: yatangaza, kudanganya, disappoint
kuwaadhibu: hatiani
elbow: bracket
attachment: appendix, uhusiano, kiraka, kiungo, kontakt
kukarabati: marejesho, uboreshaji, upya, marekebisho
tuhuma: tuhuma, mtuhumiwa
sabini: 
maandiko: Biblia, Muswada
shimo: shimo, excavation, pool
machafuko: machafuko, machafuko, machafuko, usumbufu, fujo, upsetting, kuingiliwa, aibu
binary: dyadic
Abbey: utawa
mshale: 
huwa: kutozwa, kawaida, kawaida, kawaida
kufafanua: kina, kufafanua, kufafanua, kuendeleza, ngumu, gumu, Fanya-mazoezi
uaminifu: kujitoa, waaminifu, uaminifu, uaminifu, uaminifu, uaminifu, uaminifu, imani, imani
sarafu: fedha
hutetemeka: shiver
uhamishoni: risasi, nje-ya-nchi
mitambo: mashine, fundi, mhandisi
mtego: mtego, hatiani
keki: pie, cookie, unga
sir: Bwana, mister, bwana, muungwana
kubisha: kubisha, haunt, mzunguko, hover
kumi-na-saba: 
asali: 
wadau: bet, uwiano, kabari, rundo, kushiriki, sehemu, mchango
kutembea: hoja, hila, kutembea, kutembea, kanyagio, hatua, stride, rung
matofali: tile
themanini: 
kwa-bahati-mbaya: bahati-mbaya, unlucky, cha-kusikitisha
kushauriana: kushauriana, rejea
legend: hadithi
mavuno: mazao
kukuza: kuinua, kukuza, kuanzishwa, kuwasilisha, utangazaji
jiko: jiko-la, slab, tanuri
waasi: uasi, uasi
mtindo-wa-zamani wa: kale
jazwa: kupandisha, kuvimba, mfumuko-wa-bei, uvimbe, kupanua
swamp: Marsh
dressing: mchuzi, bandage
kujiepusha-na-anasa: hermit
meneja: wakili, mkuu, bosi, msimamizi, mkurugenzi, msimamizi, kiongozi, mtendaji
chorus: gari, timu
mantiki: haki, mantiki, mantiki, mantiki, busara, sababu, busara
usindikaji: 
wolf: 
carpet: sakafu
mambo-ya-kale: 
rutuba: 
filimbi: filimbi
jibini: 
kuuma: kuwakata, kuchonga, kuumwa
kukaribisha: mwaliko
Makuu: nyumba
bandari: bandari
tanga: stroll, kuhamia, kuongezeka
mazao: mazao
Navy: baharini, meli
mask: facade, mdudu
kalamu: kalamu
mboga: mboga
maonyesho: maonyesho, kutoa, kuonyesha, kuwasilisha, dalili, yatokanayo
suruali: trouser, suruali
rushwa: kashfa, uchafuzi
baraza-la-mawaziri: kabati, chumbani, WARDROBE, choo
supu: 
upasuaji: upasuaji, upasuaji, operesheni
posho: badala, mbadala, fidia, apposition, mgao, appendix
kupeleleza: 
reckless: kutojali, untidy
uvumi: uvumi, uvumi
ishara: 
abstract: muhtasari, mtaala
Alhamisi: 
trafiki: mzunguko, usafiri, usafiri
usanifu: 
ufa: mwanya, kupasuka, aondoke, kujiondoa, fracture
pambo: mapambo, mapambo, kupamba, vito, trim
kubadili: kinyume, inverse, kubadili, Geuza, mbaya, Juu-chini, nyuma
amuse: kuwakaribisha, burudani, amused
ahueni: marejesho, kuwaokoa, uboreshaji, uamsho, kuokoa, kurejesha, upya
lami: taksi, lami, lami, lami, cover
maamuzi: muhimu, muhimu, kuamua, kuamua, assertive
hasi: mbaya
tamasha: tamasha
kupunguza: kupunguza, kupunguza, kupunguza, kupunguza, kupunguza, kuharibu, kufyeka, trim, Ondoa, kuunda, kuzuia
uhaini: 
wawindaji: 
nyoka: mtambaazi
betri: 
nta: mshumaa
upelelezi: mpelelezi
uchambuzi: kuchambua, utafiti, utafiti, kuchunguza, kukagua, utafutaji, azimio, kuvunja, kuvunja
mkazo: mkazo, shinikizo, kusisitiza, kusisitiza, alisisitiza, lafudhi, madai, kipaumbele
kuogelea: kuogelea
bahasha: hali, kielezi, ala
yeyote: ambao, mtu, ambaye, mtu-yeyote
sigara: sigara, tumbaku
motor: magari, injini, nia, pikipiki
kujitolea: kujitolea, hiari
majibu: tendaji, majibu, kujibu, kuguswa, maoni
mizigo: mizigo, mizigo, shina, sanduku
viziwi: 
juisi: dondoo
unyenyekevu: unyenyekevu, kawaida
wizara: 
ngono: ngono, kujamiiana
mduara: 
shoka: 
diamond: 
mbadala: vipuri, mbadala, mbadala, chaguo, naibu, badala, kupandikiza
echo: 
kujizuia: kuzuia, taksi, kiwango-cha-juu, kizuizi, kikwazo
utambulisho: kutambua, kitambulisho, ishara
screen: kuonyesha, pazia
wavivu: bovu
momentane-kipengele: 
Compact: mkataba, imara, mnene
drift: operesheni, deflection, tabia, mwenendo
kutoweka: haiko
ray: boriti, aisle, radius
wino: 
mkubwa: kubwa, grand, mkubwa, kubwa, kubwa, kubwa, enormously
pishi: 
kukumbukwa: maarufu
glare: mwanga, uangaze, uzuri
seneti: bunge
jeneza: 
msamaha: 
kumeza: sip
kujiingiza: kujiingiza, kukidhi
swing: 
meadow: malisho, kabla, lawn
tata: ngumu, magumu, kisasa, kiwanja, gumu
kujiuzulu: kujiuzulu, kustaafu
wanyenyekevu-kusajili: 
njama: njama
pilipili: 
GPPony: 
mgombea: mwombaji
fox: 
chimney: fireplace, stack
mamlaka: mamlaka, hukumu, hukumu, umahiri
kilimo: kilimo, kilimo
usahihi: usahihi, usafi-wa-moyo, usahihi, usahihi, ukweli
zamani-marehemu: 
kidemokrasia: 
bud: Knob, chipukizi
blanketi: dari, cover, sakafu, chanjo
mvua-ya-mawe: ulichukua, kusalimiana
nguruwe: kupanda
umbo: takwimu, sura, mitini, facet
pembe-za-ndovu: 
classical: classic, jadi
waangalizi: msimamizi, mgeni
tembo: 
misumari: msumari
nyuki: 
kuzika: mazishi, kupachika
muigizaji: mwigizaji, Performer, mdai
jasho: 
polish: dialect
udanganyifu: udanganyifu
kutokuwa-na-uhakika: uhakika, utata
sekondari: madogo, kati, wastani, wastani, tawala, katikati
mara: folding
vijijini: mkoa, mashambani, mwanakijiji
tunaugua: 
kufanana-na: sawa, kufanana, kuwakumbusha
kunukuu: dondoo, quotation, unquote, kuwakopesha, kukopa, mkopo
gunia: kumfukuza, kufukuzwa, mfuko
kero: usumbufu, kuingiliwa, usumbufu, ugumu-wa-maisha, boredom, kujisumbua
sindano: sindano, sindano, stylus, siri
kudhibitiwa: kudhibiti
kuku: kuku
thabiti: kuendelea, sambamba, thabiti, thabiti, sahihi, niche, husika, madhubuti, utaratibu-wa-kudumu, uwiano, steady
pipa: ndoo
habitual-kipengele: 
mtaalam: mtaalamu, uzoefu, maalum, maalum
kumvutia: kuathiri, hisia, kuvutia
mizeituni: 
van: valve
kikwazo: kupinga, kikwazo, ulemavu, kizuizi, setback
nod: 
wa-kambo: kulima, mchicha, kukuza, kuwezesha, kulisha, neema, neema
ufafanuzi: ufafanuzi, kitambulisho, maelezo, uamuzi
siku-ya-kuzaliwa: maadhimisho-ya-miaka
nyundo: 
harufu-nzuri: 
marudio: nzito, marudio, kurudia, kuiga, rehearsal
yasiyo-na-maana: ndogo-ndogo, muhimu
kick: kugonga, mapema, soka, calcium, soka, pigo
kuchimba: excavate, drill, excavation
pet: 
fuvu: 
bunge: bunge, wabunge, sheria
kisigino: kuruka
frown: 
patent: 
bilioni: 
kemikali: kemia, kemikali, duka-la-dawa
majaribio: majaribio, majaribio
kuiga: kuiga, simulation, kuiga, kuzaliana
skirt: mwamba
isiyo-ya-kawaida: kawaida, usiokuwa-wa-kawaida, isiyo-ya-kawaida, ajabu, ajabu, ajabu, kawaida, phenomenal, incredibly, sana, oddly
kila-wiki: 
kiufundi: mbinu, teknolojia, kitaalam, tech
uoto-wa-asili: 
jogoo: Rook
sunrise: 
maisha: maisha, maisha, maisha, hai
kuchangia: mchango, kuchangia, ushirikiano, kukuza, kuwezesha
ndoano: yanahusiana, kuungana, correlate, bracket
tiger: 
kupenya: kutoboa, kupitia, ushawishi-mkubwa
sleeve: mkono
barabara: barabara
wanamgambo: 
shimoni: mfereji, shimoni
uadilifu: 
kumi-na-tisa: 
kikaboni: 
theolojia: 
kuelea: mashua, hover, meli
mchawi: 
kuchoka: boring, boredom
kidiplomasia: mwanadiplomasia
studio: studio, warsha, utafiti
kisichozidi: uchokozi, ubakaji, kuondokana-na, kuvuka
champagne: 
kuhamasisha: kuhamasisha, msukumo, moyo, Vuta
bendera: bendera, bango, tiketi
talaka: talaka
bolt: umeme, msumari, twist, screw
mshipa: ujasiri
watazamaji: watazamaji, walemavu
povu: Bubble
changarawe: 
apron: Lap
sayari: 
rafu: rack, kabati
shabiki: 
kitropiki: 
awamu: picha, hatua, kipindi, kujenga, hatua
holela: hiari
kutamka: matamshi, lafudhi, kutamka, yazua
zebaki: 
huenda: crawl, kupanda, kondoo
kujiua: 
mwandishi-wa: mwandishi-wa-habari
kuwanyima: kunyimwa, kutengua, kuwatenga, Ondoa
wenye-ujuzi: ustadi, ufanisi, uwezo, vipaji, uzoefu, waliohitimu, wajanja
balcony: mtaro, ukumbi
uma: 
mfanyakazi: mfanyakazi, mfanyakazi, kufanya-kazi, sababu, tegemezi, karani
mwajiri: bosi
upana: upana, usambazaji, pana, nusu
irritated: annoyed, msisimko, kuiudhi, kumfanya, kusisimua
kuwashitaki: kukemea
pensheni: kustaafu, syntax
kitendo: kitendo, kuguswa
tumbili: 
kukubalika: kukubali, kukubalika, plausible
saini: 
orthodox: kihafidhina
kejeli: mzaha, twist
kitalu: mashamba
kusita: chuki
kuagiza: kuanzishwa
mwenge: 
sarufi: kisarufi
amana: kujilimbikiza
ukoloni: 
yacht: kivuko, mashua
consequential: matokeo, episode, muhimu, makubwa, kuongoza, maarufu, mno, muhimu, kikubwa, maana
kuba: 
unene: 
ukaidi: assertive
misuli: 
ukubwa: ukubwa, wingi, amplitude, kupima, wingi
RUB: 
waoga: 
kuunganisha: kuunganisha, kuunganisha, kuunganisha, kutumia, ukanda
toast: Snack
panya: panya
silabi: 
pat: kupiga-makofi, kubisha
mazungumzo: kuwasiliana, mazungumzo
upande-wowote: neuter
bidii: bidii, chini-ya-ulinzi
utata: kupingana, utata, utata, utata, utata, utata, Kitendawili, kinyume-na, ugomvi, pingamizi
kufikia: kutambua, kufikia, kuwasili
mbuzi: 
kustawi: mafanikio, kufanikiwa, boom, kito, gem
kulazimisha: nguvu, kutekeleza, kuamua
bila-majina: 
rasmi-kusajili: 
ndama: haraka
mwongozo: kuongoza, mwongozo, brand, uongozi, vitabu-vya-kiada, maelekezo, kiongozi, msimamizi
kuyeyuka: kuyeyuka, thaw, fusion
kufuta: kufuta, kufuta, kufuta, kuondoa, kuwatenga, kukomesha, kuondoa, kuondoa
mwavuli: parachute
Boot: kiatu, shina
madini: madini, madini, chuma
truce: kusitisha-mapigano
bata: 
mipango: 
sabuni: 
doll: mtoto, toy
mifupa: 
villa: Fairy
kushona: kushona, kushona
kupatanisha: kupatanisha, kuunganisha, kuunganisha
aaaa: 
kukomaa: watu-wazima
sungura: 
kondakta: ngazi, Mrakibu, dereva, kiongozi
utegemezi: wanategemea, utegemezi, tegemezi, addicted, mshikamano, mtazamo
mchezaji: Performer
wadudu: wadudu
mgahawa: 
owl: 
radical: wapiganaji, msimamo-mkali, maendeleo
mkazi: mwenyeji, asili, ndani, asili
joka: kite
auditory-evidential: 
kiu: 
msiweke: muda-mrefu
hesabu: mahesabu-ya, hesabu, kompyuta, calculus, hesabu, akaunti, sensa
udhibiti: udhibiti, kudhibiti, kikwazo, kizuizi, makazi
Meya: 
wachache: 
upatikanaji: kupata, faida, kupata, upatikanaji, upatikanaji
mkongwe: mwandamizi
orchestra: 
Bacon: 
hasara: hasara, kunyimwa, mbaya, flaw, ulemavu
kitambaa: nguo, mavazi, kitambaa, turubai, tishu
mwanamuziki: mtunzi, kimuziki
kiakili: kiroho, akili, ari, mana, subjective
kushirikiana: kushirikiana, uhusiano, kiwanja, chama, mshirika, kuchanganya, madhubuti, sambamba, mwendelezo, linker
duni: anakosa, hayatoshi, upungufu, duni, duni, Awkward, kutosha, bahati-mbaya, incongruous, muafaka
mbunifu: 
lemon: 
kikohozi: kukohoa
maumivu-ya-kichwa: 
mpangaji: mpangaji
uzazi: uzazi
kupona: tiba, kuboresha, kuongeza, uboreshaji, kutibu
tisini: 
random: nasibu, randomize, ajali
kijiko: ndoo
puto: 
chaki: plasta
inferential-evidential: 
mchapishaji: mhariri
siki: 
ash: gray, gray
expletive: kuapishwa
kufufua: uamsho
wanahusika: mazingira-magumu, nyeti, busara, hisia, kutozwa
handaki: Subway
puzzle: kuwavurugia, utata
utaratibu: utaratibu, utaratibu, utaratibu, mashine
hisabati: hisabati, hisabati
fade: 
ini: 
sublative-kesi: 
kuzamisha: kupiga-mbizi, kupachika, kushuka, kuporomoka, matukio, mteremko, elekea, sloped, gradient, loweka
kitengo: umoja, chombo, moduli, mdomo, umoja
ukiritimba: kipekee
kamari: kamari, mchezo, mechi, kibali, toy
manowari: chini-ya-maji
tetemeko: tetemeko
maabara: maabara
cork: uyoga, Kuvu, cap
binafsi-kudhibiti: 
buddha: 
kuunganishwa: knitting, weave, kutia, knitted, fundo, node, braid
ubalozi: 
farthest: 
declarative-mood: 
kichocheo: faraja, motisha, kichocheo, motisha, nia
chocolate: pipi
bahati-mbaya: nafasi, mchanganyiko, bahati-mbaya, nasibu, ajali, mechi
glove: 
kupiga-magoti: 
jiografia: 
uwekezaji: kuwekeza, mradi
matusi: amesema, mdomo, matusi
mlinganisho: usawa, kufanana, mshikamano, ujamaa, uwiano
kidunia: kuweka
kipanga: tai
saikolojia: 
fasten: yanahusiana, kumfunga, kuungana, bandage, kuwakamata, ambatisha
chakavu: kufuta, takataka, takataka, fragment
jukumu: kapi, kushiriki, hisa, mshiriki
dozi: wingi
salmon: 
pudding: 
magnetic: kuvutia
pampu: bomu
oksijeni: 
cheti: 
medali: 
rhetoric: 
scrape: mwanzo, kufuga
kasia: koleo, fin
darubini: darubini
mkufu: kushindwa, kuweka
herufi: uchawi
whiskey: 
Willow: malisho
ngamia: 
amateur: 
exit: kuuza-nje, outlet, kuibuka, pato
wasifu: 
punda: 
kila-mwezi: 
kupuuza: kutelekezwa, waache, kumfukuza, ujinga
likizo: kuondoka, likizo, burudani, wengine
click: clique, snap
mviringo: 
elastic: mpira, rahisi
kamusi: lexical, msamiati
ham: mguu, kitako
upinde-wa-mvua: 
hutumia: matumizi, kutumia, kupeleka
mate: mate, ulimi
tank: hifadhi, chombo, VAT
mwenzake: vyama-vya-ushirika, wenzake, mate, mshirika
butterfly: 
chati: mchoro, graph, graphic, graphics, ratiba, mpango
pacha: mara-mbili, mbili
kujitegemea: huru, uhuru, mbali
mianzi: 
muuzaji: muuzaji, muuzaji, salesperson, mfanyabiashara
mkusanyiko: kujilimbikiza, mkusanyiko, mkusanyiko
mkaguzi: mkaguzi, Mrakibu
tonge: fragment, kipande, bit
ndoto: ndoto
jam: jelly
makumbusho: 
alfabeti: kialfabeti
kuwatawanya: kupeleka, kuenea
uvamizi: uvamizi, uvamizi, shambulio, kukera, mwanzo, kubwa, kukomesha
kufichua: kutangaza, yatangaza, kugundua, kuwafichua, tengua, kuchapisha, kugundua
kuoza: uozo, kuzorota
fujo: fujo, fujo, uvamizi, uchokozi, kukera, assertive
msuguano: 
gati: 
buibui: 
viazi: 
marekebisho: kurekebisha, marekebisho, kurekebisha, marekebisho, marekebisho, mapitio, ukaguzi
uchoyo: tamaa
mapema: mapema, mapema
kuzidisha: kugonga, kuzaliana, mapema
spin: mzunguko, mzunguko, ond, thread, twist
takwimu: takwimu, takwimu, kuzungumza
kalenda: ratiba, ratiba, diary, mtazamo
uteuzi: kuteua, uteuzi, uteuzi, ushiriki
trilioni: 
Attic: upepo
usawa-wa-kijinsia mood: 
maombi: 
majina: 
kutoridhika: 
maambukizi: kuwaambukiza, kuambukizwa, mpito, maambukizi, kuambukiza
mtungi: jar
shrug: papatika
waanzilishi: kuu, avant-garde
upungufu: chaguo-msingi, gaffe, upungufu, uzembe, kutelekezwa, kuondoa
kabichi: 
riadha: riadha, hisabati, mwanamichezo
ulevi: sukari
idiophone: 
lever: tafiti
seneta: 
iris: 
ant: 
mdudu: 
wajawazito: wajawazito
precipitate: hapa-na-pale, mashapo, kasi, haraka, kuharakisha
kifundo-cha-mguu: 
uainishaji: aina, kuainisha, classifier
kutofautiana: kutofautiana
wrap: pakiti, sehemu, pakiti, mfuko, spool, wrapping, cover, kufunika
curly: curl, hurl, coil, kitabu, helix
kiberiti: kiberiti, iliyovunjika
kuandikisha: 
kuibuka: itaonekana, kuonekana, kutokea, kuibuka, kujiondoa
frog: 
kupindukia-kesi: 
sifongo: Kuvu, uyoga
annoying: upsetting, fujo, kujisumbua, fuss, waudhi, boring, fastidious, disturbing
squirrel: 
grind: nusu, nusu
irrealis-mood: 
volkano: 
ndani-ya-nyumba: ndani, ndani-ya, ndani-ya, majengo
kunyonya: kutumia, kunyonya, mafanikio, kuchunguza
kijiolojia: 
pasipoti: 
kinyume-cha-maadili: matata, bovu
biskuti: cookie
ushirikiano: kushirikiana, ushirikiano, ushirikiano, kusaidia
kibao: risasi, kidonge, slab
relaxation: slack, walishirikiana, burudani, kupumzika, kufurahi, burudani
chembe: atomic, chembe, mtu-binafsi
misaada: misaada, misaada, msaidizi
piramidi: 
mzunguko: mzunguko, mzunguko, mzunguko, mzunguko, mzunguko, baiskeli, baiskeli
nap: 
kinyume-cha-sheria: haramu
makucha: claw, toe
shyness: aibu, contraction
kupatwa: Obscure
kinanda: slant
ufagio: 
jopo: sahani, slab, uchoraji, bodi, kundi, kamati
elimu-ya-nyota: 
maze: 
udhamini: udhamini
kobe: 
mshauri: mshauri, kushauri
fiber: fiber, kifungu
kriketi: 
mbaazi: 
kukabiliana-na-hali: kukabiliana, fixture, kufuata, muundo, kurekebisha
pembe-tatu: 
mweka-hazina: 
hidrojeni: 
tete: delicate, crisp
printer: 
hulisonga: 
sugu: sugu
kukabiliana: kukutana, kukabiliana, kukabiliana, kukabiliana, kuondokana-na, kukabiliana-na, contrastive, kushughulikia
mtanziko: 
uhandisi: mbinu, kitaalam
kamera: chumba
kuomba-msamaha: kuomba-msamaha, msamaha
lick: 
dancer: 
uhamiaji: kuhamia, uhamiaji
tennis: 
mgongo: 
kaanga: 
kufungwa: kufungwa, kufungwa
kumchoma: kuumwa, kutoboa, kunyakua, jaribio, ilijaribu
nywila: ishara, cue, kauli-mbiu
ncha: ncha, ncha
mkakati: kimkakati
quartz: 
mkasi: kuvuta, Drag
doria: 
glacier: 
halfway: nusu, sehemu, nusu, katikati, katikati
mkataba: mkataba, mkataba, mkataba, mkataba, kibali
koni: tapered
ulinganifu: 
watengenezaji: uzalishaji, uzalishaji, kujenga
mshtakiwa: wakili
msikiti: 
chess: 
toll: malipo, ada, muathirika, takwimu, matatizo
cherry: 
kuenea: kina, sana, kuenea, pana, pana
mashaka: kuporomoka
lori: lori, mizigo, freighter
haradali: 
asilimia: per--cent, cent
mnada: kuuza
ungo: 
unsteady: msimamo, kuyumba, uhakika, uneasy
sumaku: 
Suck: kunyonya, loweka
islam: 
njongwanjongwa: toe, tayari, tayari
utando: 
kunyoa: 
guitar: 
shiny: mkali, lokal-tid-i, kipaji
elm: 
kuongezeka: kuongezeka, hover, koo, ndege
pronoun-marker: 
kikuu: kipande-cha, bracket, muhimu, msingi, msingi, kuu, kuu, mwisho, msingi
spice: zest
dhamana: dhamana, uhakika, ahadi, kuhakikisha
carrier: vector, mdai, mbeba-mizigo
vibration: resonance
tease: asije, waudhi, kuiudhi, sihiri
jembe: kutatua, jembe, hijack
kisaikolojia: mwili
gutter: kukimbia
Comet: mkosaji
medieval: katikati
shomoro: 
fidia: remunerate, fidia, kukabiliana, kuwakomboa, babies, kufanya-up
plastiki: 
footnote: 
obiti: tabaka-la, darasani, trajectory
frugal: kawaida
gofu: 
sifuri: null
chip: kipande, fragment, kipande, chunk
kuonea: kukandamiza, kukandamiza, depress, overwhelm
yawn: kuyeyuka
kukosekana-kwa-usawa: 
mole: ufuta, udongo
ufinyanzi: 
mama-wa-nyumbani: 
Rye: 
muasi: kukiuka
wavumilivu: kuvumiliana
kiinitete: tairi, tairi, fetal, fetus, kiini
miner: madogo
kupongeza: kufahamu, applause, kupiga-makofi
chachu: enzyme, unga
premium: bonus, tuzo, tuzo
plum: 
kufilisika: kushindwa
kilimo-cha-umwagiliaji: 
mnanaa: pipi
ubepari: ubepari
elasticity: kubadilika
papa: 
recruit: hila, novice
kuhifadhi: kuhifadhi, kuhifadhi, duka, kuokoa
uhalisia: 
tangawizi: 
ambulance: 
kulinganishwa: sawia, sawa
mkoba: kwingineko
grimace: mug, grin, wriggle
mwanasayansi: kisayansi, msomi, mtafiti, mpelelezi
gut: matumbo, bowel
equanimity: 
radio: radium
lisilo: kupingana, muafaka, incongruous, muhimu
maharage: mbegu-za-mafuta, pea, karanga, nafaka
isiyo-rasmi: 
mjukuu: mjukuu, mjukuu, mpwa, ukoo
kutokubaliana: pingamizi, mjadala, mzozo, hawakubaliani
steak: kuwakata
nitrogen: 
wembe: 
zinazokinzana: Tofauti, contrastive, kupingana, kinyume, kinyume
propaganda: kutangaza, utangazaji, matangazo, matangazo, kutangaza
fireworks: 
pop: snap, bang
undress: 
mitaro: 
madhara: madhara, hatari, mbaya
Judaism: 
inayosaidia: nyongeza, kuvipa, Aidha
Lens: lentil, tochi
pegative-kesi: 
kansa: 
pawn: mikopo, askari, ahadi
mhadhiri: 
leak: kumwagika, hasara, kushuka
kuhitimu: haki, sifa, stahili, waliohitimu, kufuzu
msongamano: msongamano, kiwango
introduktionsutbildning: 
kutafuna: 
talkative: mawasiliano
lobster: 
discount: msamaha, kuuza, mawaidha
teksi: 
uongozi: uongozi, mfumo
jade: 
gwafua: 
mjusi: 
maporomoko-ya-maji: 
kuwakatisha-tamaa: depressing, tamaa, disappoint, tamaa, nasty
Veto: kukataa, kuwaeleza, kukataa, kumfukuza, kukasirika, bet, traction
urais: rais
mnunuzi: mteja
gallon: 
mbu: 
kupotoka: deflection, kuvuruga, kukabiliana
kushindana: kushindana
mosaic: 
kuziba: kontakt, vocha
squat: ota
vyakula-na-vinywaji: 
kikomunisti: 
amaze: inashangaza, ajabu, stunning, kupotosha, kuwavurugia, stun, kuwashangaza
prosecutive-kesi: 
constellation: galaxy
dikteta: 
preoccupation: ajira, wasiwasi, wasiwasi, wasiwasi
satellite: 
slipper: viatu
consonant: 
takriban: makadirio, takriban, approximative
ajira: ajira
msaidizi: msaidizi, msaidizi, kuvumilia, bracket
lotus: 
lettuce: saladi, mchicha
chloride: 
vimelea: Kuvu, bakteria
nata: KINATACHO
sehemu: 
kernel: 
jipa: kujifanya, kuiga
Byte: 
secretion: secrete
waziwazi: wazi, hadharani, inaonekana, wazi, dhahiri
sanjari: mechi, mzuri, inafaa, mkataba, vinavyolingana
ballet: fin
mkojo: piss
vitunguu: 
ilipita: siku-za-nyuma, kupita
uchumi: uchumi, uchumi, kuokoa
daraja-la-kati: 
agile: haraka, haraka, haraka, haraka
koleo: koleo, kipande-cha
kufulia: kuosha
strawberry: 
mijini: kiraia
embarrass: tamaa, ulemavu, aibu, kuwashangaza, kuwavurugia
daftari: 
albamu: 
baseball: 
vuta: 
makofi: 
Mmoja: mshiriki, mshiriki
karakana: 
utambuzi: uchunguzi, kutambua, utambuzi, kutambua
mkongojo: 
kujipatia: usaliti, kukwanyua, kuwalazimisha
usajili: rekodi, kusajili, kurekodi, kuingia
mumunyifu: kufuta
phosphorus: 
kimuundo: muundo, Configuration, config
gundi: 
Thesis: dissertation
fundi: fundi
banana: 
axiom: theorem, frank, dhahiri, dhahiri, wazi, kanuni
ubavu: gia
nickel: hakuna
pi: bye, pie, silicon
basi: basi
censor: udhibiti
kombora: roketi
sausage: moto-mbwa
kudanganywa: kazi, kuendesha, uendeshaji, hila, kudanganya, kushughulikia
nyanya: 
kuimarisha: kuimarisha, kuimarisha, kuthibitisha
tundu: uondoaji, outlet, kontakt, kiota
potassium: 
retrieve: kuchota, kuokoa, kurejesha, marejesho
virtual: halisi, halisi, halisi
algebra: 
daktari-wa-meno: jino
macho: Visual
Budge: mawaidha, concessive, hoja, kusonga, hubadilisha
biolojia: 
ukosefu-wa-ajira: 
caterpillar: 
solo: tofauti, phenomenal, Diskret, udongo, peke-yake
kisakuzi: 
kijijini-siku-za nyuma uliopo: 
kihistoria-uliopo: 
nyuklia: kiini, atomic
wigo: 
sodiamu: 
hysteria: 
mdhamini: msimamizi
mateka: mikopo, ahadi
gourd: pumpkin, mafuta
kasoro: kasoro
uwazi: uwazi, wazi, moja-kwa-moja
Mwiba: kabari, lace, ncha, msumari
kipaumbele: kipaumbele
pedestrian: kutembea
atheism: 
kufuatilia: kufuatilia, kusimamia, kuangalia, kujiingiza
jimbo-la-uchaguzi: wapiga-kura, wapiga-kura
ulafi: 
probe: uchunguzi, uchunguzi, uchunguzi, kuchunguza, uchunguzi, utafutaji, kesi
platinum: 
mbili-idadi: 
mapafu: 
super: phenomenal, enormously, incredibly
kitoroli: inasimamia, gari, wagon
ndani-ya-nchi: ndani
kuchocheana: Excite, waudhi
petroli: petroli
figo: 
kupora: wizi, uporaji, nyara, nyara, kuwaibia, haul
tathmini: makisio, kukadiria, kutathmini, daraja
arseniki: 
konokono: helix
panzi: 
equation: formula, usawa
ujamaa: ujamaa
filter: 
hisia-evidential-mood: 
kuongeza: kupanua, pana, kuongeza, kuongeza, kuongeza, kupanua, upana, azimio, ugani, upanuzi
emit: uzinduzi, kutupa, exhale, risasi, basi
leash: kukodisha, kamba
mandarin: 
jockey: 
pneumonia: 
mshikamano: kuunganisha, mkutano-wa-hadhara, mshikamano, umoja, kufanana
pata: kina, kitanzi
longitudinal: wima
mgao: mgao
skate: ski
exponent: ripoti, kielelezo
ulemavu: ulemavu, kukosa-uwezo, kasoro, kamili, walemavu, flaw, dosari
obsession: kumnyanyasa
mgawo-huo: mgao, kutenga, utoaji, upendeleo, zoezi
mpiga-picha: picha
delta: kushiriki
digital: takwimu, numeral, namba
Bitch: 
Eyelid: 
diagonal: 
subconscious: 
eyebrow: 
kuchafya: 
hilarious: kwa-moyo-mkunjufu, furaha, furaha, funny, burudani, amusing, amused, humorous, ujinga
Uhindu: 
wakimbizi: wahamiaji
kuhamisha: spaceship, inasimamia, usafiri, usafiri
protini: yai--nyeupe
dampo: rundo, stack, kukomesha, takataka, takataka
kuboresha: 
matapishi: 
jeni: vinasaba, maumbile
freshman: 
sosholojia: 
boga: pumpkin, kuponda
mvuvi: 
kikanda: kata, eneo, zone, wodi, nyanja, sekta, pembeni
mwendo-uphill: 
retrospective: siku-za-nyuma, kujichunguza
tornado: 
inversion: Geuza, kinyume, kubadilishana, inverse
filamu: televisheni, filamu
cube: 
tija: utendaji, pato
karoti: 
Masi: molekuli, substrate
conglomerate: clique, kundi, nguzo
mhasibu: mkaguzi
tango: chaguo, koo
orgy: 
kutengenezea: kufuta
phosphate: 
primer: chambo, marafiki, kuanzishwa
alkali: 
gymnastics: fitness
comma: kukosa-fahamu, chama
mwendo-kuteremka: 
kuharibika-kwa-mimba: utoaji-mimba, Asili, kushindwa
ganda: ganda, ala, peel
wafadhili: 
manganese: 
psychologist: 
chlorine: 
keyboard: 
wasomi: 
mabano: 
mchezo-wa-raga: 
kidonda: kidonda, jeraha, kiwewe, jipu
Inflected: 
nibble: 
quantum: kiasi, wingi, upendeleo, uwiano
sweta: koti
evolutionary: maendeleo, mageuzi
notation: ishara, ishara, kumbuka
bounce: boom, kuruka
dissection: kutenga, kifungu-cha
cache: 
linear: moja-kwa-moja
antimoni: 
superessive-kesi: 
tumor: tumor, wingi, mapema
mmomonyoko: 
alpha: 
kitovu: tumbo, pole
kinga: kinga, sugu
mafua: mafua, mafua, homa, ushawishi
kampuni-ya-bia: 
kurahisisha: 
abridge: kikomo, kuunda, kuzuia
dent: donge, mapema, jino
captivate: kukamata, sihiri
kuilazimisha: kuwalazimisha, nguvu, kutekeleza, utekelezaji
sock: 
movie: filamu, sinema, Ribbon, mkanda, stripe
cosmos: ulimwengu
kuchafua: uchafuzi, kuwaambukiza
gregarious: 
uume: ngono
misitu: 
alumini: alumini
oscillation: fluctuation
horoscope: 
sua: ndege, kufukuza, oust, kumfukuza-nchini, secrete, hubadilisha, Ondoa
ushirikishwaji: kurekodi, ushirikiano, kupachika, cover, pamoja-na, kufunika, Kidokezo, kuhusisha, ushiriki
walengwa: madarakani, user
dolphin: 
muuaji: 
mamalia: 
kiashiria: mkao, ripoti, vigezo, kidole-cha-kati, kupima
dioxide: 
colon: 
urasimu: urasimu
kupotosha: kupotosha, kinyang'anyiro, kuvuruga
jokofu: friji
archaeological: akiolojia, akiolojia, mafuta
haikubaliki: disapproving
vipimo: suala-la-kawaida, standardize
kipeperushi: bulletin, kitini, karatasi
anthropolojia: 
kitamu: ladha
elekezi: kisingizio, mpito
cower: crawl
alizeti: 
chawa: Jibu, bit
ion: 
utalii: utalii, kusafiri
modem: 
kuongeza-kasi: kukuza, kuwezesha, kusisimua
kadhibisha: kuwashangaza, yazua
chafu: chafu, suala
kidnap: hijack, upitishaji, kuwatoa
mwingiliano: mwingiliano, mwingiliano
hairdresser: 
ngano: ngano
kapilari: 
utaifa: utaifa
matako: hip, kitako
motif: mandhari, mada, nia, viwanja-vya
sublimate: 
kuchanganyikiwa: setback, kukata-tamaa, tamaa, kuchanganyikiwa, kufuta
cobalt: 
oat: 
mwendo-upriver: 
haja-kubwa: 
bovin: 
flip: kutafsiri, kutafsiri
redundancy: mengi, mabaki, ziada, kumfukuza, kufukuzwa, msamaha
video: 
kususia: kata, kutengwa, kutelekezwa
jaribio: jaribio, mtihani, dodoso
magongo: 
msituni: 
magnesium: 
rada: 
chimpanzee: 
kuegemea: uaminifu
mstatili: 
kelp: 
kujumlisha: generalization
amri-ya-kutotoka nje: 
mashoga: 
scenario: Muswada, mazingira
uundaji: kujenga, kujenga, kujenga, maneno, viumbe, malezi, kuunda
reincarnation: 
kuwasha: 
urani: 
catcher: receptor
kuratibu: uratibu
walipa-kodi: 
jumuishi: muhimu
alitoa-maoni-yake: mtazamo, maoni, remark
gamma: 
safari: safari, safari, safari, safari
mwendo-downriver: 
mgawo: daraja, sababu
kichwa-cha-habari: kichwa, mada
mchambuzi: kuchambua
Checkmate: 
mall: maduka-makubwa
bismuth: 
Postcard: salamu
muunganiko: makadirio, hukutana
digress: mafungo, aondoke
mbia: mpenzi
kidudu: 
sehemu-za-siri: 
maumbile: maumbile, morphology
beta: 
jeans: 
database: 
calculator: kompyuta
X-ray: 
Hazrat: 
mazingira: mazingira, mazingira, mazingira, mazingira, kimazingira, jirani, jirani, contour
sigma: 
disjunction: kutengwa, kujitenga, kuvunja, kuvunja
agenda: mpango, mpango, mtaala
visa: 
miundombinu: 
kimulimuli: 
detector: 
adaptive: 
biologist: 
ganga: bandika, marekebisho, ambatisha, kuungana
bromini: 
palladium: 
kwikwi: 
Pastel: rangi
zoo: 
kliniki: 
connotation: Kidokezo, maana, semantic, dhana, dhana, maana, mazingira
yoga: Jumla
Bookstore: bookcase
tiba: matibabu, kutibu, tiba, dawa, mtaalamu
mzalendo: kikabila
behead: 
yeah: ndiyo
matatizo: suala, tatizo, matatizo
jazz: 
Tungsten: 
kigaidi: wapiganaji, hofu
piga-chenga: lami
kimetaboliki: 
alimony: 
mwishoni-mwa-wiki: 
Chrysanthemum: 
chanjo: ufafanuzi, chanjo
pikipiki: pikipiki
mantra: 
muhula: mrefu
heroin: 
folder: 
cathode: 
itikadi: wazo
maegesho: 
theta: 
anticlimax: tamaa
selenium: 
baiskeli: mzunguko, kitanzi, cyclic, baiskeli, baiskeli
cortex: maganda, ganda, peel
yanayolinagana: usawa
sasa-umuhimu-marker: 
uwanja-wa-ndege: 
butua: kupinga
mpira-wa-kikapu: 
mzushi: 
cockroach: 
chromium: 
lita: lita
hata-hivyo: hata-hivyo, lakini, Hata-hivyo, anyway
homoni: 
kiujanja: ukosefu, upungufu, kamili, potofu, uongo, anakosa
toboa: kutoboa
animism: 
poligoni: angle
masuala-ya-kijinsia: 
conjugate: elekea, kushikamana
euro: 
ginseng: 
algorithm: 
laser: 
drugstore: 
millimeter: millimeter
flex: bend, ikiwa, rahisi, mazuri, cable
anode: 
nuance: kivuli
sehemu-ya-muda: 
unyeti: 
demonstrator: 
helium: 
bilingual: 
kifupi: kifupi, kwa-ufupi, kuogopa
initialism: 
gerund: 
plasma: 
chromosome: 
makutano: makutano, mstari, mara-kwa-mara, utaratibu-wa-kudumu
kilometa: kilometa
faksi: 
genetics: maumbile, vinasaba
freckle: 
bisibisi: bisibisi
broccoli: 
preterite: 
vitamini: 
cadmium: 
mshambuliaji: 
graphical: 
titanium: 
splurge: brag
lambda: 
mpenzi: mpenzi, mpenzi, lover, msichana
--jamii: 
hourglass: 
uelewa: huruma, huruma, uelewa
boroni: 
helikopta: 
tellurium: scandium, lanthanum
Tarehe-ya-mwisho: mrefu
kujipanga: 
sentimita: 
molybdenum: 
lithiamu: 
multimedia: 
update: kisasa, nishati
calorie: 
robot: 
kazi-ya-nyumbani: 
logarithm: 
vunjajungu: 
instal: mlima, kufunga, awali
amino: 
glyph: misaada
aorist: muda-usiojulikana
ikolojia: kimazingira
sophisticate: nyara
bangi: 
micro: hila, ndogo, vidogo, diminutive, kipaza-sauti
kilo: 
overeat: 
kutabirika: utabiri, kutabiri, utabiri
pizza: 
eavesdrop: 
isimu: lugha
haircut: 
Iridium: 
ubaguzi-wa-rangi: ubaguzi-wa-rangi
mojawapo: juu, optimum
viwanda: industrialize, viwanda, viwanda
Makao-makuu: makao-makuu, kiti
cerium: 
congruent: kirafiki, inafaa, mazuri, sambamba, sawa
partitive-kesi: 
mkanda: mkanda
willpower: hiari, mapenzi
dimensional: ukubwa, sura, mwelekeo, anga
parameter: 
synchronize: kusawazisha
maximo: upeo, kuongeza, chumvi
semina: warsha
disco: sahani
neon: 
osmium: 
Epifania: 
plagiarize: wizi
artifact: 
mtambo-huo: 
oregano: 
plutonium: 
yttrium: 
augmentative: 
username: 
Uzamili: 
mrengo-wa-kulia: 
argon: 
phobia: hofu, hofu, haunt, unyarafu
utakusanyika: kuwasiliana, kuingiliana
utandawazi: 
wavelength: 
encode: kificho
kusaga: kutumika
Anzisha-tena: reboot
hepatitis: 
torus: donge
kidini: kidini
modulo: mold, moduli
proton: 
diskette: 
milligram: 
pixel: 
tantalum: 
solute: kuamua
mauaji-ya-kimbari: 
predator: mkali
gallium: 
zirconium: 
determiner: kuamua, kufafanua, mpelelezi
nonlinear: 
madawa-ya-kuulia wadudu: 
berili: 
neuron: 
predicative: assertive
chupi: chupi
factorial: Kitivo
neutron: 
niobamu: 
Gerimani: 
metalloid: zisizo-chuma
kuweka-juu-ya: 
prolative-kesi: 
viumbe-hai: 
joystick: 
antibiotic: 
actinium: 
astronaut: nafasi
extraterrestrial: mgeni
crackpot: kijinga, wazimu, mambo, mwendawazimu, usiokuwa-wa-kawaida
marathon: 
ytterbium: 
autism: 
ionize: 
Radoni: 
Nerium: 
magonjwa: 
Uzee: wazee
kambi: kambi
striped: stripe, mpango, mpangaji
INDIUM: 
veridical: kweli, safi, wavu
tovuti: tovuti, tovuti, profile
kurani: 
flatware: 
nth---mzizi: 
lawrencium: 
kiraia--haki: 
Simu-ya-rununu: simu-ya-mkononi, simu-ya-mkononi
amepooza: 
protactinium: 
mionzi: mwanga
wanategemea-juu-ya: 
thorium-chembe: thulium-chembe, terbium-chembe, rhodium-chembe, rubidium-chembe, vanadium-chembe, florini-chembe, polonium-chembe, thalliamu-chembe, Strontium-chembe, ruthenium-chembe
bluu--jean: 
nyumba-kupanda: 
mmoja-mmoja: binafsi, mtu-binafsi, binafsi, tofauti
mtiririko--sasa: 
mara-tatu--kumweka: 
binadamu--mwili: 
fizikia: kimwili, kimwili
rejareja-duka: 
cesium: 
muda-mrefu-iliyopita: 
spreadsheet: 
kitengo--ya--habari: 
kukusanya: 
mapacha---thamani: 
binadamu-kuwa: 
na-njia-ya: 
depan-dari: 
praseodymium: 
kadi: kadi
finite-verb: 
kesi-idadi: 
pro-hukumu: pro-maneno
critic: muhimu, kina
ufungaji: wrapping, pakiti
impermanence: msimamo
katika-zaidi: 
descriptor: maelezo
neodymium: 
urafiki: kirafiki, mshirika
kusoma-tu: 
inaanzisha: 
gnomic-mood: 
phoneme: 
rationality: fahamu, mantiki
kifonolojia: 
dining-chumba: 
hai-chumba: 
centric-kesi: 
kabla-hodiernal: 
mgonjwa-kesi: 
oblique-kesi: 
vijijini-eneo-la: 
recurse: 
katikati-sauti: 
meitnerium: 
mail--carrier: 
noncommittal: gorofa
hisa-soko: 
zinazotambulika: kitambulisho, kutambua
lengo-trigger: 
moja-na-mbili: 
lative-kesi: 
ration: sehemu
zisizo-binadamu: 
hai-jambo: 
pia-kidogo: 
movie--ukumbi: sinema
hassium: 
attenuative: 
multal-idadi: 
milky-njia: 
neptunium: 
ghostwriter: 
trans-numeral: 
kumdanganya-kuzunguka: 
americium: 
asubuhi-utukufu: 
firefighter: 
berkelium: 
galaxy-jinsia: 
nobelium: 
kwaheri: bye, kwaheri, mpaka
mabudha: 
fermium: 
cyan: magenta
soya: 
distribuerar: 
strikebreaker: 
processor: 
abessive-kesi: 
adessive-kesi: 
kwa-kesi: katika-kesi, nasibu
agentive-kesi: 
rutherfordium: 
antibody: 
kama-kiasi-kama: 
wakala-trigger: 
muigizaji-jukumu: 
ethidium: 
kawaida-jinsia: 
accompanier: 
katamu: 
francium: 
Erbium: 
watazamaji-sauti: 
Astatini: 
kubugia-gum: 
nyota-jinsia: 
citation-fomu: 
curium: 
Comic--strip: 
rangi-kipofu: 
euler's---idadi: 
kuangalia-katika: 
crosswalk: njia
uwanja-wa-vita: 
motorist: dereva
mzunguko-mfupi: 
matusi-noun: 
kilio-nje: 
kitakwimu: takwimu
mgando: 
xenon: 
hypnotize: 
kuchukua-mbali: 
kifungu-mkia: 
moja-kwa-moja kitu: moja-kwa-moja kitu
vyakula-na-vinywaji duka: 
wajumbe-ya: 
ergative-kesi: 
katika-lugha: 
kwanza-mkono: moja-kwa-moja
locative-kesi: 
Bwawa-la-kuogelea: pool, bonde
adverbial-kesi: 
kitalii: safari, kukagua, mzunguko
televisheni-seti: 
mwisho-chembe: 
evitative-kesi: 
ukarabati: 
regression: kurudi, uondoaji, mafungo, setback
kuzuia-ya-kujaa: 
kuamka-up: 
polisi-afisa: 
kumwapisha: 
INTERVIEWER: mahojiano
rhenium: 
erosoli: 
kutochukua-kesi: kutochukua-kesi
nominalization: noun
mwendawazimu-kesi: 
fedha-zaidi: 
msaidizi-verb: 
msingi-kitu: 
kompyuta-virusi: 
mtu-wa-biashara: biashara-mtu, mfanyabiashara
a-watu: watu, watu
antessive-kesi: 
Waziri-Mkuu: 
lutetium: 
europium: 
emote: 
folk---muziki: 
mshairi: 
ofisi-ya-Posta: baada, barua-pepe
eti: dhana, hypothesize, labda, inaonekana, uwezekano
animate-jinsia: 
subessive-kesi: 
gesi--kanyagio: 
polarity: polar
gari-jinsia: 
madini-jinsia: 
kitendo---suffix: 
passionate: hisia, hisia, hisia
samarium: 
mwezeshaji: msimamizi
imaginary--kitengo: 
kasi---ya -mwanga: 
Jeshi-la-anga: 
huruma-furaha: 
muhimu-ya-kiwango: 
wakati-wote: 
hafnium: 
kolinesterasi: kuzuia, taksi, kuzuia, kuzuia
mabadiliko-ya-tukio: 
holmium: 
tofauti-tukio: 
ulimwengu-jinsia: 
eneo-jinsia: 
virtual-mashine: 
utafiti-jinsia: 
kisanii-jinsia: 
crastinal-uliopo: 
abstract-jinsia: 
exocentric-kesi: 
elekezi-verb: 
morpheme: 
chauvinist: 
siku-za-nyuma perfective: 
ufundi: specialty, taaluma-ya, uvamizi, hila, mtaalamu
moja-kwa-moja hotuba: 
pili-lugha: 
kwa-kuwa: 
graveyard-mabadiliko: 
pamoja-noun: 
absolutive-kesi: 
mgonjwa-trigger: 
binafsi-kujiamini: 
kinyesi: kinyesi, kinyesi, uchafu
reflexive-sauti: 
impersonal-verb: 
seaborgium: 
nafasi-nyeupe: 
modal-kesi: 
inanimate-jinsia: 
causative: 
propositive-mood: 
umeme-sasa: 
associative-kesi: 
superlative-kesi: 
pia-kiasi: 
planetary-jinsia: 
animated-cartoon: 
kubadilishana-sauti: 
kutunga-sheria: sheria, wabunge, kupanga, kuandaa
katika-angalau: 
kisarufi-kesi: 
user: 
msingi-benefactive: 
kipa: 
:-except-for: 
denominator: 
kingine---kama: 
sideways: kando
kila-mmoja: mmoja-mwingine, kuheshimiana
mfululizo-kifungu: 
kuvaa-nje: 
kaptula: 
dysprosium: 
haraka-baadaye-uliopo: 
si-vitengo: 
Kriptoni: 
mendelevium: 
applicative-sauti: 
antipassive-sauti: 
continuative-kipengele: 
mionzi--ugonjwa: 
necessitative-mood: 
single-hatua-verb: 
railcar: 
superlative-shahada: 
existential-kifungu: 
californium: 
sasa-Mmoja: 
luminous-kiwango: 
singulative-idadi: 
kisarufi---kitu: 
watazamaji-Mmoja: 
kupindukia-muda: 
supercritical---maji: 
kiasi-ya-Dutu: 
postpositional-kesi: 
elective-watakwimu: 
gadolinium: 
epenthetic-morpheme: 
negatory-watakwimu: 
einsteinium: 
bandia-lugha: 
connective-chembe: 
kijijini-baadaye-uliopo: 
frequentative-kipengele: 
distributive-pronoun: 
allocution-makubaliano: 
bald: wazi
kitongoji: kitongoji, mashambani
wote-watakwimu: 
kompyuta-programu: 
televisheni-mpango: 
floating-kumweka---idadi: 
existential-watakwimu: 
the-siku-baada kesho: 
mbadala-watakwimu: 
--tukuta: mbaya
siku-za-nyuma watazamaji Mmoja: 
the-siku-kabla jana: 
locative-directional-kesi: 
counterfactual-masharti: 
