nauni: hnit
nominative-kesi: hnak
accusative-kesi: hkak
mada-kesi: htak
mzazi: hmat
baba: hpap
mama: hmam
hodi: hnat
babu: htat
grandparent: hyat
njaa: hcac
genitive-kesi: hnik
kivumishi: hcit
na: hwan
mimi: hmic
wewe: hnan
sisi: hnam
ni: hyic
marudio-kesi: htas
dative-kesi: htik
mambo-ya-ndani mazingira: htis
mtu-mazingira: hpak
tegemezi-kifungu: htan
perfective-kipengele: htap
siku-za-nyuma uliopo: hkat
masculine-jinsia: hsan
comitative-kesi: hmik
sasa-uliopo: hyan
benefactive-kesi: hpik
essive-kesi: swik
si: hnic
wake: hsis
uso-mazingira: hsak
adpositional-kesi: hpan
eneo-kesi: hwak
nafasi-mazingira: hnos
njia-kesi: hrak
instrumental-kesi: hsik
ambayo: hkan
interrogative-mood: hnim
na-au: htam
kipekee---au: hkit
chanzo-kesi: hsok
ablative-kesi: hlak
demonstrative: hdit
lakini: hlan
zote: hsut
kike-jinsia: hnin
wao: hwin
wingi-idadi: hlun
moja: hyik
baadaye-uliopo: hwet
kijamii-mazingira: hson
lini: hkap
imperfective-kipengele: hmap
kuna: hkac
masharti-mood: hcan
zaidi: hdoc
nje: htac
jamaa-kesi: hrik
illative-kesi: hlik
kufanya: hkas
agizo-mood: hden
deontic-mood: hdim
swali-neno: hwac
copula: hkok
mtu: hpon
kiume: hman
naweza: kwat
wengine: hcon
idadi: hnoc
sana: tcac
wakati: htim
wakati-mazingira: htos
muda-kesi: hmak
kuhusu: hkam
epistemic-mood: hsim
tu: htun
kidogo: hcak
kisha: pcan
hortative-mood: hton
retrospective-kipengele: hrip
kubwa: hcat
volitive-mood: hlim
kabla: hsec
lazima: pcic
mbili: htut
ona: tcan
kujua: hsat
chini: hcin
baada-ya: hcas
kwanza: hpas
mwenyewe: hpun
alienable-milki: hlic
kamwe: hnac
inalienable-milki: hkic
umri-wa: hwat
taamali-mood: hcim
siku: htin
ambapo: hnap
kuja: hlat
njia: hyas
kazi: hkaf
vowel: hwaf
kwenda: hkun
perlative-kesi: pwik
maendeleo-kipengele: hpip
muda-mrefu: hlac
kusema: hsac
jinsi: hkin
hata: hpit
nyuma: hwap
hapa: hcic
kufikiri: hcik
sawa: hsam
mwisho: kcac
mbali: twan
chini-ya-mazingira: hnas
kuchukua: htit
kupatikana: hfan
mkono: cyat
vijana: hyac
ingawa: hyap
kutoa: hkik
mungu: hmac
delative-kesi: lwak
kitu: hmin
haki: hyit
mara-moja: hyam
semelfactive-kipengele: fwip
sehemu: hpat
msumeno: htic
nyumba: hfas
dunia: tcat
kichwa: hcaf
tatu: tyin
mamboleo: hnon
lengo: hcok
upendo: hpac
daima: hsit
usiku: hwit
kila: hmit
mfalme: hyak
kati-ya: hsin
moyo: cyin
paucal-idadi: plom
kwa-sababu: hyok
causal-kesi: ksak
jambo: hkis
kuweka: swat
jina: hnem
sahihi-noun: hran
hortative: hrat
nchi: hlit
aliuliza: hput
inayoonekana-evidential: crit
bora: pcac
upande: psac
Bila-shaka: hkus
kike: hfin
kutosha: kyat
haraka: hpuc
kamili: hcun
chumba: hfac
karibu: hlap
hawawezi: nyat
maji: hwik
desiderative-mood: hdin
mwanga: lyak
wala: hnun
neno: slat
mlango: tyan
matumizi: hpus
asubuhi: hsap
terminative-kesi: twik
nguvu: hkuk
wenyewe: hmis
sasa: hyin
sauti: hwas
nyeupe: hpis
fedha: tlan
ijayo: kyak
maskini: hyis
kifo: hmut
fomu: hfam
inessive-kesi: nwik
aina: tyac
mara-nyingi: tsan
mwaka: nwan
rafiki: myat
ili: hyut
muhimu-mood: hpim
pande-zote: hcut
kuamini: hban
umma: hpin
hali-mazingira: hsas
mwana: psat
mia: hmas
watoto: hcis
hivyo: tyak
matumaini: hcap
juu: hyip
wapenzi: pyin
kusoma: pyac
mji: hsic
tayari: hpic
ukweli: hfat
factive-evidential: hfit
kusikia: hsun
angalau: hmim
labda: pyat
wazi: kcat
mwili: tcic
hewa: cwac
asili: nyit
kusaidia: mlat
barua: lyat
nne: ksat
optative-mood: hpam
moto: hfak
Kwa-hiyo: hyif
saa: hcam
bure: tyit
vita: syat
iwapo: hsaf
sababu: kyan
umoja: hnut
wito: hkuc
kwa-nini: hwam
waliopotea: hkut
elfu: tsas
familia: hfic
nafsi: twam
swali: swac
huduma: kcan
realis-mood: hlin
maana: mwit
uwezo-mood: hten
kuelekea: cyan
allative-kesi: lwik
anthropic-jinsia: hrin
short: kyut
uwezo: hyuk
kuishi: hkip
somo: hsek
sawa-somo-marker: hcek
tofauti-somo: hfek
jibu: tsat
bahari: mwat
hofu: hcoc
kuelewa: pcat
ngumu: kyin
suala: tyut
shaka: hdac
dubitative-mood: twin
kuuliza: psan
silaha: tcas
nyeusi: clis
kuleta: tyat
nzuri: ksis
giza: tcak
kushikilia: psak
kumi: htaf
show: pyan
hadithi: hkif
kawaida: kwan
kitabu: hkup
umeme: lyin
majadiliano: plak
alama: myac
maslahi: nyis
kuandika: kcit
kitanda: pwat
muhimu: syis
wazo: hwis
sanaa: klat
vialis-kesi: hlas
kaka: pyak
wakati-mwingine: ksas
mstari: lyan
meza: tlas
mto: nwit
jicho: kyac
maelezo: fyin
ghafla: tfan
ajabu: hgan
kina: ksan
mabadiliko: hrit
hisia: nwac
kukutana: mlit
madhumuni: htuc
furaha: hcuc
kuonekana: syit
damu: cyac
kufufuka: kwas
kusini: swan
baridi: tlat
mbele: myik
nafasi: psis
marehemu: tyam
kusimama: syan
kudhani: nlas
binti: pyit
yangu: myan
kukata: hkim
nakala: hfap
mume: hgat
sita: hlis
kumbuka: twat
athari: hyaf
kuanguka: htuk
isipokuwa: hsip
nywele: hpaf
kupita: pyas
hati-miliki: pcit
jeshi: cyit
kukimbia: kcak
farasi: kcas
baadaye: hwic
magharibi: pcak
kulipa: plit
nyekundu: hyun
dhahabu: tcun
hamu: hdan
kucheza: plin
bwana: mwas
ofisi: hfus
serikali: syak
kanisa: kyas
urefu: hlen
kampuni: ksin
karatasi: kyis
uwezekano: hbin
hasa: cyas
kubeba: pcas
dirisha: cyak
makubaliano: hgac
uzuri: syac
wajibu: tfac
kutuma: fyan
umbali: htif
ukimya: slan
mguu: fyat
porini: kyik
kufa: myam
kuokoa: pfan
kijani: kcin
shida: mlan
tabasamu: myak
vibaya: clat
mbalimbali: pcin
usingizi: slit
quotative-kesi: kwik
mwanzo: cwan
hatua: kfan
ziara: fwat
kufuata: nlan
kujaribu: tcis
uwepo: psit
tamu: tlit
tajiri: tcin
adui: tcam
meli: hcip
hali: kyit
Ikiwa-ni-pamoja na: hkum
umoja-mtu: hlon
siri: kwit
precative-mood: pwim
polite-kusajili: hbit
mabaya: pwac
maandamano: myas
chochote: kwac
kukaa: hlam
badala: plat
bluu: plan
haiwezekani: psap
shule: hsuk
tukio: ksac
ndoa: nwat
chakula: hcuk
ishirini: tsis
utulivu: tcit
urahisi: hnis
wanaotazamiwa-kipengele: hrap
lugha: lyac
kujieleza: syas
wiki: hsus
ukumbi: hcum
hatari: kcic
mali: myit
aliyezaliwa: nyan
mahakama: kcut
ujumla: tyap
gnomic-kipengele: hmip
thamani: tyas
rahisi: syap
mti: pyic
mapambano: pyap
ukuta: twit
mbinguni: cwak
inchoative-kipengele: htip
jussive-mood: hjin
tone: twun
kujali: klan
inatarajiwa: pcik
mwezi: hmaf
uzoefu: nyap
kabisa: nyac
safi: tsac
duke: hnuk
kufunikwa: kwak
amefungwa: hyim
mashariki: tyuk
jiwe: pwan
kiasi-fulani: kfat
mwelekeo: tlac
kiti: kwis
msaada: syut
tarehe: tyic
kijiji: klac
uwanja: clit
ruhusa: nwin
permissive-mood: hmom
mafanikio: slak
sahihi: hric
kilima: clin
muziki: ksik
distal-demonstrative: hdat
alasiri: htup
kilio: hyuc
heshima: hnaf
saba: swit
binafsi: pfat
habari: nwas
eneo-la-tukio: slac
bustani: cyam
mbio: htus
distributive-kesi: twak
kujifunza: clan
kisiasa: syik
uongo: kcun
kutupwa: tsak
kula: kcam
sakafu: hlaf
mgonjwa: pwin
awali: mlin
majira: kyam
dini: tlam
picha: ksit
kutoroka: plap
mwandishi: hlut
brown: pyun
kuamua: htem
maumivu: hdon
spring: psin
karne: syic
laini: mwan
kona: kyun
kuzalisha: psas
kicheko: cyaf
kusahau: flat
Ulaya: hyup
nane: lwat
mavazi: lwac
kutisha: cyap
pumzi: syaf
busara: hbas
kutochukua-marker: srak
kumbukumbu: myin
kisasa: fwan
doa: tcap
kupanda: hyus
mapumziko: pyik
hamsini: hfis
kisiwa: tlap
kugusa: hsuc
ahadi: pcam
commissive-mood: mwin
shahada: tfat
mpango: plac
mwenendo: nyak
mshangao: cran
dakika: hmun
risasi: hwut
mbaya: pcap
kioo: klak
mfano: tlin
salama: hsif
daktari: tsit
completive-kipengele: hmep
mara-kwa-mara: tyun
kijeshi: slin
joto: nyam
kunywa: pfin
maswali: pcaf
hasira: nran
moja-kwa-moja: tyik
kofia: hcup
mbwa: kwap
mtumishi: hnuc
kiburi: hram
umati: tcuc
treni: nyin
maadili: myut
kuhusishwa: kyim
kuingia: fyak
utawala: nyas
upanga: cwat
mashambulizi: kfak
afya: clac
aya: pyaf
kijamii: hsum
refund: tfit
pole: hpec
ujasiri: krac
neema: hnen
rasmi: hfaf
zinazotolewa: tsik
ombi: pwit
mtazamo: klas
harakati: hyon
kutarajia: cwit
kinyume: psam
kumi-na-mbili: tyaf
wanaohusika: nyut
mvinyo: hwun
ladha: swut
chuma: fyac
kusambaza: syin
biashara: myap
faida: twac
nguo: kfip
hakimu: fwak
tofauti: tfaf
wasiwasi: kcis
nahodha: kwin
kumaliza: nlat
kukoma-kipengele: hsep
curious: kyic
kigeni: kwic
intensifier: hnif
umuhimu: myun
hatimaye: hfim
muswada: fwin
kuthibitisha: hpuk
kuzuia: flan
shingo: cyun
kisheria: hfik
kavu: swak
kutumikia: syam
kupoteza: pcut
ushahidi: pyut
evidential-kesi: hdak
maendeleo: pyis
jengo: klit
search: syuc
kusikitisha: hrac
dhambi: psip
thelathini: tfis
waaminifu: tsin
kufunga: kyap
benki: pcun
hatma: cyik
msitu: hfun
kupima: mlac
vinginevyo: htoc
mkondo: lyam
mkate: hpup
ziada: tfak
kuchagua: twas
wanyama: nwam
Zoic-jinsia: hzin
eventive-mood: hwim
sawa-tukio-marker: hcom
multiplicative-kesi: tlak
nene: hmus
kiumbe: hyum
mvua: myic
uso: pfas
takatifu: swis
Julai: clim
ripoti-hiyo: hfut
pwani: pwas
faili: hfif
bega: cwut
kushangaa: kran
kifalme: klik
wimbo: hkuf
faraja: kfaf
mtu-yeyote: nyic
nyasi: kcap
kuteka: cwik
ufunguzi: cyic
Juni: cwun
samaki: mlic
mji-mkuu: klin
matiti: cyut
theluji: hcif
elimu: tlik
mkali: tcaf
huruma: hdam
gharama: fyas
lenu: hmuc
milioni: mlun
uchovu: tcik
kuua: ksam
kivuli: cwap
uzito: plas
wingi: mlas
imara: tlip
jasiri: pyam
nyembamba: plic
kuridhika: srat
kuangalia: kcik
wema: hdet
kitaifa: nyaf
Mungu: swin
bonde: clak
nadhani: kwam
mapema-mno-mood: hken
njano: clas
mabaki: mwac
bent: nlac
sanduku: pwak
msimu: tsim
sayansi: slas
kuzaa: kcuc
mjomba: hmuk
orodha: lyit
Agosti: ksut
maarufu: hlup
haijulikani: fyit
ukoo: flak
ukoo-kusajili: krit
msomaji: tsut
mbinu: pcuc
mara-mbili: tsap
akili: tfik
kweli: tsam
kuhani: pcis
waliojeruhiwa: fran
huzuni: hpom
ikulu: kfas
kuwapiga: clap
eh?: hnec
kumdanganya: myuk
makali: pfac
tisa: nwun
kupasuka: psut
kuteseka: tfas
kelele: hcus
fasihi: lyic
ushauri: swas
tupu: kcuk
cheo: psik
dhoruba: tcut
mfukoni: kyip
mawazo: nlin
hukumu: cwas
Novemba: nwap
Desemba: tsip
kukosekana: psic
kuwashukuru: ryak
anuani: tyis
ndege: pyuc
mmiliki: mlik
kanzu: kwut
kuandaa: tyip
mahusiano: lwan
moshi: htum
Januari: nwak
mashine: clic
yaliyomo: nyik
meno: tlis
aibu: hcet
bay: kcaf
ubongo: pyuk
pete: klic
maneno-marker: frak
mraba: ksap
matunda: fyut
chai: tsic
kueleza: slam
kuwakaribisha: cwam
mashairi: pwis
kununua: klam
mwaminifu: hdic
msisimko: hcen
arobaini: klis
Aprili: pyip
kindly: kfit
Oktoba: kfap
uchungu: kyuc
mtumwa: tlaf
huru: hluk
Nakala: tsus
mikopo: cyip
kumi-na-tano: pfit
kikatili: kcim
kujiunga: cluc
mchakato: hpif
uhalifu: kyaf
vumbi: tsuc
vitendo: plik
rangi: nlak
kuharibu: nyuc
Ongeza: lyas
pua: hnus
kukubali: tyim
jana: kfac
hesternal-uliopo: tlen
kushindwa: slap
kuendelea: tcim
kuvaa: pwam
kipofu: nlit
kadhaa: tsun
kuruka: fyap
sifa: cwin
shetani: cwaf
hatua-kwa-hatua: twic
sadaka: kyif
zoezi: cyis
dhamiri: tfin
nadharia: tlic
waziri: myis
chuki: hnet
ziwa: cwic
kituo-cha: syun
kukata-tamaa: pfic
mantiki-jinsia: hron
makini: fwac
kufurahia: nlam
ibada: pwap
bidhaa: twap
ngozi: twaf
paa: tlut
taji: gyan
ngome: klap
kiti-cha-enzi: tcus
masharti: nlaf
maili: mlim
uliokithiri: krim
gerezani: fyis
kikombe: kcip
mwanachama: mlam
kiraia: syim
kila-mahali: tsaf
dhahiri: tfic
wanandoa: pwaf
kiasi: clam
desturi: ksaf
upinde: ksun
suti: slut
nyama: mwak
maziwa: hluc
vegetal-jinsia: hwen
maono: slic
nadra: nlap
binamu: ksic
daraja: pwut
kulinda: pfak
chumvi: swam
wasio-na-hatia: hwus
malkia: kwim
kuhesabu: kcus
udadisi: hras
ngoma: tyus
hoteli: clut
kujaza: flin
mfungwa: psun
duka: hjan
ngazi: sric
naomba: hmen
mchanga: sran
vurugu: hgit
Septemba: hsem
kuondoka: prac
uharibifu: crin
ujuzi: krin
ng'ombe: hwec
vifaa-vya: hwip
jikoni: hkon
kuuza: hbak
kasi: hsot
hitimisho: clon
kompyuta: hkot
milele: hsen
mdogo: mrit
maktaba: hbek
msingi: hbac
mkanganyiko: hrun
tukufu: cris
vivyo-hivyo: hjic
kutishika: hbic
ole: prin
makala: hrek
mpishi: kfin
band: hbat
jangwa: hget
busu: hbun
mpira: hbot
fimbo: hpot
hoja: hrut
kuchunguza: nrak
baraka-mood: hbim
fora: hrim
hatia: hdis
gun: hgin
polisi: plis
kujificha: hzan
msafara: srin
wajinga: nrin
ukarimu: drac
wingu: blan
taka: htek
Februari: frif
ugonjwa: hren
kutumia: bwan
chanzo: sron
mpango-kesi: hnok
shangazi: hbam
kuchelewa: dlic
kuchelewa-muhimu: hlip
taarifa-evidential: prat
usiku-wa-manane: dyit
shujaa: nrac
falsafa: hfof
kidole: hjit
vizuri: hzat
mahali-fulani: hmoc
vyombo-vya-habari: bran
wafanyakazi: hraf
zawadi: rwan
lawama: dlac
taabu: krat
paji-la-uso: htec
tangazo: glan
angel: htet
umoja-idadi: hgam
alfajiri: hbon
kibiashara: krak
kusamehe: pran
kondoo: hcec
uvumilivu: hpen
shamba: crac
rejea: hrec
mahindi: mran
ufunguo: kcif
wengi: hmot
udhaifu: hdut
anga: traf
sigh: tcoc
ubinadamu: mlis
upinzani: pric
disk: hdik
upweke: hket
msanii: nrat
knight: cwis
charm: tran
uamuzi: drin
gavana: gran
tawi: rwac
disposition: hsoc
shauku: tsum
kufata-mood: hdum
jamii: hmum
mafuta: hyen
bomba: hbap
magazeti: trat
oh: dyoc
mjadala-mazingira: hros
vocative-kesi: hwok
cabin: ksen
kengele: plam
neva: hnes
kudumu: hset
kisu: ksuk
hariri: slik
dharau: grin
kuzimu: nrik
kutengwa: plen
umakini: mrat
mchanganyiko: mrik
mbao: mrak
kupendelea: hpet
onyo: trin
mawaidha-mood: htom
msukumo: hmos
tamaa: mrac
kukataa: hnek
katiba: swic
chombo: srit
kuendelea-kipengele: hnip
tide: hgas
chuo: klen
mkia: hkek
kizazi: nric
paka: blat
moja-kwa-moja evidential: hret
kutelekezwa: trac
kumi-na-moja: hyec
Instinct: nlik
tabia: trit
kabila: hgik
apprehensive-mood: pcim
makazi: crat
rude: hruc
wanaoendesha: hris
kuitingisha: hmon
sekta: hdot
taaluma: hres
taa: hdap
kahawa: kfif
kutii: htot
kaskazini: nrit
muuguzi: nris
kuwahakikishia: hjat
mlolongo: ryin
mafundisho: cric
viatu: hgut
yadi: mram
hazieleweki: hmec
mahali-pengine: hlet
ghorofa: pret
shughuli: twot
Jumamosi: cram
mwanga-wa-jua: hduc
mjane: hwuc
kipengele: hlem
tafakari: hfen
shirika: hgis
nyota: tram
tukio-hilo: hgon
mgeni: hgip
bar: brap
chupa: hbet
awabariki: blak
koroga: crak
ndani: trik
kurekebisha: krik
unatokana: prit
mashimo: hcot
jimbo: hpos
ustaarabu: srac
hutegemea: hgak
mshtuko: crok
ubaguzi: swap
mzigo: tren
kiwango-cha: ryan
kuendesha-gari: dran
kuondoa: hruk
kuapa: kses
hazina: zran
mbegu: hbis
mnara: tras
favorite: fwit
hivi-karibuni: hcem
hivi-karibuni-siku za nyuma uliopo: hrot
ari: srik
samani: mrin
kamba: hkos
adventure: hdas
mrahaba: ryit
sikukuu: dyat
kuelezea: dras
sitini: hses
wadogo: hkem
sherehe: srec
uwindaji: clik
whisper: psus
kwa-kiasi-kikubwa: ryat
ukristo: ksim
Mwanasheria: hwif
undani: drit
princess: hrus
madhabahuni: dlat
mtandao: hwes
zambarau: brin
kukusanya: hkoc
uchaguzi: hben
mimba: kren
mlevi: crik
kumwaga: brac
kuinua: hlif
ishara: hjis
kusimamia: rwin
kubadilishana: tcen
uhakika-makala: hdek
Kaizari: mras
kijijini: hroc
ugly: clup
wapole: cras
roll: hrof
inch: nlic
gazeti: grat
ndevu: dric
machozi: srim
tume: kson
ilhali: grak
kuvuka: kcoc
uhuru: htes
harufu: hwon
kumi-na-nane: hdec
kihistoria: tris
pato-la: krut
mzizi: hrok
matope: hbik
bibi: dlan
pazia: pras
ukumbi-wa-michezo: tret
kulinganisha: kras
mpinzani: rwis
usawa: slen
kocha: kron
ucheshi: hnum
riwaya: rwas
kisasi: hbaf
wivu: ryut
gurudumu: hlok
kuteketezwa: glat
flash: flac
kujenga: hkec
migogoro: hnot
laana: hlos
imprecatory-mood: pram
wanyonge: hces
chanya: hzit
klabu: klup
mafuriko: nras
nafaka: gwan
kutojali: hdun
upeo-wa-macho: crim
assumptive-mood: hsom
mwinuko: htop
maelewano: mron
radi: hgot
utoto: htok
goti: hgun
programu: pwen
kuumia: kram
kupokea: ryis
kuwawezesha: nlim
protasis: hpoc
kuingizwa: slok
mapinduzi: hrif
mkulima: hjim
kiharusi: trak
jukwaa: hpof
mjumbe: hmes
upendeleo: hpek
iliyoandaliwa: hyot
mwanafunzi: clen
pango: hgec
mila: rwat
janga: tses
kuaga: hjap
kukosolewa: ryik
pamba: krap
hospitali: slot
kodi: kris
gesi: hges
kuepukika: pwic
mauti: hgim
jani: glit
uchapishaji: plun
uhasama: tsup
tafsiri: dwan
mazishi: jran
unga: mrun
mawasiliano: ryon
kimapenzi: hrom
kibanda: clun
kupendekeza: psot
mimetic: hmet
dola: dlon
mchana: hjac
kumi-na-sita: hsos
mkutano: hzac
koloni: klon
mrengo: gyin
simba: hles
utamaduni: klut
safu: hkom
ujanja: glak
mchezo-wa-kuigiza: dram
utani: hjuc
ukungu: hdus
dawa: dwas
kumi-na-nne: hkes
acid: sram
yaani: hyet
mapato: hmok
askofu: hbip
machungwa: tron
umwagaji: byan
primitive: rwit
kikapu: ksek
katibu: sris
majani: prak
papara: pfif
wokovu: slon
hodiernal-uliopo: dlin
nia: zrin
mvuke: tcip
sumu: hwoc
vipaji: tlon
hali-ya-hewa: lwim
ufanisi: fric
kutofautisha: tcif
osha: dwac
kukiri: kfis
yasiyo-na-msingi: hjas
makaa-ya-mawe: kyon
mtumbwi: kwon
muda: tric
delimitative-kipengele: hdip
mfupa: hcos
Jumatatu: nwic
Jumanne: glac
Jumatano: bwac
shirikisho: frin
kuhitajika: hzic
mwakilishi: ryic
sanda: lwin
kuzama: swuk
mpwa: bwin
umwagaji-damu: kric
kuzingirwa: cren
tumbo: hpem
shaba: pcon
mkutano-wa-kilele: hzik
tano: pfik
nafuu: brat
kipekee-mtu: kwen
kumtia: zrat
uzio: hzas
sanamu: tfam
artillery: tlep
kukumbatia: mrap
jirani: sren
madhubuti: srot
kulungu: hluf
kichaka: hbuc
reli: hrep
kutokwa: hduk
mrithi: mris
mwaloni: blun
unpleasant: pren
uvumbuzi: hgic
piano: pyon
kuwashawishi: swen
asiyeonekana: gric
vizuri-inayojulikana: ryun
ukatili: kluk
majaribu: hyoc
telic-kipengele: hlep
kiuchumi: kfik
kimataifa: troc
kuingilia-kati: tcek
mwanafalsafa: flif
kifahari: gyit
ustawi: kyen
uvuvi: mlak
kuiba: truc
mdomo: hloc
kustaafu: ryac
kunyoosha: sras
nyumba-ya-sanaa: glen
sambamba: zlan
atelic-kipengele: htep
bara: trap
kikwazo-mood: nrim
tai: dwat
kiini: slep
yai: dyan
bandia: jrat
wakati-huo-huo: nwis
mgogoro: ksot
polite: sloc
chakula-cha-mchana: lyon
pine: pwon
kushinikiza: hcef
muungano: lyen
kiuno: hkop
miujiza: hmek
baharia: slis
usafi: prut
jamhuri: hguk
simu: tfen
mjeledi: krip
shati: cyim
kuanzisha: ryas
sofa: hsof
sweep: hsup
mwizi: ksif
kurejesha: nrec
channel: kcen
utu: klim
mageuzi: kfam
kutishia: hzim
palm: plim
msemaji: hzak
kizingiti: dwic
kushawishi: pris
mkuki: bzak
nadhifu: syec
kikao: cwen
mateso: crot
uchafu: tcum
ridge: grit
msafiri: hyek
kinu: mwik
ramani: jrac
collar: klok
kuchukua-nafasi-ya: klif
makusudi: drat
bia: hbif
velvet: hwem
mvuto: gwit
mahubiri: hpum
matumizi-mabaya: glas
kundi: hgen
kumi-na-tatu: tres
kuhalalisha: jyit
Ijumaa: crum
brush: broc
download: dlas
cream: krem
cliff: klaf
jury: jrin
monster: ksos
waliohifadhiwa: hgoc
sufuria: pfot
senti: psen
kusisitiza: srut
apple: hpep
kujadili: drak
background: prun
nukulu: trim
upimaji: prik
burudani: nren
virusi: bris
kitoto: blit
kutafakari: flit
kubadilisha: kcet
muhtasari: kluc
opera: hpop
idhini: nron
kumsaliti: rwak
kuwaadhibu: hzen
elbow: kcon
attachment: tcet
kukarabati: hrop
tuhuma: cyec
sabini: swet
maandiko: srip
shimo: grac
machafuko: dlak
binary: byin
Abbey: bjan
mshale: tcec
huwa: trec
kufafanua: frat
uaminifu: hlot
sarafu: syip
hutetemeka: tcem
uhamishoni: gwin
mitambo: myim
mtego: crap
keki: kyek
sir: cyes
kubisha: sret
kumi-na-saba: syet
asali: myon
wadau: dzat
kutembea: hjam
matofali: brit
themanini: hpes
kwa-bahati-mbaya: pcen
kushauriana: kcot
legend: lwen
mavuno: hfos
kukuza: pfon
jiko: hsop
waasi: bric
mtindo-wa-zamani wa: hnom
jazwa: cron
swamp: swot
dressing: hdes
kujiepusha-na-anasa: pces
meneja: mren
chorus: cros
mantiki: tson
usindikaji: pson
wolf: blaf
carpet: hgap
mambo-ya-kale: hjak
rutuba: frut
filimbi: slif
jibini: twis
kuuma: byat
kukaribisha: jwan
Makuu: kyet
bandari: brak
tanga: djan
mazao: tsos
Navy: nlen
mask: mrok
kalamu: pses
mboga: sroc
maonyesho: hzet
suruali: tlun
rushwa: hrup
baraza-la-mawaziri: nram
supu: srup
upasuaji: syon
posho: tcot
kupeleleza: gyas
reckless: hlec
uvumi: gyic
ishara: hzon
abstract: srok
Alhamisi: cwim
trafiki: ryaf
usanifu: ryek
ufa: rwaf
pambo: rwon
kubadili: lwas
amuse: mwun
ahueni: ksus
lami: plut
maamuzi: dyin
hasi: nraf
tamasha: hfec
kupunguza: hrum
uhaini: zyan
wawindaji: djin
nyoka: syen
betri: bret
nta: flam
upelelezi: dlit
uchambuzi: nlis
mkazo: hzot
kuogelea: twen
bahasha: lwaf
yeyote: hgek
sigara: jrit
motor: mrot
kujitolea: hwot
majibu: ryif
mizigo: blam
viziwi: hboc
juisi: hjus
unyenyekevu: jlit
wizara: mret
ngono: hjon
mduara: dyam
shoka: blac
diamond: dlam
mbadala: hlek
echo: hgus
kujizuia: swon
utambulisho: hdaf
screen: krun
wavivu: lwis
momentane-kipengele: hmop
Compact: kfot
drift: hdif
kutoweka: hgaf
ray: ryen
wino: mwic
mkubwa: mraf
pishi: dyac
kukumbukwa: nrun
glare: klek
seneti: slet
jeneza: tfap
msamaha: frac
kumeza: nlun
kujiingiza: nlot
swing: swun
meadow: gram
tata: klos
kujiuzulu: hzis
wanyenyekevu-kusajili: nret
njama: swim
pilipili: prip
GPPony: pron
mgombea: hzam
fox: flik
chimney: tcon
mamlaka: drik
kilimo: rwic
usahihi: tcuk
zamani-marehemu: brim
kidemokrasia: mrek
bud: hbos
blanketi: bwat
mvua-ya-mawe: hgep
nguruwe: srus
umbo: krek
pembe-za-ndovu: craf
classical: ksok
waangalizi: nwet
tembo: lwit
misumari: nwus
nyuki: hmif
kuzika: dzan
muigizaji: bzat
jasho: zwan
polish: ploc
udanganyifu: hlus
kutokuwa-na-uhakika: pcet
sekondari: syif
mara: tsot
vijijini: grun
tunaugua: nyen
kufanana-na: slec
kunukuu: hzun
gunia: cyek
kero: fren
sindano: hjun
kudhibitiwa: nroc
kuku: truk
thabiti: kwot
pipa: bras
habitual-kipengele: hcep
mtaalam: ksec
kumvutia: blin
mizeituni: zlin
van: myen
kikwazo: bwak
nod: kcec
wa-kambo: plaf
ufafanuzi: fyic
siku-ya-kuzaliwa: gjin
nyundo: hcof
harufu-nzuri: hfon
marudio: trun
yasiyo-na-maana: twut
kick: hjik
kuchimba: kwaf
pet: plot
fuvu: hcop
bunge: dlik
kisigino: cruk
frown: crun
patent: plet
bilioni: blim
kemikali: fyik
majaribio: pyot
kuiga: mlot
skirt: kwet
isiyo-ya-kawaida: srap
kila-wiki: jwik
kiufundi: tfip
uoto-wa-asili: tset
jogoo: kraf
sunrise: sruc
maisha: glin
kuchangia: hyom
ndoano: hdok
tiger: blic
kupenya: crut
sleeve: slun
barabara: jras
wanamgambo: mlip
shimoni: kroc
uadilifu: kret
kumi-na-tisa: dzin
kikaboni: rwik
theolojia: flic
kuelea: flut
mchawi: byac
kuchoka: hwuk
kidiplomasia: dyik
studio: twos
kisichozidi: kcok
champagne: cyen
kuhamasisha: crif
bendera: hbes
talaka: lwon
bolt: hbut
mshipa: jyan
watazamaji: psif
povu: hgum
changarawe: grik
apron: tyen
sayari: gren
rafu: claf
shabiki: flon
kitropiki: hjip
awamu: fwas
holela: rwen
kutamka: kfun
zebaki: krok
huenda: hrem
kujiua: tcos
mwandishi-wa: prot
kuwanyima: hpok
wenye-ujuzi: klun
balcony: blik
uma: fras
mfanyakazi: mlek
mwajiri: myot
upana: jrak
irritated: djit
kuwashitaki: klot
pensheni: pyen
kitendo: kres
tumbili: mwon
kukubalika: hwek
saini: tlim
orthodox: rwos
kejeli: fron
kitalu: nrap
kusita: jlan
kuagiza: tyot
mwenge: croc
sarufi: gjak
amana: gyat
ukoloni: plon
yacht: jyat
consequential: kwec
kuba: kwun
unene: hfot
ukaidi: cyon
misuli: hmup
ukubwa: ryam
RUB: ryos
waoga: rwam
kuunganisha: gwac
toast: tros
panya: myus
silabi: slim
pat: prap
mazungumzo: dlaf
upande-wowote: nrot
bidii: dwin
utata: trot
kufikia: kfic
mbuzi: byak
kustawi: hfet
kulazimisha: mlon
bila-majina: nwim
rasmi-kusajili: frit
ndama: hbof
mwongozo: mwut
kuyeyuka: hjec
kufuta: flas
mwavuli: gras
Boot: bzut
madini: mrim
truce: crus
bata: hbok
mipango: pfam
sabuni: hsuf
doll: gwak
mifupa: klet
villa: blis
kushona: jlin
kupatanisha: dyak
aaaa: kset
kukomaa: mruc
sungura: kruc
kondakta: nwot
utegemezi: djat
mchezaji: jlic
wadudu: pset
mgahawa: cret
owl: lwun
radical: djik
mkazi: zwin
joka: dron
auditory-evidential: drot
kiu: kyos
msiweke: dren
hesabu: glun
udhibiti: ryim
Meya: mlap
wachache: mric
upatikanaji: dwon
mkongwe: bren
orchestra: ryes
Bacon: bjin
hasara: zwat
kitambaa: frap
mwanamuziki: gzik
kiakili: hnep
kushirikiana: nyon
duni: nrip
mbunifu: tsek
lemon: nyim
kikohozi: kcos
maumivu-ya-kichwa: crek
mpangaji: ryet
uzazi: srun
kupona: hfoc
tisini: nwon
random: hbec
kijiko: kcek
puto: blon
chaki: hfip
inferential-evidential: nlet
mchapishaji: pcot
siki: sruk
ash: fyec
expletive: slek
kufufua: nrut
wanahusika: kfim
handaki: tfun
puzzle: hpef
utaratibu: mwim
hisabati: gzit
fade: frun
ini: jwin
sublative-kesi: bwik
kuzamisha: dris
kitengo: twim
ukiritimba: hnop
kamari: hgup
manowari: bzin
tetemeko: hbem
maabara: brot
cork: kruk
binafsi-kudhibiti: syot
buddha: hbus
kuunganishwa: bjat
ubalozi: blas
farthest: sres
declarative-mood: drim
kichocheo: tyuc
chocolate: clot
bahati-mbaya: tyon
glove: gwat
kupiga-magoti: hjek
jiografia: hjif
uwekezaji: nwes
matusi: mrec
mlinganisho: nlip
kidunia: srek
kipanga: blap
saikolojia: nloc
fasten: gjan
chakavu: krep
jukumu: cyum
dozi: hdos
salmon: slom
pudding: pwun
magnetic: gyik
pampu: pcom
oksijeni: ksip
cheti: tfot
medali: hmem
rhetoric: trok
scrape: rwap
kasia: dyas
darubini: trip
mkufu: clek
herufi: prif
whiskey: hwos
Willow: hwof
ngamia: hlum
amateur: myet
exit: crec
wasifu: brif
punda: gzac
kila-mwezi: mwis
kupuuza: nruk
likizo: byit
click: lyik
mviringo: twon
elastic: lyet
kamusi: kfon
ham: gzam
upinde-wa-mvua: rwun
hutumia: kcum
mate: tcup
tank: trek
mwenzake: clok
butterfly: trif
chati: graf
pacha: jwat
kujitegemea: trem
mianzi: hbum
muuzaji: jlat
mkusanyiko: kles
mkaguzi: nyet
tonge: hyos
ndoto: hbom
jam: gjam
makumbusho: mrem
alfabeti: lwam
kuwatawanya: zras
uvamizi: crip
kufichua: clus
kuoza: fraf
fujo: gris
msuguano: mroc
gati: gyac
buibui: brik
viazi: trut
marekebisho: cwon
uchoyo: jlac
mapema: ryot
kuzidisha: gzan
spin: pcip
takwimu: tsok
kalenda: klem
uteuzi: nwen
trilioni: tlos
Attic: tlok
usawa-wa-kijinsia mood: rwim
maombi: pfen
majina: nlon
kutoridhika: sraf
maambukizi: hfok
mtungi: krot
shrug: cyok
waanzilishi: gzin
upungufu: nlif
kabichi: glic
riadha: tlet
ulevi: mrut
idiophone: hdof
lever: lwek
seneta: syem
iris: nrif
ant: mwam
mdudu: hbop
wajawazito: grim
precipitate: hjet
kifundo-cha-mguu: tcok
uainishaji: glik
kutofautiana: prim
wrap: ryap
curly: krec
kiberiti: hsef
kuandikisha: dwik
kuibuka: brun
frog: fram
kupindukia-kesi: twek
sifongo: hjen
annoying: djon
squirrel: slip
grind: zyin
irrealis-mood: flim
volkano: glam
ndani-ya-nyumba: gron
kunyonya: kloc
kijiolojia: jlik
pasipoti: psop
kinyume-cha-maadili: mlet
biskuti: hbuk
ushirikiano: kros
kibao: tlot
relaxation: kces
chembe: trom
misaada: hzip
piramidi: psim
mzunguko: swok
nap: hnup
kinyume-cha-sheria: hjaf
makucha: pfap
shyness: crom
kupatwa: klip
kinanda: lwap
ufagio: srum
jopo: mwen
elimu-ya-nyota: tcom
maze: blen
udhamini: bwit
kobe: kfuc
mshauri: dwak
fiber: fwic
kriketi: jrik
mbaazi: ksom
kukabiliana-na-hali: dyon
pembe-tatu: tfon
mweka-hazina: tsen
hidrojeni: jron
tete: hfuk
printer: pyet
hulisonga: tcof
sugu: gzon
kukabiliana: slaf
mtanziko: dlim
uhandisi: jyin
kamera: hkef
kuomba-msamaha: pluc
lick: lwet
dancer: dret
uhamiaji: mres
tennis: tces
mgongo: clip
kaanga: zrac
kufungwa: tfuc
kumchoma: twuc
nywila: psaf
ncha: praf
mkakati: zrit
quartz: krus
mkasi: jris
doria: proc
glacier: lwic
halfway: dwam
mkataba: mwap
koni: kwuc
ulinganifu: hzut
watengenezaji: zrak
mshtakiwa: fwik
msikiti: djis
chess: cres
toll: htof
cherry: tref
kuenea: kfen
mashaka: tfok
lori: ryok
haradali: mros
asilimia: pfet
mnada: jlam
ungo: srif
unsteady: swoc
sumaku: gjat
Suck: syus
islam: slum
njongwanjongwa: twip
utando: mlen
kunyoa: clet
guitar: gjit
shiny: bzan
elm: hyem
kuongezeka: kcom
pronoun-marker: ryec
kikuu: pcus
spice: zlat
dhamana: jlas
carrier: zyac
vibration: bron
tease: trus
jembe: hlom
kisaikolojia: zlik
gutter: hgok
Comet: cyet
medieval: dyic
shomoro: grec
fidia: twet
plastiki: psuk
footnote: cyot
obiti: rwot
frugal: twum
gofu: hgof
sifuri: zrun
chip: tcep
kuonea: prok
yawn: gjac
kukosekana-kwa-usawa: gwas
mole: tloc
ufinyanzi: frik
mama-wa-nyumbani: hgif
Rye: rwem
muasi: hyes
wavumilivu: glon
kiinitete: brec
miner: jren
kupongeza: zlac
chachu: lyim
premium: pfim
plum: plem
kufilisika: byas
kilimo-cha-umwagiliaji: rwif
mnanaa: nyun
ubepari: glis
elasticity: hlef
papa: gyak
recruit: drut
kuhifadhi: zren
uhalisia: cles
tangawizi: djic
ambulance: blus
kulinganishwa: kwip
mkoba: bjap
grimace: glim
mwanasayansi: gyis
gut: grot
equanimity: hwum
radio: href
lisilo: zlit
maharage: bwam
isiyo-rasmi: frim
mjukuu: gyut
kutokubaliana: dloc
steak: tfek
nitrogen: zron
wembe: hjut
zinazokinzana: krom
propaganda: pcoc
fireworks: fris
pop: pcop
undress: crop
mitaro: cruc
madhara: hzaf
Judaism: hjum
inayosaidia: pluk
Lens: lyes
pegative-kesi: pwek
kansa: kfes
pawn: pyek
mhadhiri: zyat
leak: hzuk
kuhitimu: krif
msongamano: djot
introduktionsutbildning: dyis
kutafuna: htuf
talkative: bzit
lobster: hgos
discount: dyut
teksi: tsuk
uongozi: crem
jade: gyec
gwafua: glaf
mjusi: lyis
maporomoko-ya-maji: crof
kuwakatisha-tamaa: djak
Veto: frot
urais: ryip
mnunuzi: mrif
gallon: jlen
mbu: mruk
kupotoka: dwen
kushindana: lyut
mosaic: myok
kuziba: plok
squat: pcuk
vyakula-na-vinywaji: ksoc
kikomunisti: myos
amaze: mwek
prosecutive-kesi: rwuk
constellation: nlos
dikteta: dwit
preoccupation: tyet
satellite: tlec
slipper: hlop
consonant: fyon
takriban: tsif
ajira: byet
msaidizi: sros
lotus: lwot
lettuce: sles
chloride: lwok
vimelea: bwic
nata: pcek
sehemu: bwon
kernel: klec
jipa: bjak
Byte: bzet
secretion: sruf
waziwazi: pres
sanjari: mloc
ballet: blet
mkojo: mrus
vitunguu: lyun
ilipita: hguc
uchumi: kcem
daraja-la-kati: hdom
agile: gjic
koleo: htef
kufulia: lyoc
strawberry: srem
mijini: pcos
embarrass: mlaf
daftari: tfut
albamu: zlam
baseball: hbep
vuta: sluc
makofi: hbuf
Mmoja: rwip
karakana: grek
utambuzi: djas
mkongojo: ksuc
kujipatia: srom
usajili: psuc
mumunyifu: jlun
phosphorus: psof
kimuundo: rwut
gundi: glum
Thesis: twes
fundi: clif
banana: bwas
axiom: kyom
ubavu: psos
nickel: nyek
pi: pyim
basi: bwos
censor: swes
kombora: mlus
sausage: slos
kudanganywa: nlut
nyanya: tfet
kuimarisha: kfut
tundu: syok
potassium: tsom
retrieve: prup
virtual: zwit
algebra: gjas
daktari-wa-meno: dzit
macho: pcok
Budge: bzen
biolojia: bwim
ukosefu-wa-ajira: byim
caterpillar: krum
solo: slof
kisakuzi: bjac
kijijini-siku-za nyuma uliopo: nyot
kihistoria-uliopo: crep
nyuklia: nluk
wigo: pyem
sodiamu: syom
hysteria: syes
mdhamini: tyos
mateka: byik
gourd: gluk
kasoro: kwuk
uwazi: tfif
Mwiba: swip
kipaumbele: pcif
pedestrian: dyen
atheism: tsem
kufuatilia: mwot
jimbo-la-uchaguzi: nlec
ulafi: hkof
probe: grok
platinum: plip
mbili-idadi: dlun
mapafu: pcep
super: syup
kitoroli: trop
ndani-ya-nchi: lyot
kuchocheana: gzat
petroli: plif
figo: grif
kupora: bzac
tathmini: dlen
arseniki: syek
konokono: nrok
panzi: tsec
equation: fwen
ujamaa: swos
filter: flot
hisia-evidential-mood: hxin
kuongeza: kyot
emit: mwet
leash: pwet
mandarin: drun
jockey: hjok
pneumonia: hnof
mshikamano: gret
pata: cyif
longitudinal: nruc
mgao: dwun
skate: hkep
exponent: slop
ulemavu: dlif
obsession: bwen
mgawo-huo: pfun
mpiga-picha: trof
delta: dlet
digital: djim
Bitch: brut
Eyelid: hyop
diagonal: dyun
subconscious: byon
eyebrow: bruc
kuchafya: pcec
hilarious: dlis
Uhindu: nwum
wakimbizi: nyif
kuhamisha: cwot
protini: pwot
dampo: hdop
kuboresha: flen
matapishi: hwom
jeni: gyen
freshman: hdem
sosholojia: syoc
boga: kwoc
mvuvi: hfuc
kikanda: jyen
mwendo-uphill: hvok
retrospective: hxik
tornado: gyon
inversion: nwos
filamu: twif
cube: kfet
tija: pwuk
karoti: krop
Masi: mwuk
conglomerate: glet
mhasibu: ksum
tango: kyok
orgy: drok
kutengenezea: jlet
phosphate: psef
primer: gwik
alkali: flis
gymnastics: jyas
comma: kwom
mwendo-kuteremka: hvat
kuharibika-kwa-mimba: jwac
ganda: tcop
wafadhili: dzon
manganese: hzem
psychologist: syos
chlorine: clos
keyboard: kyoc
wasomi: zyit
mabano: pfaf
mchezo-wa-raga: rwoc
kidonda: jlon
Inflected: hxit
nibble: nres
quantum: fwam
sweta: swek
evolutionary: fwis
notation: nyoc
bounce: tcuf
dissection: drec
cache: kcep
linear: lyec
antimoni: trum
superessive-kesi: psek
tumor: twom
mmomonyoko: cyos
alpha: flaf
kitovu: nwip
kinga: myip
mafua: flun
kampuni-ya-bia: bjit
kurahisisha: slef
abridge: bram
dent: djen
captivate: dwim
kuilazimisha: brok
sock: bzas
movie: fyim
cosmos: klom
kuchafua: hpuf
gregarious: gjen
uume: zyis
misitu: lyif
alumini: lwum
oscillation: zlon
horoscope: ksop
sua: dlek
ushirikishwaji: nluc
walengwa: byic
dolphin: dlip
muuaji: cyus
mamalia: myaf
kiashiria: swif
dioxide: dwis
colon: zlen
urasimu: brus
kupotosha: jric
jokofu: frip
archaeological: cluk
haikubaliki: kwok
vipimo: pfis
kipeperushi: pfut
anthropolojia: nlom
kitamu: kyec
elekezi: txit
cower: kwus
alizeti: hzuc
chawa: glus
ion: lyos
utalii: tyum
modem: myom
kuongeza-kasi: jrun
kadhibisha: tsoc
chafu: hmef
kidnap: drap
mwingiliano: hwep
hairdresser: pfes
ngano: floc
kapilari: plek
utaifa: nlum
matako: nros
motif: hmuf
sublimate: slem
kuchanganyikiwa: xras
cobalt: kwos
oat: gwam
mwendo-upriver: trup
haja-kubwa: gyam
bovin: bwun
flip: flip
redundancy: dzun
video: hwop
kususia: bjik
jaribio: cwif
magongo: cwok
msituni: grip
magnesium: hgem
rada: drek
chimpanzee: hzif
kuegemea: kwif
mstatili: tyec
kelp: klep
kujumlisha: jlak
amri-ya-kutotoka nje: kfec
mashoga: mlok
scenario: srop
uundaji: flus
reincarnation: nrom
kuwasha: zlak
urani: ryum
catcher: kwes
kuratibu: kyop
walipa-kodi: nwaf
jumuishi: trep
alitoa-maoni-yake: hzap
gamma: hxam
safari: fwim
mwendo-downriver: ht6n
mgawo: kfus
kichwa-cha-habari: zlic
mchambuzi: nles
Checkmate: hzes
mall: hmof
bismuth: bzim
Postcard: psok
muunganiko: bros
digress: djet
mbia: ksem
kidudu: mrip
sehemu-za-siri: jwit
maumbile: mluk
beta: byot
jeans: gjis
database: tles
calculator: klus
X-ray: ksef
Hazrat: zram
mazingira: zyen
sigma: zyim
disjunction: hxon
agenda: gres
visa: bzis
miundombinu: nyuk
kimulimuli: gyun
detector: tyek
adaptive: dyip
biologist: byis
ganga: pyec
bromini: brom
palladium: plum
kwikwi: kfok
Pastel: psec
zoo: zwac
kliniki: lyok
connotation: nwoc
yoga: hjoc
Bookstore: byun
tiba: grap
mzalendo: zlis
behead: zlet
yeah: swec
matatizo: byam
jazz: dzas
Tungsten: tsof
kigaidi: gwis
piga-chenga: droc
kimetaboliki: tlem
alimony: lyaf
mwishoni-mwa-wiki: hfom
Chrysanthemum: gzim
chanjo: byap
pikipiki: tyok
mantra: dyot
muhula: myes
heroin: gwon
folder: flap
cathode: kfoc
itikadi: dlec
maegesho: prek
theta: fret
anticlimax: hxis
selenium: clem
baiskeli: blek
cortex: pros
yanayolinagana: swaf
sasa-umuhimu-marker: hxak
uwanja-wa-ndege: cwoc
butua: gyet
mpira-wa-kikapu: bwet
mzushi: mwip
cockroach: tlek
chromium: hgom
lita: hl6t
hata-hivyo: nwec
homoni: cwom
kiujanja: tluc
toboa: prec
animism: nyom
poligoni: cloc
masuala-ya-kijinsia: hfes
conjugate: kcop
euro: dros
ginseng: hjes
algorithm: hlof
laser: lwes
drugstore: dlot
millimeter: mlem
flex: flek
anode: nlok
nuance: hzus
sehemu-ya-muda: prem
unyeti: nyec
demonstrator: drom
helium: clum
bilingual: dzic
kifupi: hqim
initialism: nl6m
gerund: gros
plasma: psem
chromosome: rwom
makutano: rwok
kilometa: klum
faksi: tfes
genetics: nwek
freckle: frek
bisibisi: dres
broccoli: blok
preterite: xrit
vitamini: tyem
cadmium: kyem
mshambuliaji: bwoc
graphical: gjik
titanium: dyim
splurge: clec
lambda: lwem
mpenzi: pcem
--jamii: kyuk
hourglass: tlus
uelewa: mlif
boroni: bres
helikopta: cwet
tellurium: tlum
Tarehe-ya-mwisho: jyic
kujipanga: gwic
sentimita: hfem
molybdenum: mlom
lithiamu: tfim
multimedia: myum
update: dyet
calorie: clom
robot: ryoc
kazi-ya-nyumbani: groc
logarithm: grom
vunjajungu: gzas
instal: nwut
amino: myoc
glyph: glif
aorist: pyos
ikolojia: plec
sophisticate: flok
bangi: bjam
micro: mrom
kilo: lwom
overeat: jrot
kutabirika: dzik
pizza: zyas
eavesdrop: zris
isimu: bwis
haircut: braf
Iridium: ryom
ubaguzi-wa-rangi: gwim
mojawapo: gyim
viwanda: drif
Makao-makuu: krup
cerium: zrim
congruent: nrum
partitive-kesi: pxik
mkanda: ksep
willpower: blot
dimensional: dzen
parameter: rwet
synchronize: nrop
maximo: dzim
semina: mwec
disco: dyok
neon: nyok
osmium: hzom
Epifania: hp6n
plagiarize: lyap
artifact: rwek
mtambo-huo: fyet
oregano: ryop
plutonium: pwum
yttrium: tyom
augmentative: hxat
username: mrum
Uzamili: zrot
mrengo-wa-kulia: dwaf
argon: jros
phobia: hxot
utakusanyika: sluk
utandawazi: bluc
wavelength: hnef
encode: kfom
kusaga: psoc
Anzisha-tena: nrek
hepatitis: pyes
torus: fros
kidini: myep
modulo: mwok
proton: zwot
diskette: dwet
milligram: mlum
pixel: psep
tantalum: twem
solute: hjot
mauaji-ya-kimbari: nyos
predator: rwes
gallium: glem
zirconium: hzum
determiner: txin
nonlinear: nlem
madawa-ya-kuulia wadudu: pyif
berili: brem
neuron: nrus
predicative: pxit
chupi: tlif
factorial: kref
neutron: zrut
niobamu: nwom
Gerimani: hjem
metalloid: tlop
kuweka-juu-ya: dlap
prolative-kesi: hl6k
viumbe-hai: jwic
joystick: jyok
antibiotic: twok
actinium: gjim
astronaut: srof
extraterrestrial: tyes
crackpot: hwup
marathon: mrof
ytterbium: zwim
autism: tyif
ionize: nlof
Radoni: cwos
Nerium: nrem
magonjwa: pwip
Uzee: lyuc
kambi: kyep
striped: drip
INDIUM: nyum
veridical: hvik
tovuti: bwes
kurani: kwek
flatware: fwet
nth---mzizi: tfec
lawrencium: lyem
kiraia--haki: glip
Simu-ya-rununu: mlof
amepooza: twoc
protactinium: prum
mionzi: hd6n
wanategemea-juu-ya: pxin
thorium-chembe: hxim
bluu--jean: bjun
nyumba-kupanda: hxas
mmoja-mmoja: dvit
mtiririko--sasa: lwuk
mara-tatu--kumweka: ht6t
binadamu--mwili: hn6n
fizikia: bzik
rejareja-duka: hxan
cesium: hs6m
muda-mrefu-iliyopita: hqan
spreadsheet: hxet
kitengo--ya--habari: hn6m
kukusanya: ml6n
mapacha---thamani: vrim
binadamu-kuwa: nyus
na-njia-ya: hvan
depan-dari: pxat
praseodymium: pyom
kadi: kxat
finite-verb: hqik
kesi-idadi: hr6n
pro-hukumu: hr6t
critic: hk6k
ufungaji: pxas
impermanence: pxan
katika-zaidi: txas
descriptor: drop
neodymium: nyem
urafiki: hvit
kusoma-tu: xyak
inaanzisha: xwan
gnomic-mood: kxin
phoneme: hxom
rationality: xlit
kifonolojia: xlin
dining-chumba: hxac
hai-chumba: hxic
centric-kesi: zrik
kabla-hodiernal: hx6n
mgonjwa-kesi: hqak
oblique-kesi: bwok
vijijini-eneo-la: hqat
recurse: hr6s
katikati-sauti: dyos
meitnerium: hm6m
mail--carrier: hvak
noncommittal: kxit
hisa-soko: xrak
zinazotambulika: hxap
lengo-trigger: krof
moja-na-mbili: hxen
lative-kesi: dvak
ration: hr6c
zisizo-binadamu: hg6n
hai-jambo: hvic
pia-kidogo: hxut
movie--ukumbi: hvin
hassium: xyim
attenuative: ty6t
multal-idadi: ml6m
milky-njia: txam
neptunium: nwem
ghostwriter: txik
trans-numeral: ts6s
kumdanganya-kuzunguka: hqun
americium: myem
asubuhi-utukufu: txan
firefighter: xran
berkelium: blem
galaxy-jinsia: kxan
nobelium: blum
kwaheri: hvac
mabudha: hfum
fermium: frem
cyan: xyan
soya: syof
distribuerar: qrit
strikebreaker: txak
processor: ples
abessive-kesi: bvak
adessive-kesi: dvik
kwa-kesi: kxak
agentive-kesi: dvek
rutherfordium: hr6m
antibody: txip
kama-kiasi-kama: hjos
wakala-trigger: hg6t
muigizaji-jukumu: xram
ethidium: txim
kawaida-jinsia: hk6n
accompanier: kl6n
katamu: kxam
francium: fyam
Erbium: ry6m
watazamaji-sauti: xyis
Astatini: hqit
kubugia-gum: hqam
nyota-jinsia: hqin
citation-fomu: ht6m
curium: jrim
Comic--strip: kxis
rangi-kipofu: hqon
euler's---idadi: hl6m
kuangalia-katika: kxas
crosswalk: pwok
uwanja-wa-vita: txat
motorist: vrit
mzunguko-mfupi: txok
matusi-noun: hvis
kilio-nje: hk6t
kitakwimu: xyit
mgando: txot
xenon: hs6n
hypnotize: hxif
kuchukua-mbali: hxaf
kifungu-mkia: hxok
moja-kwa-moja kitu: dwot
vyakula-na-vinywaji duka: kxun
wajumbe-ya: hm6t
ergative-kesi: gvik
katika-lugha: txic
kwanza-mkono: pxam
locative-kesi: hqok
Bwawa-la-kuogelea: slup
adverbial-kesi: vlak
kitalii: hqas
televisheni-seti: ht6s
mwisho-chembe: xlik
evitative-kesi: hvek
ukarabati: xlat
regression: xris
kuzuia-ya-kujaa: kxot
kuamka-up: hxup
polisi-afisa: ps6s
kumwapisha: vran
INTERVIEWER: qrat
rhenium: ryem
erosoli: xres
kutochukua-kesi: kxik
nominalization: mlec
mwendawazimu-kesi: dzak
fedha-zaidi: pxak
msaidizi-verb: xyik
msingi-kitu: mlut
kompyuta-virusi: prus
mtu-wa-biashara: hqis
a-watu: hqen
antessive-kesi: ts6k
Waziri-Mkuu: pxis
lutetium: lyum
europium: rwum
emote: xrot
folk---muziki: zyik
mshairi: vwit
ofisi-ya-Posta: pxot
eti: hvas
animate-jinsia: hven
subessive-kesi: bvik
gesi--kanyagio: glep
polarity: pr6t
gari-jinsia: vlin
madini-jinsia: xrin
kitendo---suffix: hvif
passionate: pc6n
samarium: sr6m
mwezeshaji: hs6t
imaginary--kitengo: xyin
kasi---ya -mwanga: kxac
Jeshi-la-anga: hxes
huruma-furaha: pfec
muhimu-ya-kiwango: qyit
wakati-wote: hxem
hafnium: xyam
kolinesterasi: hn6s
mabadiliko-ya-tukio: qrin
holmium: xlim
tofauti-tukio: hf6t
ulimwengu-jinsia: hvip
eneo-jinsia: kxen
virtual-mashine: hvim
utafiti-jinsia: txen
kisanii-jinsia: ts6n
crastinal-uliopo: sl6t
abstract-jinsia: srep
exocentric-kesi: zrek
elekezi-verb: txif
morpheme: tfom
chauvinist: dvis
siku-za-nyuma perfective: xrat
ufundi: hy6n
moja-kwa-moja hotuba: tyoc
pili-lugha: draf
kwa-kuwa: txis
graveyard-mabadiliko: vrak
pamoja-noun: hxos
absolutive-kesi: bvuk
mgonjwa-trigger: tr6t
binafsi-kujiamini: hs6s
kinyesi: hzos
reflexive-sauti: hf6s
impersonal-verb: hxek
seaborgium: br6m
nafasi-nyeupe: hxep
modal-kesi: dlok
inanimate-jinsia: hj6n
causative: qran
propositive-mood: psom
umeme-sasa: tr6n
associative-kesi: nwok
superlative-kesi: tluk
pia-kiasi: xyut
planetary-jinsia: pxen
animated-cartoon: nwuk
kubadilishana-sauti: vrik
kutunga-sheria: hqaf
katika-angalau: vlas
kisarufi-kesi: qrak
user: pxut
msingi-benefactive: kfef
kipa: hgop
:-except-for: kcef
denominator: dvan
kingine---kama: lyek
sideways: hx6s
kila-mmoja: dles
mfululizo-kifungu: lyuk
kuvaa-nje: hxun
kaptula: ht6k
dysprosium: prom
haraka-baadaye-uliopo: rwec
si-vitengo: vyin
Kriptoni: kxon
mendelevium: dlem
applicative-sauti: hp6s
antipassive-sauti: tsef
continuative-kipengele: ht6p
mionzi--ugonjwa: hr6k
necessitative-mood: hn6t
single-hatua-verb: hqek
railcar: xlak
superlative-shahada: tlup
existential-kifungu: hs6k
californium: kf6n
sasa-Mmoja: vrat
luminous-kiwango: hc6t
singulative-idadi: slus
kisarufi---kitu: hy6t
watazamaji-Mmoja: vris
kupindukia-muda: kxic
supercritical---maji: sr6t
kiasi-ya-Dutu: ks6t
postpositional-kesi: pxok
elective-watakwimu: lwif
gadolinium: dl6n
epenthetic-morpheme: hp6m
negatory-watakwimu: nwif
einsteinium: ny6n
bandia-lugha: txac
connective-chembe: qrik
kijijini-baadaye-uliopo: twec
frequentative-kipengele: hfep
distributive-pronoun: bvin
allocution-makubaliano: hk6m
bald: blos
kitongoji: syum
wote-watakwimu: vlit
kompyuta-programu: mr6m
televisheni-mpango: tr6m
floating-kumweka---idadi: hvun
existential-watakwimu: tl6t
the-siku-baada kesho: dwek
mbadala-watakwimu: lw6t
--tukuta: hdup
siku-za-nyuma watazamaji Mmoja: hp6t
the-siku-kabla jana: txet
locative-directional-kesi: tc6k
counterfactual-masharti: ht6c
