nauni: ni
nominative-kesi: na
accusative-kesi: ka
mada-kesi: ta
hodi: ca
genitive-kesi: sa
kivumishi: ci
na: wa
mimi: mi
wewe: ya
sisi: nlah
ni: yi
marudio-kesi: ti
dative-kesi: pa
mambo-ya-ndani mazingira: tu
mtu-mazingira: pi
tegemezi-kifungu: yu
perfective-kipengele: fa
siku-za-nyuma uliopo: ki
masculine-jinsia: si
comitative-kesi: mwih
sasa-uliopo: ma
benefactive-kesi: pwah
essive-kesi: swih
si: nu
wake: tsih
uso-mazingira: su
adpositional-kesi: pu
eneo-kesi: te
nafasi-mazingira: no
njia-kesi: ra
instrumental-kesi: se
interrogative-mood: ri
na-au: to
kipekee---au: ku
chanzo-kesi: so
ablative-kesi: lwah
demonstrative: di
lakini: la
kike-jinsia: ne
wingi-idadi: lu
baadaye-uliopo: we
kijamii-mazingira: mo
imperfective-kipengele: me
kuna: klah
masharti-mood: co
zaidi: kcoh
jamaa-kesi: nwih
illative-kesi: lwih
agizo-mood: de
deontic-mood: da
swali-neno: slah
copula: ksah
mtu: psoh
wengine: tcoh
idadi: do
sana: tcah
wakati: trah
wakati-mazingira: ro
muda-kesi: mrah
kuhusu: ke
epistemic-mood: pe
tu: twuh
kisha: pcah
hortative-mood: twah
retrospective-kipengele: rwih
volitive-mood: li
kabla: tceh
baada-ya: ba
alienable-milki: lyih
inalienable-milki: nlih
taamali-mood: drih
perlative-kesi: pwih
maendeleo-kipengele: psih
hapa: tcih
chini-ya-mazingira: ce
delative-kesi: dwih
semelfactive-kipengele: mweh
mamboleo: nyoh
lengo: fo
upendo: pyah
paucal-idadi: ploh
kwa-sababu: yo
causal-kesi: ksih
jina: gi
sahihi-noun: tsah
hortative: re
inayoonekana-evidential: crih
desiderative-mood: dwah
terminative-kesi: twih
inessive-kesi: nweh
muhimu-mood: prih
kuamini: kcah
hali-mazingira: ga
matumaini: cwah
factive-evidential: fwih
optative-mood: pcih
realis-mood: le
uwezo-mood: tlah
allative-kesi: lweh
anthropic-jinsia: fi
somo: wo
sawa-somo-marker: cyah
tofauti-somo: fe
hofu: ko
shaka: cu
dubitative-mood: tweh
maslahi: nyih
vialis-kesi: wi
ajabu: trih
mabadiliko: ryih
furaha: clah
isipokuwa: swah
hamu: kwah
urefu: lo
uwezekano: bi
makubaliano: grah
shida: mlah
quotative-kesi: kwih
umoja-mtu: lwoh
precative-mood: rwah
polite-kusajili: brih
wanaotazamiwa-kipengele: tfah
gnomic-kipengele: go
inchoative-kipengele: zi
jussive-mood: jwih
permissive-mood: mwah
sahihi: kcih
distal-demonstrative: tseh
distributive-kesi: nwah
kuamua: treh
maumivu: droh
busara: ja
kutochukua-marker: srah
commissive-mood: mu
mshangao: crah
completive-kipengele: kweh
hasira: nrah
kiburi: brah
pole: pceh
ujasiri: krah
neema: nreh
harakati: mroh
wasiwasi: cwih
kukoma-kipengele: za
intensifier: tfih
evidential-kesi: ryah
kusikitisha: syah
vinginevyo: tyah
Zoic-jinsia: zo
eventive-mood: nwoh
sawa-tukio-marker: cwoh
multiplicative-kesi: plah
kushangaa: prah
huruma: lyah
wingi: mlih
kuridhika: srih
wema: be
mapema-mno-mood: po
ukoo-kusajili: krih
waliojeruhiwa: frah
huzuni: proh
eh?: nyah
kuwashukuru: kyah
aibu: ru
maneno-marker: fyah
mwaminifu: cyih
msisimko: tyeh
hesternal-uliopo: tleh
chuki: tyih
mantiki-jinsia: tlih
uliokithiri: kreh
vegetal-jinsia: slih
udadisi: kyih
kutishika: kcuh
makala: myah
baraka-mood: bwih
hatia: dlih
wajinga: nrih
ukarimu: drah
mpango-kesi: twoh
kuchelewa-muhimu: ji
taarifa-evidential: psah
lawama: dlah
taabu: kfah
umoja-idadi: gu
kusamehe: pfah
uvumilivu: je
rejea: freh
upweke: kyoh
charm: croh
shauku: tsuh
kufata-mood: tcuh
mjadala-mazingira: ye
vocative-kesi: bo
dharau: grih
mawaidha-mood: tyuh
tamaa: bwah
kuendelea-kipengele: nyeh
moja-kwa-moja evidential: troh
apprehensive-mood: pcoh
mshtuko: cruh
hivi-karibuni-siku za nyuma uliopo: clih
uhakika-makala: klih
wivu: ryuh
imprecatory-mood: mrih
kutojali: du
assumptive-mood: syih
kuumia: kroh
protasis: rwoh
uhasama: cyuh
mimetic: mreh
yaani: gwih
hodiernal-uliopo: dloh
delimitative-kipengele: dweh
kipekee-mtu: kwuh
telic-kipengele: tfeh
atelic-kipengele: tsoh
kikwazo-mood: jrih
mateso: nroh
uaminifu: nloh
momentane-kipengele: myeh
msamaha: jrah
wanyenyekevu-kusajili: myih
zamani-marehemu: frih
kunukuu: wu
kero: zrah
habitual-kipengele: bu
consequential: kseh
bidii: dyih
rasmi-kusajili: sreh
auditory-evidential: creh
kushirikiana: ksoh
inferential-evidential: flih
expletive: sleh
sublative-kesi: swoh
declarative-mood: ksuh
matusi: kceh
usawa-wa-kijinsia mood: fwah
kutoridhika: dyah
idiophone: dyoh
kupindukia-kesi: zwah
irrealis-mood: ze
shyness: cyoh
kukabiliana-na-hali: pyih
pronoun-marker: ryeh
kuonea: zroh
equanimity: jyah
pegative-kesi: pweh
prosecutive-kesi: pwuh
preoccupation: byah
Mmoja: pfih
kijijini-siku-za nyuma uliopo: dzah
kihistoria-uliopo: sroh
hysteria: syeh
mbili-idadi: dluh
hisia-evidential-mood: xi
mwendo-uphill: ryoh
retrospective: txih
mwendo-kuteremka: myoh
Inflected: blih
superessive-kesi: psuh
elekezi: t6
kuchanganyikiwa: xrah
mwendo-upriver: truh
mwendo-downriver: txah
disjunction: xo
anticlimax: tloh
sasa-umuhimu-marker: xa
kifupi: qi
initialism: nl6h
gerund: ge
preterite: preh
aorist: broh
partitive-kesi: pxih
Epifania: pf6h
augmentative: xe
phobia: xyoh
determiner: txeh
predicative: plih
prolative-kesi: pxah
veridical: vyih
mapacha---thamani: vrih
finite-verb: vi
kesi-idadi: pc6h
pro-hukumu: r6
urafiki: va
gnomic-mood: kxih
centric-kesi: dreh
kabla-hodiernal: x6
mgonjwa-kesi: qa
oblique-kesi: bwoh
katikati-sauti: tyoh
zinazotambulika: xyah
lengo-trigger: groh
lative-kesi: dvah
zisizo-binadamu: n6
attenuative: nyuh
multal-idadi: mloh
trans-numeral: ts6h
galaxy-jinsia: gjah
kwaheri: jwah
abessive-kesi: bvah
adessive-kesi: dvih
kwa-kesi: kxah
agentive-kesi: dveh
wakala-trigger: greh
muigizaji-jukumu: nruh
kawaida-jinsia: k6
accompanier: kloh
watazamaji-sauti: pyoh
nyota-jinsia: qrah
citation-fomu: xu
matusi-noun: xlih
kifungu-mkia: kluh
moja-kwa-moja kitu: rweh
ergative-kesi: gvih
katika-lugha: byih
locative-kesi: kwoh
adverbial-kesi: vlah
mwisho-chembe: nluh
evitative-kesi: ve
kutochukua-kesi: kfih
nominalization: mleh
mwendawazimu-kesi: djah
msaidizi-verb: fyih
msingi-kitu: myuh
antessive-kesi: nleh
animate-jinsia: xrih
subessive-kesi: bvih
gari-jinsia: vlih
madini-jinsia: xwih
kitendo---suffix: kxeh
huruma-furaha: pfeh
mabadiliko-ya-tukio: qrih
tofauti-tukio: txoh
ulimwengu-jinsia: bjih
eneo-jinsia: lyeh
utafiti-jinsia: txuh
kisanii-jinsia: s6
crastinal-uliopo: sl6h
abstract-jinsia: sruh
exocentric-kesi: zrih
elekezi-verb: tfoh
siku-za-nyuma perfective: tr6h
moja-kwa-moja hotuba: dyeh
pili-lugha: sr6h
pamoja-noun: kxoh
absolutive-kesi: bvuh
mgonjwa-trigger: pruh
binafsi-kujiamini: swuh
reflexive-sauti: flah
impersonal-verb: pseh
modal-kesi: dleh
inanimate-jinsia: djih
causative: kruh
propositive-mood: pxoh
umeme-sasa: breh
associative-kesi: sloh
superlative-kesi: sluh
planetary-jinsia: pxeh
kubadilishana-sauti: syoh
msingi-benefactive: kfeh
kingine---kama: kyeh
mfululizo-kifungu: lyoh
haraka-baadaye-uliopo: rwuh
applicative-sauti: pyuh
antipassive-sauti: ps6h
continuative-kipengele: tfuh
necessitative-mood: nr6h
single-hatua-verb: qyah
superlative-shahada: tluh
existential-kifungu: sy6h
sasa-Mmoja: vrah
luminous-kiwango: kyuh
singulative-idadi: glih
watazamaji-Mmoja: pfoh
kupindukia-muda: kxuh
kiasi-ya-Dutu: m6
postpositional-kesi: pwoh
elective-watakwimu: vwih
epenthetic-morpheme: p6
negatory-watakwimu: gwah
connective-chembe: qyih
kijijini-baadaye-uliopo: tl6h
frequentative-kipengele: f6
distributive-pronoun: bzih
allocution-makubaliano: ks6h
wote-watakwimu: xlah
floating-kumweka---idadi: fu
existential-watakwimu: sweh
mbadala-watakwimu: l6
siku-za-nyuma watazamaji Mmoja: xyih
locative-directional-kesi: kfoh
counterfactual-masharti: fyoh
