mastar: hnit
yalın-dava: hnak
ismin--i-hali dava: hkak
konu-dava: htak
ebeveyn: hmat
baba: hpap
anne: hmam
Merhaba: hnat
ata: htat
büyükbaba-veya-büyükanne: hyat
aç: hcac
-in-hali-dava: hnik
sıfat: hcit
ve: hwan
bana: hmic
sen: hnan
bize: hnam
o: hyic
hedef-dava: htas
datif-dava: htik
iç-bağlam: htis
kişi-bağlam: hpak
bağımlı-fıkra: htan
tamamlanma-belirten-görünüş: htap
geçmiş-gergin: hkat
eril-cinsiyet: hsan
comitative-dava: hmik
mevcut-gergin: hyan
benefactive-dava: hpik
essive-dava: swik
değil: hnic
onun: hsis
yüzey-bağlam: hsak
adpositional-dava: hpan
yer-dava: hwak
uzay-bağlam: hnos
yol-dava: hrak
enstrümental-dava: hsik
hangi: hkan
soru-ruh-hali: hnim
ve-veya: htam
dışlamalı-veya: hkit
kaynak-dava: hsok
ablatif-dava: hlak
inandırıcı: hdit
ama: hlan
tüm: hsut
kadınsı-cinsiyet: hnin
onlar: hwin
çoğul-sayı: hlun
bir: hyik
gelecek-gergin: hwet
sosyal-bağlam: hson
ne-zaman: hkap
bitmemişlik-görünüş: hmap
Orada: hkac
şartlı-ruh-hali: hcan
Daha: hdoc
dışarı: htac
göreceli-dava: hrik
illative-dava: hlik
yapmak: hkas
direktif-ruh-hali: hden
dışsal-bir-ruh hali: hdim
soru-sözcük: hwac
bağ: hkok
kişi: hpon
erkek: hman
olabilir: kwat
diğer: hcon
numara: hnoc
çok: tcac
zaman: htim
zaman-bağlam: htos
geçici-dava: hmak
hakkında: hkam
epistemik-ruh-hali: hsim
sadece: htun
küçük: hcak
daha-sonra: pcan
gayretlendirici-ruh-hali: hton
geçmişe-yönelik-görünüş: hrip
harika: hcat
irade-ile-ilgili ruh hali: hlim
önce: hsec
şart: pcic
iki: htut
görmek: tcan
bilmek: hsat
aşağı: hcin
sonra: hcas
ilk: hpas
kendi: hpun
devredilebilir-mülk: hlic
asla: hnac
devredilemez-mülk: hkic
eski: hwat
ihtiyatlı-ruh-hali: hcim
gün: htin
nerede: hnap
hadi: hlat
yol: hyas
iş: hkaf
ünlü: hwaf
gitmek: hkun
perlative-dava: pwik
ilerici-görünüş: hpip
uzun: hlac
söylemek: hsac
Nasıl: hkin
hatta: hpit
geri: hwap
İşte: hcic
düşünmek: hcik
aynı: hsam
son: kcac
uzakta: twan
altında-bağlam: hnas
almak: htit
bulundu: hfan
el: cyat
genç: hyac
gerçi: hyap
vermek: hkik
Tanrı: hmac
delative-dava: lwak
hiçbir-şey: hmin
sağ: hyit
bir-Zamanlar: hyam
semelfactive-görünüş: fwip
bölüm: hpat
testere: htic
ev: hfas
Dünya: tcat
kafa: hcaf
üç: tyin
neo: hnon
odak: hcok
aşk: hpac
her-zaman: hsit
gece: hwit
her: hmit
kral: hyak
arasında: hsin
kalp: cyin
paucal-sayı: plom
çünkü: hyok
nedensel-dava: ksak
şey: hkis
set: swat
isim: hnem
uygun-isim: hran
gayretlendirici: hrat
ülke: hlit
diye-sordu: hput
görünür-ortada: crit
daha-iyi: pcac
yan: psac
kurs: hkus
kadın: hfin
yeter: kyat
yakında: hpuc
tam: hcun
oda: hfac
neredeyse: hlap
olamaz: nyat
su: hwik
dilek-ruh-hali: hdin
ışık: lyak
ne: hnun
kelime: slat
kapı: tyan
kullanım: hpus
sabah: hsap
terminative-dava: twik
güç: hkuk
kendilerini: hmis
mevcut: hyin
ses: hwas
beyaz: hpis
para: tlan
Sonraki: kyak
fakir: hyis
ölüm: hmut
form: hfam
inessive-dava: nwik
tür: tyac
sık-sık: tsan
yıl: nwan
arkadaş: myat
sipariş: hyut
zorunlu-ruh-hali: hpim
yuvarlak: hcut
inanmak: hban
kamu: hpin
devlet-bağlam: hsas
oğul: psat
yüz: hmas
çocuklar: hcis
böylece: tyak
umut: hcap
yukarıdaki: hyip
sevgili: pyin
okumak: pyac
şehir: hsic
zaten: hpic
gerçek: hfat
factive-ortada: hfit
duymak: hsun
en-az: hmim
belki: pyat
açık: kcat
vücut: tcic
hava: cwac
doğa: nyit
Yardım-Edin: mlat
mektup: lyat
dört: ksat
dilek-kipi-ruh hali: hpam
ateş: hfak
bu-nedenle: hyif
saat: hcam
ücretsiz: tyit
savaş: syat
olup-olmadığını: hsaf
neden: kyan
birleşik: hnut
çağrı: hkuc
Neden: hwam
kayıp: hkut
bin: tsas
aile: hfic
ruh: twam
soru: swac
bakım: kcan
realis-ruh-hali: hlin
fena: mwit
potansiyel-ruh-hali: hten
karşı: cyan
allative-dava: lwik
antropik-cinsiyet: hrin
kısa: kyut
güçlü: hyuk
canlı: hkip
konu: hsek
aynı-konu-işaretleyici: hcek
farklı-konu: hfek
cevap: tsat
deniz: mwat
korku: hcoc
iyi-anlamak: pcat
sert: kyin
şartlar: tyut
şüphe: hdac
kararsızlık-belirten-ruh hali: twin
sormak: psan
silâh: tcas
siyah: clis
getirmek: tyat
güzel: ksis
karanlık: tcak
ambar: psak
on: htaf
gösteri: pyan
öykü: hkif
ortak: kwan
kitap: hkup
elektronik: lyin
konuşma: plak
işaret: myac
faiz: nyis
yazmak: kcit
yatak: pwat
gerekli: syis
Fikir: hwis
sanat: klat
vialis-dava: hlas
kardeş: pyak
bazen: ksas
çizgi: lyan
tablo: tlas
nehir: nwit
göz: kyac
bilgi: fyin
aniden: tfan
garip: hgan
derin: ksan
değişiklik: hrit
duygu: nwac
karşılamak: mlit
amaç: htuc
mutlu: hcuc
görünmek: syit
kan: cyac
gül: kwas
güney: swan
soğuk: tlat
ileri: myik
pozisyon: psis
geç: tyam
durmak: syan
zannetmek: nlas
kız: pyit
mayın: myan
kesim: hkim
kopya: hfap
koca: hgat
altı: hlis
hatırlamak: twat
etki: hyaf
düşmek: htuk
dışında: hsip
saç: hpaf
pas: pyas
telif-hakkı: pcit
ordu: cyit
koşmak: kcak
at: kcas
gelecek: hwic
batısında: pcak
ödeme: plit
kırmızı: hyun
altın: tcun
arzu: hdan
oynamak: plin
usta: mwas
ofis: hfus
hükümet: syak
kilise: kyas
uzunluk: hlen
şirket: ksin
kâğıt: kyis
olasılık: hbin
özellikle: cyas
ayı: pcas
pencere: cyak
anlaşma: hgac
güzellik: syac
görev: tfac
göndermek: fyan
mesafe: htif
Sessizlik: slan
ayak: fyat
vahşi: kyik
ölmek: myam
kurtarmak: pfan
yeşil: kcin
sorun: mlan
gülümseme: myak
yanlış: clat
çeşitli: pcin
uyku: slit
quotative-dava: kwik
başlangıç: cwan
eylem: kfan
ziyaret: fwat
izleyin: nlan
denemek: tcis
varlık: psit
tatlı: tlit
zengin: tcin
düşman: tcam
gemi: hcip
durum: kyit
Dahil: hkum
dahil-kişi: hlon
gizli: kwit
precative-ruh-hali: pwim
kibar-kayıt: hbit
kötülük: pwac
Mart: myas
her-neyse: kwac
kalmak: hlam
yerine: plat
mavi: plan
imkansız: psap
okul: hsuk
fırsat: ksac
evli: nwat
Gıda: hcuk
yirmi: tsis
sessiz: tcit
kolayca: hnis
muhtemel-görünüş: hrap
dil: lyac
ifade: syas
hafta: hsus
salon: hcum
Tehlike: kcic
özellik: myit
doğmuş: nyan
mahkeme: kcut
genellikle: tyap
Gnomic-görünüş: hmip
değer: tyas
basit: syap
ağaç: pyic
kavga: pyap
duvar: twit
cennet: cwak
yeni-başlayan-görünüş: htip
emir-ruh-hali: hjin
ton: twun
saygı: klan
beklenen: pcik
ay: hmaf
deneyim: nyap
tamamen: nyac
taze: tsac
dük: hnuk
kapalı: kwak
bağlı: hyim
Doğu: tyuk
taş: pwan
biraz: kfat
yön: tlac
sandalye: kwis
destek: syut
tarih: tyic
köy: klac
alan: clit
izin: nwin
hoşgörülü-ruh-hali: hmom
başarı: slak
uygun: hric
tepe: clin
müzik: ksik
merkezden-uzak-inandırıcı: hdat
öğleden-sonra: htup
ağlamak: hyuc
onur: hnaf
Yedi: swit
özel: pfat
haber: nwas
sahne: slac
bahçe: cyam
yarış: htus
dağıtım-dava: twak
öğrenmek: clan
siyasi: syik
yalan: kcun
döküm: tsak
yemek: kcam
zemin: hlaf
hasta: pwin
orijinal: mlin
yaz: kyam
din: tlam
resim: ksit
kaçış: plap
yazar: hlut
kahverengi: pyun
kararlı: htem
ağrı: hdon
bahar: psin
yüzyıl: syic
yumuşak: mwan
köşe: kyun
üretmek: psas
gülmek: cyaf
unutmak: flat
Avrupa: hyup
sekiz: lwat
elbise: lwac
korkunç: cyap
nefes: syaf
bilge: hbas
iyelik-işaretleyici: srak
bellek: myin
modern: fwan
spot: tcap
yükselmek: hyus
mola: pyik
elli: hfis
ada: tlap
dokunma: hsuc
söz: pcam
commissive-ruh-hali: mwin
derece: tfat
plan: plac
davranış: nyak
sürpriz: cran
dakika: hmun
atış: hwut
daha-da-kötüsü: pcap
bardak: klak
örnek: tlin
kasa: hsif
doktor: tsit
completive-görünüş: hmep
tekrarlanan: tyun
askeri: slin
sıcak: nyam
içki: pfin
sorular: pcaf
öfke: nran
doğrudan-doğruya: tyik
şapka: hcup
köpek: kwap
hizmetçi: hnuc
gurur: hram
kalabalık: tcuc
tren: nyin
manevi: myut
ilişkili: kyim
girmek: fyak
kural: nyas
kılıç: cwat
saldırı: kfak
sağlık: clac
paragraf: pyaf
sosyal: hsum
geri-ödeme: tfit
Üzgünüm: hpec
cesaret: krac
lütuf: hnen
resmi: hfaf
sağlanan: tsik
istek: pwit
bakış: klas
hareket: hyon
beklemek: cwit
karşısında: psam
oniki: tyaf
nişanlı: nyut
şarap: hwun
tat: swut
demir: fyac
dağıtmak: syin
ticaret: myap
avantaj: twac
giysi: kfip
yargıç: fwak
fark: tfaf
endişeli: kcis
kaptan: kwin
bitmiş: nlat
kesilme-görünüş: hsep
meraklı: kyic
yabancı: kwic
koyulaştırıcı: hnif
önem: myun
nihayet: hfim
fatura: fwin
kanıtlamak: hpuk
önlemek: flan
boyun: cyun
yasal: hfik
kuru: swak
servis: syam
kaybetmek: pcut
kanıt: pyut
ortada-dava: hdak
ilerleme: pyis
bina: klit
arama: syuc
üzücü: hrac
günah: psip
otuz: tfis
dürüst: tsin
kapamak: kyap
banka: pcun
kader: cyik
orman: hfun
ölçmek: mlac
aksi-halde: htoc
dere: lyam
ekmek: hpup
ek: tfak
seçmek: twas
hayvan: nwam
hayvanlara-ait-cinsiyet: hzin
EVENTIVE-ruh-hali: hwim
aynı-olay-işaretleyici: hcom
çarpımsal-dava: tlak
kalın: hmus
yaratık: hyum
yağmur: myic
yüzey: pfas
kutsal: swis
Temmuz: clim
rapor: hfut
sahil: pwas
dosya: hfif
omuz: cwut
şaşırmış: kran
royal: klik
şarkı: hkuf
konfor: kfaf
kimse: nyic
çim: kcap
çekmek: cwik
açılış: cyic
Haziran: cwun
balık: mlic
sermaye: klin
meme: cyut
kar: hcif
Eğitim: tlik
keskin: tcaf
yazık: hdam
gider: fyas
seninki: hmuc
milyon: mlun
yorgun: tcik
öldürmek: ksam
gölge: cwap
ağırlık: plas
kitle: mlas
kurulmuş: tlip
cesur: pyam
ince: plic
memnun: srat
ara: kcik
erdem: hdet
ulusal: nyaf
ilahi: swin
vadi: clak
tahmin: kwam
spekülatif-ruh-hali: hken
sarı: clas
kalıntılar: mwac
bükülmüş: nlac
kutu: pwak
sezon: tsim
bilim: slas
delik: kcuc
amca: hmuk
liste: lyit
Ağustos: ksut
popüler: hlup
bilinmeyen: fyit
tanıdık: flak
tanıdık-kayıt: krit
okuyucu: tsut
yaklaşım: pcuc
iki-kere: tsap
entellektüel: tfik
gerçekten: tsam
rahip: pcis
yaralı: fran
üzüntü: hpom
saray: kfas
dövmek: clap
ha?: hnec
aptal: myuk
kenar: pfac
dokuz: nwun
patlama: psut
acı-çekmek: tfas
gürültü: hcus
edebiyat: lyic
tavsiye: swas
boş: kcuk
rütbe: psik
fırtına: tcut
cep: kyip
hayal-gücü: nlin
cümle: cwas
Kasım: nwap
Aralık: tsip
yokluk: psic
teşekkür: ryak
adres: tyis
kuş: pyuc
mal-sahibi: mlik
ceket: kwut
hazırlamak: tyip
ilişkiler: lwan
duman: htum
Ocak: nwak
makine: clic
içerik: nyik
dişler: tlis
utanç: hcet
defne: kcaf
beyin: pyuk
halka: klic
ifade-işaretleyici: frak
kare: ksap
meyve: fyut
çay: tsic
açıklamak: slam
hoşgeldiniz: cwam
şiir: pwis
satın-almak: klam
sadık: hdic
heyecan: hcen
kırk: klis
Nisan: pyip
nazikçe: kfit
Ekim: kfap
acı: kyuc
köle: tlaf
gevşek: hluk
metin: tsus
kredi: cyip
onbeş: pfit
zalim: kcim
katılmak: cluc
süreç: hpif
suç: kyaf
toz: tsuc
pratik: plik
renk: nlak
yıkmak: nyuc
artırmak: lyas
burun: hnus
itiraf-etmek: tyim
dün: kfac
hesternal-gergin: tlen
başarısız: slap
devam-etmek: tcim
aşınma: pwam
kör: nlit
düzine: tsun
sinek: fyap
övgü: cwin
şeytan: cwaf
kademeli-olarak: twic
kurban: kyif
egzersiz: cyis
vicdan: tfin
teori: tlic
bakan: myis
nefret: hnet
göl: cwic
merkez: syun
soluk: pfic
akılcı-cinsiyet: hron
dikkatli: fwac
zevk-almak: nlam
ibadet: pwap
mal: twap
cilt: twaf
çatı: tlut
taç: gyan
kale: klap
taht: tcus
ekli: nlaf
mil: mlim
aşırı: krim
hapis: fyis
fincan: kcip
üye: mlam
sivil: syim
her-yerde: tsaf
belirgin: tfic
çift: pwaf
hacim: clam
görenek: ksaf
yay: ksun
takım-elbise: slut
et: mwak
süt: hluc
bitkisel-cinsiyet: hwen
vizyon: slic
nadir: nlap
kuzen: ksic
köprü: pwut
korumak: pfak
tuz: swam
masum: hwus
kraliçe: kwim
saymak: kcus
merak: hras
dans: tyus
otel: clut
doldurmak: flin
tutuklu: psun
mağaza: hjan
merdivenler: sric
dilenmek: hmen
kum: sran
şiddetli: hgit
Eylül: hsem
kalkış: prac
harabe: crin
beceri: krin
sığırlar: hwec
ekipman: hwip
mutfak: hkon
satmak: hbak
hız: hsot
Sonuç: clon
bilgisayar: hkot
sonsuz: hsen
sınırlı: mrit
kütüphane: hbek
baz: hbac
karışıklık: hrun
şanlı: cris
aynı-şekilde: hjic
korkmuş: hbic
mutsuz: prin
makale: hrek
pişirmek: kfin
bant: hbat
çöl: hget
öpücük: hbun
top: hbot
sopa: hpot
tartışma: hrut
gözlemek: nrak
kutsama-ruh-hali: hbim
çarpıcı: hrim
suçlu: hdis
tabanca: hgin
polis: plis
gizlemek: hzan
sefer: srin
cahil: nrin
cömert: drac
bulut: blan
atık: htek
Şubat: frif
hastalık: hren
harcamak: bwan
kaynak: sron
girişim-dava: hnok
teyze: hbam
gecikme: dlic
gecikmiş-zorunlu: hlip
rapor-ortada: prat
gece-yarısı: dyit
kahraman: nrac
felsefe: hfof
parmak: hjit
rahat: hzat
bir-yerde: hmoc
basın: bran
personel: hraf
ödül: rwan
suçlama: dlac
sefalet: krat
alın: htec
ilan: glan
melek: htet
Tekil-sayı: hgam
şafak: hbon
ticari: krak
affetmek: pran
koyun: hcec
sabır: hpen
çiftlik: crac
tutarlılığına: hrec
Mısır: mran
anahtar: kcif
çoğunluk: hmot
zayıflık: hdut
atmosfer: traf
iç-çekiş: tcoc
insanlık: mlis
muhalefet: pric
disk: hdik
yalnız: hket
sanatçı: nrat
şövalye: cwis
çekicilik: tran
karar: drin
vali: gran
şube: rwac
eğilim: hsoc
coşku: tsum
tümevarımsal-ruh-hali: hdum
topluluk: hmum
yağ: hyen
boru: hbap
baskı: trat
aman: dyoc
söylev-bağlam: hros
vokatif-dava: hwok
kabin: ksen
alarm: plam
sinir: hnes
kalıcı: hset
bıçak: ksuk
ipek: slik
hakaret: grin
cehennem: nrik
ayrılmış: plen
ağır: mrat
karışık: mrik
ahşap: mrak
tercih: hpet
uyarı: trin
öğüt-ruh-hali: htom
dürtü: hmos
hırs: mrac
reddetmek: hnek
anayasa: swic
enstrüman: srit
sürekli-görünüş: hnip
gelgit: hgas
kolej: klen
kuyruk: hkek
nesil: nric
kedi: blat
direkt-ortada: hret
terkedilmiş: trac
on-bir: hyec
içgüdü: nlik
karakteristik: trit
kabile: hgik
endişeli-ruh-hali: pcim
barınak: crat
kaba: hruc
binme: hris
sallamak: hmon
sanayi: hdot
meslek: hres
lamba: hdap
Kahve: kfif
itaat-etmek: htot
kuzey: nrit
hemşire: nris
sağlamak: hjat
zincir: ryin
öğretim: cric
ayakkabı: hgut
yarda: mram
belirsiz: hmec
başka-yerde: hlet
daire: pret
etkinlik: twot
Cumartesi: cram
güneş: hduc
dul: hwuc
eleman: hlem
yansıma: hfen
organizasyon: hgis
star: tram
olay: hgon
konuk: hgip
bar: brap
şişe: hbet
kutsamak: blak
karıştırma: crak
iç: trik
düzeltmek: krik
türetmek: prit
oyuk: hcot
il: hpos
medeniyet: srac
asmak: hgak
şok: crok
istisna: swap
gerginlik: tren
standart: ryan
sürücü: dran
kurtulmuş: hruk
küfretmek: kses
hazine: zran
tohum: hbis
kule: tras
favori: fwit
geçenlerde: hcem
son-geçmiş-gergin: hrot
uyanık: srik
mobilya: mrin
halat: hkos
macera: hdas
kraliyet: ryit
bayram: dyat
tanımlamak: dras
altmış: hses
ölçek: hkem
tören: srec
avcılık: clik
fısıltı: psus
genelde: ryat
Hristiyanlık: ksim
avukat: hwif
detay: drit
prenses: hrus
altar: dlat
ağ: hwes
mor: brin
toplamak: hkoc
seçim: hben
gebe-kalma: kren
sarhoş: crik
dökmek: brac
asansör: hlif
jest: hjis
yönetmek: rwin
takas: tcen
kesin-makale: hdek
imparator: mras
uzak: hroc
çirkin: clup
zararsız: cras
rulo: hrof
inç: nlic
gazete: grat
sakal: dric
gözyaşı: srim
komisyon: kson
oysa: grak
geçit: kcoc
bağımsızlık: htes
koku: hwon
onsekiz: hdec
tarihi: tris
brüt: krut
kök: hrok
çamur: hbik
gelin: dlan
peçe: pras
tiyatro: tret
karşılaştırma: kras
rakip: rwis
denge: slen
koç: kron
mizah: hnum
yeni: rwas
intikam: hbaf
kıskanç: ryut
tekerlek: hlok
yanmış: glat
flaş: flac
oluşturmak: hkec
çatışma: hnot
lanet: hlos
lanet-ruh-hali: pram
çaresiz: hces
pozitif: hzit
kulüp: klup
sel: nras
tahıl: gwan
kayıtsızlık: hdun
ufuk: crim
assumptive-ruh-hali: hsom
dik: htop
armoni: mron
gök-gürültüsü: hgot
çocukluk: htok
diz: hgun
yazılım: pwen
hasar: kram
makbuz: ryis
etkinleştirmek: nlim
protasis: hpoc
kayma: slok
devrim: hrif
çiftçi: hjim
inme: trak
platform: hpof
haberci: hmes
ayrıcalık: hpek
örgütlü: hyot
öğrenci: clen
mağara: hgec
gelenek: rwat
trajedi: tses
veda: hjap
eleştiri: ryik
pamuk: krap
hastane: slot
kira: kris
gaz: hges
kaçınılmaz: pwic
ölümcül: hgim
yaprak: glit
yayın: plun
düşmanca: tsup
çeviri: dwan
cenaze: jran
un: mrun
yazışma: ryon
romantik: hrom
kulübe: clun
önermek: psot
taklit-eden: hmet
dolar: dlon
gün-ışığı: hjac
on-altı: hsos
montaj: hzac
koloni: klon
kanat: gyin
aslan: hles
kültür: klut
sütun: hkom
kurnaz: glak
dram: dram
şaka: hjuc
sis: hdus
tıp: dwas
on-dört: hkes
asit: sram
yani: hyet
gelir: hmok
piskopos: hbip
turuncu: tron
banyo: byan
ilkel: rwit
sepet: ksek
sekreter: sris
saman: prak
sabırsız: pfif
kurtuluş: slon
hodiernal-gergin: dlin
niyetinde: zrin
buhar: tcip
zehir: hwoc
yetenek: tlon
iklim: lwim
etkili: fric
ayırmak: tcif
yıkama: dwac
itiraf: kfis
saçmalık: hjas
kömür: kyon
kano: kwon
geçici: tric
delimitative-görünüş: hdip
kemik: hcos
Pazartesi: nwic
Salı: glac
Çarşamba: bwac
federal: frin
çekici: hzic
temsilci: ryic
keten: lwin
lavabo: swuk
yeğen: bwin
kanlı: kric
kuşatma: cren
mide: hpem
pirinç: pcon
zirve: hzik
beşinci: pfik
ucuz: brat
özel-kişi: kwen
kaçırmamak: zrat
çit: hzas
heykel: tfam
ağır-silahlar: tlep
kucaklamak: mrap
çevreleyen: sren
kesinlikle: srot
geyik: hluf
çalı: hbuc
demiryolu: hrep
deşarj: hduk
mirasçı: mris
meşe: blun
tatsız: pren
buluş: hgic
piyano: pyon
ikna-etmek: swen
görünmez: gric
tanınmış: ryun
zulüm: kluk
ayartma: hyoc
bitmişlik-görünüş: hlep
ekonomik: kfik
uluslararası: troc
müdahale-etmek: tcek
filozof: flif
zarif: gyit
refah: kyen
balık-tutma: mlak
çalmak: truc
dudak: hloc
emekli-olmak: ryac
germek: sras
galeri: glen
paralel: zlan
atelic-görünüş: htep
kıta: trap
yasaklayıcı-ruh-hali: nrim
kravat: dwat
hücre: slep
yumurta: dyan
yapay: jrat
bu-arada: nwis
kriz: ksot
kibar: sloc
öğle-yemeği: lyon
çam: pwon
it: hcef
ittifak: lyen
bel: hkop
mucize: hmek
denizci: slis
saflık: prut
cumhuriyet: hguk
telefon: tfen
kırbaç: krip
gömlek: cyim
tanıtmak: ryas
kanepe: hsof
süpürme: hsup
hırsız: ksif
tutmak: nrec
kanal: kcen
kişilik: klim
reform: kfam
tehdit: hzim
palmiye: plim
konuşmacı: hzak
eşik: dwic
uyarmak: pris
mızrak: bzak
temiz: syec
oturum: cwen
işkence: crot
nemli: tcum
sırt: grit
gezgin: hyek
değirmen: mwik
harita: jrac
yaka: klok
değiştirmek: klif
kasten: drat
bira: hbif
kadife: hwem
yerçekimi: gwit
vaaz: hpum
taciz: glas
sürü: hgen
on-üç: tres
haklı-çıkarmak: jyit
Cuma: crum
fırça: broc
indir: dlas
krem: krem
uçurum: klaf
jüri: jrin
canavar: ksos
dondurulmuş: hgoc
pot: pfot
kuruş: psen
ısrar: srut
elma: hpep
tartışmak: drak
arka-plân: prun
uyarlamak: trim
periyodik: prik
eğlence: nren
virüs: bris
çocukça: blit
yansıtmak: flit
dönüştürmek: kcet
taslak: kluc
opera: hpop
onay: nron
açığa-vurmak: rwak
cezalandırmak: hzen
dirsek: kcon
haciz: tcet
onarım: hrop
şüpheli: cyec
yetmiş: swet
yazı: srip
çukur: grac
düzensizlik: dlak
ikili: byin
manastır: bjan
ok: tcec
eğilimi: trec
ayrıntılı: frat
bağlılık: hlot
sikke: syip
titreme: tcem
sürgün: gwin
mekanik: myim
tuzak: crap
kek: kyek
bayım: cyes
tereddüt: sret
on-yedi: syet
bal: myon
kazık: dzat
basmak: hjam
tuğla: brit
seksen: hpes
ne-yazık-ki: pcen
danışmak: kcot
efsane: lwen
hasat: hfos
tanıtım: pfon
soba: hsop
asi: bric
eski-moda: hnom
kabarma: cron
bataklık: swot
pansuman: hdes
sofu: pces
müdür: mren
koro: cros
akılcı: tson
işleme: pson
kurt: blaf
halı: hgap
eskilik: hjak
bereketli: frut
düdük: slif
peynir: twis
ısırık: byat
davet-etmek: jwan
katedral: kyet
liman: brak
dolaşmak: djan
bitkileri: tsos
donanma: nlen
maske: mrok
kalem: pses
sebze: sroc
sergi: hzet
pantolon: tlun
rüşvet: hrup
kabine: nram
çorba: srup
cerrah: syon
ödenek: tcot
casus: gyas
pervasız: hlec
dedikodu: gyic
simge: hzon
soyut: srok
Perşembe: cwim
trafik: ryaf
mimari: ryek
çatlak: rwaf
süs: rwon
ters: lwas
eğlendirmek: mwun
kurtarma: ksus
kaldırım: plut
belirleyici: dyin
negatif: nraf
festival: hfec
azaltmak: hrum
vatan-hainliği: zyan
avcı: djin
yılan: syen
pil: bret
balmumu: flam
dedektif: dlit
analiz: nlis
vurgu: hzot
yüzmek: twen
zarf: lwaf
her-kim: hgek
sigara: jrit
motor: mrot
gönüllü: hwot
reaksiyon: ryif
bagaj: blam
SAĞIR: hboc
meyve-suyu: hjus
tevazu: jlit
bakanlık: mret
cinsel: hjon
çap: dyam
balta: blac
elmas: dlam
alternatif: hlek
yankı: hgus
kısıtlama: swon
kimlik: hdaf
ekran: krun
tembel: lwis
momentane-görünüş: hmop
kompakt: kfot
sürüklenme: hdif
kaybolmak: hgaf
ışın: ryen
mürekkep: mwic
masif: mraf
kiler: dyac
unutulmaz: nrun
parıltı: klek
senato: slet
tabut: tfap
affetme: frac
yutmak: nlun
şımartmak: nlot
salıncak: swun
çayır: gram
karmaşık: klos
istifa: hzis
mütevazi-kayıt: nret
komplo: swim
biber: prip
midilli: pron
aday: hzam
tilki: flik
baca: tcon
yargı: drik
tarım: rwic
doğruluk: tcuk
eski-merhum: brim
demokratik: mrek
tomurcuk: hbos
battaniye: bwat
dolu: hgep
domuz: srus
şeklinde: krek
fildişi: craf
klasik: ksok
gözlemci: nwet
fil: lwit
çiviler: nwus
arı: hmif
gömmek: dzan
aktör: bzat
ter: zwan
lehçe: ploc
yanılsama: hlus
belirsizlik: pcet
ikincil: syif
kat: tsot
kırsal: grun
inilti: nyen
benzemek: slec
alıntı: hzun
çuval: cyek
sıkıntı: fren
iğne: hjun
kontrollü: nroc
tavuk: truk
tutarlı: kwot
varil: bras
alışılmış-görünüş: hcep
uzman: ksec
etkilemek: blin
zeytin: zlin
kamyonet: myen
engel: bwak
kafa-sallama: kcec
beslemek: plaf
tanım: fyic
doğum-günü: gjin
çekiç: hcof
kokulu: hfon
tekrarlama: trun
önemsiz: twut
tekme: hjik
kazmak: kwaf
evcil-hayvan: plot
kafatası: hcop
yasama-organı: dlik
topuk: cruk
kaşlarını-çatmak: crun
patent: plet
milyar: blim
kimyasal: fyik
pilot: pyot
taklit-etmek: mlot
etek: kwet
alışılmadık: srap
haftalık: jwik
teknik: tfip
bitki-örtüsü: tset
karga: kraf
gündoğumu: sruc
ömür: glin
katkıda-bulunmak: hyom
kanca: hdok
kaplan: blic
nüfuz: crut
kol: slun
karayolu: jras
milis: mlip
hendek: kroc
bütünlük: kret
on-dokuz: dzin
organik: rwik
ilahiyat: flic
şamandıra: flut
cadı: byac
sıkılmış: hwuk
diplomatik: dyik
stüdyo: twos
aşmak: kcok
Şampanya: cyen
ilham-vermek: crif
afiş: hbes
boşanma: lwon
sürgü: hbut
damar: jyan
pasif: psif
köpük: hgum
çakıl: grik
apron: tyen
gezegen: gren
raf: claf
fan: flon
tropikal: hjip
faz: fwas
keyfi: rwen
telaffuz: kfun
Merkür: krok
sürünme: hrem
intihar: tcos
muhabir: prot
yoksun-bırakmak: hpok
yetenekli: klun
balkon: blik
çatal: fras
işçi: mlek
işveren: myot
genişlik: jrak
tedirgin: djit
suçlamak: klot
emeklilik: pyen
fiil: kres
maymun: mwon
kabul-edilebilir: hwek
imza: tlim
Ortodoks: rwos
alay: fron
fidanlık: nrap
isteksizlik: jlan
ithalat: tyot
meşale: croc
dilbilgisi: gjak
mevduat: gyat
sömürge: plon
yat: jyat
önemli: kwec
kubbe: kwun
kalınlık: hfot
inatçı: cyon
kas: hmup
kadir: ryam
ovmak: ryos
korkakça: rwam
koşum: gwac
tost: tros
fare: myus
hece: slim
sıvazlama: prap
diyalog: dlaf
nötr: nrot
çalışkanlık: dwin
çelişki: trot
başarmak: kfic
keçi: byak
güzelleşmek: hfet
yüklemek: mlon
anonim: nwim
resmi-kayıt: frit
buzağı: hbof
manuel: mwut
eriyik: hjec
silmek: flas
şemsiye: gras
çizme: bzut
mineral: mrim
ateşkes: crus
ördek: hbok
planlama: pfam
sabun: hsuf
bebek: gwak
iskelet: klet
villa: blis
dikiş: jlin
uzlaştırmak: dyak
çaydanlık: kset
olgun: mruc
tavşan: kruc
kondüktör: nwot
bağımlılık: djat
oyuncu: jlic
böcek: pset
restoran: cret
baykuş: lwun
radikal: djik
yerli: zwin
Ejderha: dron
işitsel-ortada: drot
susuz: kyos
oyalanmak: dren
hesaplama: glun
düzenleme: ryim
belediye-başkanı: mlap
azınlık: mric
edinme: dwon
emektar: bren
orkestra: ryes
domuz-pastırması: bjin
dezavantaj: zwat
kumaş: frap
müzisyen: gzik
zihinsel-olarak: hnep
bağlaç: nyon
yetersiz: nrip
mimar: tsek
limon: nyim
öksürük: kcos
başağrısı: crek
kiracı: ryet
doğurganlık: srun
iyileşmek: hfoc
doksan: nwon
rasgele: hbec
kaşık: kcek
balon: blon
tebeşir: hfip
anlaşılan-ortada: nlet
yayımcı: pcot
sirke: sruk
kül: fyec
küfür: slek
canlandırmak: nrut
duyarlı: kfim
tünel: tfun
bulmaca: hpef
mekanizma: mwim
matematik: gzit
karartmak: frun
karaciğer: jwin
sublative-dava: bwik
daldırma: dris
birim: twim
tekel: hnop
kumar: hgup
denizaltı: bzin
deprem: hbem
laboratuvar: brot
mantar: kruk
öz-kontrol: syot
Buda: hbus
örme: bjat
elçilik: blas
en-uzak: sres
bildiren-ruh-hali: drim
uyarıcı: tyuc
çikolata: clot
tesadüf: tyon
eldiven: gwat
diz-çökmek: hjek
coğrafya: hjif
yatırım: nwes
sözlü: mrec
analoji: nlip
laik: srek
şahin: blap
psikoloji: nloc
tutturmak: gjan
hurda: krep
rol: cyum
doz: hdos
somon: slom
puding: pwun
manyetik: gyik
pompa: pcom
oksijen: ksip
sertifika: tfot
madalya: hmem
belâgat: trok
sıyrık: rwap
kürek: dyas
teleskop: trip
kolye: clek
yazım: prif
viski: hwos
Söğüt: hwof
deve: hlum
amatör: myet
çıkış: crec
biyografi: brif
eşek: gzac
aylık: mwis
aldırmamak: nruk
tatil: byit
tık: lyik
oval: twon
elastik: lyet
sözlük: kfon
jambon: gzam
gökkuşağı: rwun
tüketmek: kcum
tükürmek: tcup
tank: trek
meslektaş: clok
kelebek: trif
grafik: graf
ikiz: jwat
bağımsız: trem
bambu: hbum
satıcı: jlat
birikim: kles
müfettiş: nyet
lokma: hyos
karabasan: hbom
reçel: gjam
müze: mrem
alfabe: lwam
dağılım: zras
baskın: crip
ifşa: clus
çürüme: fraf
agresif: gris
sürtünme: mroc
iskele: gyac
örümcek: brik
patates: trut
revizyon: cwon
açgözlülük: jlac
erken: ryot
çarpmak: gzan
dönme: pcip
istatistik: tsok
takvim: klem
adaylık: nwen
trilyon: tlos
çatı-katı: tlok
olumlu-ruh-hali: rwim
uygulamaları: pfen
nominal: nlon
memnuniyetsizlik: sraf
enfeksiyon: hfok
sürahi: krot
omuz-silkme: cyok
öncü: gzin
ihmal: nlif
lahana: glic
atletik: tlet
sarhoşluk: mrut
idiophone: hdof
manivela: lwek
senatör: syem
iris: nrif
karınca: mwam
böcek: hbop
hamile: grim
çökelti: hjet
ayak-bileği: tcok
sınıflandırma: glik
değişken: prim
sarmak: ryap
Kıvırcık: krec
sülfür: hsef
dikte: dwik
çıkmak: brun
kurbağa: fram
aşırı-dava: twek
sünger: hjen
can-sıkıcı: djon
sincap: slip
eziyet: zyin
irrealis-ruh-hali: flim
volkan: glam
içeriye: gron
sömürmek: kloc
jeolojik: jlik
pasaport: psop
ahlaksız: mlet
bisküvi: hbuk
işbirliği: kros
tablet: tlot
gevşeme: kces
atom: trom
AİDS: hzip
piramit: psim
devir: swok
şekerleme: hnup
yasadışı: hjaf
pençe: pfap
utangaçlık: crom
tutulma: klip
ut: lwap
süpürge: srum
panel: mwen
astronomi: tcom
labirent: blen
burs: bwit
kaplumbağa: kfuc
danışman: dwak
lif: fwic
kriket: jrik
güvercin: ksom
adaptasyon: dyon
üçgen: tfon
veznedar: tsen
hidrojen: jron
kırılgan: hfuk
yazıcı: pyet
boğma: tcof
kronik: gzon
başa-çıkmak: slaf
ikilem: dlim
mühendislik: jyin
kamera: hkef
özür-dilemek: pluc
yalamak: lwet
dansçı: dret
göç: mres
tenis: tces
omurga: clip
kızartma: zrac
dokuma-tezgâhı: tfuc
bıçaklama: twuc
parola: psaf
yarımküre: praf
strateji: zrit
kuvars: krus
makas: jris
devriye: proc
buzul: lwic
yarım: dwam
muhtıra: mwap
koni: kwuc
simetri: hzut
üretici: zrak
sanık: fwik
cami: djis
satranç: cres
Geçiş-ücreti: htof
Kiraz: tref
yaygın: kfen
yanılmak: tfok
kamyon: ryok
hardal: mros
yüzde: pfet
açık-artırma: jlam
elek: srif
kararsız: swoc
mıknatıs: gjat
emmek: syus
İslâm: slum
heyecanla: twip
zar: mlen
tıraş: clet
gitar: gjit
parlak: bzan
karaağaç: hyem
uçmak: kcom
zamir-işaretleyici: ryec
zımba: pcus
baharat: zlat
kefalet: jlas
taşıyıcı: zyac
titreşim: bron
kızdırmak: trus
pulluk: hlom
fizyolojik: zlik
oluk: hgok
kuyrukluyıldız: cyet
ortaçağ: dyic
serçe: grec
tazmin-etmek: twet
plastik: psuk
dipnot: cyot
yörünge: rwot
tutumlu: twum
golf: hgof
sıfır: zrun
yonga: tcep
ezmek: prok
esnemek: gjac
eşitsizlik: gwas
mol: tloc
çanak-çömlek: frik
ev-hanımı: hgif
çavdar: rwem
uymamak: hyes
hoşgörülü: glon
embriyo: brec
madenci: jren
alkışlamak: zlac
maya: lyim
prim: pfim
Erik: plem
iflas: byas
sulama: rwif
nane: nyun
kapitalist: glis
elastikiyet: hlef
Köpekbalığı: gyak
acemi: drut
depolama: zren
gerçekçilik: cles
zencefil: djic
ambulans: blus
karşılaştırılabilir: kwip
cüzdan: bjap
yüz-buruşturma: glim
bilim-adamı: gyis
bağırsak: grot
ağırbaşlılık: hwum
radyo: href
ilgisiz: zlit
fasulye: bwam
resmi-olmayan: frim
torun: gyut
anlaşmazlık: dloc
biftek: tfek
azot: zron
jilet: hjut
zıt: krom
propaganda: pcoc
havai-fişek-gösterisi: fris
pop: pcop
soyunmak: crop
kırışık: cruc
zararlı: hzaf
Yahudilik: hjum
tamamlayıcı: pluk
mercek: lyes
pegative-dava: pwek
kanser: kfes
piyon: pyek
okutman: zyat
sızıntı: hzuk
nitelemek: krif
yoğunluk: djot
indüksiyon: dyis
çiğnemek: htuf
konuşkan: bzit
Istakoz: hgos
indirim: dyut
taksi: tsuk
hiyerarşi: crem
yeşim-taşı: gyec
söylenmek: glaf
kertenkele: lyis
çağlayan: crof
hayal-kırıklığı: djak
veto: frot
başkanlık: ryip
alıcı: mrif
galon: jlen
sivrisinek: mruk
sapma: dwen
güreşmek: lyut
mozaik: myok
fiş: plok
bodur: pcuk
bakkal: ksoc
komünist: myos
şaşırtmak: mwek
prosecutive-dava: rwuk
takımyıldız: nlos
diktatör: dwit
kaygı: tyet
uydu: tlec
terlik: hlop
ünsüz: fyon
yaklaşık: tsif
işsiz: byet
destekçi: sros
lotus: lwot
marul: sles
klorid: lwok
bakteriler: bwic
yapışkan: pcek
bileşen: bwon
çekirdek: klec
uydurmak: bjak
bayt: bzet
salgı: sruf
açıkça: pres
rastlamak: mloc
bale: blet
idrar: mrus
sarımsak: lyun
geçen: hguc
ekonomi-bilimi: kcem
orta-sınıf: hdom
çevik: gjic
maşa: htef
çamaşır: lyoc
çilek: srem
kentsel: pcos
utandırmak: mlaf
not-defteri: tfut
albüm: zlam
beyzbol: hbep
koklama: sluc
büfe: hbuf
ortaç: rwip
garaj: grek
tanı: djas
koltuk-değneği: ksuc
koparmak: srom
kayıt: psuc
çözünür: jlun
fosfor: psof
yapısal: rwut
tutkal: glum
tez: twes
esnaf: clif
muz: bwas
aksiyom: kyom
kaburga: psos
nikel: nyek
pi-sayısı: pyim
otobüs: bwos
sansürcü: swes
füze: mlus
sosis: slos
hile: nlut
domates: tfet
güçlendirmek: kfut
soket: syok
potasyum: tsom
geri-almak: prup
sanal: zwit
cebir: gjas
dişçi: dzit
optik: pcok
hareket-ettirmek: bzen
biyoloji: bwim
işsizlik: byim
tırtıl: krum
solo: slof
tarayıcı: bjac
uzak-geçmiş-gergin: nyot
tarihi-gergin: crep
nükleer: nluk
spektrum: pyem
sodyum: syom
histeri: syes
yediemin: tyos
rehin: byik
sukabağı: gluk
kırışıklık: kwuk
şeffaflık: tfif
başak: swip
öncelik: pcif
yaya: dyen
ateizm: tsem
izlemek: mwot
seçim-bölgesi: nlec
kontrolsüz: hkof
sonda: grok
platin: plip
çift-sayı: dlun
akciğer: pcep
Süper: syup
tramvay: trop
lokal-olarak: lyot
tahrik: gzat
benzin: plif
böbrek: grif
yağma: bzac
değerlendirme: dlen
arsenik: syek
salyangoz: nrok
çekirge: tsec
denklem: fwen
sosyalist: swos
filtre: flot
duyusal-ortada-ruh hali: hxin
genişletmek: kyot
yaymak: mwet
tasma-kayışı: pwet
mandalina: drun
jokey: hjok
zatürree: hnof
dayanışma: gret
menteşe: cyif
uzunlamasına: nruc
kâr-payı: dwun
paten: hkep
üs: slop
sakatlık: dlif
takıntı: bwen
tahsis: pfun
fotoğrafçı: trof
delta: dlet
dijital: djim
orospu: brut
gözkapağı: hyop
diyagonal: dyun
bilinçaltı: byon
kaş: bruc
hapşırma: pcec
neşeli: dlis
Hinduizm: nwum
mülteci: nyif
mekik: cwot
protein: pwot
çöplük: hdop
arıtmak: flen
kusmuk: hwom
gen: gyen
birinci-sınıf-öğrencisi: hdem
sosyoloji: syoc
kabak: kwoc
balıkçı: hfuc
bölgesel: jyen
hareket-yokuş-yukarı: hvok
geçmişe-yönelik: hxik
kasırga: gyon
ters-çevirme: nwos
TV: twif
küp: kfet
verimlilik: pwuk
havuç: krop
moleküler: mwuk
holding: glet
muhasebeci: ksum
salatalık: kyok
alem: drok
çözücü: jlet
fosfat: psef
astar-boya: gwik
alkalik: flis
Jimnastik: jyas
virgül: kwom
hareket-yokuş-aşağı: hvat
düşük: jwac
koza: tcop
verici: dzon
manganez: hzem
psikolog: syos
klor: clos
klavye: kyoc
seçkinler: zyit
parantez: pfaf
Ragbi: rwoc
ülser: jlon
çekimli: hxit
kemirmek: nres
kuantum: fwam
kazak: swek
evrimsel: fwis
notasyonu: nyoc
sıçrama: tcuf
teşrih: drec
önbellek: kcep
doğrusal: lyec
antimon: trum
superessive-dava: psek
tümör: twom
erozyon: cyos
alfa: flaf
göbek: nwip
bağışık: myip
grip: flun
bira-fabrikası: bjit
basitleştirmek: slef
kısaltmak: bram
göçük: djen
cezbetmek: dwim
zorlamak: brok
çorap: bzas
film: fyim
kozmos: klom
kirletmek: hpuf
sokulgan: gjen
penis: zyis
ormancılık: lyif
alüminyum: lwum
salınım: zlon
burç: ksop
çıkarmak: dlek
içerme: nluc
hak-sahibi: byic
yunus: dlip
katil: cyus
memeli: myaf
gösterge: swif
dioksit: dwis
kolon: zlen
bürokrasi: brus
çarpıtmak: jric
buzdolabı: frip
arkeolojik: cluk
kabul-edilemez: kwok
şartname: pfis
broşür: pfut
antropoloji: nlom
lezzetli: kyec
geçişli: txit
çömelmek: kwus
ayçiçeği: hzuc
bit: glus
iyon: lyos
turizm: tyum
modem: myom
hızlanma: jrun
tahrif-etmek: tsoc
emisyon: hmef
kaçırmak: drap
üst-üste-gelme: hwep
kuaför: pfes
folklor: floc
kılcal: plek
milliyetçilik: nlum
kalça: nros
motif: hmuf
yüceltmek: slem
hüsran: xras
kobalt: kwos
yulaf: gwam
hareket-akıntıya-karşı: trup
anüs: gyam
sığır: bwun
çevirmek: flip
fazlalık: dzun
video: hwop
boykot: bjik
bilgi-yarışması: cwif
hokey: cwok
gerilla: grip
magnezyum: hgem
radar: drek
şempanze: hzif
güvenilirlik: kwif
dikdörtgen: tyec
varek: klep
genellemek: jlak
sokağa-çıkma-yasağı: kfec
homoseksüel: mlok
senaryo: srop
formülasyon: flus
reenkarnasyon: nrom
tutuşturmak: zlak
uranyum: ryum
yakalayan-şey: kwes
koordinat: kyop
vergi-mükellefi: nwaf
entegre: trep
opined: hzap
gama: hxam
safari: fwim
hareket-akıntı-yönünde: ht6n
katsayı: kfus
başlık: zlic
analist: nles
mat: hzes
alışveriş-Merkezi: hmof
bizmut: bzim
kartpostal: psok
yakınsama: bros
sapmak: djet
hissedar: ksem
mikrop: mrip
jenital: jwit
morfolojik: mluk
beta: byot
kot: gjis
veritabanı: tles
hesap-makinesi: klus
X-ışını: ksef
ayrıştırmak: zram
çevre: zyen
sigma: zyim
parçalanma: hxon
gündem: gres
Visa: bzis
altyapı: nyuk
ateş-böceği: gyun
detektör: tyek
adaptif: dyip
biyolog: byis
ek-yeri: pyec
brom: brom
palladyum: plum
hıçkırık: kfok
pastel: psec
hayvanat-bahçesi: zwac
klinik: lyok
çağrışım: nwoc
yoga: hjoc
kitapçı: byun
tedavi: grap
milliyetçi: zlis
kafasını-kesmek: zlet
Evet: swec
sorunsal: byam
caz: dzas
tungsten: tsof
terörist: gwis
salya: droc
metabolizma: tlem
nafaka: lyaf
hafta-sonu: hfom
krizantem: gzim
aşı: byap
motosiklet: tyok
mantra: dyot
yarıyıl: myes
eroin: gwon
Klasör: flap
katot: kfoc
ideoloji: dlec
otopark: prek
teta: fret
düş-kırıklığı: hxis
selenyum: clem
bisiklete-binme: blek
korteks: pros
denklik: swaf
akım-ilgi-işaretleyici: hxak
havalimanı: cwoc
kesmek: gyet
basketbol: bwet
taklitçi: mwip
hamamböceği: tlek
krom: hgom
litre: hl6t
yine-de: nwec
hormon: cwom
kusurlu: tluc
delmek: prec
animizm: nyom
çokgen: cloc
feminist: hfes
eşlenik: kcop
euro: dros
jinseng: hjes
algoritma: hlof
lazer: lwes
eczane: dlot
milimetre: mlem
esnek: flek
anot: nlok
nüans: hzus
yarı-zamanlı: prem
duyarlılık: nyec
gösterici: drom
helyum: clum
iki-dil-bilen: dzic
kısaltması: hqim
initialism: nl6m
ulaç: gros
plazma: psem
kromozom: rwom
sıra: rwok
kilometre: klum
faks: tfes
genetik: nwek
çil: frek
tornavida: dres
brokoli: blok
geçmiş-zaman: xrit
vitamin: tyem
kadmiyum: kyem
bombardıman-uçağı: bwoc
grafiksel: gjik
titanyum: dyim
savurganlık: clec
lambda: lwem
kız-arkadaş: pcem
çiftleşmek: kyuk
kum-saati: tlus
empati: mlif
bor: bres
helikopter: cwet
tellür: tlum
son-tarih: jyic
hizalamak: gwic
santimetre: hfem
molibden: mlom
lityum: tfim
multimedya: myum
güncelleştirme: dyet
kalori: clom
robot: ryoc
ev-ödevi: groc
logaritma: grom
peygamber-devesi: gzas
instal: nwut
amino: myoc
kabartma: glif
aorist: pyos
ekoloji: plec
kaşarlanmak: flok
esrar: bjam
mikro: mrom
kilogram: lwom
çok-yemek: jrot
tahmin-edilebilir: dzik
pizza: zyas
kulak-misafiri-olmak: zris
dilbilim: bwis
saç-kesimi: braf
iridyum: ryom
ırkçılık: gwim
optimum: gyim
sanayileşme: drif
Merkezi: krup
seryum: zrim
uyumlu: nrum
bir-parçayı-belirten dava: pxik
kaset: ksep
irade: blot
boyutlu: dzen
parametre: rwet
senkronize-etmek: nrop
maksimuma-çıkarmak: dzim
seminer: mwec
disko: dyok
neon: nyok
osmiyum: hzom
görünüş: hp6n
çalıntı-yapmak: lyap
eser: rwek
reaktör: fyet
keklikotu: ryop
plutonyum: pwum
itriyum: tyom
büyüten: hxat
kullanıcı-adı: mrum
doktora: zrot
sağ-kanat: dwaf
argon: jros
fobi: hxot
sosyalleştirmek: sluk
küreselleşme: bluc
dalga-boyu: hnef
kodlamak: kfom
geri-dönüşüm: psoc
tekrar-başlat: nrek
hepatit: pyes
yumru: fros
kemoterapi: myep
modülo: mwok
proton: zwot
disket: dwet
miligram: mlum
piksel: psep
tantal: twem
çözünen: hjot
soykırım: nyos
yırtıcı-hayvan: rwes
galyum: glem
zirkonyum: hzum
belirteç: txin
doğrusal-olmayan: nlem
böcek-zehiri: pyif
berilyum: brem
nöron: nrus
doğrulayıcı: pxit
külot: tlif
faktöryel: kref
nötron: zrut
niyobyum: nwom
germanyum: hjem
metaloid: tlop
koymak-üzerinde: dlap
uzatan-dava: hl6k
biyoçeşitlilik: jwic
joystick: jyok
antibiyotik: twok
aktinyum: gjim
astronot: srof
dünya-dışı: tyes
çılgın: hwup
maraton: mrof
iterbiyum: zwim
otizm: tyif
iyonlaştırmak: nlof
radon: cwos
nerium: nrem
epidemioloji: pwip
ihtiyarlık: lyuc
kamp: kyep
çizgili: drip
indiyum: nyum
gerçeğe-uygun: hvik
web-sitesi: bwes
Kuran: kwek
sofra-takımı: fwet
nth-kök: tfec
lavrensiyum: lyem
insan-hakları: glip
cep-telefonu: mlof
felçli: twoc
protaktinyum: prum
radyasyon: hd6n
bağlı-üzerinde: pxin
toryum-atom: hxim
Mavi---jean: bjun
ev-bitkisi: hxas
bireysel: dvit
Akış---akım: lwuk
Üç-nokta: ht6t
insan-vücudu: hn6n
fizik: bzik
perakende-mağaza: hxan
sezyum: hs6m
uzun-önce: hqan
tablo: hxet
Birim-kütle: hn6m
derlemek: ml6n
ikili-değer: vrim
insan-varlık: nyus
tarafından-araç-arasında: hvan
depan-dari: pxat
praseodim: pyom
karton: kxat
sınırlı-fiil: hqik
Deneme-sayı: hr6n
profesyonel-cümle: hr6t
eleştirmen: hk6k
paketleme: pxas
geçiciliktir: pxan
En-en: txas
tanımlayıcı: drop
neodimyum: nyem
dostluk: hvit
okumak-sadece: xyak
kurar: xwan
Gnomic-ruh-hali: kxin
fonem: hxom
rasyonellik: xlit
fonolojik: xlin
yemek-oda: hxac
yaşam-oda: hxic
merkezi-dava: zrik
ön-hodiernal: hx6n
sabırlı-dava: hqak
eğik-dava: bwok
kırsal-alan: hqat
recurse: hr6s
orta-ses: dyos
meitnerium: hm6m
mail-taşıyıcı: hvak
çekimser: kxit
stok-pazar: xrak
teşhis-edilebilir: hxap
hedef-tetik: krof
bir-saniye: hxen
yasama-dava: dvak
tayın: hr6c
olmayan-insan: hg6n
yaşam-şey: hvic
çok-küçük: hxut
sinema: hvin
hassiyum: xyim
soğurma: ty6t
multal-sayı: ml6m
sütlü-yol: txam
neptunyum: nwem
Hayalet-Yazar: txik
trans-rakam: ts6s
Takılmak: hqun
americium: myem
sabah-şan: txan
itfaiyeci: xran
berkelyum: blem
gökada-cinsiyet: kxan
nobelium: blum
güle-güle: hvac
Budizm: hfum
fermium: frem
camgöbeği: xyan
soya: syof
distribütör: qrit
strikebreaker: txak
işlemci: ples
abessive-dava: bvak
adessive-dava: dvik
için-dava: kxak
agentive-dava: dvek
rutherfordiyum: hr6m
antikor: txip
olarak-çok-olarak: hjos
ajan-tetik: hg6t
aktör-rol: xram
ethidium: txim
ortak-cinsiyet: hk6n
yakınının-bulunmasını: kl6n
aspir: kxam
francium: fyam
erbiyum: ry6m
pasif-ses: xyis
astatin: hqit
çiğneme-sakız: hqam
star-cinsiyet: hqin
alıntı-form: ht6m
curium: jrim
çizgi-roman: kxis
renk-körü: hqon
euler's-numarası: hl6m
bak-En: kxas
yaya-geçidi: pwok
savaş-alanı: txat
araba-kullanan-kimse: vrit
kısa-devre: txok
sözlü-isim: hvis
ağlamak-dışarı: hk6t
istatistiksel: xyit
yoğurt: txot
ksenon: hs6n
uyutmak: hxif
almak-kapalı: hxaf
fıkra---tail: hxok
direkt-nesne: dwot
bakkal-mağaza: kxun
oluşur-arasında: hm6t
kılıcısız-dava: gvik
in--dili: txic
ilk-elden: pxam
lokatif-dava: hqok
yüzme-havuzu: slup
zarf-dava: vlak
gezi: hqas
televizyon-set: ht6s
son-parçacık: xlik
evitative-dava: hvek
rehabilitasyon: xlat
gerileme: xris
blok-arasında-yassı: kxot
uyanmak-yukarı: hxup
polis-subay: ps6s
yemin--in: vran
görüşmeci: qrat
renyum: ryem
aerosol: xres
iyelik-dava: kxik
adlaştırma: mlec
deli-dava: dzak
abartma: pxak
yardımcı-fiil: xyik
birincil-nesne: mlut
bilgisayar-virüsü: prus
iş-adamı: hqis
bir-insanlar: hqen
antessive-dava: ts6k
Başbakan: pxis
lutesyum: lyum
öropiyum: rwum
emote: xrot
Halk-Müziği: zyik
şair: vwit
Postane: pxot
sözde: hvas
hareketlendirmek-cinsiyet: hven
subessive-dava: bvik
gaz-pedalı: glep
polarite: pr6t
araç-cinsiyet: vlin
mineral-cinsiyet: xrin
fiil---eki: hvif
tutkulu: pc6n
samaryum: sr6m
kolaylaştırıcı: hs6t
hayali-birim: xyin
ışık-hızı: kxac
hava-Kuvveti: hxes
empatik-sevinç: pfec
kritik-nokta: qyit
tam-zamanlı: hxem
hafniyum: xyam
engelleme: hn6s
değişim-arasında-olay: qrin
holmiyum: xlim
farklı-olay: hf6t
Evren-cinsiyet: hvip
yer-cinsiyet: kxen
sanal-makine: hvim
araştırma-cinsiyet: txen
artistik-cinsiyet: ts6n
crastinal-gergin: sl6t
soyut-cinsiyet: srep
exocentric-dava: zrek
geçişli-fiil: txif
morfem: tfom
şovenist: dvis
geçmiş-tamamlanma-belirten: xrat
mesleki: hy6n
dolaylı-konuşma: tyoc
ikinci-dil: draf
için-olmak: txis
mezarlık-vardiya: vrak
toplu-isim: hxos
absolutive-dava: bvuk
sabırlı-tetik: tr6t
öz-güven: hs6s
dışkı: hzos
dönüşlü-ses: hf6s
kişiliksiz-fiil: hxek
seaborgiyum: br6m
beyaz-boşluk: hxep
tipik-dava: dlok
cansız-cinsiyet: hj6n
ettirgen: qran
propositive-ruh-hali: psom
elektrik-akım: tr6n
ilişkisel-dava: nwok
üstün-dava: tluk
çok-çok: xyut
gezegen-cinsiyet: pxen
canlandırılmış-karikatür: nwuk
karşılıklı-ses: vrik
yasamak: hqaf
En-en-az: vlas
dilbilgisi-durum: qrak
kullanıcı: pxut
çekirdek-benefactive: kfef
kaleci: hgop
:-except-for: kcef
payda: dvan
else-if: lyek
yanlamasına: hx6s
herbiri: dles
ardışık-fıkra: lyuk
aşınma--out: hxun
şort: ht6k
disporsiyum: prom
yakında-gelecek-gergin: rwec
si-birimler: vyin
kripton: kxon
mendelevyum: dlem
uygulamalı-ses: hp6s
antipassive-ses: tsef
continuative-görünüş: ht6p
radyasyon-hastalığı: hr6k
necessitative-ruh-hali: hn6t
tek-eylem-fiil: hqek
vagon: xlak
üstün-derece: tlup
varoluşsal-fıkra: hs6k
kaliforniyum: kf6n
mevcut-ortaç: vrat
aydınlık-yoğunluk: hc6t
singulative-sayı: slus
dilbilgisi-nesne: hy6t
pasif-ortaç: vris
aşırı-süre: kxic
süper-kritik-akışkan: sr6t
miktar-arasında-madde: ks6t
İlgeç-dava: pxok
seçmeli-nicelik: lwif
gadolinyum: dl6n
epenthetic-morfem: hp6m
olumsuz-nicelik: nwif
aynştaynyum: ny6n
yapay-dil: txac
bağlayıcı-parçacık: qrik
uzak-gelecek-gergin: twec
tekrarlama-bildiren-görünüş: hfep
dağıtım-zamir: bvin
hitabe-anlaşma: hk6m
kel: blos
banliyö: syum
evrensel-nicelik: vlit
bilgisayar-programlama: mr6m
televizyon-program: tr6m
kayan-noktalı-sayı: hvun
varoluşsal-nicelik: tl6t
gün-sonra-yarın: dwek
alternatif-nicelik: lw6t
kötü-huylu: hdup
geçmiş-pasif-ortaç: hp6t
gün-önce-dün: txet
lokatif-yönlü-dava: tc6k
counterfactual-şartlı: ht6c
