bất-định-cách: hnit
được-bổ-nhiệm trường hợp: hnak
đối-cách-trường hợp: hkak
chủ-đề-trường hợp: htak
Cha-mẹ: hmat
cha: hpap
mẹ: hmam
chào-bạn: hnat
tổ-tiên: htat
ông-bà: hyat
đói: hcac
tánh-cách-trường hợp: hnik
tính-từ: hcit
và: hwan
tôi: hmic
bạn: hnan
chúng-tôi: hnam
nó: hyic
nơi-đến-trường hợp: htas
quyền-giám-hộ trường hợp: htik
Nội-địa-bối cảnh: htis
một-người-bối cảnh: hpak
phụ-thuộc-điều khoản: htan
hoàn-bị-diện mạo: htap
quá-khứ-căng: hkat
đàn-ông-tính: hsan
comitative-trường-hợp: hmik
hiện-tại-căng: hyan
benefactive-trường-hợp: hpik
essive-trường-hợp: swik
không: hnic
nó-là: hsis
bề-mặt-bối cảnh: hsak
adpositional-trường-hợp: hpan
vị-trí-trường hợp: hwak
không-gian-bối cảnh: hnos
đường-trường-hợp: hrak
instrumental-trường-hợp: hsik
cái-nào: hkan
nghi-vấn-tâm trạng: hnim
và-hoặc-là: htam
độc-quyền-hoặc: hkit
nguồn-trường-hợp: hsok
văn-biểu-la tinh trường hợp: hlak
chỉ-thị: hdit
nhưng: hlan
toàn-bộ: hsut
giống-cái-tính: hnin
họ: hwin
số-nhiều-con số: hlun
một: hyik
Tương-lai-căng: hwet
xã-hội-bối cảnh: hson
Khi-nào: hkap
không-trọn-vẹn diện mạo: hmap
chỗ-đó: hkac
có-điều-kiện tâm trạng: hcan
hơn: hdoc
ngoài: htac
họ-hàng-trường hợp: hrik
kết-thúc-trường hợp: hlik
làm: hkas
chỉ-thị-khí sắc: hden
deontic-tâm-trạng: hdim
câu-hỏi-lời: hwac
liên-hiệp-tiếp từ: hkok
một-người: hpon
Nam: hman
có-thể: kwat
khác: hcon
con-số: hnoc
rất: tcac
thời-gian: htim
thời-gian-bối cảnh: htos
thời-gian-trường hợp: hmak
trong-khoảng: hkam
tri-thức-tâm trạng: hsim
chỉ: htun
ít: hcak
sau-đó: pcan
có-ý-khuyến khích khí sắc: hton
quá-khứ-diện mạo: hrip
thật-tuyệt: hcat
volitive-tâm-trạng: hlim
trước: hsec
cần: pcic
số-hai: htut
nhìn-thấy: tcan
biết: hsat
xuống: hcin
sau: hcas
Thứ-nhất: hpas
của-bản-thân: hpun
có-thể-sang chiếm hữu: hlic
không-bao-giờ: hnac
không-thể-cho chiếm hữu: hkic
cũ: hwat
có-quyền-thảo luận tâm trạng: hcim
ngày: htin
Ở-đâu: hnap
đến: hlat
đường: hyas
công-việc: hkaf
nguyên-âm: hwaf
đi: hkun
perlative-trường-hợp: pwik
cấp-tiến-diện mạo: hpip
Dài: hlac
nói-rằng: hsac
làm-cách-nào: hkin
cũng: hpit
trở-lại: hwap
chỗ-này: hcic
nghĩ: hcik
cùng-một: hsam
Cuối-cùng: kcac
cách-xa: twan
Dưới-bối-cảnh: hnas
cầm-lấy: htit
tìm-thấy: hfan
tay: cyat
trẻ: hyac
Tuy-nhiên: hyap
biếu-tặng: hkik
thần: hmac
delative-trường-hợp: lwak
chẳng-có-gì: hmin
bên-phải: hyit
một-khi: hyam
semelfactive-diện-mạo: fwip
phần: hpat
cái-cưa: htic
Nhà: hfas
thế-giới: tcat
cái-đầu: hcaf
số-ba: tyin
tân: hnon
chú-trọng: hcok
thân-ái: hpac
luôn-luôn: hsit
đêm: hwit
mỗi: hmit
Vua: hyak
giữa: hsin
hình-trái-tim: cyin
paucal-con-số: plom
bởi-vì: hyok
nguyên-nhân-trường hợp: ksak
Điều: hkis
bộ: swat
tên-gọi: hnem
đúng-danh-từ: hran
có-ý-khuyến khích: hrat
đất-nước: hlit
hỏi: hput
có-thể-nhìn thấy chứng cớ: crit
tốt-hơn: pcac
bên: psac
khóa-học: hkus
nữ: hfin
đủ: kyat
Sớm: hpuc
đầy: hcun
căn-phòng: hfac
gần: hlap
không-thể: nyat
nước: hwik
desiderative-tâm-trạng: hdin
nhẹ: lyak
cũng-không: hnun
lời: slat
cánh-cửa: tyan
sử-dụng: hpus
buổi-sáng: hsap
terminative-trường-hợp: twik
năng-lượng: hkuk
mình: hmis
hiện-nay: hyin
giọng-nói: hwas
màu-trắng: hpis
tiền-bạc: tlan
bên-cạnh: kyak
nghèo-nàn: hyis
cái-chết: hmut
mẫu-đơn: hfam
inessive-trường-hợp: nwik
Hiền-hậu: tyac
thường: tsan
năm: nwan
bạn-bè: myat
gọi-món: hyut
bắt-buộc-tâm trạng: hpim
tròn: hcut
tin: hban
công-cộng: hpin
tiểu-bang-bối cảnh: hsas
Con-trai: psat
một-trăm: hmas
bọn-trẻ: hcis
như-vậy: tyak
mong-ước: hcap
phía-trên: hyip
kính-thưa: pyin
đọc: pyac
thành-thị: hsic
rồi: hpic
sự-thật: hfat
factive-chứng-cớ: hfit
Nghe: hsun
ít-nhất: hmim
có-lẽ: pyat
mở-ra: kcat
cơ-thể-người: tcic
hàng-không: cwac
bản-chất: nyit
cứu-giúp: mlat
lá-thư: lyat
bốn: ksat
nguyện-vọng-pháp tâm trạng: hpam
lửa: hfak
vì-thế: hyif
giờ: hcam
miễn-phí: tyit
chiến-tranh: syat
cho-dù: hsaf
lý-do: kyan
hiệp: hnut
gọi-điện: hkuc
tại-sao: hwam
đi-lạc: hkut
một-ngàn: tsas
gia-đình: hfic
Linh-hồn: twam
câu-hỏi: swac
chăm-sóc: kcan
realis-tâm-trạng: hlin
có-nghĩa: mwit
tiềm-năng-tâm trạng: hten
về-phía: cyan
allative-trường-hợp: lwik
anthropic-tính: hrin
ngắn: kyut
khả-năng: hyuk
sống: hkip
bộ-môn: hsek
giống-nhau-đối tượng đánh dấu: hcek
khác-nhau-đối tượng: hfek
bài-giải: tsat
biển: mwat
nỗi-sợ: hcoc
hiểu-rõ: pcat
chăm-chỉ: kyin
các-điều-khoản: tyut
nghi-ngờ: hdac
dubitative-tâm-trạng: twin
hỏi: psan
cánh-tay: tcas
màu-đen: clis
mang-lại: tyat
đẹp: ksis
bóng-tối: tcak
cầm: psak
mười: htaf
hiển-thị: pyan
câu-chuyện: hkif
chung: kwan
sách: hkup
điện-tử: lyin
nói-chuyện: plak
chấm-điểm: myac
làm-quan-tâm, thích thú: nyis
viết: kcit
giường-ngủ: pwat
cần-thiết: syis
ý-kiến: hwis
môn-vẽ: klat
vialis-trường-hợp: hlas
anh-em: pyak
thỉnh-thoảng: ksas
dòng: lyan
bàn: tlas
con-sông: nwit
mắt: kyac
thông-tin: fyin
bỗng-nhiên: tfan
lạ: hgan
sâu: ksan
sự-thay-đổi: hrit
cảm-giác: nwac
gặp: mlit
mục-đích: htuc
sung-sướng: hcuc
dường-như: syit
máu: cyac
bông-hồng: kwas
hướng-Nam: swan
lạnh: tlat
phía-trước: myik
vị-trí: psis
trễ,-muộn: tyam
đứng: syan
giả-sử: nlas
con-gái: pyit
mìn: myan
cắt-tỉa: hkim
bản-sao: hfap
chồng: hgat
sáu: hlis
ghi-nhớ: twat
hiệu-quả: hyaf
gục-ngã: htuk
ngoại-trừ: hsip
tóc: hpaf
thông-qua: pyas
bản-quyền: pcit
quân-đội: cyit
chạy: kcak
con-ngựa: kcas
Tương-lai: hwic
hướng-Tây: pcak
trả: plit
đỏ: hyun
vàng: tcun
khao-khát: hdan
chơi: plin
bậc-thầy: mwas
văn-phòng: hfus
chính-phủ: syak
nhà-thờ: kyas
chiều-dài: hlen
Công-ty: ksin
giấy: kyis
xác-suất: hbin
đặc-biệt: cyas
chịu: pcas
cửa-sổ: cyak
đồng-ý: hgac
nét-đẹp: syac
nhiệm-vụ: tfac
gửi-đi: fyan
khoảng-cách: htif
khoảng-lặng: slan
bàn-chân: fyat
hoang-dã: kyik
chết: myam
lưu-giữ: pfan
màu-xanh-lá: kcin
rắc-rối: mlan
nụ-cười: myak
sai: clat
khác-nhau: pcin
ngủ: slit
quotative-trường-hợp: kwik
bắt-đầu: cwan
hoạt-động: kfan
Thăm-quan: fwat
theo: nlan
cố-gắng: tcis
sự-có-mặt: psit
ngọt: tlit
giàu-có: tcin
kẻ-thù: tcam
con-tàu: hcip
điều-kiện: kyit
kể-ra: hkum
bao-hàm-một người: hlon
bí-mật: kwit
precative-tâm-trạng: pwim
lịch-sự-ghi danh: hbit
quỷ-quái: pwac
tháng-Ba: myas
bất-cứ-điều gì: kwac
ở-lại: hlam
thay-cho: plat
màu-xanh-da trời: plan
bất-khả-thi: psap
ngôi-trường: hsuk
dịp: ksac
có-gia-đình: nwat
món-ăn: hcuk
hai-mươi: tsis
trầm-tính: tcit
Dễ-dàng: hnis
tiềm-năng-diện mạo: hrap
ngôn-ngữ: lyac
biểu-hiện: syas
tuần: hsus
hội-trường: hcum
nguy-hiểm: kcic
bất-động-sản: myit
chào-đời: nyan
tòa-án: kcut
nói-chung: tyap
châm-ngôn-diện mạo: hmip
giá-trị: tyas
đơn-giản: syap
cây: pyic
chiến-đấu,-đấu tranh: pyap
Tường: twit
trời: cwak
mở-đầu-diện mạo: htip
JUSSIVE-tâm-trạng: hjin
giai-điệu: twun
Về-vấn-đề: klan
kỳ-vọng: pcik
tháng: hmaf
Trải-qua: nyap
trọn-vẹn: nyac
tươi: tsac
công-tước: hnuk
phủ: kwak
giới-hạn: hyim
hướng-Đông: tyuk
Cục-đá: pwan
hơi: kfat
chiều-hướng: tlac
chiếc-ghế: kwis
hỗ-trợ: syut
hẹn-hò: tyic
làng: klac
cánh-đồng: clit
sự-cho-phép: nwin
cho-phép-tâm trạng: hmom
sự-thành-công: slak
đúng: hric
đồi: clin
Âm-nhạc: ksik
xa-chỉ-thị: hdat
buổi-chiều: htup
khóc: hyuc
danh-dự: hnaf
bảy: swit
riêng-tư: pfat
Tin-tức: nwas
bối-cảnh: slac
vườn: cyam
cuộc-đua: htus
phân-phối-trường hợp: twak
học: clan
chính-trị: syik
nói-dối: kcun
đúc: tsak
ăn: kcam
mặt-sàn: hlaf
bệnh: pwin
nguyên: mlin
mùa-hè: kyam
tôn-giáo: tlam
bức-ảnh: ksit
bỏ-trốn: plap
tác-giả: hlut
nâu: pyun
xác-định: htem
đau: hdon
mùa-xuân: psin
thế-kỷ: syic
dịu-dàng: mwan
góc: kyun
sản-xuất: psas
cười: cyaf
quên: flat
Châu-Âu: hyup
tám: lwat
bộ-váy: lwac
khủng-khiếp: cyap
hơi-thở: syaf
khôn-ngoan: hbas
trường-hợp-chiếm hửu đánh dấu: srak
ký-ức: myin
hiện-đại: fwan
nơi: tcap
nổi-lên: hyus
gãy: pyik
năm-mươi: hfis
Đảo: tlap
chạm: hsuc
lời-hứa: pcam
commissive-tâm-trạng: mwin
bằng: tfat
kế-hoạch: plac
hạnh-kiểm: nyak
bất-ngờ: cran
phút: hmun
bắn: hwut
tệ-hơn: pcap
ly: klak
trường-hợp: tlin
an-toàn: hsif
Bác-sĩ: tsit
để-bổ-xung diện mạo: hmep
lặp-đi-lặp lại: tyun
quân-sự: slin
nóng: nyam
uống: pfin
câu-hỏi: pcaf
Sự-phẫn-nộ: nran
trực-tiếp: tyik
cái-mũ: hcup
chó: kwap
đầy-tớ: hnuc
niềm-tự-hào: hram
đám-đông: tcuc
huấn-luyện: nyin
luân-lý: myut
liên-quan: kyim
vào: fyak
qui-định: nyas
Gươm: cwat
tấn-công: kfak
Sức-khỏe: clac
đoạn: pyaf
xã-hội: hsum
hoàn-tiền: tfit
lấy-làm-tiếc: hpec
lòng-can-đảm: krac
vẻ-duyên-dáng: hnen
chính-thức: hfaf
cung-cấp: tsik
yêu-cầu: pwit
nhìn-thoáng-qua: klas
sự-vận-động: hyon
chờ-đợi: cwit
ngược-lại: psam
mười-hai: tyaf
đính-hôn: nyut
rượu: hwun
mùi-vị: swut
bàn-là: fyac
phân-phát: syin
buôn-bán: myap
Ưu-điểm: twac
quần-áo: kfip
phán-xét: fwak
chênh-lệch: tfaf
nóng-lòng: kcis
thuyền-trưởng: kwin
đã-kết-thúc: nlat
đình-chỉ-diện mạo: hsep
Hiếu-kỳ: kyic
nước-ngoài: kwic
khuếch: hnif
tầm-quan-trọng: myun
cuối-cùng: hfim
hóa-đơn: fwin
chứng-minh: hpuk
ngăn-chặn: flan
cái-cổ: cyun
hợp-pháp: hfik
khô: swak
phục-vụ: syam
mất: pcut
bằng-chứng: pyut
chứng-cớ-trường hợp: hdak
tiến-trình: pyis
cao-ốc: klit
Tìm-kiếm: syuc
buồn: hrac
tội: psip
Ba-mươi: tfis
thành-thật: tsin
đóng: kyap
ngân-hàng: pcun
số-phận: cyik
khu-rừng: hfun
đo: mlac
nếu-không-thì: htoc
suối: lyam
bánh-mì: hpup
thêm-vào: tfak
chọn: twas
thú-vật: nwam
zoic-tính: hzin
eventive-tâm-trạng: hwim
giống-nhau-biến cố đánh dấu: hcom
nhân-giống-trường hợp: tlak
dầy: hmus
sinh-vật: hyum
mưa: myic
bề-mặt: pfas
thánh: swis
tháng-bảy: clim
bài-báo-cáo: hfut
bờ-biển: pwas
Hồ-sơ: hfif
vai: cwut
ngạc-nhiên: kran
Hoàng-gia: klik
bài-hát: hkuf
sự-an-ủi: kfaf
bất-cứ-người nào: nyic
cỏ: kcap
rút-ra: cwik
khai-mạc: cyic
tháng-6: cwun
cá: mlic
nguồn-vốn: klin
nhũ-hoa: cyut
tuyết: hcif
giáo-dục: tlik
nhọn: tcaf
lòng-thương-hại: hdam
kinh-phí: fyas
của-bạn: hmuc
triệu: mlun
mệt: tcik
giết: ksam
bóng: cwap
cân-nặng: plas
khối-lượng: mlas
thành-lập: tlip
can-đảm: pyam
gầy: plic
hài-lòng: srat
kiểm-tra: kcik
Đức: hdet
quốc-dân: nyaf
thần-thánh: swin
thung-lũng: clak
phỏng-đoán: kwam
đầu-cơ-tâm trạng: hken
màu-vàng: clas
di-hài: mwac
khuynh-hướng: nlac
cái-hộp: pwak
mùa-vụ: tsim
khoa-học: slas
khoan: kcuc
Chú: hmuk
danh-sách: lyit
tháng-8: ksut
phổ-biến: hlup
Không-biết: fyit
quen: flak
quen-ghi-danh: krit
độc-giả: tsut
cách-tiếp-cận: pcuc
hai-lần: tsap
trí-tuệ: tfik
thật: tsam
thầy-tu: pcis
bị-thương: fran
nỗi-buồn: hpom
cung-điện: kfas
tiêt-tâu: clap
eh?: hnec
ngu-xuẩn: myuk
cạnh: pfac
chín: nwun
nổ: psut
chịu-đựng: tfas
tiếng-ồn: hcus
Ngữ-văn: lyic
khuyên-bảo: swas
trống: kcuk
cấp: psik
bão-táp: tcut
túi-quần: kyip
sự-tưởng-tượng: nlin
câu-văn: cwas
Tháng-mười-một: nwap
Tháng-mười-hai: tsip
vắng-mặt: psic
cảm-tạ: ryak
địa-chỉ-nhà: tyis
chim: pyuc
chủ-nhân: mlik
áo-khoác: kwut
chuẩn-bị: tyip
quan-hệ: lwan
hút-thuốc: htum
Tháng-một: nwak
máy: clic
Nội-dung: nyik
răng: tlis
xấu-hổ: hcet
vịnh: kcaf
não-bộ: pyuk
chiếc-nhẫn: klic
cụm-từ-đánh dấu: frak
hình-vuông: ksap
Hoa-quả: fyut
trà: tsic
giải-thích: slam
chào-mừng: cwam
thơ-ca: pwis
mua: klam
Trung-thành: hdic
hứng-thú: hcen
bốn-mươi: klis
tháng-tư: pyip
tử-tế: kfit
tháng-mười: kfap
đắng: kyuc
nô-lệ: tlaf
lỏng-lẻo: hluk
bản-văn: tsus
thẻ-tín-dụng: cyip
mười-lăm: pfit
hung-ác: kcim
tham-gia: cluc
qui-trình: hpif
tội-phạm: kyaf
bụi-bẩn: tsuc
Thực-hành: plik
màu: nlak
hủy-hoại: nyuc
tăng: lyas
mũi: hnus
thừa-nhận: tyim
hôm-qua: kfac
hesternal-căng: tlen
Thất-bại: slap
tiếp-tục: tcim
mặc: pwam
mù: nlit
tá: tsun
bay: fyap
khen-ngợi: cwin
ác-quỷ: cwaf
dần-dần: twic
sự-hy-sinh: kyif
bài-tập: cyis
lương-tâm: tfin
học-thuyết: tlic
bộ-trưởng: myis
chán-ghét: hnet
hồ: cwic
Trung-tâm: syun
mờ-nhạt: pfic
hợp-lý-tính: hron
cẩn-thận: fwac
hưởng-thụ: nlam
tôn-sùng: pwap
các-mặt-hàng: twap
da: twaf
mái-nhà: tlut
tôn-lên: gyan
Lâu-đài: klap
ngôi-vua: tcus
đính-kèm: nlaf
dặm: mlim
cực: krim
nhà-tù: fyis
ly-uống-nước: kcip
hội-viên: mlam
dân-sự: syim
bất-cứ-nơi đâu: tsaf
hiển-nhiên: tfic
cặp-vợ-chồng: pwaf
âm-lượng: clam
khách-hàng: ksaf
cây-cung: ksun
bộ-đồ: slut
thịt: mwak
sữa: hluc
thực-vật-tính: hwen
thị-giác: slic
hiếm: nlap
anh-chị-em họ: ksic
cầu: pwut
bảo-vệ: pfak
muối: swam
vô-tội: hwus
Nữ-hoàng: kwim
đếm: kcus
sự-tò-mò: hras
nhảy: tyus
khách-sạn: clut
lấp-đầy: flin
Tù-nhân: psun
cửa-tiệm: hjan
cầu-thang: sric
van-xin: hmen
cát: sran
hung-bạo: hgit
tháng-chín: hsem
khởi-hành: prac
sự-đổ-nát: crin
kỹ-năng: krin
gia-súc: hwec
thiết-bị: hwip
nhà-bếp: hkon
bán: hbak
tốc-độ: hsot
lời-kết: clon
máy-tính-bàn: hkot
đời-đời: hsen
có-hạn: mrit
thư-viện: hbek
căn-cứ: hbac
nhầm-lẫn: hrun
huy-Hoàng: cris
tương-tự-như vậy: hjic
sợ-hãi: hbic
không-hạnh-phúc: prin
bài-báo: hrek
đầu-bếp: kfin
ban-nhạc: hbat
hoang-mạc: hget
hôn: hbun
quả-bóng: hbot
cây-gậy: hpot
cãi-vã: hrut
quan-sát: nrak
lể-giáng-phước khí sắc: hbim
nổi-bật: hrim
phạm-tội: hdis
súng: hgin
công-an: plis
giấu: hzan
thám-hiểm: srin
dốt: nrin
hào-phóng: drac
mây: blan
chất-thải: htek
Tháng-hai: frif
Căn-bệnh: hren
chi-tiêu: bwan
nguồn: sron
sáng-kiến-trường hợp: hnok
cô-dì: hbam
chậm-trễ: dlic
bị-hoãn-bắt buộc: hlip
báo-cáo-chứng cớ: prat
nữa-đêm: dyit
anh-hùng: nrac
triết-lý: hfof
ngón-tay: hjit
dễ-chịu: hzat
một-vài-nơi: hmoc
nhấn: bran
nhân-viên: hraf
giải-thưởng: rwan
khiển-trách: dlac
đau-khổ: krat
trán: htec
quảng-cáo: glan
Thiên-thần: htet
số-ít-con số: hgam
rạng-sáng: hbon
Quảng-cáo: krak
tha-thứ: pran
con-cừu: hcec
kiên-nhẫn: hpen
nông-trại: crac
tham-chiếu: hrec
ngô: mran
Chìa-khóa: kcif
đa-số: hmot
yếu-đuối: hdut
bầu-khí-quyển: traf
thở-dài: tcoc
tình-người: mlis
phản-đối: pric
đĩa: hdik
cô-độc: hket
họa-sĩ: nrat
hiệp-sĩ: cwis
quyến-rũ: tran
phán-quyết: drin
thống-đốc: gran
chi-nhánh: rwac
bố-trí: hsoc
hăng-hái: tsum
dòng-cảm-điện khí sắc: hdum
cộng-đồng: hmum
dầu: hyen
ống: hbap
in: trat
oh: dyoc
đàm-luận-bối cảnh: hros
hô-cách-trường hợp: hwok
lều: ksen
báo-thức: plam
lo-lắng: hnes
thường-xuyên: hset
dao: ksuk
lụa: slik
sự-khinh-thường: grin
âm-phủ: nrik
tách: plen
nghiêm-túc: mrat
hỗn-hợp: mrik
bằng-gỗ: mrak
thích-hơn: hpet
cảnh-báo: trin
khuyên-bảo-tâm trạng: htom
xung: hmos
Hoài-bão: mrac
chối-bỏ: hnek
hiến-pháp: swic
nhạc-cụ: srit
liên-tiếp-diện mạo: hnip
thủy-triều: hgas
trường-đại-học: klen
cái-đuôi: hkek
thế-hệ: nric
con-mèo: blat
Chỉ-đường-chứng cớ: hret
bị-bỏ-rơi: trac
mười-một: hyec
bản-năng: nlik
đặc-tính: trit
bộ-lạc: hgik
nhát-gan-tâm trạng: pcim
che-chở: crat
bất-lịch-sự: hruc
cưỡi: hris
lắc: hmon
ngành-công-nghiệp: hdot
chuyên-nghiệp: hres
đèn: hdap
cà-phê: kfif
tuân-lệnh: htot
Phương-bắc: nrit
cô-y-tá: nris
cam-đoan: hjat
chuỗi: ryin
giảng-bài: cric
giày-dép: hgut
cái-sân: mram
mơ-hồ: hmec
nơi-khác: hlet
chung-cư: pret
Hoạt-động: twot
thứ-bảy: cram
ánh-nắng-mặt trời: hduc
Người-đàn-bà góa: hwuc
thành-phần: hlem
sự-phản-xạ: hfen
cơ-quan: hgis
ngôi-sao: tram
biến-cố: hgon
khách: hgip
quán-ba: brap
chai: hbet
ban-phước: blak
sự-náo-động: crak
bên-trong: trik
sửa-chữa: krik
lấy-được: prit
rỗng: hcot
tỉnh: hpos
nền-văn-minh: srac
treo: hgak
sốc: crok
ngoại-lệ: swap
sự-căng-thẳng: tren
Tiêu-chuẩn: ryan
chạy-xe: dran
thoát-khỏi: hruk
xin-thề: kses
Châu-báu: zran
hạt: hbis
cái-tháp: tras
yêu-thích: fwit
gần-đây: hcem
mới-đây-quá khứ căng: hrot
thức: srik
Nội-thất: mrin
dây: hkos
phiêu-lưu: hdas
vương-quyền: ryit
tiệc: dyat
diễn-tả: dras
sáu-chục: hses
tỉ-lệ: hkem
Lễ: srec
săn-bắn: clik
thì-thầm: psus
phần-lớn: ryat
Cơ-đốc-giáo: ksim
luật-sư: hwif
chi-tiết: drit
công-chúa: hrus
bàn-thờ: dlat
web: hwes
màu-tía: brin
quây-quần: hkoc
bầu-cử: hben
quan-niệm: kren
say: crik
đổ-vào: brac
nâng: hlif
cử-chỉ: hjis
quản-lý: rwin
trao-đổi: tcen
xác-định-bài báo: hdek
Hoàng-đế: mras
xa: hroc
xấu-xí: clup
vô-hại: cras
lăn: hrof
inch: nlic
báo: grat
râu: dric
nước-mắt: srim
tiền-hoa-hồng: kson
trong-khi: grak
đi-qua: kcoc
sự-độc-lập: htes
mùi: hwon
mười-tám: hdec
lịch-sử: tris
Tổng: krut
gốc-cây: hrok
bùn: hbik
cô-dâu: dlan
mạng-che-mặt: pras
nhà-hát: tret
sự-so-sánh: kras
đối-thủ: rwis
cân-đối: slen
Huấn-luyện-viên: kron
hài: hnum
Tiểu-thuyết: rwas
trả-thù: hbaf
ghen-tuông: ryut
bánh-xe: hlok
cháy: glat
đèn-flash: flac
sáng-tạo: hkec
cuộc-xung-đột: hnot
nguyền-rủa: hlos
trù-rủa-tâm trạng: pram
không-nơi-nương tựa: hces
khả-quan: hzit
câu-lạc-bộ: klup
lũ: nras
ngũ-cốc: gwan
thờ-ơ: hdun
chân-trời: crim
kiêu-căng-tâm trạng: hsom
dốc: htop
hài-hòa: mron
sấm-sét: hgot
thời-thơ-ấu: htok
đầu-gối: hgun
phần-mềm: pwen
chấn-thương: kram
biên-lai: ryis
cho-phép: nlim
màn-đầu-của vở kịch: hpoc
trượt: slok
Cuộc-cách-mạng: hrif
người-nông-dân: hjim
Cú-đánh: trak
nền-tảng: hpof
sứ-giả: hmes
đặc-quyền: hpek
tổ-chức: hyot
học-sinh: clen
hang: hgec
truyền-thống: rwat
thảm-kịch: tses
giã-từ: hjap
sự-chỉ-trích: ryik
bông: krap
bệnh-viện: slot
thuê: kris
khí: hges
không-thể-tránh khỏi: pwic
chết-người: hgim
lá-cây: glit
công-bố: plun
thù-nghịch: tsup
dịch: dwan
tang-lễ: jran
bột-mì: mrun
sự-tương-hợp: ryon
trữ-tình: hrom
túp-lều: clun
đề-xuất: psot
tài-bắt-chước: hmet
đô-la: dlon
ánh-sáng-ban ngày: hjac
mười-sáu: hsos
hội: hzac
thuộc-địa: klon
cánh: gyin
sư-tử: hles
nền-văn-hóa: klut
cột: hkom
xảo-quyệt: glak
kịch: dram
câu-nói-đùa: hjuc
sương-mù: hdus
thuốc-chữa-bệnh: dwas
mười-bốn: hkes
chua: sram
cụ-thể-là: hyet
mức-thu-nhập: hmok
giám-mục: hbip
màu-cam: tron
bồn-tắm: byan
nguyên-thủy: rwit
cái-giỏ: ksek
Thư-ký: sris
rơm: prak
nóng-nảy: pfif
sự-cứu-rỗi: slon
thuộc-về-ngày nay căng: dlin
có-ý-định: zrin
Hơi-nước: tcip
chất-độc: hwoc
năng-lực: tlon
khí-hậu: lwim
có-hiệu-lực: fric
phân-biệt: tcif
rửa: dwac
lời-thú-tội: kfis
vô-lý: hjas
than-đá: kyon
xuồng: kwon
tạm-thời: tric
delimitative-diện-mạo: hdip
khúc-xương: hcos
Thứ-hai: nwic
thứ-ba: glac
thứ-tư: bwac
liên-bang: frin
ao-ước: hzic
Tiêu-biểu: ryic
lanh: lwin
bồn-nước: swuk
cháu-trai: bwin
dính-máu: kric
sự-bao-vây: cren
Dạ-dày: hpem
thau: pcon
đỉnh: hzik
thứ-năm: pfik
rẻ: brat
độc-quyền-một người: kwen
chiếm: zrat
hàng-rào: hzas
bức-tượng: tfam
Súng-đại-bác: tlep
ôm-hôn: mrap
xung-quanh: sren
nghiêm-khắc: srot
con-hươu: hluf
bụi-gai: hbuc
đường-sắt: hrep
phóng-điện: hduk
người-kế-thừa: mris
cây-sồi: blun
khó-chịu: pren
phát-minh: hgic
Dương-cầm: pyon
khuyên: swen
tàng-hình: gric
ai-cũng-biết: ryun
tàn-ác: kluk
sự-cám-dỗ: hyoc
telic-diện-mạo: hlep
kinh-tế: kfik
quốc-tế: troc
gây-trở-ngại: tcek
nhà-triết-học: flif
tao-nhã: gyit
phúc-lợi: kyen
đánh-bắt-cá: mlak
lấy-trộm: truc
môi: hloc
về-hưu: ryac
căng-ra: sras
bộ-sưu-tập: glen
song-song: zlan
atelic-diện-mạo: htep
lục-địa: trap
cấm-tâm-trạng: nrim
bó-lại: dwat
tế-bào: slep
trứng: dyan
nhân-tạo: jrat
Trong-khi-đó: nwis
cuộc-khủng-hoảng: ksot
lịch-sự: sloc
bữa-ăn-trưa: lyon
cây-thông: pwon
đẩy: hcef
liên-minh: lyen
thắt-lưng: hkop
phép-màu: hmek
thủy-thủ: slis
tinh-khiết: prut
cộng-hòa: hguk
Điện-thoại: tfen
roi-da: krip
áo-sơ-mi: cyim
giới-thiệu: ryas
ghế-sô-pha: hsof
quét: hsup
người-ăn-trộm: ksif
giữ-lại: nrec
kênh: kcen
nhân-cách: klim
cải-cách: kfam
đe-dọa: hzim
cây-cọ: plim
cái-loa: hzak
ngưỡng: dwic
khiến: pris
thương: bzak
khéo-léo: syec
buổi-họp: cwen
tra-tấn: crot
ẩm: tcum
cây-rơm: grit
du-khách: hyek
máy-xay: mwik
bản-đồ: jrac
cổ-áo: klok
thay-thế: klif
cố-tình: drat
bia: hbif
nhung: hwem
nghiêm-trọng: gwit
bài-thuyết-giáo: hpum
lạm-dụng: glas
đàn: hgen
mười-ba: tres
biện-hộ: jyit
Thứ-sáu: crum
chải: broc
tải-về: dlas
kem: krem
cheo-leo: klaf
ban-bồi-thẩm: jrin
con-quái-vật: ksos
đông-lạnh: hgoc
nồi: pfot
đồng-xu: psen
năn-nỉ: srut
quả-táo: hpep
bàn-luận: drak
Bối-cảnh: prun
chép-lại: trim
định-kỳ: prik
giải-trí: nren
vi-rút: bris
trẻ-con: blit
phản-chiếu: flit
chuyển-đổi: kcet
dàn-bài: kluc
nhạc-kịch: hpop
sự-chấp-thuận: nron
phản-bội: rwak
trừng-phạt: hzen
khuỷu-tay: kcon
tập-tin-đính kèm: tcet
sửa: hrop
khả-nghi: cyec
bảy-mươi: swet
thánh-kinh: srip
hố: grac
xáo-trộn: dlak
nhị-phân: byin
tu-viện: bjan
mũi-tên: tcec
có-xu-hướng: trec
kỹ-lưỡng: frat
lòng-trung-thành: hlot
tiền-xu: syip
rung-rinh: tcem
tha-hương: gwin
cơ-khí: myim
bẩy: crap
bánh-ngọt: kyek
quý-ngài: cyes
do-dự: sret
mười-bảy: syet
Cục-cưng: myon
cổ-phần: dzat
bước-đi: hjam
gạch: brit
tám-mươi: hpes
không-may: pcen
tham-khảo: kcot
huyền-thoại: lwen
mùa-gặt: hfos
khuyến-mãi: pfon
bếp: hsop
phiến-loạn: bric
cổ-hủ: hnom
sưng-lên: cron
đầm-lầy: swot
nước-sốt: hdes
khổ-tu: pces
giám-đốc: mren
điệp-khúc: cros
hợp-lý: tson
Chế-biến: pson
chó-sói: blaf
thảm: hgap
cổ-xưa: hjak
phì-nhiêu: frut
Còi: slif
phô-mai: twis
cắn: byat
mời: jwan
thánh-đường: kyet
Bến-cảng: brak
đi-lang-thang: djan
cây-trồng: tsos
Hải-quân: nlen
mặt-nạ: mrok
bút-chì: pses
rau: sroc
tang-vật: hzet
quần: tlun
tham-nhũng: hrup
buồng: nram
canh: srup
bác-sĩ-phẫu thuật: syon
phụ-cấp: tcot
gián-điệp: gyas
táo-bạo: hlec
ngồi-lê-đôi mách: gyic
mã-thông-báo: hzon
trừu-tượng: srok
Thứ-năm: cwim
giao-thông: ryaf
kiến-trúc: ryek
vết-nứt: rwaf
trang-trí: rwon
đảo-ngược: lwas
làm-cho-vui: mwun
phục-hồi: ksus
vỉa-hè: plut
quyết-định: dyin
phủ-định: nraf
lễ-hội: hfec
giảm: hrum
sự-làm-phản: zyan
thợ-săn: djin
con-rắn: syen
ắc-quy: bret
sáp: flam
thám-tử: dlit
nghiên-cứu: nlis
nhấn-mạnh: hzot
bơi: twen
phong-bì: lwaf
bất-cứ-ai: hgek
thuốc-lá: jrit
động-cơ: mrot
Tình-nguyện: hwot
sự-phản-ứng: ryif
hành-lý: blam
điếc: hboc
nước-ép: hjus
khiêm-tốn: jlit
Bộ: mret
tình-dục: hjon
đường-kính: dyam
rìu: blac
kim-cương: dlam
luân-phiên: hlek
bắt-chước: hgus
sự-hạn-chế: swon
bản-sắc: hdaf
màn: krun
lười-biếng: lwis
momentane-diện-mạo: hmop
chắc: kfot
trôi-giạt: hdif
biến-mất: hgaf
cá-đuối: ryen
mực: mwic
to-lớn: mraf
hầm: dyac
đáng-ghi-nhớ: nrun
chói: klek
Thượng-nghị-viện: slet
quan-tài: tfap
sự-tha-thứ: frac
nuốt: nlun
thưởng-thức: nlot
lung-lay: swun
đồng-cỏ: gram
phức-tạp: klos
sự-từ-chức: hzis
khiêm-tốn-ghi danh: nret
âm-mưu: swim
cây-tiêu: prip
ngựa-con: pron
ứng-cử-viên: hzam
cáo: flik
ống-khói: tcon
quyền-tài-phán: drik
nông-nghiệp: rwic
tính-chính-xác: tcuk
trước-đây-người chết: brim
dân-chủ: mrek
đọt-non: hbos
cái-mền: bwat
kêu: hgep
con-heo: srus
hình: krek
ngà-voi: craf
cổ-điển: ksok
quan-sát-viên: nwet
con-voi: lwit
móng-tay: nwus
con-ong: hmif
chôn: dzan
diễn-viên: bzat
mồ-hôi: zwan
đánh-bóng: ploc
ảo-giác: hlus
tính-không-chắc chắn: pcet
thứ-cấp: syif
gập-lại: tsot
nông-thôn: grun
than-van: nyen
giống-nhau: slec
Trích-dẫn: hzun
bao: cyek
điều-khó-chịu: fren
cây-kim: hjun
được-kiểm-soát: nroc
gà: truk
thích-hợp: kwot
thùng-rượu: bras
thường-lệ-diện mạo: hcep
chuyên-gia: ksec
gây-ấn-tượng: blin
ôliu: zlin
van: myen
trở-ngại: bwak
gật-đầu: kcec
nuôi: plaf
Định-nghĩa: fyic
ngày-sinh-nhật: gjin
búa: hcof
thơm: hfon
sự-lập-lại: trun
tầm-thường: twut
đá: hjik
đào: kwaf
con-vật-cưng: plot
sọ: hcop
cơ-quan-lập pháp: dlik
gót-chân: cruk
nhăn-mặt: crun
bằng-sáng-chế: plet
tỷ: blim
hóa-chất: fyik
Phi-công: pyot
theo-gương: mlot
chiếc-váy: kwet
bất-thường: srap
hàng-tuần: jwik
kĩ-thuật: tfip
thảm-thực-vật: tset
con-quạ: kraf
mặt-trời-mọc: sruc
cả-đời: glin
Góp-phần: hyom
cái-móc: hdok
Cọp: blic
xuyên-qua: crut
tay-áo: slun
Xa-lộ: jras
dân-quân: mlip
rãnh: kroc
toàn-vẹn: kret
mười-chín: dzin
hữu-cơ: rwik
khoa-thần-học: flic
phao: flut
bà-phù-thủy: byac
chán: hwuk
ngoại-giao: dyik
phòng-thu: twos
quá: kcok
rượu-sâm-banh: cyen
cảm-hứng: crif
cờ: hbes
ly-hôn: lwon
chớp: hbut
tĩnh-mạch: jyan
thụ-động: psif
bọt: hgum
đá-sỏi: grik
khăn: tyen
hành-tinh: gren
giá-để-hàng: claf
cái-quạt: flon
nhiệt-đới: hjip
giai-đoạn: fwas
độc-đoán: rwen
phát-âm: kfun
thủy-ngân: krok
leo: hrem
tự-vận: tcos
phóng-viên: prot
tước-đoạt: hpok
giỏi: klun
ban-công: blik
cái-nĩa: fras
công-nhân: mlek
nhà-tuyển-dụng: myot
bề-rộng: jrak
bị-kích-thích: djit
tố-cáo: klot
tiền-cấp-dưỡng: pyen
động-từ: kres
con-khỉ: mwon
chấp-nhận-được: hwek
chữ-ký: tlim
chánh-thống: rwos
trớ-trêu: fron
vườn-ươm: nrap
miễn-cưỡng: jlan
nhập-khẩu: tyot
đuốc: croc
ngữ-pháp: gjak
gửi-tiền: gyat
thực-dân: plon
du-thuyền: jyat
theo-sau: kwec
mái-vòm: kwun
độ-dày: hfot
bướng-bỉnh: cyon
bắp-thịt: hmup
độ-lớn: ryam
chà: ryos
hèn-nhát: rwam
yên-cương: gwac
bánh-mì-nướng: tros
chuột: myus
vần: slim
vuốt-nhẹ: prap
cuộc-đối-thoại: dlaf
Trung-lập: nrot
siêng-năng: dwin
sự-mâu-thuẩn: trot
Hoàn-thành: kfic
con-dê: byak
mọc-lên: hfet
áp-đặt: mlon
vô-danh: nwim
chính-thức-ghi danh: frit
bò-con: hbof
nhãn-hiệu: mwut
làm-tan: hjec
xóa-bỏ: flas
ô: gras
khởi-động: bzut
khoáng-chất: mrim
cuộc-hưu-chiến: crus
con-vịt: hbok
lập-kế-hoạch: pfam
xà-bông: hsuf
búp-bê: gwak
bộ-xương: klet
Biệt-thự: blis
May: jlin
hòa-giải: dyak
ấm-đun-nước: kset
chín-chắn: mruc
con-thỏ: kruc
Nhạc-trưởng: nwot
sự-phụ-thuộc: djat
người-chơi: jlic
côn-trùng: pset
nhà-hàng: cret
chim-cú: lwun
cấp-tiến: djik
cư-dân: zwin
con-rồng: dron
thính-giác-chứng cớ: drot
khát-nước: kyos
kéo-dài: dren
tính: glun
Quy-định: ryim
thị-trưởng: mlap
thiểu-số: mric
mua-lại: dwon
cựu-chiến-binh: bren
dàn-nhạc: ryes
Thịt-ba-rọi: bjin
bất-lợi: zwat
vải: frap
nhạc-sĩ: gzik
tinh-thần: hnep
kết-hợp: nyon
không-đủ: nrip
kiến-trúc-sư: tsek
chanh: nyim
ho: kcos
đau-đầu: crek
người-thuê-nhà: ryet
khả-năng-sinh sản: srun
chữa-lành: hfoc
chín-mươi: nwon
ngẫu-nhiên: hbec
cái-muỗng: kcek
khí-cầu: blon
phấn-viết-bảng: hfip
suy-luận-chứng cớ: nlet
nhà-phát-hành: pcot
giấm: sruk
tro: fyec
lời-nguyền: slek
sống-lại: nrut
nhạy-cảm: kfim
đường-hầm: tfun
câu-đố: hpef
cơ-chế: mwim
toán: gzit
phai: frun
Gan: jwin
Sublative-trường-hợp: bwik
nhúng: dris
đơn-vị: twim
độc-quyền: hnop
bài-bạc: hgup
tàu-ngầm: bzin
động-đất: hbem
phòng-thí-nghiệm: brot
điên-điển: kruk
tự-kiểm-soát: syot
Phật: hbus
dệt-kim: bjat
đại-sứ-quán: blas
xa-nhất: sres
khai-báo-tâm trạng: drim
kích-thích-kinh tế: tyuc
sô-cô-la: clot
trùng: tyon
găng-tay: gwat
quì-gối: hjek
môn-Địa-lí: hjif
đầu-tư: nwes
bằng-lời-nói: mrec
phép-loại-suy: nlip
thế-tục: srek
chim-ưng: blap
tâm-lý-học: nloc
đóng-lại: gjan
sắt-vụn: krep
vai-trò: cyum
liều-thuốc: hdos
cá-hồi: slom
bánh-pudding: pwun
có-từ-tính: gyik
máy-bơm: pcom
ôxy: ksip
giấy-chứng-nhận: tfot
huy-chương: hmem
thuật-hùng-biện: trok
làm-trầy: rwap
chèo: dyas
kính-viễn-vọng: trip
chuỗi-hạt: clek
chính-tả: prif
whisky: hwos
liễu: hwof
con-lạc-đà: hlum
nghiệp-dư: myet
lối-thoát: crec
tiểu-sử: brif
con-lừa: gzac
hằng-tháng: mwis
bỏ-qua: nruk
kì-nghỉ: byit
nhấp-chuột: lyik
hình-trái-xoan: twon
dây-cao-su: lyet
tự-điển: kfon
giăm-bông: gzam
cầu-vồng: rwun
tiêu-thụ: kcum
nước-miếng: tcup
xe-tăng: trek
bạn-đồng-nghiệp: clok
Con-bướm: trif
biểu-đồ: graf
sinh-đôi: jwat
độc-lập: trem
cây-tre: hbum
người-chia-bài: jlat
tích-lũy: kles
viên-thanh-tra: nyet
miếng: hyos
cơn-ác-mộng: hbom
mứt: gjam
bảo-tàng: mrem
bảng-chữ-cái: lwam
tiêu-tan: zras
bố-ráp: crip
tiết-lộ: clus
thúi: fraf
hung-hăng: gris
ma-sát: mroc
Bến-tàu: gyac
con-nhện: brik
khoai-tây: trut
sửa-đổi: cwon
tham-lam: jlac
sớm: ryot
nhân: gzan
quay: pcip
số-liệu-thống kê: tsok
lịch: klem
đề-cử: nwen
nghìn-tỷ: tlos
tầng-áp-mái: tlok
khẳng-định-tâm trạng: rwim
các-ứng-dụng: pfen
hư-danh: nlon
không-bằng-lòng: sraf
nhiễm-trùng: hfok
bình: krot
nhún-vai: cyok
tiên-phong: gzin
bỏ-xót: nlif
cải-bắp: glic
Khỏe-mạnh: tlet
người-say-rượu: mrut
idiophone: hdof
đòn-bẩy: lwek
thượng-nghị-sĩ: syem
iris: nrif
con-kiến: mwam
bọ: hbop
Có-thai: grim
làm-kết-tủa: hjet
mắt-cá: tcok
phân-loại: glik
biến-số: prim
bọc: ryap
quăn: krec
lưu-huỳnh: hsef
bắt-buộc: dwik
hiện-ra: brun
con-ếch: fram
quá-đáng-trường hợp: twek
bọt-biển: hjen
làm-phiền: djon
con-sóc: slip
mài-ngọc: zyin
irrealis-tâm-trạng: flim
núi-lửa: glam
trong-nhà: gron
khai-thác: kloc
Địa-chất-học: jlik
hộ-chiếu: psop
trái-với-đạo đức: mlet
bánh-quy: hbuk
sự-hợp-tác: kros
máy-tính-bảng: tlot
sự-thư-giãn: kces
nguyên-tử: trom
AIDS: hzip
hình-kim-tự tháp: psim
chu-kỳ: swok
ngủ-trưa: hnup
bất-hợp-pháp: hjaf
quấu: pfap
nhút-nhát: crom
che-khuất: klip
trám-bằng-nhựa: lwap
cây-chổi: srum
bảng-điều-khiển: mwen
Thiên-văn-học: tcom
mê-lộ: blen
học-bổng: bwit
rùa: kfuc
cố-vấn: dwak
chất-xơ: fwic
con-dế: jrik
chim-bồ-câu: ksom
thích-ứng: dyon
Tam-giác: tfon
thủ-quỹ: tsen
khinh-khí: jron
dễ-vỡ: hfuk
máy-in: pyet
ngộp-thở: tcof
mãn-tính: gzon
đương-đầu: slaf
tình-trạng-khó xử: dlim
kỹ-thuật: jyin
máy-ảnh: hkef
xin-lỗi: pluc
liếm: lwet
vũ-công: dret
di-cư: mres
quần-vợt: tces
xương-sống: clip
chiên: zrac
khung-cửa: tfuc
dao-gâm: twuc
mật-khẩu: psaf
bán-cầu: praf
chiến-lược: zrit
đá-thạch-anh: krus
kéo: jris
tuần-tra: proc
băng-hà: lwic
nữa-đường: dwam
Biên-bản-ghi nhớ: mwap
hình-nón: kwuc
tính-cân-xứng: hzut
nhà-chế-tạo: zrak
bị-cáo: fwik
nhà-thờ-Hồi giáo: djis
cờ-vua: cres
số-điện-thoại: htof
quả-anh-đào: tref
phổ-biến-rộng rãi: kfen
tình-cờ-gặp: tfok
xe-tải: ryok
mù-tạt: mros
phần-trăm: pfet
bán-đấu-giá: jlam
rây: srif
không-vửng: swoc
nam-châm: gjat
hút: syus
đạo-Hồi: slum
nhón-gót-chân: twip
màng: mlen
cạo-râu: clet
đàn-ghi-ta: gjit
sáng: bzan
cây-du: hyem
bay-lên: kcom
đại-danh-từ đánh dấu: ryec
kẹp-giấy: pcus
đồ-gia-vị: zlat
tiền-thế-chân: jlas
người-chuyên-chở: zyac
sự-rung: bron
chọc-tức: trus
cái-cày: hlom
sinh-lý: zlik
Máng-xối: hgok
sao-chổi: cyet
trung-cổ: dyic
chim-se-sẻ: grec
bù-lại: twet
Nhựa: psuk
chú-thích: cyot
quĩ-đạo: rwot
thanh-đạm: twum
golf: hgof
số-không: zrun
Chip: tcep
áp-bức: prok
ngáp: gjac
bất-bình-đẳng: gwas
nốt-ruồi: tloc
đồ-gốm: frik
bà-nội-trợ: hgif
lúa-mạch: rwem
không-tuân-theo: hyes
khoan-dung: glon
phôi-thai: brec
thợ-mỏ: jren
tán-thưởng: zlac
men: lyim
phí-bảo-hiểm: pfim
mận: plem
sự-phá-sản: byas
thủy-lợi: rwif
cây-bạc-hà: nyun
nhà-tư-bản: glis
Độ-co-dãn: hlef
cá-mập: gyak
tuyển-dụng: drut
Lưu-trữ: zren
chủ-nghĩa-hiện thực: cles
củ-gừng: djic
xe-cấp-cứu: blus
có-thể-so sánh: kwip
ví: bjap
nhăn-nhó: glim
nhà-khoa-học: gyis
ruột: grot
bình-thản: hwum
Radio: href
không-thích-hợp: zlit
hạt-đậu: bwam
không-chính-thức: frim
cháu-gái: gyut
bất-đồng-ý kiến: dloc
miếng-bò-hầm: tfek
nitơ: zron
dao-cạo: hjut
tương-phản: krom
tuyên-truyền: pcoc
pháo-bông: fris
pop: pcop
quần-áo-mặc trong nhà: crop
luống-cày: cruc
có-hại: hzaf
đạo-Do-thái: hjum
bổ-thể: pluk
ống-kính: lyes
pegative-trường-hợp: pwek
bệnh-ung-thư: kfes
cầm-đồ: pyek
giảng-sư: zyat
rò-rỉ: hzuk
đủ-điều-kiện: krif
tỉ-trọng: djot
sự-cảm-ứng: dyis
nhai: htuf
lắm-lời: bzit
tôm: hgos
chiết-khấu: dyut
xe-tắc-xi: tsuk
hệ-thống: crem
ngọc-bích: gyec
tiếng-cằn-nhằn: glaf
con-thằn-lằn: lyis
thác-nước: crof
thất-vọng: djak
phủ-quyết: frot
tổng-thống: ryip
người-mua: mrif
gallon: jlen
muỗi: mruk
độ-lệch: dwen
vật-lộn: lyut
khảm: myok
phích-cắm: plok
ngồi-xổm: pcuk
tạp-hóa: ksoc
cộng-sản: myos
làm-kinh-ngạc: mwek
prosecutive-trường-hợp: rwuk
chòm-sao: nlos
nhà-độc-tài: dwit
sự-lo-lắng: tyet
vệ-tinh: tlec
dép: hlop
phụ-âm: fyon
ước-chừng: tsif
người-thất-nghiệp: byet
người-ủng-hộ: sros
sen: lwot
rau-diếp: sles
clorua: lwok
vi-khuẩn: bwic
dính: pcek
thành-phần: bwon
hạt-nhân: klec
đặt-chuyện: bjak
byte: bzet
sự-tiết: sruf
một-cách-rõ ràng: pres
phù-hợp: mloc
ba-lê: blet
nước-tiểu: mrus
củ-tỏi: lyun
trôi-qua: hguc
Kinh-tế-học: kcem
tầng-lớp-trung lưu: hdom
nhanh-nhẹn: gjic
kẹp: htef
giặt-ủi: lyoc
dâu: srem
đô-thị: pcos
lúng-túng: mlaf
quyển-vở: tfut
album: zlam
bóng-chày: hbep
bị-nghẹt-mũi: sluc
tiệc-đứng: hbuf
phân-từ: rwip
nhà-xe: grek
chẩn-đoán: djas
cái-nạng: ksuc
tống-tiền: srom
đăng-ký: psuc
hòa-tan-được: jlun
phốt-pho: psof
cấu-trúc: rwut
keo-dán: glum
luận-văn: twes
thủ-công: clif
chuối: bwas
định-lý: kyom
xương-sườn: psos
kền: nyek
pi: pyim
xe-buýt: bwos
pháp-quan: swes
tên-lửa: mlus
xúc-xích: slos
thao-tác: nlut
cà-chua: tfet
củng-cố: kfut
ổ-cắm-điện: syok
kali: tsom
lấy-lại: prup
ảo: zwit
đại-số-học: gjas
bác-sĩ-nha khoa: dzit
quang-học: pcok
nhúc-nhích: bzen
môn-sinh-học: bwim
thất-nghiệp: byim
sâu-bướm: krum
độc-tấu: slof
trình-duyệt: bjac
xa-quá-khứ căng: nyot
lịch-sử-căng: crep
Nguyên-tử: nluk
quang-phổ: pyem
natri: syom
thần-kinh-loạn: syes
ủy-thác: tyos
con-tin: byik
cây-bầu: gluk
nếp-nhăn: kwuk
minh-bạch: tfif
mũi-nhọn: swip
sự-ưu-tiên: pcif
người-đi-bộ: dyen
thuyết-vô-thần: tsem
màn-hình: mwot
các-cử-tri: nlec
không-kiểm-soát được: hkof
thăm-dò: grok
bạch-kim: plip
hai-con-số: dlun
phổi: pcep
siêu: syup
xe-đẩy-hàng: trop
tại-địa-phương: lyot
xúi-giục: gzat
xăng: plif
quả-thận: grif
cướp-bốc: bzac
đánh-giá: dlen
Thạch-tín: syek
ốc: nrok
Châu-chấu: tsec
phương-trình: fwen
xã-hội-chủ nghĩa: swos
bộ-lọc: flot
cảm-chứng-cớ tâm trạng: hxin
mở-rộng: kyot
xông-lên: mwet
buộc-bằng-dây xích: pwet
Quan-thoại: drun
nài-ngựa: hjok
viêm-phổi: hnof
tinh-thần-đoàn kết: gret
bản-lề: cyif
theo-chiều-dọc: nruc
cổ-tức: dwun
giày-trượt-băng: hkep
số-mũ: slop
khuyết-tật: dlif
sự-ám-ảnh: bwen
sự-phân-phối: pfun
nhiếp-ảnh-gia: trof
đồng-bằng: dlet
kỹ-thuật-số: djim
chó-cái: brut
mí-mắt: hyop
đường-chéo: dyun
tiềm-thức: byon
lông-mày: bruc
hắt-xì: pcec
vui-vẻ: dlis
ấn-độ-giáo: nwum
người-tị-nạn: nyif
đưa-đón: cwot
chất-đạm: pwot
bãi: hdop
lọc: flen
chất-mửa-ra: hwom
gen: gyen
sinh-viên-năm đầu: hdem
xã-hội-học: syoc
bí-đao: kwoc
người-câu-cá: hfuc
khu-vực: jyen
vận-động-khó khăn: hvok
quá-khứ: hxik
vòi-rồng: gyon
sự-đảo-ngược: nwos
TV: twif
hình-lập-phương: kfet
năng-suất: pwuk
cà-rốt: krop
phân-tử: mwuk
tập-đoàn: glet
kế-toán: ksum
quả-dưa-chuột: kyok
orgy: drok
hòa-tan: jlet
phosphate: psef
mồi: gwik
kiềm: flis
môn-thể-dục: jyas
dấu-phẩy: kwom
vận-động-xuống dốc: hvat
sẩy-thai: jwac
pod: tcop
nhà-tài-trợ: dzon
mangan: hzem
nhà-tâm-lý học: syos
clo: clos
bàn-phím: kyoc
ưu-tú: zyit
ngoặc: pfaf
bóng-bầu-dục: rwoc
ung-nhọt: jlon
biến-cách: hxit
gặm-cỏ: nres
lượng-tử: fwam
áo-len: swek
tiến-hóa: fwis
ký-hiệu: nyoc
tung-lên: tcuf
sự-mổ-xẻ: drec
bộ-nhớ-cache: kcep
tuyến-tính: lyec
antimon: trum
superessive-trường-hợp: psek
bướu: twom
xói-mòn: cyos
alpha: flaf
lỗ-rốn: nwip
miễn-dịch: myip
cúm: flun
nhà-máy-bia: bjit
đơn-giản-hóa: slef
giãm-bớt: bram
sứt-mẻ: djen
làm-xiêu-lòng: dwim
ép-buộc: brok
bít-tất: bzas
bộ-phim: fyim
vũ-trụ: klom
gây-ô-nhiễm: hpuf
ở-thành-đoàn: gjen
dương-vật: zyis
lâm-nghiệp: lyif
nhôm: lwum
sự-dao-động: zlon
lá-số-tử vi: ksop
trục-xuất: dlek
bao-gồm: nluc
người-thụ-hưởng: byic
cá-heo: dlip
kẻ-giết-người: cyus
động-vật-có vú: myaf
Chỉ-số: swif
dioxide: dwis
Dấu-hai-chấm: zlen
quan-liêu: brus
xuyên-tạc: jric
tủ-lạnh: frip
khảo-cổ-học: cluk
không-thể-chấp nhận được: kwok
đặc-điểm-kỹ thuật: pfis
tờ-rơi: pfut
nhân-chủng-học: nlom
ngon: kyec
tha: txit
khúm-núm: kwus
hướng-dương: hzuc
con-rận: glus
ion: lyos
du-lịch: tyum
modem: myom
sự-tăng-tốc: jrun
làm-sai: tsoc
phát-thải: hmef
bắt-cóc: drap
chồng-chéo: hwep
thợ-làm-tóc: pfes
văn-hóa-dân gian: floc
mao-mạch: plek
dân-tộc-chủ nghĩa: nlum
mông: nros
motif: hmuf
làm-ăn-da: slem
sự-thất-bại: xras
coban: kwos
vênh-váo: gwam
vận-động-thượng nguồn: trup
hậu-môn: gyam
giống-bò: bwun
lật: flip
dư: dzun
video: hwop
tẩy-chay: bjik
đố: cwif
khúc-côn-cầu: cwok
du-kích: grip
magiê: hgem
radar: drek
con-đười-ươi: hzif
sự-đáng-tin cậy: kwif
hình-chữ-nhật: tyec
tảo-bẹ: klep
tổng-quát: jlak
Lệnh-giới-nghiêm: kfec
đồng-tính: mlok
kịch-bản: srop
xây-dựng: flus
sự-đầu-thai: nrom
khơi-dậy: zlak
uranium: ryum
catcher: kwes
phối-hợp: kyop
người-trả-thuế: nwaf
tích-hợp: trep
phát-biểu: hzap
gamma: hxam
Safari: fwim
vận-động-phía hạ lưu: ht6n
hệ-số: kfus
tiêu-đề: zlic
phân-tích: nles
chiếu-tướng: hzes
trung-tâm-mua sắm: hmof
thanh-diên: bzim
bưu-thiếp: psok
hội-tụ: bros
lạc-đề: djet
cổ-đông: ksem
vi-trùng: mrip
cơ-quan-sinh dục: jwit
hình-thái-học: mluk
beta: byot
Quần-jean: gjis
cơ-sở-dữ liệu: tles
máy-tính: klus
tia-X: ksef
phân-tích-cú pháp: zram
môi-trường: zyen
sigma: zyim
phân-ly: hxon
chương-trình-nghị sự: gres
thị-thực: bzis
cơ-sở-hạ tầng: nyuk
con-đom-đóm: gyun
phát-hiện: tyek
thích-nghi: dyip
sinh-vật-học: byis
ghép-mộng: pyec
một-hóa-chất: brom
sự-che-chở: plum
nấc-cục: kfok
phấn-màu: psec
vườn-bách-thú: zwac
phòng-khám: lyok
ý-nghĩa: nwoc
yoga: hjoc
hiệu-sách: byun
trị-liệu: grap
dân-tộc: zlis
chém-đầu: zlet
vâng: swec
có-vấn-đề: byam
nhạc-jazz: dzas
vonfram: tsof
khủng-bố: gwis
chảy-nước-dãi: droc
sự-trao-đổi chất: tlem
tiền-trợ-cấp: lyaf
cuối-tuần: hfom
cây-cúc: gzim
vắc-xin: byap
xe-gắn-máy: tyok
thần-chú: dyot
học-kỳ: myes
heroin: gwon
thư-mục: flap
âm-cực: kfoc
tư-tưởng: dlec
bãi-đỗ-xe: prek
theta: fret
anticlimax: hxis
selen: clem
đạp-xe: blek
vỏ-cây: pros
sự-tương-đương: swaf
hiện-tại-liên quan đánh dấu: hxak
phi-trường: cwoc
cưa-đi: gyet
bóng-rổ: bwet
Kẻ-lừa-đảo: mwip
con-gián: tlek
cơ-rôm: hgom
lít: hl6t
dù-sao: nwec
kích-thích-tố: cwom
thiếu-sót: tluc
khoan-lổ: prec
thuyết-tâm-linh: nyom
đa-giác: cloc
nữ-quyền: hfes
liên-hợp: kcop
Đồng-euro: dros
nhân-sâm: hjes
thuật-toán: hlof
tia-laser: lwes
nhà-thuốc: dlot
milimet: mlem
uốn-cong: flek
dương-cực: nlok
sắc-thái: hzus
bán-thời-gian: prem
độ-nhạy: nyec
người-đi-biểu tình: drom
heli: clum
nói-hai-thứ tiếng: dzic
từ-viết-tắt: hqim
initialism: nl6m
động-từ-tiến hành cách: gros
huyết-tương: psem
nhiễm-sắc-thể: rwom
thứ-tự: rwok
km: klum
fax: tfes
di-truyền-học: nwek
đốm-trên-da: frek
cái-vặn-vít: dres
bông-cải-xanh: blok
preterite: xrit
vitamin: tyem
cadmium: kyem
máy-bay-ném bom: bwoc
đồ-họa: gjik
titan: dyim
làm-oai: clec
lambda: lwem
bạn-gái: pcem
giao-cấu: kyuk
đồng-hồ-cát: tlus
đồng-cảm: mlif
bằng-tố: bres
máy-bay-lên thẳng: cwet
tên-chất-hóa học: tlum
hạn-chót: jyic
căn-chỉnh: gwic
centimet: hfem
molypden: mlom
lithium: tfim
đa-phương-tiện: myum
cập-nhật: dyet
nhiệt-lượng: clom
người-máy: ryoc
bài-tập-về nhà: groc
đối-số: grom
con-bọ-ngựa: gzas
lắp-đặt: nwut
amin: myoc
glyph: glif
thì-QUÁ-KHỨ: pyos
sinh-thái-học: plec
pha-rượu: flok
cần-sa: bjam
vi: mrom
kg: lwom
ăn-nhiều-quá: jrot
dự-đoán-được: dzik
bánh-pizza: zyas
rình: zris
ngôn-ngữ-học: bwis
cắt-tóc: braf
iridium: ryom
kỳ-thị-chủng tộc: gwim
tối-ưu: gyim
công-nghiệp-hóa: drif
trụ-sở-chính: krup
kim-thuộc-làm măm sông đèn: zrim
thích-đáng: nrum
bộ-phận-ngữ trường hợp: pxik
băng-cassette: ksep
ý-chí: blot
không-gian: dzen
tham-số: rwet
đồng-bộ-hóa: nrop
tối-đa-hóa: dzim
Hội-thảo: mwec
sàn-nhảy: dyok
neon: nyok
chất-mể: hzom
hiển-linh: hp6n
ăn-cắp-của người khác làm của mình: lyap
tạo-tác: rwek
lò-phản-ứng: fyet
rau-oregano: ryop
plutonium: pwum
hóa-yt-tri: tyom
chử-dùng-thêm ý: hxat
tên-truy-nhập: mrum
sau-đại-học: zrot
cánh-phải: dwaf
chất-a-gon: jros
ám-ảnh: hxot
xã-hội-hóa: sluk
toàn-cầu-hóa: bluc
bước-sóng: hnef
mã-hóa: kfom
tái-chế: psoc
khởi-động-lại: nrek
viêm-gan: pyes
hình-xuyến: fros
hóa-trị: myep
modulo: mwok
proton: zwot
đĩa: dwet
một-phần-ngàn gờ ram: mlum
điểm-ảnh: psep
tantali: twem
tan: hjot
diệt-chủng: nyos
động-vật-ăn thịt: rwes
hóa-ga-li: glem
zirconi: hzum
determiner: txin
phi-tuyến: nlem
thuốc-trừ-sâu: pyif
bé-ryl: brem
nơron: nrus
nhận-chắc: pxit
quần-lót: tlif
giai-thừa: kref
neutron: zrut
chất-ni-op: nwom
hóa-géc-man: hjem
á-kim: tlop
đặt-trên: dlap
prolative-trường-hợp: hl6k
đa-dạng-sinh học: jwic
cần-điều-khiển: jyok
kháng-sinh: twok
ac-tin-chất phát quang tuyến: gjim
phi-hành-gia: srof
ngoài-trái-đất: tyes
crackpot: hwup
marathon: mrof
ytterbium: zwim
tự-kỷ: tyif
ion-hóa: nlof
radon: cwos
nerium: nrem
dịch-tễ-học: pwip
tuổi-già: lyuc
cắm-trại: kyep
sọc: drip
indium: nyum
đích-thật: hvik
trang-mạng: bwes
kinh-Koran: kwek
flatware: fwet
thứ-n--root: tfec
lawrenci: lyem
quyền-công-dân: glip
điện-thoại-di động: mlof
tê-liệt: twoc
protactini: prum
sự-bức-xạ: hd6n
tùy-theo-trên: pxin
chất-hóa-học nguyên tử: hxim
Quần-jean-xanh: bjun
cây-nhà: hxas
cá-nhân: dvit
dòng-chảy-hiện tại: lwuk
ba-điểm: ht6t
cơ-thể-con người: hn6n
vật-lí: bzik
bán-lẻ-cửa hàng: hxan
hóa-chất-cê ci: hs6m
Dài-cách-đây: hqan
bảng-tính: hxet
đơn-vị-của khối lượng: hn6m
biên-soạn: ml6n
nhị-phân-có giá trị: vrim
Nhân-loại-được: nyus
qua-phương-tiện của: hvan
depan-dari: pxat
praseodymium: pyom
các-tông: kxat
có-hạn-động từ: hqik
thử-nghiệm-con số: hr6n
pro-kết-án: hr6t
nhà-phê-bình: hk6k
bao-bì: pxas
vô-thường: pxan
tại-phần-lớn: txas
mô-tả: drop
neodymium: nyem
hữu-nghị: hvit
đọc-chỉ-có: xyak
sáng-lập: xwan
châm-ngôn-tâm trạng: kxin
đơn-âm: hxom
tính-hợp-lý: xlit
âm-vị-học: xlin
ăn-uống-phòng: hxac
sống-phòng: hxic
trung-tâm-trường hợp: zrik
thuộc-về-ngày nay trước: hx6n
bệnh-nhân-trường hợp: hqak
xiên-trường-hợp: bwok
nông-thôn-khu vực: hqat
recurse: hr6s
ở-giữa-giọng nói: dyos
meitneri: hm6m
ngươi-đưa-thư: hvak
không-hứa-hẹn: kxit
chứng-khoán-thị trường: xrak
nhận-biết: hxap
mục-tiêu-cò súng: krof
một-giây: hxen
lative-trường-hợp: dvak
khẩu-phần: hr6c
không-Nhân-loại: hg6n
sống-Điều: hvic
quá-ít: hxut
rạp-chiếu-phim: hvin
Hassi: xyim
attenuative: ty6t
multal-con-số: ml6m
milky-đường: txam
neptuni: nwem
người-viết-mướn: txik
xuyên-số: ts6s
đánh-lừa-xung quanh: hqun
americium: myem
buổi-sáng-quang vinh: txan
cứu-hỏa: xran
berkeli: blem
Thiên-hà-tính: kxan
nobeli: blum
tạm-biệt: hvac
Phật-giáo: hfum
fermium: frem
cyan: xyan
đậu-nành: syof
nhà-phân-phối: qrit
strikebreaker: txak
vi-xử-lý: ples
abessive-trường-hợp: bvak
adessive-trường-hợp: dvik
đến-trường-hợp: kxak
agentive-trường-hợp: dvek
rutherfordi: hr6m
kháng-thể: txip
như-nhiều-như: hjos
đại-lý-cò súng: hg6t
diễn-viên-vai trò: xram
ethidium: txim
chung-tính: hk6n
accompanier: kl6n
rum: kxam
franxi: fyam
hóa-ec-bi: ry6m
thụ-động-giọng nói: xyis
astatine: hqit
sự-nhai-kẹo cao su: hqam
ngôi-sao-tính: hqin
trích-dẫn-hình thức: ht6m
Curi: jrim
truyện-tranh: kxis
mù-màu: hqon
euler's---số: hl6m
nhìn-tại: kxas
crosswalk: pwok
chiến-trường: txat
người-lái-xe hơi: vrit
ngắn-mạch: txok
bằng-lời-nói danh từ: hvis
khóc-ngoài: hk6t
thống-kê: xyit
sữa-chua: txot
xenon: hs6n
thôi-miên: hxif
lấy-tắt: hxaf
khoản-đuôi: hxok
Chỉ-đường-vật: dwot
tạp-hóa-cửa hàng: kxun
gồm-có-của: hm6t
ergative-trường-hợp: gvik
trong-ngôn-ngữ: txic
đầu-tay: pxam
trường-sở-cách trường hợp: hqok
Hồ-bơi: slup
thuộc-về-trạng từ trường hợp: vlak
ngắm-cảnh: hqas
tivi-bộ: ht6s
cuối-cùng-hạt: xlik
evitative-trường-hợp: hvek
sự-phục-hồi: xlat
hồi-quy: xris
khối-của-căn hộ: kxot
thức-lên: hxup
cảnh-sát-nhân viên văn phòng: ps6s
thề--in: vran
Người-phỏng-vấn: qrat
rheni: ryem
aerosol: xres
trường-hợp-chiếm hửu trường hợp: kxik
nominalization: mlec
chiếm-hữu-trường hợp: dzak
sự-bán-giá quá cao: pxak
phụ-tá-động từ: xyik
tiểu-học-vật: mlut
virus-máy-tính: prus
doanh-nhân: hqis
một-những-người: hqen
antessive-trường-hợp: ts6k
thủ-tướng: pxis
Lutetium: lyum
europium: rwum
biểu-hiện-cảm xúc: xrot
dân-ca: zyik
thi-sĩ: vwit
Bưu-điện: pxot
giả-định: hvas
động-tính: hven
subessive-trường-hợp: bvik
chân-ga: glep
tính-phân-cực: pr6t
xe-cộ-tính: vlin
khoáng-chất-tính: xrin
verb--hậu-tố: hvif
đam-mê: pc6n
samari: sr6m
facilitator: hs6t
tưởng-tượng-đơn vị: xyin
tốc-độ-ánh sáng: kxac
không-quân: hxes
đồng-cảm-vui sướng: pfec
trọng-điểm: qyit
toàn-thời-gian: hxem
hóa-hạp-ni: xyam
ức-chế: hn6s
thay-đổi-của biến cố: qrin
holmium: xlim
khác-nhau-biến cố: hf6t
vũ-trụ-tính: hvip
địa-bàn-tính: kxen
ảo-máy-móc: hvim
nghiên-cứu-tính: txen
nghệ-thuật-tính: ts6n
crastinal-căng: sl6t
trừu-tượng-tính: srep
exocentric-trường-hợp: zrek
tha-động-từ: txif
hình-vị: tfom
người-yêu-nước: dvis
quá-khứ-hoàn bị: xrat
nghề: hy6n
gián-tiếp-phát biểu: tyoc
thứ-hai-ngôn ngữ: draf
đến-được: txis
nghĩa-địa-sự thay đổi: vrak
tập-hợp-danh từ: hxos
absolutive-trường-hợp: bvuk
bệnh-nhân-cò súng: tr6t
tự-sự-tự tin: hs6s
phân: hzos
phản-xạ-giọng nói: hf6s
nhân-hóa-động từ: hxek
seaborgi: br6m
không-gian-trắng: hxep
phương-thức-trường hợp: dlok
vô-hồn-tính: hj6n
chỉ-nguyên-nhân: qran
propositive-tâm-trạng: psom
điện-hiện-hành: tr6n
kết-hợp-trường hợp: nwok
tối-thượng-trường hợp: tluk
quá-nhiều: xyut
hành-tinh-tính: pxen
hoạt-hình-hoạt hình: nwuk
đối-ứng-giọng nói: vrik
lập-pháp: hqaf
tại-ít-nhất: vlas
ngữ-pháp-hợp: qrak
người-dùng: pxut
cốt-lõi-benefactive: kfef
thủ-môn: hgop
:-except-for: kcef
mẫu-số: dvan
else-if: lyek
ngang: hx6s
lẫn-nhau: dles
kế-tiếp-điều khoản: lyuk
mặc---ra: hxun
quần-short: ht6k
dysprosium: prom
Sớm-Tương-lai căng: rwec
si-các-đơn vị: vyin
tên-một-chất khí: kxon
mendelevi: dlem
applicative-giọng-nói: hp6s
antipassive-giọng-nói: tsef
vừa-liên-tục diện mạo: ht6p
bức-xạ-bệnh: hr6k
necessitative-tâm-trạng: hn6t
Độc-thân-hoạt động động từ: hqek
Railcar: xlak
tối-thượng-trình độ: tlup
hiện-sinh-điều khoản: hs6k
californi: kf6n
hiện-tại-phân từ: vrat
chói-lọi-cường độ: hc6t
singulative-con-số: slus
ngữ-pháp,-đối tượng: hy6t
thụ-động-phân từ: vris
quá-đáng-thời gian: kxic
siêu---chất lỏng: sr6t
lượng-của-vật chất: ks6t
postpositional-trường-hợp: pxok
không-bắt-buộc lượng hóa: lwif
gadolinium: dl6n
tháp-tự-hình vị: hp6m
dùng-để-phủ định lượng hóa: nwif
Einsteinium: ny6n
nhân-tạo-ngôn ngữ: txac
liên-kết-hạt: qrik
xa-Tương-lai căng: twec
liên-diển-diện mạo: hfep
phân-phối-đại danh từ: bvin
đoạn-văn-đồng ý: hk6m
hói: blos
vùng-ngoại-ô: syum
thế-giới-lượng hóa: vlit
máy-vi-tính lập trình: mr6m
tivi-chương-trình: tr6m
floating--point--số: hvun
hiện-sinh-lượng hóa: tl6t
các-ngày-sau Ngày mai: dwek
thay-thế-lượng hóa: lw6t
nóng-tính: hdup
quá-khứ-thụ động phân từ: hp6t
các-ngày-trước hôm qua: txet
trường-sở-cách hướng trường hợp: tc6k
đối-chứng-có điều kiện: ht6c
