bất-định-cách: ni
được-bổ-nhiệm trường hợp: na
đối-cách-trường hợp: ka
chủ-đề-trường hợp: ta
chào-bạn: ca
tánh-cách-trường hợp: sa
tính-từ: ci
và: wa
tôi: mi
bạn: ya
chúng-tôi: nlah
nó: yi
nơi-đến-trường hợp: ti
quyền-giám-hộ trường hợp: pa
Nội-địa-bối cảnh: tu
một-người-bối cảnh: pi
phụ-thuộc-điều khoản: yu
hoàn-bị-diện mạo: fa
quá-khứ-căng: ki
đàn-ông-tính: si
comitative-trường-hợp: mwih
hiện-tại-căng: ma
benefactive-trường-hợp: pwah
essive-trường-hợp: swih
không: nu
nó-là: tsih
bề-mặt-bối cảnh: su
adpositional-trường-hợp: pu
vị-trí-trường hợp: te
không-gian-bối cảnh: no
đường-trường-hợp: ra
instrumental-trường-hợp: se
nghi-vấn-tâm trạng: ri
và-hoặc-là: to
độc-quyền-hoặc: ku
nguồn-trường-hợp: so
văn-biểu-la tinh trường hợp: lwah
chỉ-thị: di
nhưng: la
giống-cái-tính: ne
số-nhiều-con số: lu
Tương-lai-căng: we
xã-hội-bối cảnh: mo
không-trọn-vẹn diện mạo: me
chỗ-đó: klah
có-điều-kiện tâm trạng: co
hơn: kcoh
họ-hàng-trường hợp: nwih
kết-thúc-trường hợp: lwih
chỉ-thị-khí sắc: de
deontic-tâm-trạng: da
câu-hỏi-lời: slah
liên-hiệp-tiếp từ: ksah
một-người: psoh
khác: tcoh
con-số: do
rất: tcah
thời-gian: trah
thời-gian-bối cảnh: ro
thời-gian-trường hợp: mrah
trong-khoảng: ke
tri-thức-tâm trạng: pe
chỉ: twuh
sau-đó: pcah
có-ý-khuyến khích khí sắc: twah
quá-khứ-diện mạo: rwih
volitive-tâm-trạng: li
trước: tceh
sau: ba
có-thể-sang chiếm hữu: lyih
không-thể-cho chiếm hữu: nlih
có-quyền-thảo luận tâm trạng: drih
perlative-trường-hợp: pwih
cấp-tiến-diện mạo: psih
chỗ-này: tcih
Dưới-bối-cảnh: ce
delative-trường-hợp: dwih
semelfactive-diện-mạo: mweh
tân: nyoh
chú-trọng: fo
thân-ái: pyah
paucal-con-số: ploh
bởi-vì: yo
nguyên-nhân-trường hợp: ksih
tên-gọi: gi
đúng-danh-từ: tsah
có-ý-khuyến khích: re
có-thể-nhìn thấy chứng cớ: crih
desiderative-tâm-trạng: dwah
terminative-trường-hợp: twih
inessive-trường-hợp: nweh
bắt-buộc-tâm trạng: prih
tin: kcah
tiểu-bang-bối cảnh: ga
mong-ước: cwah
factive-chứng-cớ: fwih
nguyện-vọng-pháp tâm trạng: pcih
realis-tâm-trạng: le
tiềm-năng-tâm trạng: tlah
allative-trường-hợp: lweh
anthropic-tính: fi
bộ-môn: wo
giống-nhau-đối tượng đánh dấu: cyah
khác-nhau-đối tượng: fe
nỗi-sợ: ko
nghi-ngờ: cu
dubitative-tâm-trạng: tweh
làm-quan-tâm, thích thú: nyih
vialis-trường-hợp: wi
lạ: trih
sự-thay-đổi: ryih
sung-sướng: clah
ngoại-trừ: swah
khao-khát: kwah
chiều-dài: lo
xác-suất: bi
đồng-ý: grah
rắc-rối: mlah
quotative-trường-hợp: kwih
bao-hàm-một người: lwoh
precative-tâm-trạng: rwah
lịch-sự-ghi danh: brih
tiềm-năng-diện mạo: tfah
châm-ngôn-diện mạo: go
mở-đầu-diện mạo: zi
JUSSIVE-tâm-trạng: jwih
cho-phép-tâm trạng: mwah
đúng: kcih
xa-chỉ-thị: tseh
phân-phối-trường hợp: nwah
xác-định: treh
đau: droh
khôn-ngoan: ja
trường-hợp-chiếm hửu đánh dấu: srah
commissive-tâm-trạng: mu
bất-ngờ: crah
để-bổ-xung diện mạo: kweh
Sự-phẫn-nộ: nrah
niềm-tự-hào: brah
lấy-làm-tiếc: pceh
lòng-can-đảm: krah
vẻ-duyên-dáng: nreh
sự-vận-động: mroh
nóng-lòng: cwih
đình-chỉ-diện mạo: za
khuếch: tfih
chứng-cớ-trường hợp: ryah
buồn: syah
nếu-không-thì: tyah
zoic-tính: zo
eventive-tâm-trạng: nwoh
giống-nhau-biến cố đánh dấu: cwoh
nhân-giống-trường hợp: plah
ngạc-nhiên: prah
lòng-thương-hại: lyah
khối-lượng: mlih
hài-lòng: srih
Đức: be
đầu-cơ-tâm trạng: po
quen-ghi-danh: krih
bị-thương: frah
nỗi-buồn: proh
eh?: nyah
cảm-tạ: kyah
xấu-hổ: ru
cụm-từ-đánh dấu: fyah
Trung-thành: cyih
hứng-thú: tyeh
hesternal-căng: tleh
chán-ghét: tyih
hợp-lý-tính: tlih
cực: kreh
thực-vật-tính: slih
sự-tò-mò: kyih
sợ-hãi: kcuh
bài-báo: myah
lể-giáng-phước khí sắc: bwih
phạm-tội: dlih
dốt: nrih
hào-phóng: drah
sáng-kiến-trường hợp: twoh
bị-hoãn-bắt buộc: ji
báo-cáo-chứng cớ: psah
khiển-trách: dlah
đau-khổ: kfah
số-ít-con số: gu
tha-thứ: pfah
kiên-nhẫn: je
tham-chiếu: freh
cô-độc: kyoh
quyến-rũ: croh
hăng-hái: tsuh
dòng-cảm-điện khí sắc: tcuh
đàm-luận-bối cảnh: ye
hô-cách-trường hợp: bo
sự-khinh-thường: grih
khuyên-bảo-tâm trạng: tyuh
Hoài-bão: bwah
liên-tiếp-diện mạo: nyeh
Chỉ-đường-chứng cớ: troh
nhát-gan-tâm trạng: pcoh
sốc: cruh
mới-đây-quá khứ căng: clih
xác-định-bài báo: klih
ghen-tuông: ryuh
trù-rủa-tâm trạng: mrih
thờ-ơ: du
kiêu-căng-tâm trạng: syih
chấn-thương: kroh
màn-đầu-của vở kịch: rwoh
thù-nghịch: cyuh
tài-bắt-chước: mreh
cụ-thể-là: gwih
thuộc-về-ngày nay căng: dloh
delimitative-diện-mạo: dweh
độc-quyền-một người: kwuh
telic-diện-mạo: tfeh
atelic-diện-mạo: tsoh
cấm-tâm-trạng: jrih
tra-tấn: nroh
lòng-trung-thành: nloh
momentane-diện-mạo: myeh
sự-tha-thứ: jrah
khiêm-tốn-ghi danh: myih
trước-đây-người chết: frih
Trích-dẫn: wu
điều-khó-chịu: zrah
thường-lệ-diện mạo: bu
theo-sau: kseh
siêng-năng: dyih
chính-thức-ghi danh: sreh
thính-giác-chứng cớ: creh
kết-hợp: ksoh
suy-luận-chứng cớ: flih
lời-nguyền: sleh
Sublative-trường-hợp: swoh
khai-báo-tâm trạng: ksuh
bằng-lời-nói: kceh
khẳng-định-tâm trạng: fwah
không-bằng-lòng: dyah
idiophone: dyoh
quá-đáng-trường hợp: zwah
irrealis-tâm-trạng: ze
nhút-nhát: cyoh
thích-ứng: pyih
đại-danh-từ đánh dấu: ryeh
áp-bức: zroh
bình-thản: jyah
pegative-trường-hợp: pweh
prosecutive-trường-hợp: pwuh
sự-lo-lắng: byah
phân-từ: pfih
xa-quá-khứ căng: dzah
lịch-sử-căng: sroh
thần-kinh-loạn: syeh
hai-con-số: dluh
cảm-chứng-cớ tâm trạng: xi
vận-động-khó khăn: ryoh
quá-khứ: txih
vận-động-xuống dốc: myoh
biến-cách: blih
superessive-trường-hợp: psuh
tha: t6
sự-thất-bại: xrah
vận-động-thượng nguồn: truh
vận-động-phía hạ lưu: txah
phân-ly: xo
anticlimax: tloh
hiện-tại-liên quan đánh dấu: xa
từ-viết-tắt: qi
initialism: nl6h
động-từ-tiến hành cách: ge
preterite: preh
thì-QUÁ-KHỨ: broh
bộ-phận-ngữ trường hợp: pxih
hiển-linh: pf6h
chử-dùng-thêm ý: xe
ám-ảnh: xyoh
determiner: txeh
nhận-chắc: plih
prolative-trường-hợp: pxah
đích-thật: vyih
nhị-phân-có giá trị: vrih
có-hạn-động từ: vi
thử-nghiệm-con số: pc6h
pro-kết-án: r6
hữu-nghị: va
châm-ngôn-tâm trạng: kxih
trung-tâm-trường hợp: dreh
thuộc-về-ngày nay trước: x6
bệnh-nhân-trường hợp: qa
xiên-trường-hợp: bwoh
ở-giữa-giọng nói: tyoh
nhận-biết: xyah
mục-tiêu-cò súng: groh
lative-trường-hợp: dvah
không-Nhân-loại: n6
attenuative: nyuh
multal-con-số: mloh
xuyên-số: ts6h
Thiên-hà-tính: gjah
tạm-biệt: jwah
abessive-trường-hợp: bvah
adessive-trường-hợp: dvih
đến-trường-hợp: kxah
agentive-trường-hợp: dveh
đại-lý-cò súng: greh
diễn-viên-vai trò: nruh
chung-tính: k6
accompanier: kloh
thụ-động-giọng nói: pyoh
ngôi-sao-tính: qrah
trích-dẫn-hình thức: xu
bằng-lời-nói danh từ: xlih
khoản-đuôi: kluh
Chỉ-đường-vật: rweh
ergative-trường-hợp: gvih
trong-ngôn-ngữ: byih
trường-sở-cách trường hợp: kwoh
thuộc-về-trạng từ trường hợp: vlah
cuối-cùng-hạt: nluh
evitative-trường-hợp: ve
trường-hợp-chiếm hửu trường hợp: kfih
nominalization: mleh
chiếm-hữu-trường hợp: djah
phụ-tá-động từ: fyih
tiểu-học-vật: myuh
antessive-trường-hợp: nleh
động-tính: xrih
subessive-trường-hợp: bvih
xe-cộ-tính: vlih
khoáng-chất-tính: xwih
verb--hậu-tố: kxeh
đồng-cảm-vui sướng: pfeh
thay-đổi-của biến cố: qrih
khác-nhau-biến cố: txoh
vũ-trụ-tính: bjih
địa-bàn-tính: lyeh
nghiên-cứu-tính: txuh
nghệ-thuật-tính: s6
crastinal-căng: sl6h
trừu-tượng-tính: sruh
exocentric-trường-hợp: zrih
tha-động-từ: tfoh
quá-khứ-hoàn bị: tr6h
gián-tiếp-phát biểu: dyeh
thứ-hai-ngôn ngữ: sr6h
tập-hợp-danh từ: kxoh
absolutive-trường-hợp: bvuh
bệnh-nhân-cò súng: pruh
tự-sự-tự tin: swuh
phản-xạ-giọng nói: flah
nhân-hóa-động từ: pseh
phương-thức-trường hợp: dleh
vô-hồn-tính: djih
chỉ-nguyên-nhân: kruh
propositive-tâm-trạng: pxoh
điện-hiện-hành: breh
kết-hợp-trường hợp: sloh
tối-thượng-trường hợp: sluh
hành-tinh-tính: pxeh
đối-ứng-giọng nói: syoh
cốt-lõi-benefactive: kfeh
else-if: kyeh
kế-tiếp-điều khoản: lyoh
Sớm-Tương-lai căng: rwuh
applicative-giọng-nói: pyuh
antipassive-giọng-nói: ps6h
vừa-liên-tục diện mạo: tfuh
necessitative-tâm-trạng: nr6h
Độc-thân-hoạt động động từ: qyah
tối-thượng-trình độ: tluh
hiện-sinh-điều khoản: sy6h
hiện-tại-phân từ: vrah
chói-lọi-cường độ: kyuh
singulative-con-số: glih
thụ-động-phân từ: pfoh
quá-đáng-thời gian: kxuh
lượng-của-vật chất: m6
postpositional-trường-hợp: pwoh
không-bắt-buộc lượng hóa: vwih
tháp-tự-hình vị: p6
dùng-để-phủ định lượng hóa: gwah
liên-kết-hạt: qyih
xa-Tương-lai căng: tl6h
liên-diển-diện mạo: f6
phân-phối-đại danh từ: bzih
đoạn-văn-đồng ý: ks6h
thế-giới-lượng hóa: xlah
floating--point--số: fu
hiện-sinh-lượng hóa: sweh
thay-thế-lượng hóa: l6
quá-khứ-thụ động phân từ: xyih
trường-sở-cách hướng trường hợp: kfoh
đối-chứng-có điều kiện: fyoh
