bất-định-cách: vô-hạn, vô-cực
được-bổ-nhiệm trường hợp: 
đối-cách-trường hợp: 
chủ-đề-trường hợp: đối-tượng-trường hợp
Cha-mẹ: của-cha-mẹ, chính, cao-cấp
cha: cha
mẹ: mẹ, mẹ, thuộc-về-mẹ
chào-bạn: tạm-biệt, Chào, ê
tổ-tiên: người-tiền-nhiệm, ông-ngoại
ông-bà: ông-ngoại, bà-ngoại
đói: đói, chết-đói
tánh-cách-trường hợp: trường-hợp-chiếm hửu trường hợp
tính-từ: 
và: tổng-số, qua
tôi: bản-thân-mình, tôi, của-tôi, chúng-tôi
bạn: họ, ngươi, mầy
chúng-tôi: chúng-tôi, của-chúng-ta, của-chúng-tôi
nó: anh-ta, cái-kia, bà-ấy, cái-này, những
nơi-đến-trường hợp: khách-quan-trường hợp
quyền-giám-hộ trường hợp: 
Nội-địa-bối cảnh: 
một-người-bối cảnh: 
phụ-thuộc-điều khoản: 
hoàn-bị-diện mạo: 
quá-khứ-căng: 
đàn-ông-tính: thiến-tính
comitative-trường-hợp: 
hiện-tại-căng: 
benefactive-trường-hợp: 
essive-trường-hợp: 
không: Không, không, hầu-như-không, không-thể, không, sân-cỏ
nó-là: của-họ, của-anh-ấy, cô-ấy, anh-ta, những, của-cô-ấy, của
bề-mặt-bối cảnh: 
adpositional-trường-hợp: 
vị-trí-trường hợp: 
không-gian-bối cảnh: 
đường-trường-hợp: 
instrumental-trường-hợp: 
cái-nào: ai, như, có, bất-kì, cũng-không, cái-kia, ai, đó---đó, cái-gì, tất-cả, bất-cứ
nghi-vấn-tâm trạng: 
và-hoặc-là: 
độc-quyền-hoặc: 
nguồn-trường-hợp: 
văn-biểu-la tinh trường hợp: 
chỉ-thị: chắc, trọng-yếu, bê-tông, vửng-chắc, chỉ-thị, kịch
nhưng: chưa, Tuy-nhiên
toàn-bộ: mọi-người, mọi-người, toàn-bộ, toàn-thể, tổng-thể, toàn-thể, mọi-thứ, bất-kì, lên
giống-cái-tính: 
họ: họ, bà-ấy, những, của-họ, họ, họ, những
số-nhiều-con số: 
một: Độc-thân, một, trong, một-mình
Tương-lai-căng: 
xã-hội-bối cảnh: 
Khi-nào: bất-cứ-khi nào
không-trọn-vẹn diện mạo: 
chỗ-đó: 
có-điều-kiện tâm trạng: thuộc-về-tiếp tục pháp tâm trạng, giả-tâm-trạng
hơn: hơn, phần-lớn, hơn-nữa, ngoài, trở-lên, trở-lên, đa, hơn, hơn, cũng-thế, hơn-thế-nữa, cộng, còn, chưa, khác, một-số, nhiều
ngoài: ngoài-kia, ngoài, ngoài, ngoài-trời, ngoài-trời, tắt, bên-ngoài-của, ngoài, lên, trên, lên
họ-hàng-trường hợp: họ-hàng-trường hợp
kết-thúc-trường hợp: 
làm: chế-tạo, thực-hiện, đảm-đương, trả-lại, hoạt-động, đã-làm, cam-kết
chỉ-thị-khí sắc: chỉ-thị-tâm trạng
deontic-tâm-trạng: 
câu-hỏi-lời: 
liên-hiệp-tiếp từ: kết-nối, phiếu, xăn-lên
một-người: Đàn-ông, người, cá-nhân, có-ai, một-ai-đó, anh-chàng, con-người, khuôn-mặt, miệng, thực-thể
Nam: đàn-ông, đề-cập, quý-ông, Đàn-ông
có-thể: có-thể, có-thể, có-thể, có-lẽ
khác: khác, còn-lại, thứ-hai, cái-khác, khác, một-khác
con-số: lượng, tổng-số, con-số, bằng-số, số, số-lượng
rất: rất-nhiều, cực-kì, ghê-sợ, nhiều, cũng, khủng-khiếp, rộng-rãi, cao, thực-sự, xấu, rất-lớn, đáng-kể, rất-nhiều, đa, to-lớn, phần-lớn, khá, khá,-tương-đối, xa, khá, được, đuợc, được-rồi
thời-gian: trong-khi, chốc-lát, trong-suốt, kịp-thời, thời-gian, thời-gian, căng, thời-gian-biểu, giai-đoạn, thời-tiết
thời-gian-bối cảnh: 
thời-gian-trường hợp: 
trong-khoảng: về, liên-quan-đến, Gần, circa, của, qua, hơn, vòng-quanh, vì, người-dùng, khiếu-nại, trên
tri-thức-tâm trạng: 
chỉ: chỉ, chỉ, đơn-giản, chỉ, chỉ, thuần, hạn-chế
ít: nhỏ, bé-nhỏ, nhẹ, hơi, một-chút, nhỏ, nhỏ-mọn, nhỏ-xíu, di-động, rất-ít
sau-đó: lại-một-lần nữa, lại, ya, từ, cách-đây, một-lát-sau, sau-đó
có-ý-khuyến khích khí sắc: 
quá-khứ-diện mạo: 
thật-tuyệt: lớn, to-lớn, cao-quý, nghiêm-chỉnh, rộng-lớn, lớn, to-lớn, khổng-lồ, rất-lớn, có-ưu-thế, tốt, khỏe, đáng-kể, khổng-lồ, trọng-yếu, quá-tuyệt-vời, Xuất-sắc, tối-ưu, lớn, chính, hoàn-hảo, đáng-chú-ý, rực-rỡ
volitive-tâm-trạng: 
trước: trước, trước, cách-đây, đứng-trước, cho-tới-khi, mặt-trước, trước-kia, chống-lại
cần: Nên, thiết, không-cần-thiết, phải, cần, phải, phải, muốn, đến
số-hai: hai, cả-hai
nhìn-thấy: nhìn, góc-nhìn, thị-giác, nhận-thấy, nhận-thức, đồng-hồ-đeo tay
biết: xác-định, biết, dạy, lá-cờ, có-thể-nhìn thấy
xuống: đi-xuống, đi-xuống, ở-dưới, dưới, ở-dưới, bên-dưới, ít-hơn, đáy, dưới, tầng-dưới
sau: phía-sau, trên, bài, kích-thước, một-lát-sau, sau-đó, về-sau, tiếp-theo, quá-khứ, ở-dưới, bên-dưới
Thứ-nhất: khởi-đầu, lúc-đầu, từ, trở-đi, nắm-tay
của-bản-thân: mình, bản-thân-bạn, có, cá-nhân, của-anh-ấy, bản-thân, tự
có-thể-sang chiếm hữu: 
không-bao-giờ: bao-giờ
không-thể-cho chiếm hữu: 
cũ: đã-qua-sử dụng, xưa, già, người-già, trước-đây, ex, nghiệm, lứa-tuổi
có-quyền-thảo luận tâm trạng: 
ngày: hằng-ngày, hôm-nay, tối-nay
Ở-đâu: bất-cứ-nơi nào, theo-đó, nơi
đến: đến, đến, đến, đến, trở-nên, thời-trang, xảy-ra
đường: phương-pháp, phương-pháp-học, phương-tiện, con-đường, tuyến-đường, đường, đường-mòn, đường-mòn, cách-thức, đường, đường, đường, đường-ray, quỹ-đạo, thói-quen
công-việc: nghề-nghiệp, phân-công, hoạt-động, công-việc, lao-động, lao-động, nghề-nghiệp, chức-năng, chạy, chức-năng, kinh-doanh, hành-động, tập-thể-dục, việc-làm, nghề-nghiệp, làm-việc, tác-phẩm-nghệ thuật
nguyên-âm: nổi-danh, cuộc-sống, Sự-sống-còn
đi: đi-bộ, giá, khởi-hành
perlative-trường-hợp: 
cấp-tiến-diện mạo: 
Dài: kéo-dài, bền-chặt, cao, dọc-theo
nói-rằng: văn-nói, nói, nói
làm-cách-nào: cũng-giống-như, như, hơn
cũng: cũng-thế, một-trong-hai, cho-tới-khi, hơn-thế-nữa, cũng
trở-lại: phía-sau, phía-sau, ngược, lạc-hậu, trở-về, lại, khôi-phục, hủy-bỏ, lại-một-lần nữa, lặp-lại, cách-đây, theo-như
chỗ-này: 
nghĩ: đang-nghĩ, nghĩ, xem-xét, tưởng-tượng, nhận-thức, suy-nghĩ, sẽ, gọi, lí-trí
cùng-một: giống-hệt-nhau, giống, bằng, tương-đương, đúng, được, được-rồi, mình, như-nhau, tương-tự
Cuối-cùng: chấm-dứt, cuối, cuối-cùng, cuối-cùng, cái-khác, khác, muộn-nhất, mới-đây, cuối, quá-khứ, các-quá-khứ, chịu-được, chịu-được, đặt, kiên-gan
cách-xa: xa, xa-xôi, tắt, cách-nhau, đứng-cách-xa, rời, rời-bỏ, vắng-mặt
Dưới-bối-cảnh: 
cầm-lấy: khu-nghỉ-mát, chiếm, lấy, nhận-nuôi, vồ-lấy, nhận-được, nhận, nhặt, bắt, bắt, Chấp-nhận, có-được, tính-phí
tìm-thấy: Tìm-thấy, khám-phá, khám-phá, khám-phá, truy-cập
tay: cánh-tay, cổ-tay
trẻ: thanh-Xuân, em, thanh-niên, thiếu-niên, mới-mẻ
Tuy-nhiên: mặc-dù, Tuy-nhiên, đã-sửa, chắc-chắn, chắc, kiên-quyết, mặc-dù, Tuy-nhiên, một-ai-đó
biếu-tặng: cho-mượn, cung-cấp, phục-vụ, cung-cấp, giao-hàng, trả-lại, đủ-khả-năng, đặt, tặng, để-cho
thần: 
delative-trường-hợp: 
chẳng-có-gì: một-cái-gì đó, vật, không-một-ai, bất-cứ-điều gì, không-ai, không-ai
bên-phải: đôi, chính-xác, chính-xác, công-bằng, Sự-công-bằng, hợp-lý, bất-công, đủ-điều-kiện, quyền, luật-pháp, đúng, thật, nhất-định, chắc-chắn-rồi, cho-phép, giếng
một-khi: ngay-tức-thì, nhanh-chóng, phương-pháp, họa-tiết, phương-pháp-học, lại-một-lần nữa
semelfactive-diện-mạo: 
phần: mục, một-phần, phần, từng-phần, Bưu-kiện, phần, chia-sẻ, một-chút, cái, đoạn-văn, tập-hợp-con, chương, phòng-ban, tập-phim, từng-phần, phân-công, khu-vực, khu-vực, tỷ-lệ, thay-mặt
cái-cưa: 
Nhà: nhà, cơ-sở, chùa, nhà-ở, Hộ-gia-đình
thế-giới: vương-quốc, toàn-cầu, vũ-trụ
cái-đầu: tiêu-đề, chính, chánh, chương, lãnh-đạo, chủ-tịch, Chủ-tịch, giám-đốc, ông-chủ, cao-cấp, cây-bút
số-ba: thứ-ba
tân: mới-mẻ, mới
chú-trọng: dụng-ý, mục-tiêu, khung-thành, mục-tiêu, tập-trung, chú-ý, nồng-độ, giọng, tập-trung
thân-ái: tình-cảm, từ-thiện, cũng-giống-như
luôn-luôn: mãi-mãi, liên-tục, bao-giờ, bình-thường
đêm: buổi-tối, bữa-tối, PM.
mỗi: mỗi, tất-cả, bất-kì
Vua: thống-trị, Chúa-tể, vua, ông-trùm
giữa: trong, giữa, của
hình-trái-tim: cổ-vũ, đáng-khích-lệ, té
paucal-con-số: 
bởi-vì: vì, từ, trường-hợp, gây-nên
nguyên-nhân-trường hợp: 
Điều: chất, việc, hiện-tượng, chuyện, cái-gì
bộ: nhóm, đặt, giữ, nằm-xuống, dán, bộ-sưu-tập, sự-kết-hợp, mảng, bộ, đóng-hàng, danh-mục-đầu tư, tổng-hợp, bên-nhau, loạt, xoay, phạm-vi, hàng, chuỗi, bộ-dụng-cụ, văn-thể
tên-gọi: họ, danh-từ
đúng-danh-từ: 
có-ý-khuyến khích: có-ý
đất-nước: Quốc-gia, đất, trái-đất, tiểu-bang, mặt-bằng, quận, đất, buổi-tiệc
hỏi: 
có-thể-nhìn thấy chứng cớ: 
tốt-hơn: cấp-trên, tốt, Xuất-sắc, lý-tưởng, nổi-bật
bên: ở-bên, ủng-hộ, ủng-hộ, thay-mặt, xoay, trang, diện-mạo, một-nửa, mặt-nhỏ
khóa-học: chương-trình-giảng dạy, bài-học, bài-giảng, chắc-chắn, chắc-chắn, chắc-chắn, tỷ-lệ
nữ: quý-bà, giống-cái, giống-cái, phụ-nữ, con-gái, người-vợ
đủ: đầy-đủ, đủ, đầy-đủ, phong-phú, khá,-tương-đối, nhiều, không-đủ, khá, khá
Sớm: một-thời-gian ngắn, nhanh-chóng, nhanh-chóng, Mau, nhanh-chóng, trực-tiếp, nhanh, vội, khẩn-cấp, cho-nên, ngay-tức-thì, dễ-dàng, lân-cận, sớm, đong-tach
đầy: đầy-đủ, đủ, tuyệt-đối, hoàn-chỉnh, không-hoàn-hảo, toàn-thể, chính-xác, chính-xác, utter, đúng, uyên-thâm, toàn-thể, toàn-diện, kích-cỡ
căn-phòng: phòng, thứ-tư, phòng-ngủ, hòa-bình
gần: Gần, thiết-thực, khoảng, circa, gần, vòng-quanh, chặt-chẽ, liền-kề, hầu-như, lân-cận, một-thời-gian ngắn, gần, khoảng, hầu-như-không
không-thể: không-thể
nước: chất-lỏng, chất-lỏng, đầu-nguồn
desiderative-tâm-trạng: 
nhẹ: phát-sáng, sáng, cây-nến, nhẹ, Phong-cách, nhẹ-nhàng, ôn-hòa, cái-bật-lửa, tái-nhợt, rõ-ràng
cũng-không: cũng-không, không, chưa, cái-gì, xảy-ra, hoặc-là
lời: từ-nguyên-học
cánh-cửa: cái-cổng, cửa, cổng-vào, chương, cảng
sử-dụng: sử-dụng, sử-dụng, sự-tiêu-thụ, chi-tiêu, người-tiêu-thụ, thuê, đơn-xin, hữu-ích, nộp-đơn, thuê
buổi-sáng: sáng, bữa-ăn-sáng
terminative-trường-hợp: 
năng-lượng: sức-mạnh, năng-lượng, có-thể, khỏe-mạnh, lực-lượng, quyền-lực, năng-động, rau-xà-lách, ưu-thế, chính-quyền
mình: mình, bản-thân-bạn, mình, bản-thân-mình, mình, bản-thân, tự, bản-ngã, chương
hiện-nay: hiện-tại, các-hiện-tại, bây-giờ, hiện-hành, quà-tặng, hiện-hữu, có-thể-dùng được, có sẵn
giọng-nói: âm-thanh, đọc-lớn-tiếng, phiếu, âm-thanh, biểu-quyết, mặt-hàng, lời-đồn, lời-đồn
màu-trắng: chỗ-trống, lời-phàn-nàn
tiền-bạc: sự-giàu-có, bạc, tài-chính, tiền-mặt, tiền-tệ, tài-chánh, tiền-tệ
bên-cạnh: bên-cạnh, bên-cạnh, bên-cạnh, tiếp-theo, một-lát-sau, kích-thước, trở-đi, tiếp-theo
nghèo-nàn: cánh-tay, nghèo-nàn, tồi-tệ, tệ-nhất, hư, yếu-ớt
cái-chết: số-tử-vong, qua-đời, chết
mẫu-đơn: hình-thù, khuôn, định-dạng, đường-viền, họa-tiết
inessive-trường-hợp: 
Hiền-hậu: lớp, loại, loài, đa-dạng, kiểu, thân-thiện, mặt-hàng, tốt, thú-vị, làm-hài-lòng, thú-vị
thường: thường-xuyên, liên-tục, thường-xuyên, Thường-xuyên, thường, thường, thường
năm: hàng-năm, hàng-năm, năm
bạn-bè: đồng-minh, bạn-trai, bạn-bè, người-bạn-đời
gọi-món: hệ-thống, sắp-xếp, sắp-xếp, hợp-đồng, mảng, chỉ-huy, xoay, hàng, sắp-hàng
bắt-buộc-tâm trạng: 
tròn: làm-tròn, hình-tròn, vạt-áo
tin: sự-tin-tưởng, tính, tự-phụ, lòng-tin, niềm-tin, lòng-tin, chắc-chắn, lạc-quan, lạc-quan
công-cộng: các-công-cộng, chung, khán-giả
tiểu-bang-bối cảnh: 
Con-trai: leo-lên-cây, con-trai
một-trăm: thứ-một-trăm, khuôn-mặt, phần-trăm
bọn-trẻ: con-nít, con-cái, trẻ-em, bé-con
như-vậy: bằng-cách-ấy, cho-nên, vì-thế, như-thế, Vâng
mong-ước: mong-ước, tương-lai, biết-trước, lạc-quan, lạc-quan
phía-trên: lên, hơn, lên-lầu, cao, đỉnh, tiên-tiến, phía-trên, ngang-qua, liên-quan-đến, qua, trên, trên-không, lên, ở-phía-trước, trở-lên
kính-thưa: người-tình, mắc-tiền
đọc: đọc-hiểu, hát, cây-huệ
thành-thị: thành-phố, thành-phố, quận
rồi: sẳn-sàng, chuẩn-bị, sẵn-lòng, dù-sao
sự-thật: sự-thật, thực-tế, tính-trung-thực, thật, có-thật, thực-tế, quả-thật, thực-sự, thật, đã-làm
factive-chứng-cớ: 
Nghe: nghe, thính-giác, cảm
ít-nhất: tối-thiểu, tối-thiểu, giảm-thiểu, dấu-trừ, ít-hơn
có-lẽ: có-lẽ, có-lẽ, đoán-chừng, có-thể, có-thể, có-thể-được, rất-có-thể, chắc-chắn
mở-ra: rõ-ràng, trơn, thông-suốt, trần, chắc-chắn, trống, minh-bạch, rõ-ràng, ngoài-trời, hụt, tái-nhợt, mở, vạch-trần
cơ-thể-người: thịt, cơ-thể, thể-chất, thể-chất, văn-thể, đàn-organ, tử-thi
hàng-không: gió, gió, hàng-không, thời-tiết, đường-hàng-không
bản-chất: tự-nhiên, tự-nhiên, một-cách-tự nhiên, có-nguồn-gốc, hạ-xuống, bản-địa, động-vật-hoang dã, nhân-vật
cứu-giúp: hỗ-trợ, Hữu-ích, viện-trợ, hỗ-trợ, phụ-tá, nằm-xuống
lá-thư: email, văn-bản
bốn: thứ-tư
nguyện-vọng-pháp tâm trạng: thuộc-về-tiếp tục pháp tâm trạng
lửa: nóng, ngọn-lửa, cảm-sốt
vì-thế: vì-thế
giờ: đồng-hồ, giờ, chuông
miễn-phí: quyền-tự-do, quyền-tự-chủ, miễn, không-lấy-tiền, hư-không, tự-do, trống, lãng-mạng, giải-phóng
chiến-tranh: trận-đánh, cuộc-tranh-đấu
cho-dù: nếu, bản-thân
lý-do: gây-nên, tài-khoản, hệ-số, phải-chăng, tha, lý-do, Lan-tràn, nguyên-cáo
hiệp: số-ít, thống-nhất, bao-hàm, công-đoàn, đồng-minh, đồng-minh, độc-nhất, nhất-trí
gọi-điện: thách, oxy-hóa, Kháng-cáo, trên, sự-liên-kết, sự-kết-hợp, chung, dung-hợp, lời-mời
tại-sao: 
đi-lạc: sự-mất, mất-tích
một-ngàn: thứ-một-ngàn
gia-đình: Hộ-gia-đình, người-sống-sót
Linh-hồn: thần-linh, con-ma, chủ-mưu
câu-hỏi: vấn-đề, nhu-cầu, đọc-hiểu, chất
chăm-sóc: liên-quan, liên-quan, chú-ý, thiền, dịch-vụ, tài-trợ, bảo-vệ, sự-an-toàn, sự-bảo-vệ, an-ninh, sự-bảo-tồn, bảo-tồn, bảo-hiểm, phòng-thủ, chú-ý, chữa, điều-trị, canh-giữ
realis-tâm-trạng: 
có-nghĩa: nghĩa-là, ý-nghĩa, Ý-nghĩa, đầy-ý-nghĩa, chứng-tỏ, ở-giữa, đại-lý, Trung-bình, Trung-bình-cộng, vừa-phải
tiềm-năng-tâm trạng: 
về-phía: về-phía, chống-lại, phản-đối, phản-đối, mỗi, kính-trọng, vì
allative-trường-hợp: 
anthropic-tính: 
ngắn: ít-hơn, thấp, ngắn-gọn, một-thời-gian ngắn, một-thời-gian ngắn, Thẻ, hẹp, nhẹ
khả-năng: có-thể, có-đủ-năng lực, đủ-điều-kiện, có-khả-năng, sức-chứa, khả-năng, không-có-khả năng, có-thẩm-quyền, tiềm-năng, khả-năng, khả-năng, khỏe-mạnh, quyền-lực, khéo, Tháng-Năm
sống: cuộc-sống, sống-sót, hành-xử, sống, lồng, huyện, khu-vực-lân cận, khu-vực-lân cận, còn-sống, sống, sống, cư-trú-tại
bộ-môn: kỷ-luật, chủ-đề, chủ-đề, bài-học, vật-chất, vấn-đề, vật, Ý-nghĩa, chất-liệu, ngữ-nghĩa, chất, việc, tiêu-đề
giống-nhau-đối tượng đánh dấu: 
khác-nhau-đối tượng: 
bài-giải: Bắc, trả-lời, phản-ứng, biện-pháp, trao-đổi-thư tín, đáp-ứng
biển: đại-dương, ở-biển
nỗi-sợ: kinh-sợ, sợ, khủng-bố, kinh-sợ, sợ-hãi, hoảng-loạn, lo-ngại, angst, kinh-dị, khủng-khiếp
hiểu-rõ: hiểu-biết, sự-hiểu, nhận-thức, sự-hiểu-biết, nhận-thức, khó-hiểu, bao-gồm, nhận-ra
chăm-chỉ: khó, cứng, phức-tạp, thô, lớn, dữ-dội, dữ-tợn, khó-khăn, khắt-khe, thách-thức, khôn-lanh, nặng, phần-mộ, nghiêm-khắc, khó-chịu
các-điều-khoản: kỳ-hạn, thuật-ngữ, vấn-đề, dựa, lý-do, căn-cứ, chủ-yếu, cơ-bản, về-cơ-bản
nghi-ngờ: sự-nghi-ngờ, không-tin-tưởng, nghi-ngờ
dubitative-tâm-trạng: 
hỏi: nguyện-cầu, yêu-cầu, nghe, làm-ơn
cánh-tay: vũ-khí, giải-giới, vũ-trang, cánh-tay
màu-đen: 
mang-lại: lấy, Mang, sẽ, chì
đẹp: tốt, tốt-đẹp, xinh-xắn, đẹp, tốt-đẹp, khá, tưởng-tượng, mát, dễ-thương
bóng-tối: bóng-tối
cầm: giữ, duy-trì, bắt, nắm-chặt, hợp-đồng, kết-luận, thắt-nút, thập-kỷ, nhốt, chờ-đợi, cũng-giống-như, chịu-được
mười: thập-kỷ, thứ-mười, công-bằng
hiển-thị: trưng-bày, thực-hiện, buổi-biểu-diễn, cuộc-biểu-tình, sự-trình-bày, biểu-thị, chứng-tỏ, biến-cố, chiếu
câu-chuyện: chuyện-thần-thoại, lịch-sử, viễn-tưởng, Thửa
chung: chung, bình-thường, thói-quen, thông-thường, bình-thường, bất-thường, thường, khiêm-tốn, bình-thường, không-thường-xuyên, thông-thường, điển-hình, thường, thường, chung, bạn-đồng-hành, kết-hợp, tập-hợp, tổng-thể, lẫn-nhau, đoàn-thể
sách: cuộn-giấy, dự-trữ, pao, sách-giáo-khoa
điện-tử: hàng-điện-tử, điện-tử, sấm-chớp, điện, điện, điện
nói-chuyện: cuộc-hội-thoại, trò-chuyện, đàm-phán, sự-tương-tác, tương-tác, đàm-phán, nói, bài-diễn-văn, văn-nói, đàm-luận
chấm-điểm: đánh-dấu, dấu-vết, đường-mòn, ghi-bàn, Điểm-nổi-bật, đánh-dấu, biển-báo, dấu-hiệu, dấu-hiệu, cây-cơ-bida, nhãn-hiệu, nhân-vật, nhãn
làm-quan-tâm, thích thú: hoa, quan-tâm, liên-quan
viết: soạn-nhạc, văn-bản, kiểu, bằng-văn-bản
giường-ngủ: 
cần-thiết: Cần-thiết, quan-trọng, bổ-ích, chỉ-trích, quan-trọng, quan-trọng, không-quan-trọng, tích-phân, quyết-định, Quan-trọng, cần, thiết, tự-động-từ, tự-động-từ, tự-động-từ
ý-kiến: nghĩ, sự-xem-xét, lý-luận, ý-kiến, khái-niệm, động-não
môn-vẽ: nghề, nghệ-thuật
vialis-trường-hợp: 
anh-em: anh-chị-em ruột, chị-gái
thỉnh-thoảng: hiếm-khi, thỉnh-thoảng, thỉnh-thoảng
dòng: dây-điện, sợi-chỉ, hàng, đường-nhỏ, sự-dẫn, dấu-gạch-ngang, sọc, thuế-suất, kịch-bản
bàn: bàn, lịch-trình, mục-lục
con-sông: cái-gối, gối, tuôn-ra
mắt: bổ-nhiệm, vòng-quanh
thông-tin: lời-nhắn, giải-thích, miêu-tả, thông-tin, hiểu-biết, dữ-liệu
bỗng-nhiên: đột-ngột
lạ: kỳ-lạ, thật-ngạc-nhiên, kỳ-quặc, số-lẻ, ngạc-nhiên, quá-tuyệt-vời, đáng-chú-ý, phi-thường, không-thể-tin được, kinh-ngạc, kỳ-quái, buồn-cười, người-lạ, kỳ-lạ, vụng-về
sâu: sâu, chiều-sâu, rộng, cạn, uyên-thâm, chi-tiết, toàn-diện, phê-bình, sâu, ở-trong, bên-trong, trong-nhà, sâu
sự-thay-đổi: sự-sửa-đổi, sự-biến-đổi, sự-biến-đổi, biến-đổi, sự-biến-đổi, sự-thay-đổi, thay-đổi, tu-chính, quá-trình-chuyển đổi, sửa-đổi, thay-thế
cảm-giác: cảm, cảm-giác, sự-nhận-thức, ấn-tượng, xúc-động, khí-sắc, ấn-tượng, đa-cảm, cảm, Tâm-lý, ý-nghĩa, niềm-đam-mê, có-ý-thức, ý-thức
gặp: nhận-được, tập-trung, gặp-gỡ, tuân-theo, làm-vui-lòng, buổi-họp
mục-đích: vật, mục-tiêu, mục-tiêu, khung-thành, nơi-đến, mục-đích, dụng-ý, động-cơ, Mục-tiêu
sung-sướng: người-vui-vẻ, lừa-quân-địch, Hân-hạnh, vui-vẻ, sự-vui-mừng, sự-hạnh-phúc, vui-mừng, vui-mừng, niềm-vui, hạnh-phúc, may-mắn, vừa-lòng
dường-như: Dáng-vẻ-bên ngoài, hiện-ra, rõ-ràng
máu: chảy-máu, hình-sự
bông-hồng: màu-hồng
hướng-Nam: Nam-Bộ, buổi-trưa, giữa-trưa
lạnh: mùa-đông, mát, lạnh-lùng
phía-trước: hơn-nữa, xa-hơn, ở-phía-trước, thị-giác, mặt-trước, tiên-tiến, cách-đây, con-dơi, lên, trở-đi
vị-trí: vị-trí, tình-huống, tình-trạng, cơ-hội, cơ-hội, khoảng-trống, lập-trường, tư-thế, nơi, bài, mặt-hàng
trễ,-muộn: chậm-lại, chấm-dứt
đứng: ga-tàu, theo-chiều-dọc, thái-độ, lập-trường, dừng-lại, tư-thế, đặt-ra, gian-hàng
giả-sử: giả-định, giả-thuyết, giả-sử, nhận-nuôi, tự-phụ, giả-định, đề-nghị
con-gái: con-gái, gái-trinh
mìn: của-tôi
cắt-tỉa: thiếu-sót, thiếu-xót, giảm, thiếu-sót, giảm-bớt, sự-thiếu, Hoa-hậu, cắt, làm-gián-đoạn, chặt, chém, trồng-trọt, tỉa, bị-gãy, xâm-phạm
bản-sao: tái-sản-xuất, nhân-rộng, tái-tạo, phiên-mã, photocopy, bản-sao, phiên-bản, toa-thuốc
chồng: Đàn-ông, vợ-hoặc-chồng
sáu: tình-dục
ghi-nhớ: chú-ý, hồi-tưởng, nhắc-lại, học-thuộc-lòng
hiệu-quả: gây-ảnh-hưởng, có-ảnh-hưởng đến, ấn-tượng, va-chạm, ưu-thế, hiệu-quả, hiệu-quả, hiệu-quả, hậu-quả, kết-quả, Phơi-bày
gục-ngã: mùa-thu, trường-hợp, nằm, tai-nạn, tình-trạng-lộn xộn, phá-vỡ, phá-dỡ, rơi-vãi, suy-giảm, giảm-bớt
ngoại-trừ: trừ-khi, ngoài-kia, bên-ngoài-của, ngoài---từ, cách-nhau, chưa-bao-gồm, bên-cạnh, qua-một-bên, ngoài-ra
tóc: 
thông-qua: qua, xuyên-qua, đi-ngang-qua, qua, gần, bên-cạnh, gồm-có, tốt-nghiệp, rỉ-sét, băng-qua, đoạn-văn, tiến-hành
bản-quyền: 
quân-đội: quân-đội, quân-đội, chủ-nhà, lính
chạy: trốn, cống, chạy-bộ, thi-hành, chạy, lái-xe, chảy-nước-mũi, Hộp-số
con-ngựa: móng-ngựa, tại
Tương-lai: các-Tương-lai, một-lát-sau, về-sau, sau-đó
hướng-Tây: tây
trả: tiền-lương, tiền-lương, tiền-lương, đẩy, thanh-toán, tặng-thưởng, học-phí, giá-tiền
đỏ: 
vàng: 
khao-khát: ý, háo-hức, thèm-ăn, mong-ước, khao-khát, thúc-giục
chơi: khiêu-vũ, cờ-bạc, trò-chơi, gò-má, đồ-chơi
bậc-thầy: Chúa-tể, sơ-cấp, chính, giáo-sư, thống-trị, quản-lý, Ông, quý-ông, hàng-đầu, quí-ông
văn-phòng: cơ-quan, bàn
chính-phủ: tiểu-bang, hàng
nhà-thờ: 
chiều-dài: chiều-cao, độ-cao, nhịp-cầu, dọc-theo, thời-gian
Công-ty: chắc-chắn, công-ty, xã-hội, kinh-doanh, đoàn-thể, thực-thể, tổ-chức, cơ-quan, tổ-chức, mạo-hiểm
giấy: tấm, Thẻ, hiến-chương
xác-suất: khả-năng, khả-năng, rất-có-thể, có-thể, không-chắc, tương-lai, cơ-hội
đặc-biệt: đặc-biệt, đặc-biệt, đặc-biệt, đặc-biệt, cụ-thể, chính-xác, phần-lớn, đa-phần, chủ-yếu, đặc-biệt
chịu: Mang, chịu-được, chịu-được, sự-kiêng-cử, lòng-khoan-dung, có, có, đủ-khả-năng
cửa-sổ: 
đồng-ý: giao-thức, giải-quyết, sự-thỏa-hiệp, sự-đồng-thuận, Hiệp-ước, đồng-ý, giao-dịch, phù-hợp, mềm, dây-nhau, hợp-đồng, hội-nghị, sắp-xếp
nét-đẹp: đẹp, sáng-chói, thẩm-mỹ
nhiệm-vụ: trách-nhiệm, trách-nhiệm, nghĩa-vụ, chịu-trách-nhiệm, Hải-quan, công-việc, phân-công, món-nợ, nợ, phải
gửi-đi: chuyển-giao, nộp-hồ-sơ, bài, phát-sóng, e-mail
khoảng-cách: loại-bỏ, phạm-vi, khoảng-cách
khoảng-lặng: sự-yên-lặng
bàn-chân: Chân, tạm-dừng-lại, bắp-vế, ngón-chân, phần-tư, đi-bộ, đang-đi
hoang-dã: wildly, bất-hợp-pháp, dữ-tợn, động-vật-hoang dã
chết: chết, qua-đời
lưu-giữ: tiết-kiệm, sự-bảo-tồn, bình-phục, bảo-tồn, bảo-tồn, học-thuộc-lòng, cửa-hàng, chuộc-lại, giải-thoát, ghi-lại
màu-xanh-lá: sống, thô
rắc-rối: làm-phiền, vấn-đề, vấn-đề, khó-nhọc, khó-khăn, nhào, đau-khổ
nụ-cười: nụ-cười
sai: sai-lầm, lỗi, lầm, xấu, đối-xử-tàn tệ, sai, lỗi, thất-bại, lỗ-hổng, sai, điều-lầm-lỗi
khác-nhau: khác, thay-đổi, nhiều, phạm-vi, khác-nhau, đa, không-giống, biến-thể, khác-nhau, khác-nhau, đa-dạng
ngủ: ngủ, mơ-tưởng
quotative-trường-hợp: 
bắt-đầu: bắt-đầu, bắt-đầu, đảm-đương, vết-trầy, tấn-công, sớm, lúc-đầu, bắt-đầu, khởi-đầu, nguyên-tắc
hoạt-động: công-việc, chỉ, bước-đi, sân-khấu, hành-động, phương-pháp, hoạt-động, hoạt-động, hoạt-động, hoạt-động, hoạt-động, di-chuyển, luyện-tập, luyện-tập, chạy, chứng-khoán, tập-hợp, chấp-hành, thi-hành
Thăm-quan: quyền, phỏng-vấn, truy-cập, du-lịch, chuyến-đi, hành-trình, chuyến-du-lịch
theo: tuân-thủ, tham-gia, tiếp-theo, theo-đuổi, đường-ray, hộ-tống
cố-gắng: thử, cố-gắng, sự-cố-gắng, sáng-kiến, làm-thí-nghiệm, kiểm-tra, hàng-mẫu
sự-có-mặt: đời, hiện-hữu, thực-thể, tài-sản
ngọt: Cục-kẹo, dịu-dàng, dịu-dàng, dễ-thương
giàu-có: nhiều, phong-phú, giàu-có
kẻ-thù: 
con-tàu: con-thuyền, buồm, hạm-đội, bơi-thuyền, tàu, hành-trình, phà
điều-kiện: cá-cược, cá-cược, tiểu-bang, tình-huống, tình-huống, tình-trạng, vận-may, sân-khấu, cấp-độ, thể-dục, yêu-cầu
kể-ra: chứa, bao-gồm, liên-quan-đến, thuộc-về
bao-hàm-một người: 
bí-mật: thần-bí, huyền-bí, ghim, bí-mật, tiết
precative-tâm-trạng: 
lịch-sự-ghi danh: 
quỷ-quái: Làm-hại, bẩn-thỉu, luẩn-quẩn, tồi-tệ, xấu
tháng-Ba: phô-trương, phản-đối, cuộc-biểu-tình, Hỏa-Tinh
bất-cứ-điều gì: bất-cứ-điều gì, bất-cứ
ở-lại: còn-lại, ngồi, giải-quyết, sống-sót, cư-trú-tại, chờ-đợi
thay-cho: thay-vì, hơn, sự-thay-thế, thay-thế
màu-xanh-da trời: bà-tiên
bất-khả-thi: 
ngôi-trường: khuôn-viên, thang
dịp: cơ-hội, biến-cố, xảy-ra, cơ-hội, đại-lộ, mặc-cả
có-gia-đình: hôn-nhân, kết-hôn, kết-hôn
món-ăn: bữa-ăn, chế-độ-ăn kiêng, món-ăn, nuôi, chất-bổ-dưỡng
hai-mươi: 
trầm-tính: trấn-tĩnh, yên-tịnh, ổn-định, im-lặng, Hòa-Bình, chậm, thư-giãn, nhẹ-nhàng
Dễ-dàng: rất-có-thể, dễ-dàng, chịu-trách-nhiệm, dễ-dàng, tiện, nhẹ, hơi, nhẹ-nhàng, thuận-tiện, minh-bạch
tiềm-năng-diện mạo: 
ngôn-ngữ: ngôn-ngữ-học, cái-lưỡi
biểu-hiện: bày-tỏ, bản-tường-trình, cụm-từ, rõ, sự-tiết-lộ, Phơi-bày, sự-bày-tỏ
tuần: chủ-nhật
hội-trường: cổng, nhà-hát, hành-lang, khoảng-trống, phòng, phòng-khách, phòng-chờ, gian-hàng, người-chạy, hành-lang
nguy-hiểm: nguy-hiểm, nguy-cơ, kính-trọng, mối-đe-dọa
bất-động-sản: tài-sản, thuộc-về, quyền-sở-hữu, chế-độ-quân chủ, chiếm-hữu, tính-năng, đặc-điểm, tài-sản, vận-may, sự-giàu-có
chào-đời: Sinh
tòa-án: tư-pháp, món-ăn, diễn-đàn, dùng-thử
nói-chung: bình-thường, thường, chung, tổng-thể, rộng-rãi, thông-thường, thường, thường, mở-rộng
châm-ngôn-diện mạo: 
giá-trị: xứng-đáng, giá-trị, quý-báu, giá-trị, công-đức
đơn-giản: sự-đơn-giản, minh-bạch, thuận-tiện, linh-hoạt, dễ-dàng, chỉ, đơn-giản, trơn, khiêm-tốn, chỉ, chỉ, thẳng, bình-thường
cây: cây, gỗ, thân-cây, gỗ
chiến-đấu,-đấu tranh: cuộc-tranh-đấu, trận-đánh, đối-đầu, cuộc-tranh-cãi, chen-lấn,-xô đẩy
Tường: 
trời: bầu-trời
mở-đầu-diện mạo: 
JUSSIVE-tâm-trạng: 
giai-điệu: sân-cỏ, giai-điệu, tấn, tấn, Bóng
Về-vấn-đề: kính-trọng, giả-sử, tự-phụ, chú-ý, sự-xem-xét, xem-xét, quan-hệ, sự-kết-hợp, mối-quan-hệ, liên-quan-đến, về, chú-ý, bảo-hiểm
kỳ-vọng: dự-đoán
tháng: mặt-trăng
Trải-qua: kinh-nghiệm, kinh-nghiệm, có-kinh-nghiệm, thẩm-định, sự-hăng-hái, làm-thí-nghiệm
trọn-vẹn: hoàn-toàn, hoàn-toàn, đầy-đủ, hoàn-toàn, khá, hoàn-toàn, chắc-chắn-rồi, tuyệt-đối, toàn-thể, triệt-để, khá,-tương-đối, thuần, chính-xác
tươi: tươi, nguyên-chất, lau-sạch, làm-mới, mới-mẻ, chú-tiểu
công-tước: cái-thước, Hoàng-tử
phủ: bao-gồm, bảo-hiểm, tắt, đóng, trong-nhà
giới-hạn: mức-độ, sự-hạn-chế, giới-hạn, biên-giới, sự-hạn-chế, hạn-chế, liên-hệ, phụ-thuộc, buộc
hướng-Đông: phương-Đông, cách-đây, Trước, trước, trước, phương-đông
Cục-đá: đá-cẩm-thạch, Cục-đá, ngọc
hơi: một-cái-gì đó, bất-cứ-điều gì, một-số, khá, hơn, hơi, từng-phần, bằng-cách-nào đó
chiều-hướng: sự-định-hướng, kích-thước, khuynh-hướng, mặt-nhỏ, chỉ-dẫn
chiếc-ghế: chỗ-ngồi, Ghế, ghế-đẩu
hỗ-trợ: chịu-được, thừa-nhận, hỗ-trợ, hỗ-trợ, dấu-ngoặc, viện-trợ
hẹn-hò: lịch-sử, gặp-gỡ
làng: làng-nhỏ, nông-thôn
cánh-đồng: khu-vực, vương-quốc, khu, lãnh-thổ, diện-tích, vùng, khu-vực, tên-miền, đấu-trường, sân-vận-động, khoảng-trống, lề, nông-thôn, cắm-trại
sự-cho-phép: cho-phép, tai, giấy-phép, giải-tỏa, rời-bỏ, giấy-phép, giấy-phép, bằng-lòng, phiên-bản
cho-phép-tâm trạng: 
sự-thành-công: thành-công, thành-công, sự-phồn-thịnh, thành-tích, chiến-thắng, thắng-cuộc, đánh, chiến-thắng, người-chiến-thắng
đúng: đúng-mực, chính-xác, hợp-lí, thích-hợp, chính-xác, tóm-lược, quyền, chính-xác, đúng, nhanh-chóng, trung-thành, đúng, đúng, đúng, Phù-hợp, phù-hợp, thuận-tiện, phù-hợp, trao-đổi-thư tín, đủ-điều-kiện, thích-hợp, hoàn-hảo, đầy-đủ, thường-xuyên
đồi: núi, núi
Âm-nhạc: âm-nhạc
xa-chỉ-thị: 
buổi-chiều: PM., buổi-trưa, giữa-trưa, buổi-tối
khóc: thương-tiếc, kêu-la, hét-lên
danh-dự: danh-dự, kính-trọng, nhân-phẩm, đáng-kính, đáng-kính-trọng, danh-dự, lịch-sự, quang-vinh, tỷ-lệ, giá
bảy: 
riêng-tư: cá-nhân, tự, cá-nhân, tự, đặc-biệt, riêng-tư, đặc-biệt, độc-quyền
Tin-tức: lời-nhắn
bối-cảnh: nơi, thị-giác, bối-cảnh, trưng-bày, trực-quan, sân-khấu, góc-nhìn, tương-lai, lều
vườn: công-viên
cuộc-đua: chủng-tộc, cuộc-đua, chạy-bộ, Cuộc-thi, giải-đấu, mềm, giống, phù-hợp
phân-phối-trường hợp: 
học: học, dạy
chính-trị: chính-trị, chính-trị, chính-trị-gia, chính-sách
nói-dối: sai
đúc: quăn, ném, quăng-ra, quăng, định-dạng, khuôn, phóng, rụng, bỏ
ăn: bữa-ăn, nuôi, món-ăn, ăn-cơm-trưa, sự-tiêu-thụ
mặt-sàn: tấm-thảm, mặt-bằng, đáy, đất, đi-bộ, cao, cao
bệnh: bệnh, bệnh-nhân, nhức-nhối, bệnh, sai, xấu
nguyên: có-nguồn-gốc, ban-đầu, sơ-bộ, lúc-đầu, tổng-hợp, ban-đầu, tự-nhiên, chính-hãng, thiên-phú, bản-địa, chính, sơ-cấp, nguyên-mẫu
mùa-hè: hâm-nóng
tôn-giáo: Tôn-giáo, món-nợ
bức-ảnh: Chân-dung, bức-tranh, hình-ảnh, ảnh-chụp, nhiếp-ảnh, nhiếp-ảnh, hình-chụp, photocopy, bản-vẽ, đong-tach, phim-ảnh, hình-minh-họa, vai, sung, con-số
bỏ-trốn: trốn
tác-giả: nhà-văn, giáo-viên, Biên-tập-viên
nâu: màu-xám, màu-xám, màu-da-bị sạm nắng, huy-chương-đồng
xác-định: sự-quyết-tâm, quyết-định, xác-định, xác-định, quả-quyết, nhà-thiết-kế, xác-định, xác-định, ổn-định, nhất-định
đau: đau, đau-khổ, đau-đớn, sự-đau-khổ, nhức-nhối
mùa-xuân: lông-chim, của-chúng-ta, của-chúng-tôi
thế-kỷ: lứa-tuổi
dịu-dàng: đồng-nhượng-quyền, mịn-màng, tinh, mềm, dịu-dàng, nhẹ-nhàng, dịu-dàng, dịu-dàng, ôn-hòa
góc: góc, cái-nêm, chết-chìm
sản-xuất: sản-xuất, phát-ra, sản-xuất, chế-tạo, chế-tạo, chế-tạo
cười: đùa
quên: bỏ-qua
Châu-Âu: 
tám: thứ-tám
bộ-váy: trang-phục, quần-áo, áo-choàng, y-phục, mặc-quần-áo, bộ-đồng-phục, quần-áo
khủng-khiếp: kinh-khủng, kinh-khủng, khủng-khiếp, khủng-khiếp, rất-lớn, bi-thảm, đáng-báo-động, khủng-khiếp, quái-dị, ghê-sợ
hơi-thở: hô-hấp, thở, sự-thở, xông-lên, bản-ngã, giựt-mình
khôn-ngoan: hợp-lí, hợp-lý, kín-đáo, chu-đáo, thông-minh, thông-minh, thông-minh
trường-hợp-chiếm hửu đánh dấu: 
ký-ức: học-thuộc-lòng, tài-liệu-tham khảo, đài-kỷ-niệm
hiện-đại: đồng-thời, tinh-vi, hiện-đại-hóa, hợp-thời-trang, mới-đây, đàm-luận
nơi: chỉ, chấm, giờ, vị-trí, vết-bẩn, khuyết-điểm, vá, nơi, hư-không, cơ-sở, quỹ-tích, nơi, địa-phương, xác-định-vị trí, biển-báo, mặt-bằng
nổi-lên: cây, leo, lợn-nái, leo-lên, lên, bảng, dap-xe, sự-nhướng, nảy-sinh, nâng-cao, sự-xuất-hiện, lớn-lên
gãy: cuộc-đột-nhập, phanh, khu-nghỉ-mát, phòng-chờ, gián-đoạn, khoảng-thời-gian, lỗ-hổng, Smash, làm-tiêu-tan, dừng-lại, tạm-dừng, làm-gián-đoạn
năm-mươi: 
Đảo: 
chạm: Liên-hệ
lời-hứa: cam-kết, cam-kết, lời-hứa, cuộc-hẹn
commissive-tâm-trạng: 
bằng: bằng, mức-độ, cấp, chất-lượng
kế-hoạch: kế-hoạch, giao-dịch, chương-trình, chương-trình, sáng-kiến, kế-hoạch, đề-nghị, dự-án, Thửa, phác-họa, chiếu, bố-cục, bằng-phẳng, bản-vẽ, thiết-kế
hạnh-kiểm: khuynh-hướng, cư-xử, cư-xử, hành-vi
bất-ngờ: kinh-ngạc, bất-ngờ, bất-ngờ, thật-ngạc-nhiên
phút: 
bắn: bắn, chụp, đạn, đạn-dược, ảnh-chụp, hình-chụp, thổi, tiếng-nổ, đảo-chính, ném, khung
tệ-hơn: tồi-tệ, tệ-nhất, cộc-cằn, bất-lợi, xấu, khủng-khiếp, dưới, lên, lên-lầu
ly: gương, pha-lê, bình, kính-mắt, kính-mắt
trường-hợp: thí-dụ, hình-minh-họa, kiểu-mẫu, họa-tiết, ẩn-dụ, nguyên-mẫu, như, đại-diện, mẫu, trường-hợp, tiền-lệ, hàng-mẫu, mô, Ví-dụ-như
an-toàn: bảo-mật, sự-an-toàn, an-ninh, an-toàn, chắc-chắn, bảo-hiểm
Bác-sĩ: bác-sĩ, trị-liệu, học-viên, Y-khoa
để-bổ-xung diện mạo: 
lặp-đi-lặp lại: thường-xuyên, bình-thường, hằng-số, liên-tục, thỉnh-thoảng, Thường-xuyên, thường-xuyên, lặp-lại
quân-sự: quân-đội, chiến-đấu
nóng: nóng, dự-bị, hâm-nóng, hơi-nóng, nhiệt-độ, sưởi, gram, oi-bức
uống: đồ-uống
câu-hỏi: 
Sự-phẫn-nộ: tức-giận, cơn-thịnh-nộ, xúc-phạm, kích-thích, Mặc-dù
trực-tiếp: thẳng, Chỉ-đường, Không-trực-tiếp, tự-động, minh-bạch, trực-tiếp
cái-mũ: mũ-lưỡi-trai, nón-bảo-hộ
chó: 
đầy-tớ: người-quản-lý, người-hầu-bàn, hầu-gái
niềm-tự-hào: kiêu-căng, hãnh-diện, tự-hào
đám-đông: gấp-rút, Đông, bao-vây, lượng, số-lượng, dân-số, chủ-nhà, chồng-chất
huấn-luyện: chuyên-chở, xe-hơi, toa-xe, xe-đẩy, đường-sắt, đường-sắt, giáo-dục
luân-lý: đạo-đức, đạo-đức, đạo-đức, đạo-đức-học, tinh-thần, tinh-thần
liên-quan: kết-hợp, liên-quan, tương-quan, có-liên-quan, liên-quan, liên-quan, thích-hợp, dọc-theo, liên-hệ, quan-hệ, đồng-minh
vào: khúc-gỗ, lối-vào, tiểu-bang, biểu-thị, chèn, bao-gồm
qui-định: quản-lý, quyền-thống-trị, chế-độ, phán-xét, phán-quyết, phán-xét, trọng-tài, trọng-tài, quản-lý, luật-pháp, pháp-luật, qui-tắc
Gươm: lưỡi
tấn-công: cuộc-xâm-lược, xâm-chiếm, xâm-lược, xúc-phạm, tấn-công, xúc-phạm, tấn-công, tấn-công, phản-cảm
Sức-khỏe: khỏe-mạnh, chào
đoạn: thơ, điều-khoản, đoạn, chỉ, thái-độ, lập-trường
xã-hội: xã-hội, xã-hội
hoàn-tiền: trả-lời, đáp-ứng, trở-về
lấy-làm-tiếc: hối-hận, cực, sự-tha-thứ, tha, lời-xin-lỗi
lòng-can-đảm: nhổ, Dũng-cảm, chắc-chắn, thần-kinh, nghị-lực, dám
vẻ-duyên-dáng: ủng-hộ, ủng-hộ, nhân-từ, lòng-tốt, lòng-nhân-từ, thay-mặt, sự-tha-thứ
chính-thức: chính-thức, chính-thức, chính-thức, nhân-viên-văn phòng, nhân-viên-bán hàng
cung-cấp: cung-cấp, phục-vụ, cung-cấp, sự-giới-thiệu, có-thể-dùng được, có sẵn, cung-cấp, cung-cấp, cung-cấp, nếu
yêu-cầu: cầu-nguyện, nhu-cầu, yêu-cầu, yêu-cầu, yêu-cầu, điều-tra--u003e Investigation, điều-tra--u003e Investigation, nhanh-chóng, thầu, đơn-xin
nhìn-thoáng-qua: nhìn-thoáng-qua, góc-nhìn, thái-độ, sự-nhận-thức, triển-vọng, thị-giác, nhìn
sự-vận-động: vận-động, chiến-dịch, thể-thao, cuộc-vận-động, hành-động, di-chuyển, di-động, kinh-doanh, động
chờ-đợi: hy-vọng, dự-đoán, biết-trước, chờ-đợi
ngược-lại: mặt-trước, phản-đối, trái, phản-đối, ngang-qua, phản-đối
mười-hai: 
đính-hôn: hôn-ước, bận, tham-gia, tham-dự, chiếm
rượu: quả-nho, rượu, có-chất-rượu
mùi-vị: vị, vị, thơm-ngon, mồi, sự-hăng-hái
bàn-là: Thép, kim-khí
phân-phát: chuyển-giao, triển-khai, công-bố, xuất-bản, khuếch-tán, lưu-thông, phân-phát, chỉ-định, chia-sẻ, chia-ra, chẻ, to--chia, phân-loại
buôn-bán: thương-mại, kinh-doanh, thương-nghiệp, hàng-hóa, Internet, mặc-cả, Giao-dịch, thương-thuyền, mua-sắm, thị-trường
Ưu-điểm: lợi, lợi-nhuận, lợi-ích, khả-thi, lòng-tốt, tài-sản, sự-ưa-thích, ưu-thế
quần-áo: tủ-quần-áo, tấm-vải, quần-áo, quần-áo, quần-áo, tình-trạng-lộn xộn
phán-xét: phán-xét, phán-xét, trọng-tài, trọng-tài
chênh-lệch: vi-phân, phân-biệt, khác, riêng-biệt, riêng-biệt, khác-nhau, sự-biến-đổi, riêng-biệt, biến, đúng, chia-ra
nóng-lòng: khẩn-cấp, khẩn-cấp, liên-quan, báo-động, lo-lắng, lo-ngại, liên-quan, lo, chu-đáo, không-thoải-mái, đáng-lo-ngại, sợ, quan-tâm, phiền, đáng-báo-động, hăng-hái, háo-hức, bồn-chồn, khó-chịu
thuyền-trưởng: 
đã-kết-thúc: hoàn-thành, chấm-dứt, có-hạn, sẳn-sàng
đình-chỉ-diện mạo: 
Hiếu-kỳ: háo-hức, hấp-dẫn, phấn-khởi
nước-ngoài: Hải-ngoại, người-ngoài-hành tinh, người-nước-ngoài, kỳ-lạ, người-lạ, ngoài
khuếch: tăng-cường
tầm-quan-trọng: điều-cần-thiết, liên-quan, Ý-nghĩa, giá-trị
cuối-cùng: cuối-cùng, sau-cùng, có-hạn, cuối-cùng, cuối-cùng, cuối-cùng, tinh
hóa-đơn: hành-động, bản-viết-tay, tài-khoản, tính-toán
chứng-minh: bằng-chứng, xác-nhận, xác-nhận, chứng-minh, chứng-tỏ
ngăn-chặn: ngưng, ngăn-cấm, giam, đàn-áp, hạn-chế, cản-trở, chặn, chế-ngự, ngăn-cản, cấm, tránh-khỏi, đẩy-lui, đàn-áp,-kìm nén, đình-chỉ
cái-cổ: họng
hợp-pháp: tư-pháp, luật-pháp, hợp-pháp, khung
khô: thân-cây
phục-vụ: dịch-vụ, kiếm-được, cung-cấp, phục-vụ
mất: Hoa-hậu, để-lộn-chổ
bằng-chứng: chứng-cớ, bằng-chứng, hướng-dẫn, đầu-mối, thư-mục, trưng-bày, chứng-kiến
chứng-cớ-trường hợp: 
tiến-trình: đi-bước-dài, sự-phát-triển, phát-triển, cấp-tiến, phát-triển, nâng-cao, tiến-hành, sự-cải-thiện, sự-nhướng
cao-ốc: xây-dựng, cấu-trúc, xây-dựng, công-trình-xây dựng, cơ-sở
Tìm-kiếm: Tìm-thấy, khám-phá, khám-phá, sự-tìm-kiếm, khám-phá, tìm-kiếm, tìm-kiếm, nghiên-cứu, khảo-sát, theo-đuổi, điều-tra--u003e Investigation, cuộc-điều-tra, điều-tra--u003e Investigation
buồn: chán-nản, thật-đáng-buồn, khốn-khổ, khó-chịu, buồn-bã, sự-hối-hận, chán-nản
tội: có-tội
Ba-mươi: 
thành-thật: chân-thành, trung-thành, nói-thật-là, thành-thật
đóng: chặt-chẽ, đóng, đóng-kín, tắt, lắp-vào, đóng, đóng-gói, bó-lại, Bưu-kiện, gói, đóng-hàng, nhốt
ngân-hàng: ghế-dài, thiếc
số-phận: vận-may, vận-may, thuộc-về-cú pháp, nơi-đến, rất-nhiều
khu-rừng: rừng-nhiệt-đới
đo: gauge, sự-đo-lường, cân-nặng, mét, mét
nếu-không-thì: cách-khác
suối: Dòng-chảy, điều-khoản, hiện-tại, điện, tuôn-ra, huyền
bánh-mì: nướng, lợn-nái, sandwich
thêm-vào: thêm, thay-thế, hơn-thế-nữa, thặng-dư, số-dư, hơn-nữa, thêm-vào, bổ-sung, thêm-vào, phụ-lục
chọn: sự-lựa-chọn, sự-lựa-chọn, lựa-chọn, tuyển-chọn, nhặt, trúng-tuyển, quay-số, biểu-quyết, kiểm-tra, sự-ưa-thích
thú-vật: 
zoic-tính: 
eventive-tâm-trạng: 
giống-nhau-biến cố đánh dấu: 
nhân-giống-trường hợp: 
dầy: béo-phì, dày, dầy-đặc, mập
sinh-vật: sinh-vật, Bản-chất
mưa: bị-ướt, lượng-mưa, vòi-hoa-sen
bề-mặt: khuôn-mặt, cấp-độ, máy-bay, diện-tích
thánh: Linh-thiêng, lưới, thuần
tháng-bảy: 
bài-báo-cáo: sự-quyết-tâm, bản-tường-trình, tỉ-lệ, quan-hệ, mối-quan-hệ, công-bằng, triển-lãm, bài-văn, Phơi-bày, ghi-bàn
bờ-biển: sợi, bờ-biển
Hồ-sơ: tài-liệu, xôn-xao, lều, Hồ-sơ, lưu-trữ
vai: thân-cây, trục, vai, chải, cánh-tay
ngạc-nhiên: ngạc-nhiên, ngạc-nhiên
Hoàng-gia: hoàng-đế, chế-độ-quân chủ, Vương-quốc, đế-chế, có-thật, thực-tế
bài-hát: điệu-nhạc, đường-ray, ca-hát, thơ-ca
sự-an-ủi: giảm-bớt, thư-giãn, thư-giãn, sự-khuyến-khích, tiện, còn-lại, cứu-trợ
bất-cứ-người nào: mọi-người, có-ai, một-ai-đó, không-ai, mọi-người
cỏ: cỏ-khô, cỏ-dại, thảo-mộc, cỏ, gram
rút-ra: kéo, kéo, lôi, hấp-dẫn, Kháng-cáo, hấp-dẫn, rút, phấn-khởi, thu-hút, thú-vị, bản-vẽ, gỡ-bỏ, trừ
khai-mạc: sơ-bộ, lúc-đầu, khám-phá, lỗ-hổng, khe, mở
tháng-6: 
cá: bể-nuôi-cá
nguồn-vốn: chương, quỹ, tài-sản
nhũ-hoa: ngực
tuyết: băng
giáo-dục: giáo-dục, bài-học, giáo-dục, trình-độ-học vấn, sự-hình-thành, tập-huấn, giáo-dục, học-tập
nhọn: sáng, dữ-tợn, khắt-khe, mạnh, vị-cay, nhọn, nhọn, quan-tâm, khô-teo-đi
lòng-thương-hại: nhân-từ, lòng-trắc-ẩn, sự-cảm-thông, thông-cảm, thương-xót, kinh-khủng, hình-phạt, lông-chim, không-may, lấy-làm-ân hận, Làm-hại, hư-hại, sự-hối-hận
kinh-phí: học-phí, chi-tiêu, giá-tiền, phiên-bản, đầu-ra, tính-phí
của-bạn: của-bạn
triệu: triệu
mệt: mệt-mỏi, mệt-mỏi
giết: tội-giết-người, giết-người
bóng: Bóng
cân-nặng: phụ-tải, nặng, nặng-nề, cân-nặng, sức-ép
khối-lượng: chất-lượng, tập-hợp, số-lượng, số-lượng-lớn, số-nhiều, rất-nhiều, Cục-bướu, cụm, bao-vây, xúc-phạm, bột, mỳ-ống
thành-lập: lắp-vào, chắc, kiên-quyết, ổn-định, sự-sáng-tạo, thiết-lập, phận-sự
can-đảm: Dũng-cảm
gầy: gầy, pha-loãng, thon, hẹp, gầy, khỏe, khôn-khéo, tinh, nhẹ, chê, loãng, tinh-vi, gauge
hài-lòng: vừa-lòng, sự-hài-lòng, hài-lòng, vui-vẻ, làm-vui-lòng, đáp-ứng
kiểm-tra: kiểm-tra, nhìn, đồng-hồ-đeo tay, sự-lựa-chọn, xem-xét, thanh-tra, kiểm-tra, kiểm-tra, kiểm-tra, Trung-gian, khảo-sát, truy-tìm, xác-định, xem-lại, kiểm-soát
Đức: lòng-tốt, đức-hạnh, lòng-tốt, lòng-nhân-từ
quốc-dân: Quốc-gia, quốc-tịch, dân-tộc, trong-nước
thần-thánh: Linh-thiêng
thung-lũng: lưu-vực
phỏng-đoán: suy-luận, nghi-ngờ, tự-phụ, ước-tính, dự-toán, dự-đoán, dự-đoán, dự-báo, đầu-cơ
đầu-cơ-tâm trạng: giả-tâm-trạng
màu-vàng: tái-nhợt, hổ-phách, tóc-vàng
di-hài: chất-cặn, dư, còn-lại, thức-ăn-thừa, còn-lại
khuynh-hướng: uốn-cong, bẻ-cong, uốn-khúc, khuynh-hướng, xoắn, độ-dốc, dốc, xiên, gấp
cái-hộp: va-li, ngăn-kéo, quỹ, bộ-dụng-cụ, có-thể, thùng-rác
mùa-vụ: mùa, chương, ga-tàu, kỷ-nguyên
khoa-học: khoa-học
khoan: lỗ-thủng, máy-khoan, đần-độn, buồn-chán, khoan, làm-phiền, diễn-đàn
Chú: 
danh-sách: mục-lục, mục-lục, thực-đơn, ghi-danh
tháng-8: 
phổ-biến: tỷ-lệ, nổi-danh, đáng-chú-ý, dân-gian
Không-biết: người-lạ
quen: người-quen, nòi-giống, con-cháu
quen-ghi-danh: 
độc-giả: ca-sĩ
cách-tiếp-cận: đến, quyền, kỹ-thuật, chiến-thuật, phương-pháp-học, thái-độ, cách-thức, phương-pháp, thời-trang, phương-pháp, xấp-xỉ, giao-diện
hai-lần: gấp-đôi
trí-tuệ: lí-trí, Sự-thông-minh, tâm-thần, thông-minh, tâm-thần, người-suy-nghĩ, trí-tuệ, tinh-thần
thật: thực-sự, quả-thật, chính-xác, thật, thiết-thực, hầu-như, thật, chân-thành, hiện-thực, hoàn-toàn, chắc-chắn, chắc-chắn-rồi, chắc-chắn, chắc-chắn
thầy-tu: giáo-sĩ
bị-thương: bị-thương, vết-thương, đau
nỗi-buồn: sự-đau-khổ, nỗi-buồn, Phiền-muộn, chán-nản, tang-chế, đau-khổ
cung-điện: 
tiêt-tâu: đánh-bại, cú-đấm, cái-tát, đập, ăn-hết, nhịp, khắc-phục
eh?: 
ngu-xuẩn: ngốc-nghếch, lừa, lừa-dối, gian-lận, dốt-nát, khờ-dại, điên, khùng, điên, lừa-dối
cạnh: bờ-vực, viền-tua, biên, mãnh-liệt, biên-giới, lề, bảng
chín: thứ-chín, mới-mẻ
nổ: vụ-nổ, tiếng-nổ, nổ-tung, nứt, bùng-nổ, chứng-động-kinh, tiếng-nổ
chịu-đựng: chịu-được, chịu-được
tiếng-ồn: ồn-ào, kêu-la, làm-phiền, kêu-la
Ngữ-văn: Văn-học
khuyên-bảo: hội-đồng, giới-thiệu, sự-giới-thiệu, Khuyến-cáo, Tư-vấn, bảng, đầu
trống: chỗ-trống, trống, trống, giải-trí, vô-giá-trị, sự-trống-rỗng, Khoảng-chân-không, hư-không
cấp: bài, cấp, thành-tích, thể-loại, giá-trị, lớp
bão-táp: 
túi-quần: cái-cặp-sách, gói
sự-tưởng-tượng: tưởng-tượng, tưởng-tượng, giả-định, ảo-tưởng, viễn-tưởng, tưởng-tượng
câu-văn: phán-xét, phán-xét, mệnh-đề, định-lý, gợi-ý, đề-nghị, trừng-trị, lòng-tin-chắc, cụm-từ, lên-án, tố-cáo, hình-phạt
Tháng-mười-một: 
Tháng-mười-hai: 
vắng-mặt: vắng-mặt, thiếu-sót, sự-thiếu
cảm-tạ: lòng-biết-ơn, tri-ân, cảm-ơn, cảm-ơn-bạn
địa-chỉ-nhà: 
chim: chuyến-bay, máy-bay, huyền, phi-cơ, Máy-bay, đường-hàng-không
chủ-nhân: ông-chủ, địa-chủ
áo-khoác: áo-choàng, vỏ-kiếm, bao-gồm, Áo-khoác, lông
chuẩn-bị: sẳn-sàng, chuẩn-bị, tổ-chức, sự-chuẩn-bị, Xây-dựng
quan-hệ: quan-hệ, mối-quan-hệ, tỉ-lệ, liên-quan, quan-hệ, việc, giao-tiếp, giao-tiếp
hút-thuốc: hút-thuốc, thuốc-lá, đốt-cháy
Tháng-một: 
máy: máy-móc, động-cơ, máy-bay, xe-cộ
Nội-dung: chất-liệu, chuyện, tuân-theo, làm-vui-lòng, chứa, bao-gồm, gồm-có, liên-quan-đến
răng: răng, Hộp-số
xấu-hổ: ghét-bỏ, hổ-thẹn, e-thẹn, bối-rối, lúng-túng, sự-lúng-túng, trần, trần-truồng, sự-sỉ-nhục, xúc-phạm
vịnh: berry, âm-đạo
não-bộ: chủ-mưu, tủy
chiếc-nhẫn: nhỏ-mọn, quay-số, curl, vòng, lốp-xe, lốp-xe, niêm-phong, con-tem
cụm-từ-đánh dấu: 
hình-vuông: 
Hoa-quả: 
trà: 
giải-thích: giải-thích, minh-họa, bày-tỏ, rõ, khai, làm-rõ, giải-thích, bình-luận
chào-mừng: Lời-chào, tiếp-nhận, giải-trí, ê, Chào, chào
thơ-ca: thơ-ca, thơ
mua: mua, mua, đủ-khả-năng, chợ
Trung-thành: không-trung-thực, trung-thành, trung-thành, hết-lòng, chính-xác, đáng-tin-cậy
hứng-thú: sự-khuyến-khích, bị-kích-thích, làm-phiền, sức-ép, chọc-giận, sự-vui-mừng, sự-đánh-thức, tuôn-ra, lo-ngại
bốn-mươi: 
tháng-tư: 
tử-tế: làm-ơn, thân-thiện, dịu-dàng
tháng-mười: 
đắng: khó-nhọc, sự-đau-đớn, đau-khổ, cay-đắng, đau-khổ, đau-đớn, sự-chua-chát
nô-lệ: chế-độ-nô lệ
lỏng-lẻo: độc-lập, lãng-mạng, giải-quyết, giải-quyết, lỏng, trống, tự-do
bản-văn: từ-ngữ
thẻ-tín-dụng: thế-chấp, thẻ-tín-dụng, món-nợ, cho-mượn, mượn, cho-vay, uy-tín, giá-trị, tin-tưởng
mười-lăm: 
hung-ác: dữ-tợn, khó-khăn
tham-gia: tham-dự, tham-gia, tham-gia, tham-gia, tham-gia, tham-gia, tham-gia, liên-Hợp, kết-nối
qui-trình: tay-cầm, phương-pháp, xử-lý, hoạt-động, dùng-thử
tội-phạm: có-tội, xúc-phạm, xúc-phạm
bụi-bẩn: đê, phấn
Thực-hành: chức-năng, thực-dụng, thiết-thực, thuận-tiện, hầu-như, tiện-dụng, ứng-dụng
màu: màu, Sơn, ý-thích, thuốc-nhuộm, tái-nhợt, màu, nhiều-màu-sắc, tuôn-ra, hoàn-thành
hủy-hoại: tàu-chìm, phá-hoại, sự-phá-hoại, làm-suy-giảm, phá-hủy, nghiền-nát, Smash, hủy-hoại, làm-sai, tẩy-xóa, phủ-nhận, sự-phá-hủy
tăng: tiến-hành, tăng-cường, núi, nâng-cao, thêm-vào, chèn, Tăng-trưởng, phóng-to
mũi: 
thừa-nhận: sự-thừa-nhận, công-nhận, Chấp-nhận, công-nhận, công-nhận, phê-duyệt, thừa-nhận, ban-cho, phần-thưởng
hôm-qua: Ngày-mai
hesternal-căng: 
Thất-bại: thất-bại, không-thành-công, đánh-bại, thất-bại, không-thể, làm-sai, thất-vọng
tiếp-tục: tiến-hành, liên-tiếp, cố-chấp, tiếp-tục, liên-tục, kiên-gan
mặc: Mang, nhân-viên-khuân vác
mù: 
tá: một-số
bay: đang-bay, nhảy, chuyến-bay, hàng-không
khen-ngợi: sự-khâm-phục, ngưỡng-mộ, uy-tín, công-đức, khen-ngợi, Xin-chúc-mừng, quang-vinh, danh-tiếng
ác-quỷ: 
dần-dần: chậm-lại, từ-từ
sự-hy-sinh: nạn-nhân, làm-mồi, tai-nạn
bài-tập: điền-kinh, tập-thể-dục, phân-công, luyện-tập, luyện-tập, thể-thao, thể-dục, diễn-tập
lương-tâm: đại-danh-từ, ý-thức
học-thuyết: nguyên-tắc, lý-thuyết-gia, định-lý
bộ-trưởng: 
chán-ghét: bẩn-thỉu, kinh-tởm, hận-thù, không-thích, định-kiến, mối-ác-cảm, tức-giận, chán-ghét, sự-không-ưa, thù-ghét
hồ: 
Trung-tâm: trung-tâm, Trung-tâm, ga-tàu, trụ-sở-chính
mờ-nhạt: vô-ý-thức, tuyệt-vọng, tuyệt-vọng, yếu-ớt, tái-nhợt
hợp-lý-tính: 
cẩn-thận: chu-đáo, lưu-ý, tập-trung, cẩn-thận, chính-xác, chính-xác, tóm-lược, chi-tiết
hưởng-thụ: sự-hưởng-thụ, cảm-kích
tôn-sùng: nghi-lễ
các-mặt-hàng: sản-phẩm, mặt-hàng, hàng-hóa, hàng-hóa, chuyện
da: da, hấp-thụ, vỏ, vỏ-trứng, lột-vỏ, lông, sự-hăng-hái
mái-nhà: sân-thượng, trần-nhà, bao-gồm, bảo-hiểm, Nắp
tôn-lên: 
Lâu-đài: lồng, cờ-bạc-gian lận, Khóa
ngôi-vua: 
đính-kèm: thuê, có-điều-kiện, đính-kèm, liên-hệ, phụ-thuộc, kết-hợp
dặm: xu-hướng, độ-dốc, gầy, Gradient, sẵn-lòng
cực: tối-đa, cuối-cùng, cực, cực, cực-đoan, nghiêm-chỉnh, mãnh-liệt, chuyên-sâu, chân-tay, đầu
nhà-tù: nhà-tù
ly-uống-nước: miệng, bát
hội-viên: đàn-organ, thành-viên, chân-tay, nội
dân-sự: trong-nước, công-dân, công-dân, thường-dân
bất-cứ-nơi đâu: khắp-nơi, nơi-nào
hiển-nhiên: rõ-ràng, chắc-chắn, chứng-cớ, Chỉ-đường, hiển-nhiên, chắc-chắn, xác-định, rõ-ràng, thông-suốt, minh-bạch, không-rõ, đáng-chú-ý
cặp-vợ-chồng: đôi, mệnh, gấp-đôi, hai, rất-ít, một-số, hơi-nước
âm-lượng: ống-chỉ, nhiều, mức-độ, lượng, tương-đối, định-lượng, chặn, hàng-loạt, mô-đun, số-lượng-lớn, sức-chứa, bảo-hiểm
khách-hàng: khách-hàng, không-bắt-buộc, trang-phục, Hải-quan, luyện-tập, thói-quen, đã-từng
cây-cung: hình-cung, củ-hành, đường-cong
bộ-đồ: Phù-hợp, trang-phục, thích-hợp, phù-hợp, trao-đổi-thư tín, phù-hợp, trường-hợp, truy-tố, kiện-tụng, áo-choàng, yêu-cầu
thịt: thịt, thịt-bò
sữa: sữa, vòi-nước, thạch
thực-vật-tính: 
thị-giác: thị-giác, trance, sáng-suốt, mặt-ngoài, góc-nhìn, nhìn-thoáng-qua, tương-lai, cảnh-quan, triển-vọng
hiếm: hiếm, hầu-như-không
anh-chị-em họ: họ-hàng
cầu: cấp, sàn-tàu
bảo-vệ: sự-bảo-vệ, bảo-tồn, bảo-vệ, che-chắn, bảo-vệ, bảo-tồn, duy-trì, bảo-tồn, bảo-mật
muối: phóng-đại, nói-quá, mặn
vô-tội: 
Nữ-hoàng: 
đếm: vách-ngăn, tính, tính-toán, tin-cậy, thất-vọng, tài-khoản
sự-tò-mò: nâng-lên
nhảy: trống, khiêu-vũ, nhảy, nhảy
khách-sạn: chỗ-ở, quán-trọ
lấp-đầy: 
Tù-nhân: 
cửa-tiệm: cửa-hàng, gian-hàng, kinh-doanh, giao-dịch, mua-sắm
cầu-thang: cầu-thang-gác, cầu-thang, thang, ngăn-kéo
van-xin: tìm-kiếm, giả-sử, biện-hộ
cát: 
hung-bạo: vũ-lực, dữ-tợn, náo-động, quá-tuyệt-vời, nghiêm-khắc, khỏe-mạnh, mãnh-liệt, mạnh-mẽ, wildly, chuyên-sâu
tháng-chín: 
khởi-hành: rời-bỏ, khởi-hành, lối-ra, đầu-ra
sự-đổ-nát: sự-phá-hủy, sự-lật-đổ, hư-hại, cướp-bóc, thảm-họa, vật-đổ-nát
kỹ-năng: khả-năng, có-khả-năng, sức-chứa, hiệu-quả, thẩm-quyền, nghề, thẩm-định
gia-súc: bò
thiết-bị: dụng-cụ, Thiết-bị, bộ-dụng-cụ, Hộp-số, quần-áo, giải-quyết, phần-cứng, kỹ-thuật, Công-nghệ, cơ-sở, cố-định
nhà-bếp: nấu-nướng, nồi-cơm-điện
bán: giảm-giá, bán
tốc-độ: vận-tốc, tốc-độ, đà, mạnh
lời-kết: suy-luận, sự-rút-lui, đầu-ra, Hàm-ý, độ-phân-giải, kết-quả, hậu-quả, bộ-sưu-tập, kết-luận, đề-nghị
máy-tính-bàn: máy-tính
đời-đời: bao-giờ, mãi-mãi, vô-hạn
có-hạn: có-hạn, hạn-chế, nhốt, phân-định, hạn-chế, hạn-chế
thư-viện: tủ-sách
căn-cứ: nền-tảng, căn-cứ, dựa, căn-bản, sơ-cấp, tiểu-học, cốt-lõi, căn-bản, đáy
nhầm-lẫn: hỗn-độn, hỗn-loạn, làm-phiền, khó-hiểu
huy-Hoàng: rực-rỡ, xinh-xắn, cao-quý
tương-tự-như vậy: tương-tự, cũng-thế, như-nhau
sợ-hãi: sợ, sợ-hãi, kinh-sợ, khủng-khiếp
không-hạnh-phúc: không-may, không-may, khốn-khổ
bài-báo: bài-văn, mặt-hàng
đầu-bếp: nấu-nướng, nướng, sôi-lên
ban-nhạc: dây-lưng, dây-băng, băng, đội-hình, nhóm, dải, sọc, vùng, sợi, xăn-lên, cụm, đường-nhỏ
hoang-mạc: nơi-hoang-vu, hoang-vu
hôn: 
quả-bóng: cao-su, khu-vực, súng-thần-công, đạn
cây-gậy: chứng-khoán, cây-gậy, tham-gia, gỗ, gỗ, con-dơi, cây-cơ-bida
cãi-vã: Logic, di-chuyển, lý-luận, tranh-cãi, thảo-luận, tranh-luận, tranh-chấp, đường
quan-sát: thanh-tra, xem-xét, khám-phá, truy-tìm, quan-sát
lể-giáng-phước khí sắc: 
nổi-bật: nổi-bật, kinh-ngạc, tấn-công, đáng-kể, quan-trọng, trọng-yếu, đáng-chú-ý, ấn-tượng, thật-ngạc-nhiên, kinh-ngạc, rõ-ràng, sáng
phạm-tội: có-tội, nợ, phạm-tội, người-phạm-tội, người-bị-kết án
súng: súng-trường, vũ-khí, súng-thần-công, cờ-bạc-gian lận
công-an: thi-hành, giám-sát
giấu: giấu, tiết, đóng-giả
thám-hiểm: chiến-dịch, lái-xe, chuyến-đi, hành-trình, hành-trình, chuyến-du-lịch
dốt: dốt-nát, không-biết, dốt, khờ-dại, ngốc-nghếch, dốt-nát, nực-cười
hào-phóng: tự-do, Hiếu-khách, lòng-nhân-từ
mây: 
chất-thải: vô-dụng, không-cần-thiết, từ-chối, sự-từ-chối, sự-từ-chối, chất-cặn, thức-ăn-thừa, rác
Tháng-hai: 
Căn-bệnh: bệnh, bệnh-tật, hình-vành, thỏa-đáng, đáp-ứng, hội-chứng
chi-tiêu: hoa, sử-dụng, chi-tiêu, theo-đuổi, nhảy, Hoa-hậu
nguồn: tài-nguyên, sống, Đài-phun-nước
sáng-kiến-trường hợp: 
cô-dì: 
chậm-trễ: hoãn-lại
bị-hoãn-bắt buộc: 
báo-cáo-chứng cớ: 
nữa-đêm: Bắc
anh-hùng: quân-nhân, nhà-vô-địch
triết-lý: triết-học
ngón-tay: ngón-chân
dễ-chịu: giếng, triệt-để, đúng-mực, thông-suốt, thoải-mái, thuận-tiện, thư-giãn, thú-vị, dự-bị, tiện-dụng
một-vài-nơi: nơi-nào
nhấn: phương-tiện-truyền thông, tạp-chí, tạp-chí, in-ấn, kiểu, công-thức
nhân-viên: đội, cá-nhân
giải-thưởng: giải-thưởng, quà-tặng, phần-thưởng, tiền-thưởng
khiển-trách: lỗi, khuyết-điểm, lỗ-hổng, món-nợ, có-tội, mũi-tẹt, truy-tố, trách-nhiệm, trách-nhiệm
đau-khổ: khó-nhọc, đau-khổ, đau-khổ, khốn-khổ, nhàm-chán
trán: 
quảng-cáo: Quảng-cáo, quảng-cáo, quảng-cáo, quảng-cáo, thông-báo, sự-công-khai, nhận-thấy, tờ-khai
Thiên-thần: chủ-đất, bà-tiên
số-ít-con số: 
rạng-sáng: Hoàng-hôn
Quảng-cáo: nghề-nghiệp, Quảng-cáo, thương-mại, kinh-doanh
tha-thứ: tha, sự-tha-thứ, tha-thứ, miễn, giải-tỏa, bỏ-qua
con-cừu: cừu
kiên-nhẫn: nghị-lực, sự-kiêng-cử
nông-trại: trang-trại, trồng-trọt, trồng, nông-nghiệp
tham-chiếu: tài-liệu-tham khảo, tham-khảo
ngô: lúa-mì, sừng
Chìa-khóa: phiếu, nút, cái-mỏ-lết, công-tắc-điện, chính, quan-trọng, đáng-chú-ý, nhạy-cảm, chính, thích-hợp, chính, đầu-mối
đa-số: nhiều, phần-lớn
yếu-đuối: không-có-khả năng
bầu-khí-quyển: môi-trường, bầu-trời, hàng-không, không-gian
thở-dài: giựt-mình
tình-người: con-người
phản-đối: phản-đối, đối-lại, phản-đối, tương-phản, chống-cự, phản-đối, trái, sức-đề-kháng, phản-đối, phản-đối, phản-đối, chống, chống-lại, chống, sự-phản-đối
đĩa: đĩa, lát, phản-đối, hình-trụ, đĩa, ghi-lại, cái-khay, lái-xe
cô-độc: một-mình, sự-cô-đơn, riêng-biệt, Độc-thân, chỉ
họa-sĩ: độ, họa-sĩ, nghệ-sĩ
hiệp-sĩ: lái
quyến-rũ: lôi-cuốn, sức-hút, ma-thuật, Đánh-vần
phán-quyết: quyết-định, phán-xét, phán-quyết, phán-xét, sự-quyết-tâm, độ-phân-giải, biện-pháp
thống-đốc: bảo-thủ, cái-thước
chi-nhánh: 
bố-trí: sắp-xếp, cấu-hình, xu-hướng, khuynh-hướng, cung-cấp, bố-cục, khí-sắc, lịch-trình, thời-gian-biểu
hăng-hái: nhiệt-tâm, hơi-nóng, hăng-hái, sự-hăng-hái, phơ, niềm-đam-mê, sự-ngây-ngất, cổ-vũ
dòng-cảm-điện khí sắc: suy-luận-khí sắc, suy-luận-tâm trạng
cộng-đồng: xã-hội, thể-loại, người
dầu: mập, nhiên-liệu, hóa-thạch, tủy, nhiệt, bơ
ống: ống, vòi-nước, vòi, phần-sau-lái tàu, ống
in: phiên-bản, sức-ép, in-ấn, trục, khuôn, ấn-tượng
oh: ya
đàm-luận-bối cảnh: 
hô-cách-trường hợp: 
lều: nhà-tranh, lều, lều
báo-thức: chuông, báo-động, hoảng-sợ, làm-khủng-khiếp
lo-lắng: căng, bối-rối, làm-phiền, buồn-bã, bối-rối, phiền, quấy-rầy, khó-chịu, thần-kinh, lo-lắng, thần-kinh
thường-xuyên: thời-gian, thường-xuyên, thường-xuyên, cố-chấp, hằng-số, đã-sửa, vững-chắc
dao: kêu-la, lưỡi
lụa: 
sự-khinh-thường: khinh-khi, hận-thù, không-thích, thù-ghét, sự-không-ưa, mũi-tẹt, sự-sỉ-nhục, xúc-phạm, sơ-suất
âm-phủ: 
tách: riêng-biệt, qua-một-bên, cách-nhau, riêng-biệt, khác-nhau, riêng-biệt, đứng-cách-xa, gián-đoạn, cô-lập, tẩy-chay, phân-định, khoảng-cách
nghiêm-túc: nghiêm-chỉnh, chân-thành, nặng, nặng-nề, mạnh, tích-cực
hỗn-hợp: hỗn-hợp, sự-kết-hợp, hỗn-hợp, pha-trộn, chung
bằng-gỗ: gỗ, gỗ
thích-hơn: sự-ưa-thích
cảnh-báo: chú-ý, cảnh-báo, báo-động, đài-kỷ-niệm, nhận-thấy
khuyên-bảo-tâm trạng: 
xung: cảm-hứng, mạch, hàng-loạt, thúc-giục, đà, đẩy
Hoài-bão: thất-vọng, thất-vọng, ham-muốn, tham-lam, chán-nản, tham-vọng
chối-bỏ: sự-từ-chối, Từ-chối, sự-từ-chối, sự-từ-chối, sự-phủ-nhận, từ-chối, phủ-nhận, suy-giảm, không-tán-thành, bỏ-qua, ngăn-cấm, cấm-chỉ, cấm, mâu-thuẫn
hiến-pháp: hiến-chương, theo-hiến-pháp
nhạc-cụ: dụng-cụ, tàu, thực-thể, đàn-organ, thùng-hàng, hữu-ích
liên-tiếp-diện mạo: 
thủy-triều: làn-sóng, đong-tach
trường-đại-học: giảng-viên, học-viện, khuôn-viên, trường-đại-học
cái-đuôi: sắp-hàng
thế-hệ: con-cháu
con-mèo: 
Chỉ-đường-chứng cớ: 
bị-bỏ-rơi: bỏ-bê, rời-bỏ, hoang-vu, bỏ, bỏ
mười-một: 
bản-năng: tự-phát
đặc-tính: đặc-điểm, đặc-trưng, nhân-vật, thói-quen, xu-hướng, cư-xử, cư-xử, tính-năng, đặc-tính, định-tính, điển-hình
bộ-lạc: Thân-cây, thân-cây, phụ-tải
nhát-gan-tâm trạng: 
che-chở: khu-nghỉ-mát, nơi-cư-trú, giải-quyết, môi-trường-sống, khu-dân-cư, sự-bảo-vệ, ký-túc-xá, nhà-thương-điên
bất-lịch-sự: thô-bạo, cộc-cằn, tàn-nhẫn
cưỡi: dap-xe, lái
lắc: động-não
ngành-công-nghiệp: khu-vực, chế-tạo, công-nghiệp, công-nghiệp-hóa
chuyên-nghiệp: nghề-nghiệp, nghề-nghiệp, nghề, chuyên-nghiệp
đèn: bóng-đèn
cà-phê: quán-cà-phê
tuân-lệnh: nộp-hồ-sơ, tuân-theo, nghe
Phương-bắc: Bắc
cô-y-tá: 
cam-đoan: sự-bảo-đảm, trát, lời-hứa, Bảo-hành, bảo-đảm, chắc-chắn, xác-định, xác-nhận, cung-cấp, cung-cấp, chắc-chắn-rồi, sự-thuyết-phục, xác-nhận, bảo-mật
chuỗi: trình-tự, loạt, chuỗi, nhà-tù
giảng-bài: chỉ-dẫn, giáo-dục, tập-huấn
giày-dép: giày, dép
cái-sân: Mã, trang, sự-tán-gái
mơ-hồ: mơ-hồ, che-khuất, mơ-hồ, không-rõ, thần-bí, không-chắc-chắn, vô-định, làn-sóng, trống
nơi-khác: khác
chung-cư: bằng-phẳng, hình-tròn, ngăn, bộ
Hoạt-động: Giao-dịch, chức-năng
thứ-bảy: Sa-bát
ánh-nắng-mặt trời: năng-lượng-mặt trời
Người-đàn-bà góa: 
thành-phần: diện-mạo, tính-năng, mặt-hàng, thành-phần, đàn-organ
sự-phản-xạ: sự-trầm-tư
cơ-quan: mô, cơ-quan, tổ-chức, quần-áo, công-ty, hữu-ích, cơ-quan, thực-thể, hệ-thống, cấu-trúc, kết-cấu, bố-cục, tổ-chức, tổ-chức
ngôi-sao: 
biến-cố: biến-cố, xảy-ra, hiện-tượng, tỷ-lệ, Tai-nạn, trường-hợp
khách: người-lạ, du-khách, người-ngoài-hành tinh, người-nước-ngoài, người-mới-đến, khách-hàng, quý-khách-hàng, chủ-nhà
quán-ba: trần, quán-rượu, phụ-tải, vận-tải-hàng hóa, quán-cà-phê, bối
chai: bình
ban-phước: phước-lành
sự-náo-động: vận-dụng, pha-trộn, gợi-lên, bạo-loạn
bên-trong: ở-trong, bên-trong, Nội-địa, nội-bộ, địa-phương, trong-nước, trong-nhà, tâm-thần, nội
sửa-chữa: đã-sửa, điều-chỉnh, xem-lại, biện-pháp, giải-quyết, giải-quyết, phương-thuốc, cải-thiện, thẳng, được, đuợc, hằng-số, vững-chắc, nhìn-chằm-chằm, chính-xác, xác-định, thiết-lập, nhận-định, xác-định
lấy-được: có-được, mua, phái-sinh, nhận-được, nhận
rỗng: trơn, trần, chỗ-trống, cáp
tỉnh: tỉnh
nền-văn-minh: 
treo: 
sốc: thổi, thất-bại, vết-thương, sửng-sốt, sự-xung-đột
ngoại-lệ: từng-phần, phân-biệt, khuôn-mẫu, miễn
sự-căng-thẳng: căng-thẳng, sức-ép, phụ-tải, mệt-mỏi, sự-cố-gắng, cường-độ
Tiêu-chuẩn: tiêu-chuẩn, tiêu-chí, tỷ-lệ, cấp-độ, mặc-định, qui-tắc, đã-sửa, hằng-số, vững-chắc, ổn-định, tĩnh, bền-vững, tiêu-chuẩn-hóa, họa-tiết
chạy-xe: lái-xe, lái-xe, hướng-dẫn, quản-lý, dap-xe
thoát-khỏi: gỡ-bỏ, rút, loại-bỏ, loại-bỏ, miễn, giải-tỏa, làm-xong
xin-thề: sự-tuyên-thệ
Châu-báu: ngọc-đá-quý
hạt: tinh-dịch, hạt, hạt
cái-tháp: cờ-bạc-gian lận
yêu-thích: yêu-thích
gần-đây: mới-đây, tươi, mới
mới-đây-quá khứ căng: 
thức: có-ý-thức, tinh-thần, thức, báo-động
Nội-thất: 
dây: dây, chuỗi, dây-đeo
phiêu-lưu: mạo-hiểm, cờ-bạc
vương-quyền: thống-trị
tiệc: buổi-tiệc, lễ-kỷ-niệm, đãi-tiệc, ngày-lễ
diễn-tả: miêu-tả, đặc-tính, miêu-tả, miêu-tả, định-nghĩa
sáu-chục: 
tỉ-lệ: khung, gauge, tỉ-lệ, thang, cầu-thang-gác, cầu-thang
Lễ: nghi-lễ, chức-năng
săn-bắn: săn-bắn, nạn-nhân, làm-mồi, đuổi-theo, chụp
thì-thầm: lầm-bầm
phần-lớn: đáng-kể, đáng-kể, phần-lớn, phần-lớn, đa-phần, rất-nhiều, rộng-rãi, chủ-yếu
Cơ-đốc-giáo: 
luật-sư: luật-sư, biện-hộ
chi-tiết: Lan-tràn, gia-hạn, sự-mở-rộng, sự-bành-trướng, phát-triển, sâu, chi-tiết
công-chúa: 
bàn-thờ: Thánh-địa
web: mạng-lưới, lưới, lưới, mô, Tranh-sơn-dầu, áp-phích
màu-tía: màu-đỏ-sậm
quây-quần: sưu-tầm, tích-trữ, co-lại, quay-số
bầu-cử: sự-lựa-chọn, trúng-tuyển, đường-mòn, bỏ-phiếu, cá-voi, sự-lựa-chọn, phiếu
quan-niệm: khái-niệm, khái-niệm, nhận-thức, sự-nhận-thức, nhận-thức, khái-niệm, thiết-kế, bắt, bắt-giữ, bắt
say: có-chất-rượu
đổ-vào: té, rụng, tràn, lật-đổ
nâng: thang-máy, nâng, sự-nhướng, nâng-cao, đi-lang-thang
cử-chỉ: biển-báo, dấu-hiệu, biểu-tượng, biểu-tượng, thái-độ, tư-thế
quản-lý: quản-lý, giám-sát, tay-cầm, quản-lý, quản-lý, chỉ-đạo, kiểm-soát
trao-đổi: đổi, đối-ứng, sự-đổi-chác, sự-thay-thế
xác-định-bài báo: 
Hoàng-đế: vua
xa: xa-xôi, xa, đứng-cách-xa
xấu-xí: bẩn-thỉu, kinh-tởm
vô-hại: 
lăn: cuộn-giấy, xôn-xao
inch: Hải-quan, ngón-tay-cái
báo: tạp-chí, báo, Nhật-kí
râu: đầu, cái-cằm
nước-mắt: cướp
tiền-hoa-hồng: ủy-ban, bảng
trong-khi: trong-khi, trong-suốt
đi-qua: băng-qua, giao-lộ, đoạn-văn, đi-ngang-qua, quá-trình-chuyển đổi, gian-hàng
sự-độc-lập: độc-lập, quyền-tự-do, tự-do, quyền-tự-chủ, quyền-tự-trị
mùi: mùi-hôi, nước-hoa
mười-tám: 
lịch-sử: lịch-sử, lịch-sử, sử-gia
Tổng: toàn-bộ, tập-hợp, dơ-bẩn, sống, thô
gốc-cây: thân-cây, tươi
bùn: đất, đất-bùn, đất-sét, bụi, hoa
cô-dâu: bà-ngoại
mạng-che-mặt: bức-màn, buồm, bơi-thuyền
nhà-hát: nhà-hát
sự-so-sánh: so-sánh, tương-đối, sự-tương-quan, tỉ-lệ, đối-đầu
đối-thủ: phản-đối, bất-đồng-chính kiến, cuộc-thi, cạnh-tranh, cạnh-tranh
cân-đối: thế-cân-bằng, như-nhau, bình-đẳng, chiều-ngang, cân-đối, mệnh, ngân-sách
Huấn-luyện-viên: huấn-luyện-viên, học-viên, gia-sư, người-cố-vấn
hài: hài, khôi-hài, khí-sắc, hài-kịch
Tiểu-thuyết: viễn-tưởng, mới-mẻ, mới
trả-thù: mối-ác-cảm
ghen-tuông: lòng-ghen-tị, đố-kỵ
bánh-xe: xe-đạp, hình-tròn
cháy: đốt-cháy, loe
đèn-flash: sấm-chớp, phát-sáng, chiếu-sáng
sáng-tạo: sự-sáng-tạo, xây-dựng, xây-dựng, xây-dựng, chế-tạo, chế-tạo, soạn-nhạc, rèn-luyện, phát-ra
cuộc-xung-đột: sự-xung-đột, cuộc-tranh-đấu, đối-đầu, tương-phản, tai-nạn, va-chạm
nguyền-rủa: 
trù-rủa-tâm trạng: 
không-nơi-nương tựa: khốn-khổ
khả-quan: tích-cực
câu-lạc-bộ: con-dơi, khúc-gỗ
lũ: 
ngũ-cốc: ngũ-cốc, lúa-mì
thờ-ơ: lạt-lẽo, bất-cẩn, sơ-suất
chân-trời: 
kiêu-căng-tâm trạng: giả-tâm-trạng
dốc: độ-cao, dốc
hài-hòa: sự-thỏa-hiệp, điệu-nhạc
sấm-sét: 
thời-thơ-ấu: 
đầu-gối: vạt-áo
phần-mềm: đơn-xin, tiết-mục
chấn-thương: đau, Làm-hại, hư-hại, tổn-thương, vết-thương, vết-thương, bị-thương, sự-vi-phạm
biên-lai: nhận, cổng-vào, tiếp-nhận, nhận-vào, chấp-thuận, chứng-từ, nhận-con-nuôi
cho-phép: có-khả-năng, có-thẩm-quyền, hoạt-động, cho-phép, cho-phép, Mang, thi-hành, để-cho, ủy-quyền
màn-đầu-của vở kịch: 
trượt: trơn, trượt, trượt
Cuộc-cách-mạng: nhà-cách-mạng, đảo-chính, vòng-quay, làm-loạn, cuộc-nổi-loạn
người-nông-dân: nông-dân
Cú-đánh: thổi, đảo-chính, gấp-rút, chen-lấn,-xô đẩy
nền-tảng: sân-khấu, diễn-đàn, nền-tảng
sứ-giả: đại-biểu, đại-sứ, nhà-ngoại-giao
đặc-quyền: đặc-quyền, sự-ưa-thích, hạn-ngạch, nhượng-quyền-thương mại, phục-vụ, tô-giới
tổ-chức: tổ-chức, tổ-chức, tổ-chức, sắp-xếp, sắp-xếp
học-sinh: học-sinh, học-giả, đại-học
hang: 
truyền-thống: cổ-truyền, theo-truyền-thống, Hải-quan, đầu-hàng
thảm-kịch: dịch, nỗi-buồn
giã-từ: Tạm-biệt, tạm-biệt
sự-chỉ-trích: chỉ-trích, bài-phê-bình, kiểm-tra-lại
bông: len
bệnh-viện: nhà-thương-điên
thuê: giá, Thuê, thuế-suất, cống-vật, cho-thuê, thuê, thuê, thuê, hiến-chương
khí: 
không-thể-tránh khỏi: chắc-chắn
chết-người: 
lá-cây: tấm, lưỡi
công-bố: công-bố, xuất-bản, in-ấn, công-bố, phát-sóng, giải-phóng, đầu-ra, khuếch-tán, phiên-bản, thông-báo
thù-nghịch: không-thân-thiện, thù-địch
dịch: dịch, dịch, sự-giải-thích, dịch, chuyển-giao
tang-lễ: an-táng, nghĩa-trang
bột-mì: phấn, bột, chính-xác, chính-xác, tóm-lược, bữa-ăn
sự-tương-hợp: trao-đổi-thư tín, Liên-hệ, giao-tiếp, giao-tiếp
trữ-tình: 
túp-lều: nhà-tranh, lều
đề-xuất: đặt-ra, phục-vụ, vận-động, mệnh-đề, đề-nghị, đề-nghị, giới-thiệu, gợi-ý, thầu, chỉ-định
tài-bắt-chước: 
đô-la: 
ánh-sáng-ban ngày: 
mười-sáu: 
hội: buổi-họp, hội-nghị, Hội-nghị, cấu-hình
thuộc-địa: 
cánh: khu-vực, bộ
sư-tử: 
nền-văn-hóa: văn-hóa
cột: mảng, lớp, cực, đoạn-văn
xảo-quyệt: khôn-lanh, lừa, khéo
kịch: giả-bộ, kịch
câu-nói-đùa: đùa, wisecrack
sương-mù: sương-mù
thuốc-chữa-bệnh: ma-túy, phương-thuốc, Xịt-nước, toa-thuốc
mười-bốn: 
chua: chua, có-tính-axit
cụ-thể-là: bất-kì, ví-dụ:, cụ-thể
mức-thu-nhập: ren
giám-mục: 
màu-cam: 
bồn-tắm: phòng-tắm, vòi-hoa-sen, bồn-tắm
nguyên-thủy: sớm, lúc-đầu
cái-giỏ: thùng-rác, cái-cặp-sách
Thư-ký: 
rơm: cỏ-khô
nóng-nảy: háo-hức
sự-cứu-rỗi: sự-an-toàn, giải-phóng, Chào
thuộc-về-ngày nay căng: 
có-ý-định: dụng-ý, mục-đích, quan-tâm, quan-tâm, động-cơ, không-sẵn-sàng, cống-hiến, dâng
Hơi-nước: hơi-nước
chất-độc: độc, chất-độc, thuốc-diệt-cỏ
năng-lực: sáng-chói, có-tài, năng-lực, khả-năng, tiết-mục
khí-hậu: thời-tiết
có-hiệu-lực: có-hiệu-lực, hiệu-quả, hiệu-quả, hiệu-quả, có-ảnh-hưởng, bổ-ích, khả-thi
phân-biệt: phân-biệt, phân-biệt, phân-biệt, phân-biệt, chỉ-định, to--chia, bỏ-qua, loại-trừ, tiết
rửa: giặt-giũ
lời-thú-tội: công-nhận, tín-điều, sự-thừa-nhận
vô-lý: rác, vô-lý, vô-lý
than-đá: carbon
xuồng: 
tạm-thời: khoảng-thời-gian, thời-gian, thời-gian, bất-ngờ, trong-khi
delimitative-diện-mạo: 
khúc-xương: Chân
Thứ-hai: 
thứ-ba: thứ-ba
thứ-tư: thứ-tư
liên-bang: liên-đoàn, trung-tâm
ao-ước: hấp-dẫn, thuận-tiện
Tiêu-biểu: đại-diện, thay-mặt, đại-biểu, luật-sư, Phó, phát-ngôn-viên
lanh: cây-gai, Nội-y
bồn-nước: chết-chìm, lưu-vực, kẽm
cháu-trai: cháu-gái, cháu-trai, cháu-ngoại
dính-máu: đổ-máu, chảy-máu
sự-bao-vây: bao-quanh, chỗ-ngồi
Dạ-dày: bụng, bụng, bụng, ma-trận
thau: huy-chương-đồng, đồng, cơm
đỉnh: đỉnh, đỉnh, đầu
thứ-năm: năm
rẻ: rẻ, thấp
độc-quyền-một người: 
chiếm: giải-quyết, nhốt, giam, đặt-phòng, cướp, chiếm, chiếm, nhốt, vồ-lấy, sự-hiểu-biết
hàng-rào: hàng-rào
bức-tượng: điêu-khắc
Súng-đại-bác: súng-thần-công
ôm-hôn: hấp-thụ, ôm-chặt-vào lòng
xung-quanh: vòng-quanh, khu-vực-lân cận, hàng-xóm, hàng-xóm, khu-vực-lân cận, chu-vi, môi-trường-xung quanh, liền-kề, lân-cận
nghiêm-khắc: khắt-khe, kết-hợp, chính-xác, chật, nghiêm-khắc, chắc-chắn, chắc-chắn-rồi, chắc-chắn, chặt-chẽ, thô
con-hươu: 
bụi-gai: 
đường-sắt: đường-sắt, đường-sắt
phóng-điện: giải-phóng, dỡ-bỏ, giải-phóng, từ-chức, trục-xuất
người-kế-thừa: thừa-kế
cây-sồi: 
khó-chịu: vui-mừng, làm-hài-lòng, khó-chịu, khó-chịu, khó-chịu, bẩn-thỉu, không-thoải-mái
phát-minh: phát-minh, khám-phá, sự-đổi-mới
Dương-cầm: 
khuyên: sự-thuyết-phục, tán-dương, kỷ-niệm
tàng-hình: thần-bí
ai-cũng-biết: nổi-danh, khét-tiếng, đáng-chú-ý
tàn-ác: 
sự-cám-dỗ: 
telic-diện-mạo: 
kinh-tế: nền-kinh-tế, kinh-tế, kinh-tế, tài-chính
quốc-tế: toàn-cầu, đa-quốc-gia
gây-trở-ngại: sự-can-thiệp, sự-can-thiệp, can-thiệp-vào, làm-phiền, làm-phiền, phiền, làm-gián-đoạn, làm-phiền, kích-thích, quấy-rầy, sự-xung-đột
nhà-triết-học: triết-học
tao-nhã: hợp-thời-trang, tinh-vi
phúc-lợi: lòng-nhân-từ, sự-phồn-thịnh, cung-cấp
đánh-bắt-cá: 
lấy-trộm: trộm, cướp, cướp, swipe
môi: mỏ, miệng, bờ-vực
về-hưu: nghỉ-hưu, về-hưu, người-về-hưu, rút-lui, còn-lại, giải-trí, rút, từ-bỏ
căng-ra: thẳng, gia-hạn, đường, đặc-điểm, cái, đoạn-văn, miếng, đoạn
bộ-sưu-tập: bộ-sưu-tập
song-song: bên-cạnh, tương-hợp, kết-hợp, đóng-dấu
atelic-diện-mạo: 
lục-địa: lục-địa
cấm-tâm-trạng: cấm-khí-sắc
bó-lại: cà-ra-vát, chim-ưng
tế-bào: Bản-chất, trung-tâm, lồng, phiên-bản, di-động, điện-thoại-di động, điện-thoại-di động
trứng: hòn-dái
nhân-tạo: sợi-tổng-hợp
Trong-khi-đó: đồng-loạt
cuộc-khủng-hoảng: sụt-giảm, phán-xét, phán-xét, khẩn-cấp
lịch-sự: lịch-sự, giáo-dục
bữa-ăn-trưa: bữa-ăn-sáng, bữa-tối
cây-thông: quai-hàm
đẩy: ép, lái-xe, khuyến-khích, khuyến-khích, đẩy, sức-ép
liên-minh: công-đoàn, liên-đoàn, sự-liên-minh, kết-hợp, công-ty
thắt-lưng: hông, cuộc-sống, sống, ở-giữa, ở-giữa, trung
phép-màu: ngạc-nhiên
thủy-thủ: 
tinh-khiết: trinh-tiết
cộng-hòa: chế-độ-dân chủ
Điện-thoại: điện-thoại, di-động
roi-da: 
áo-sơ-mi: Áo-thun
giới-thiệu: sự-giới-thiệu, sự-trình-bày, thiết-lập, khởi-đầu, trả-lại, cung-cấp, giới-thiệu, giới-thiệu, chích, giao-hàng, giao-hàng, miêu-tả, miêu-tả
ghế-sô-pha: Ghế
quét: lau, cái-cào, quét
người-ăn-trộm: ông-chủ
giữ-lại: bảo-tồn, dự-trữ, đặt-phòng, khôi-phục, giữ, chế-ngự, giam, chịu-được, thuê, sự-bảo-tồn, chịu-được, bảo-tồn, duy-trì, tham-gia
kênh: ống
nhân-cách: nhân-vật
cải-cách: sự-cải-thiện, điều-chỉnh, tiến-hóa, tu-chính
đe-dọa: mối-đe-dọa, hăm-dọa, nguy-hiểm, khủng-khiếp
cây-cọ: cây-phong
cái-loa: phát-ngôn-viên
ngưỡng: rào-chắn
khiến: hành-lang, thúc-giục, gây-nên, cảnh-báo, kích-thích, đặt-ra, chì, cám-dỗ, gợi-lên
thương: thay-thế
khéo-léo: dọn-dẹp, lau-sạch, căng-thẳng
buổi-họp: buổi-họp, hội-nghị
tra-tấn: đau-khổ
ẩm: bụi, bị-ướt, chảy-nước-mũi, oi-bức
cây-rơm: đỉnh, bím-tóc, cây-rơm, chải
du-khách: du-khách, du-khách, du-khách, hành-khách
máy-xay: Nha-may, chế-tạo, cây
bản-đồ: Thẻ, giản-đồ, đồ-thị, giá, vé
cổ-áo: bao-quanh
thay-thế: sự-thay-thế, thay-thế, thay-thế, thay-thế, thay-thế, thay-thế, thay-thế, thay-đổi, khác-nhau, tu-chính, phụ
cố-tình: có-ý, cố-ý, biết, có-ý-thức, cố-ý
bia: pint
nhung: 
nghiêm-trọng: sức-hút, nghiền-nát
bài-thuyết-giáo: thuyết-giáo
lạm-dụng: lầm, sai
đàn: nhóm, bầy, hàng-loạt, leo-lên-cây
mười-ba: 
biện-hộ: trát, biện-hộ, biện-hộ, sự-biện-hộ, hợp-lý
Thứ-sáu: bạc, sao-Kim
chải: chải
tải-về: 
kem: kem
cheo-leo: Cục-đá, bờ-vực
ban-bồi-thẩm: 
con-quái-vật: khổng-lồ, quái-dị
đông-lạnh: Đông-lại
nồi: cái-chảo, bình, thùng-hàng
đồng-xu: phần-trăm
năn-nỉ: lớn, đẩy, đòi, nhấn-mạnh, nhấn-mạnh, kiên-gan, khăng-khăng, yêu-cầu, tranh-luận
quả-táo: 
bàn-luận: thảo-luận, đàm-phán, tranh-luận
Bối-cảnh: 
chép-lại: phỏng-theo, viết-lại
định-kỳ: bình-thường, tuần-hoàn
giải-trí: giải-trí, nghệ-sĩ, giải-trí, giải-trí, giải-trí, niềm-vui, sở-thích
vi-rút: 
trẻ-con: soprano
phản-chiếu: sự-trầm-tư, thiền, suy-nghĩ, minh-họa, miêu-tả
chuyển-đổi: thay-đổi, biến-đổi, công-tắc-điện, sự-biến-đổi
dàn-bài: Hồ-sơ, đường-viền, Tổng-kết, phác-họa, vạch-trần, tổng-quan, bản-nháp
nhạc-kịch: 
sự-chấp-thuận: phê-duyệt, không-chấp, bằng-lòng, chấp-thuận, quả-quyết, phê-duyệt, thừa-nhận, nhận-con-nuôi, vỗ-tay
phản-bội: tiết-lộ, lừa-dối, thất-vọng
trừng-phạt: người-bị-kết án
khuỷu-tay: dấu-ngoặc
tập-tin-đính kèm: phụ-lục, sự-liên-kết, vá, liên-kết, kết-nối
sửa: phục-hồi, sự-cải-thiện, xây-lại, điều-chỉnh
khả-nghi: sự-nghi-ngờ, nghi-ngờ
bảy-mươi: 
thánh-kinh: kinh-thánh, kịch-bản
hố: lỗ-thủng, moi-lên, hồ-bơi
xáo-trộn: hỗn-loạn, tình-trạng-hổn loạn, lo-âu, băn-khoăn, hỗn-độn, khó-chịu, sự-can-thiệp, sự-lúng-túng
nhị-phân: cặp-đôi
tu-viện: tu-viện
mũi-tên: 
có-xu-hướng: chịu-trách-nhiệm, thông-thường, thường, thường
kỹ-lưỡng: chi-tiết, định-nghĩa, làm-rõ, phát-triển, phức-tạp, khôn-lanh, tập-thể-dục
lòng-trung-thành: hết-lòng, trung-thành, sự-tin-tưởng, trung-thành, nói-thật-là, không-tin-tưởng, tin-tưởng, lòng-tin, niềm-tin
tiền-xu: tiền-tệ
rung-rinh: làm-bể
tha-hương: bắn, Hải-ngoại
cơ-khí: máy-móc, thợ-cơ-khí, kĩ-sư
bẩy: nắm-chặt, người-bị-kết án
bánh-ngọt: bánh, Cookie, bột
quý-ngài: Ông, quí-ông, Chúa-tể, quý-ông
do-dự: đập, ám-ảnh, tần-số, hover
mười-bảy: 
Cục-cưng: 
cổ-phần: cá-cược, tỷ-lệ, cái-nêm, chồng-chất, chia-sẻ, phần, sự-đóng-góp
bước-đi: di-chuyển, lừa, đi-bộ, đang-đi, bàn-đạp, bước-đi, đi-bước-dài, thanh-ngang
gạch: gạch
tám-mươi: 
không-may: không-may, không-may, thật-đáng-buồn
tham-khảo: Tư-vấn, tham-khảo
huyền-thoại: chuyện-thần-thoại
mùa-gặt: trồng-trọt
khuyến-mãi: nâng, khuyến-khích, sự-giới-thiệu, sự-trình-bày, sự-công-khai
bếp: nồi-cơm-điện, slab, lò-nướng
phiến-loạn: làm-loạn, cuộc-nổi-loạn
cổ-hủ: xưa
sưng-lên: lạm-phát, sưng-lên, sự-lạm-phát, sưng-tấy, phóng-to
đầm-lầy: đầm-lầy
nước-sốt: nước-xốt, băng-bó
khổ-tu: ẩn-sĩ
giám-đốc: người-quản-lý, chánh, ông-chủ, người-quản-lý, giám-đốc, người-điều-hành, lãnh-đạo, chấp-hành
điệp-khúc: lái-xe, đội
hợp-lý: hợp-lý, Logic, logic, vô-lý, hợp-lý, phải-chăng, hợp-lí
Chế-biến: 
chó-sói: 
thảm: tấm-thảm
cổ-xưa: 
phì-nhiêu: 
Còi: ống-sáo
phô-mai: 
cắn: chặt, khắc, sự-chua-chát
mời: lời-mời
thánh-đường: chùa
Bến-cảng: cảng
đi-lang-thang: đi-dạo, di-cư, đi-lang-thang
cây-trồng: trồng-trọt
Hải-quân: ở-biển, hạm-đội
mặt-nạ: mặt-ngoài, sâu
bút-chì: cây-bút
rau: ăn-chay
tang-vật: triển-lãm, phục-vụ, trưng-bày, sự-trình-bày, triệu-chứng, Phơi-bày
quần: quần, quân-dai
tham-nhũng: scandal, sự-ô-nhiễm
buồng: cái-tủ, tủ-quần-áo, tủ-quần-áo, cầu-tiêu
canh: 
bác-sĩ-phẫu thuật: Phẫu-thuật, phẫu-thuật, hoạt-động
phụ-cấp: sự-thay-thế, thay-thế, đền-bù, sự-ghép-lại, phân-bổ, phụ-lục
gián-điệp: 
táo-bạo: bất-cẩn, Lộn-xộn
ngồi-lê-đôi mách: lời-đồn, lời-đồn
mã-thông-báo: 
trừu-tượng: Tổng-kết, giáo-trình
Thứ-năm: 
giao-thông: sự-lưu-thông, giao-thông-vận tải, phương-tiện-vận chuyển
kiến-trúc: 
vết-nứt: đường-nứt, nứt, khởi-hành, bỏ, gãy-xương
trang-trí: trang-trí, trang-trí, trang-hoàng, đồ-kim-hoàn, tỉa
đảo-ngược: trái, ngược, công-tắc-điện, đảo-ngược, bất-lợi, lộn-ngược, phía-sau
làm-cho-vui: giải-trí, giải-trí, lừa-quân-địch
phục-hồi: phục-hồi, giải-thoát, sự-cải-thiện, hồi-sinh, bình-phục, khôi-phục, xây-lại
vỉa-hè: lề-đường, sân-cỏ, dầu-hắc, đất-bùn, bao-gồm
quyết-định: quyết-định, quan-trọng, xác-định, quyết-định, quả-quyết
phủ-định: bất-lợi
lễ-hội: buổi-hòa-nhạc
giảm: giảm, giảm-bớt, giảm-bớt, giải-tỏa, giảm-thiểu, làm-suy-giảm, chém, tỉa, trừ, nhốt, hạn-chế
sự-làm-phản: 
thợ-săn: 
con-rắn: loài-bò-sát
ắc-quy: 
sáp: cây-nến
thám-tử: người-điều-tra
nghiên-cứu: phân-tích, nghiên-cứu, học, xem-xét, thanh-tra, thăm-dò, độ-phân-giải, phá-vỡ, phá-vỡ
nhấn-mạnh: đọc-nhấn-mạnh, sức-ép, nhấn-mạnh, nhấn-mạnh, nhấn-mạnh, giọng, quả-quyết, chú-ý
bơi: bơi-lội
phong-bì: tình-huống, trạng-từ, vỏ-kiếm
bất-cứ-ai: ai, có-ai, ai, mọi-người
thuốc-lá: hút-thuốc, thuốc-lá
động-cơ: xe-hơi, động-cơ, động-cơ, xe-máy
Tình-nguyện: dâng, tình-nguyện
sự-phản-ứng: phản-ứng, phản-ứng, đáp-ứng, phản-ứng, thông-tin-phản hồi
hành-lý: Hành-lý, vận-tải-hàng hóa, Thân-cây, va-li
điếc: 
nước-ép: giải-nén
khiêm-tốn: sự-đơn-giản, khiêm-tốn
Bộ: 
tình-dục: tình-dục, tình-dục
đường-kính: 
rìu: 
kim-cương: 
luân-phiên: thay-thế, thay-thế, thay-thế, Tùy-chọn, Phó, sự-thay-thế, ghép
bắt-chước: 
sự-hạn-chế: chế-ngự, lề-đường, sự-hạn-chế, sự-hạn-chế, hạn-chế
bản-sắc: nhận-định, nhận-biết, biểu-tượng
màn: trưng-bày, bức-màn
lười-biếng: hư
momentane-diện-mạo: 
chắc: phù-hợp, chắc, dầy-đặc
trôi-giạt: hoạt-động, lệch, xu-hướng, khuynh-hướng
biến-mất: bị-tiêu-diệt
cá-đuối: chùm-tia, gian-hàng, bán-kính
mực: 
to-lớn: lớn, lớn, khổng-lồ, to-lớn, rất-lớn, to-lớn, to-lớn
hầm: 
đáng-ghi-nhớ: đáng-chú-ý
chói: phát-sáng, chiếu-sáng, sáng-chói
Thượng-nghị-viện: nghị-viện
quan-tài: 
sự-tha-thứ: 
nuốt: một-hớp
thưởng-thức: theo-đuổi, làm-vui-lòng
lung-lay: 
đồng-cỏ: ăn-cỏ, trước, cỏ
phức-tạp: phức-tạp, phức-tạp, tinh-vi, phức-tạp, khôn-lanh
sự-từ-chức: từ-bỏ, nghỉ-hưu
khiêm-tốn-ghi danh: 
âm-mưu: Thửa
cây-tiêu: 
ngựa-con: 
ứng-cử-viên: đơn
cáo: 
ống-khói: lò-sưởi, cây-rơm
quyền-tài-phán: chính-quyền, phán-xét, phán-xét, thẩm-quyền
nông-nghiệp: nông-nghiệp, nông-nghiệp
tính-chính-xác: độ-chính-xác, trinh-tiết, chính-xác, đúng, tính-trung-thực
trước-đây-người chết: 
dân-chủ: 
đọt-non: nhô-lên, đâm-chồi
cái-mền: trần-nhà, bao-gồm, tấm-thảm, bảo-hiểm
kêu: chiếm, chào
con-heo: lợn-nái
hình: con-số, hình-thù, sung, mặt-nhỏ
ngà-voi: 
cổ-điển: cổ-điển, cổ-truyền
quan-sát-viên: giám-sát, du-khách
con-voi: 
móng-tay: cái-đinh
con-ong: 
chôn: an-táng, nhúng
diễn-viên: nữ-diễn-viên, độ, nguyên-cáo
mồ-hôi: 
đánh-bóng: thổ-ngữ
ảo-giác: gian-lận
tính-không-chắc chắn: không-chắc-chắn, mơ-hồ
thứ-cấp: nhỏ, Trung-bình, Trung-bình-cộng, vừa-phải, chính, trung
gập-lại: gấp
nông-thôn: tỉnh, nông-thôn, dân-làng
than-van: 
giống-nhau: giống, sự-giống-nhau, nhắc-lại
Trích-dẫn: giải-nén, bảng-báo-giá, unquote, cho-mượn, mượn, cho-vay
bao: bỏ-qua, giải-tán, cái-cặp-sách
điều-khó-chịu: băn-khoăn, sự-can-thiệp, gián-đoạn, khó-nhọc, nhàm-chán, làm-phiền
cây-kim: chích-thuốc, ống-tiêm, bút, ghim
được-kiểm-soát: kiểm-soát
gà: con-gà-mái
thích-hợp: cố-chấp, tương-hợp, bê-tông, ngầm, thích-hợp, thích-hợp, thích-hợp, kết-hợp, nối-tiếp, cân-bằng, vững-chắc
thùng-rượu: cái-xô
thường-lệ-diện mạo: 
chuyên-gia: chuyên-gia, có-kinh-nghiệm, đặc-biệt, đặc-biệt
gây-ấn-tượng: có-ảnh-hưởng đến, ấn-tượng, thu-hút
ôliu: 
van: van
trở-ngại: làm-gián-đoạn, hạn-chế, người-tàn-tật, rào-chắn, thất-bại
gật-đầu: 
nuôi: trồng-trọt, rau-bina, khuyến-khích, tạo-điều-kiện, nuôi, ủng-hộ, ủng-hộ
Định-nghĩa: bình-luận, nhận-biết, miêu-tả, sự-quyết-tâm
ngày-sinh-nhật: ngày-kỷ-niệm
búa: 
thơm: 
sự-lập-lại: nặng, nơi-đến, lặp-lại, tái-tạo, diễn-tập
tầm-thường: nhỏ-mọn, không-quan-trọng
đá: đánh, băng, bóng-đá, canxi, bóng-đá, thổi
đào: đào, máy-khoan, moi-lên
con-vật-cưng: 
sọ: 
cơ-quan-lập pháp: nghị-viện, lập-pháp, pháp-luật
gót-chân: nhảy
nhăn-mặt: 
bằng-sáng-chế: 
tỷ: 
hóa-chất: hóa-học, hóa-học, nhà-hóa-học
Phi-công: làm-thí-nghiệm, thực-nghiệm
theo-gương: mô-phỏng, mô-phỏng, tái-tạo, tái-sản-xuất
chiếc-váy: Cục-đá
bất-thường: bất-thường, dị-thường, số-lẻ, đáng-chú-ý, phi-thường, không-thể-tin được, không-thường-xuyên, hiện-tượng, vô-cùng, cực-kì, kỳ-quặc
hàng-tuần: 
kĩ-thuật: kỹ-thuật, Công-nghệ, kỹ-thuật, công-nghệ
thảm-thực-vật: 
con-quạ: cờ-bạc-gian lận
mặt-trời-mọc: 
cả-đời: cuộc-sống, Sự-sống-còn, lối-sống, sống
Góp-phần: sự-đóng-góp, tặng, công-ty, khuyến-khích, tạo-điều-kiện
cái-móc: quan-hệ, kết-nối, tương-quan, dấu-ngoặc
Cọp: 
xuyên-qua: khoan, xuyên-qua, có-ảnh-hưởng
tay-áo: cánh-tay
Xa-lộ: đường
dân-quân: 
rãnh: mương, thân-cây
toàn-vẹn: 
mười-chín: 
hữu-cơ: 
khoa-thần-học: 
phao: con-thuyền, hover, hạm-đội
bà-phù-thủy: 
chán: buồn-chán, nhàm-chán
ngoại-giao: nhà-ngoại-giao
phòng-thu: nhãn, xưởng, học
quá: xâm-lược, hãm-hiếp, khắc-phục, băng-qua
rượu-sâm-banh: 
cảm-hứng: khuyến-khích, cảm-hứng, đáng-khích-lệ, hít-vào
cờ: lá-cờ, áp-phích, vé
ly-hôn: đã-ly-dị
chớp: sấm-chớp, cái-đinh, xoắn, Đinh-ốc
tĩnh-mạch: thần-kinh
thụ-động: khán-giả, tàn-tật
bọt: bong-bóng
đá-sỏi: 
khăn: vạt-áo
hành-tinh: 
giá-để-hàng: giá-đỡ, cái-tủ
cái-quạt: 
nhiệt-đới: 
giai-đoạn: nhiếp-ảnh, sân-khấu, giai-đoạn, xây-dựng, bước-đi
độc-đoán: tự-phát
phát-âm: cách-phát-âm, giọng, sự-bày-tỏ, utter
thủy-ngân: 
leo: bò, leo, cừu
tự-vận: 
phóng-viên: nhà-báo
tước-đoạt: bị-tước-quyền, hủy-bỏ, loại-trừ, trừ
giỏi: khéo, hiệu-quả, có-khả-năng, có-tài, có-kinh-nghiệm, có-đủ-năng lực, thông-minh
ban-công: sân-thượng, cổng
cái-nĩa: 
công-nhân: người-làm-việc, người-lao-động, làm-việc, hệ-số, phụ-thuộc, nhân-viên-bán hàng
nhà-tuyển-dụng: ông-chủ
bề-rộng: mở-rộng, cung-cấp, rộng, bán
bị-kích-thích: khó-chịu, bị-kích-thích, kích-thích, chọc-giận, sự-khuyến-khích
tố-cáo: tố-cáo
tiền-cấp-dưỡng: nghỉ-hưu, cú-pháp
động-từ: hành-động, phản-ứng
con-khỉ: 
chấp-nhận-được: Chấp-nhận, chấp-thuận, chính-đáng
chữ-ký: 
chánh-thống: bảo-thủ
trớ-trêu: đùa, xoắn
vườn-ươm: trồng
miễn-cưỡng: không-thích
nhập-khẩu: sự-giới-thiệu
đuốc: 
ngữ-pháp: ngữ-pháp
gửi-tiền: tích-trữ
thực-dân: 
du-thuyền: phà, con-thuyền
theo-sau: hậu-quả, tập-phim, quan-trọng, đáng-kể, hàng-đầu, đáng-chú-ý, đáng-kể, quan-trọng, trọng-yếu, đầy-ý-nghĩa
mái-vòm: 
độ-dày: 
bướng-bỉnh: quả-quyết
bắp-thịt: 
độ-lớn: kích-cỡ, số-lượng-lớn, độ-lớn, gauge, số-lượng
chà: 
hèn-nhát: 
yên-cương: liên-Hợp, hợp-nhất, hợp-nhất, sử-dụng, dây-lưng
bánh-mì-nướng: snack
chuột: chuột-cống
vần: 
vuốt-nhẹ: tiếng-vổ-tay, đập
cuộc-đối-thoại: giao-tiếp, cuộc-hội-thoại
Trung-lập: giữ-thái-độ trung lập
siêng-năng: nhiệt-tâm, canh-giữ
sự-mâu-thuẩn: trái-ngược, tranh-cãi, mơ-hồ, khó-hiểu, gây-tranh-cãi, mơ-hồ, nghịch-lý, mâu-thuẫn, đúng, sự-phản-đối
Hoàn-thành: nhận-ra, đến, đến
con-dê: 
mọc-lên: sự-phồn-thịnh, phát-đạt, bùng-nổ, ngọc-đá-quý, ngọc
áp-đặt: lực-lượng, thi-hành, xác-định
vô-danh: 
chính-thức-ghi danh: 
bò-con: vội
nhãn-hiệu: hướng-dẫn, hướng-dẫn, nhãn-hiệu, khả-năng-lãnh đạo, sách-giáo-khoa, chỉ-dẫn, lãnh-đạo, giám-sát
làm-tan: bốc-hơi, làm-cho-tan, dung-hợp
xóa-bỏ: tẩy-xóa, hòa-tan, hủy-bỏ, gỡ-bỏ, loại-trừ, bỏ, loại-bỏ, loại-bỏ
ô: cái-dù-bay
khởi-động: giày, Thân-cây
khoáng-chất: iốt, chất-bổ-dưỡng, kim-khí
cuộc-hưu-chiến: ngưng-bắn
con-vịt: 
lập-kế-hoạch: 
xà-bông: 
búp-bê: bé-con, đồ-chơi
bộ-xương: 
Biệt-thự: bà-tiên
May: khâu, may
hòa-giải: trung-gian, liên-Hợp, hợp-nhất
ấm-đun-nước: 
chín-chắn: người-lớn
con-thỏ: 
Nhạc-trưởng: thang, người-quản-lý, lái-xe, lãnh-đạo
sự-phụ-thuộc: phụ-thuộc, sự-tín-nhiệm, phụ-thuộc, nghiện, thân-thuộc, thái-độ
người-chơi: độ
côn-trùng: côn-trùng
nhà-hàng: 
chim-cú: 
cấp-tiến: chiến-đấu, cực-đoan, cấp-tiến
cư-dân: dân-cư, tự-nhiên, trong-nước, bản-địa
con-rồng: cánh-diều
thính-giác-chứng cớ: 
khát-nước: 
kéo-dài: kéo-dài
tính: tính-toán, tính-toán, máy-tính, tính-toán, tính, tài-khoản, điều-tra-dân số
Quy-định: sự-kiểm-duyệt, kiểm-soát, hạn-chế, sự-hạn-chế, giải-quyết
thị-trưởng: 
thiểu-số: 
mua-lại: có-được, lợi, mua, quyền, sẵn-có
cựu-chiến-binh: cao-cấp
dàn-nhạc: 
Thịt-ba-rọi: 
bất-lợi: sự-mất, bị-tước-quyền, bất-lợi, lỗ-hổng, người-tàn-tật
vải: tấm-vải, quần-áo, khăn-tắm, Tranh-sơn-dầu, mô
nhạc-sĩ: người-soạn-nhạc, âm-nhạc
tinh-thần: tinh-thần, tâm-thần, tinh-thần, mana, chủ-quan
kết-hợp: hợp-tác, sự-liên-kết, phức-tạp, sự-kết-hợp, kết-hợp, kết-hợp, kết-hợp, bên-cạnh, liên-tục, mối-liên-kết
không-đủ: thiếu-xót, không-đủ, thiếu-sót, khốn-khổ, dưới, vụng-về, phong-phú, không-may, vô-lý, không-thích-hợp
kiến-trúc-sư: 
chanh: 
ho: ho
đau-đầu: 
người-thuê-nhà: kế-hoạch
khả-năng-sinh sản: sinh-sản
chữa-lành: chữa, cải-thiện, tăng-cường, sự-cải-thiện, xử-lý
chín-mươi: 
ngẫu-nhiên: ngẫu-nhiên, randomize, bất-ngờ
cái-muỗng: cái-xô
khí-cầu: 
phấn-viết-bảng: thạch-cao
suy-luận-chứng cớ: 
nhà-phát-hành: Biên-tập-viên
giấm: 
tro: màu-xám, màu-xám
lời-nguyền: sự-tuyên-thệ
sống-lại: hồi-sinh
nhạy-cảm: dễ-bị-tổn thương, nhạy-cảm, hợp-lý, đa-cảm, chịu-trách-nhiệm
đường-hầm: xe-điện-ngầm
câu-đố: gây-nhầm-lẫn, khó-hiểu
cơ-chế: phương-pháp, thói-quen, có-hệ-thống, máy-móc
toán: toán, toán-học
phai: 
Gan: 
Sublative-trường-hợp: 
nhúng: lặn, nhúng, rơi-vãi, tình-trạng-lộn xộn, tỷ-lệ, độ-dốc, giốc, dốc, Gradient, ngâm
đơn-vị: thống-nhất, thực-thể, mô-đun, mỏ, số-ít
độc-quyền: độc-quyền
bài-bạc: cờ-bạc, trò-chơi, phù-hợp, giải-tỏa, đồ-chơi
tàu-ngầm: dưới-nước
động-đất: chứng-động-kinh
phòng-thí-nghiệm: phòng-thí-nghiệm
điên-điển: nấm, nấm, mũ-lưỡi-trai
tự-kiểm-soát: 
Phật: 
dệt-kim: đan, cách-dệt, đẩy, dệt-kim, thắt-nút, nút, bím-tóc
đại-sứ-quán: 
xa-nhất: 
khai-báo-tâm trạng: 
kích-thích-kinh tế: sự-khuyến-khích, khuyến-khích, công-thức, động-lực, động-cơ
sô-cô-la: Cục-kẹo
trùng: cơ-hội, sự-kết-hợp, không-may, ngẫu-nhiên, bất-ngờ, phù-hợp
găng-tay: 
quì-gối: 
môn-Địa-lí: 
đầu-tư: đầu-tư, mạo-hiểm
bằng-lời-nói: văn-nói, miệng, lăng-nhục
phép-loại-suy: bình-đẳng, sự-giống-nhau, thân-thuộc, thân-thích, tỉ-lệ
thế-tục: nằm-xuống
chim-ưng: chim-ưng
tâm-lý-học: 
đóng-lại: quan-hệ, buộc, kết-nối, băng-bó, bắt-giữ, đính-kèm
sắt-vụn: hủy-bỏ, rác, rác, miếng
vai-trò: cái-ròng-rọc, chia-sẻ, chứng-khoán, tham-gia
liều-thuốc: số-lượng
cá-hồi: 
bánh-pudding: 
có-từ-tính: hấp-dẫn
máy-bơm: bom
ôxy: 
giấy-chứng-nhận: 
huy-chương: 
thuật-hùng-biện: 
làm-trầy: vết-trầy, gặm-cỏ
chèo: cái-xẻng, vây
kính-viễn-vọng: kính-hiển-vi
chuỗi-hạt: đánh-bại, dán
chính-tả: Đánh-vần
whisky: 
liễu: ăn-cỏ
con-lạc-đà: 
nghiệp-dư: 
lối-thoát: xuất-khẩu, lối-ra, sự-xuất-hiện, đầu-ra
tiểu-sử: 
con-lừa: 
hằng-tháng: 
bỏ-qua: bỏ-bê, bỏ-qua, bỏ-qua, dốt-nát
kì-nghỉ: rời-bỏ, ngày-lễ, giải-trí, còn-lại
nhấp-chuột: đảng-phái, đong-tach
hình-trái-xoan: 
dây-cao-su: cao-su, linh-hoạt
tự-điển: từ-nguyên-học, ngữ-vựng
giăm-bông: bắp-vế, mông-đít
cầu-vồng: 
tiêu-thụ: sự-tiêu-thụ, sử-dụng, triển-khai
nước-miếng: người-bạn-đời, cái-lưỡi
xe-tăng: hồ-chứa, thùng-hàng, vat
bạn-đồng-nghiệp: hợp-tác, bạn-bè, người-bạn-đời, kết-hợp
Con-bướm: 
biểu-đồ: giản-đồ, đồ-thị, đồ-họa, đồ-họa, lịch-trình, kế-hoạch
sinh-đôi: gấp-đôi, hai
độc-lập: độc-lập, tự-do, cách-nhau
cây-tre: 
người-chia-bài: người-bán-lẻ, người-buôn-bán, nhân-viên-bán hàng, thương-thuyền
tích-lũy: tích-trữ, bộ-sưu-tập, nồng-độ
viên-thanh-tra: người-kiểm-tra, người-quản-lý
miếng: miếng, lát, một-chút
cơn-ác-mộng: mơ-tưởng
mứt: thạch
bảo-tàng: 
bảng-chữ-cái: thuộc-về-mẫu tự
tiêu-tan: triển-khai, Lan-tràn
bố-ráp: nghề, cuộc-xâm-lược, tấn-công, phản-cảm, tấn-công, có-ưu-thế, đày
tiết-lộ: thông-báo, tiết-lộ, khám-phá, vạch-trần, hủy-bỏ, công-bố, khám-phá
thúi: phân-rã, hư-hỏng
hung-hăng: làm-phiền, hỗn-độn, nghề, xâm-lược, phản-cảm, quả-quyết
ma-sát: 
Bến-tàu: 
con-nhện: 
khoai-tây: 
sửa-đổi: điều-chỉnh, sửa-đổi, xem-lại, điều-chỉnh, tu-chính, kiểm-tra-lại, kiểm-tra
tham-lam: tham-lam
sớm: sớm, băng
nhân: đánh, giống, băng
quay: quay, vòng-quay, xoắn-ốc, sợi-chỉ, xoắn
số-liệu-thống kê: thống-kê, con-số, trò-chuyện
lịch: lịch-trình, thời-gian-biểu, Nhật-kí, góc-nhìn
đề-cử: chỉ-định, cuộc-hẹn, sự-lựa-chọn, hôn-ước
nghìn-tỷ: 
tầng-áp-mái: gió
khẳng-định-tâm trạng: 
các-ứng-dụng: 
hư-danh: 
không-bằng-lòng: 
nhiễm-trùng: lây-nhiễm, nhiễm, quá-trình-chuyển đổi, truyền-dẫn, truyền-nhiễm
bình: bình
nhún-vai: làm-co-rút
tiên-phong: chính, avant-garde
bỏ-xót: mặc-định, điều-lầm-lỗi, thiếu-sót, sơ-suất, bỏ-bê, loại-bỏ
cải-bắp: 
Khỏe-mạnh: điền-kinh, toán-học, lực-sĩ
người-say-rượu: đường
idiophone: 
đòn-bẩy: nâng-lên
thượng-nghị-sĩ: 
iris: 
con-kiến: 
bọ: 
Có-thai: thuộc-về-mẹ
làm-kết-tủa: sự-kết-tủa, trầm-tích, vận-tốc, khẩn-cấp, đẩy-nhanh-tiến độ
mắt-cá: 
phân-loại: loại, phân-loại, phân-loại
biến-số: khác-nhau
bọc: đóng-gói, Bưu-kiện, gói, đóng-hàng, ống-chỉ, gói, bao-gồm, bao-gồm
quăn: curl, quăn, xôn-xao, cuộn-giấy, vành-tai
lưu-huỳnh: lưu-huỳnh, bị-gãy
bắt-buộc: 
hiện-ra: hiện-ra, Dáng-vẻ-bên ngoài, nảy-sinh, sự-xuất-hiện, bỏ
con-ếch: 
quá-đáng-trường hợp: 
bọt-biển: nấm, nấm
làm-phiền: khó-chịu, làm-phiền, làm-phiền, làm-phiền, làm-phiền, buồn-chán, khó-tánh, phiền
con-sóc: 
mài-ngọc: một-nửa, bán
irrealis-tâm-trạng: 
núi-lửa: 
trong-nhà: trong-nhà, bên-trong, ở-trong, cơ-sở
khai-thác: sử-dụng, hấp-thụ, thành-tích, khám-phá
Địa-chất-học: 
hộ-chiếu: 
trái-với-đạo đức: luẩn-quẩn, hư
bánh-quy: Cookie
sự-hợp-tác: hợp-tác, công-ty, hội-nhập, hỗ-trợ
máy-tính-bảng: đạn, viên-thuốc, slab
sự-thư-giãn: lỏng, thư-giãn, giải-trí, thư-giãn, thư-giãn, giải-trí
nguyên-tử: nguyên-tử, hạt, cá-nhân
AIDS: viện-trợ, cứu-trợ, phụ-tá
hình-kim-tự tháp: 
chu-kỳ: hình-tròn, sự-lưu-thông, tần-số, vòng-quay, quay, Xe-đạp, xe-đạp
ngủ-trưa: 
bất-hợp-pháp: bất-hợp-pháp
quấu: móng, ngón-chân
nhút-nhát: e-thẹn, co
che-khuất: che-khuất
trám-bằng-nhựa: xiên
cây-chổi: 
bảng-điều-khiển: đĩa, slab, bức-tranh, bảng, nhóm, ủy-ban
Thiên-văn-học: 
mê-lộ: 
học-bổng: tài-trợ
rùa: 
cố-vấn: người-cố-vấn, Khuyến-cáo
chất-xơ: chất-xơ, bó-lại
con-dế: 
chim-bồ-câu: 
thích-ứng: phỏng-theo, cố-định, tuân-thủ, sự-sửa-đổi, điều-chỉnh
Tam-giác: 
thủ-quỹ: 
khinh-khí: 
dễ-vỡ: tinh-vi, khô-teo-đi
máy-in: 
ngộp-thở: 
mãn-tính: chống-lại
đương-đầu: gặp-gỡ, phỏng-theo, đối-chất, bù-lại, khắc-phục, giải-quyết, tương-phản, tay-cầm
tình-trạng-khó xử: 
kỹ-thuật: kỹ-thuật, kỹ-thuật
máy-ảnh: phòng
xin-lỗi: lời-xin-lỗi, sự-tha-thứ
liếm: 
vũ-công: 
di-cư: di-cư, nhập-cư
quần-vợt: 
xương-sống: 
chiên: 
khung-cửa: đóng, đóng-kín
dao-gâm: sự-chua-chát, khoan, vồ-lấy, thử, cố-gắng
mật-khẩu: dấu-hiệu, cây-cơ-bida, khẩu-hiệu
bán-cầu: nhọn, đầu
chiến-lược: chiến-lược
đá-thạch-anh: 
kéo: kéo, kéo
tuần-tra: 
băng-hà: 
nữa-đường: một-nửa, từng-phần, bán, ở-giữa, ở-giữa
Biên-bản-ghi nhớ: Hiệp-ước, hợp-đồng, hội-nghị, phù-hợp, trát
hình-nón: thon
tính-cân-xứng: 
nhà-chế-tạo: sản-xuất, người-sản-xuất, xây-dựng
bị-cáo: biện-hộ
nhà-thờ-Hồi giáo: 
cờ-vua: 
số-điện-thoại: tính-phí, học-phí, nạn-nhân, con-số, biến-chứng
quả-anh-đào: 
phổ-biến-rộng rãi: rộng, rộng-rãi, Lan-tràn, rộng, rộng
tình-cờ-gặp: tình-trạng-lộn xộn
xe-tải: xe-vận-tải, vận-tải-hàng hóa, vận-tải-hàng hóa
mù-tạt: 
phần-trăm: phần-trăm, phần-trăm
bán-đấu-giá: giảm-giá
rây: 
không-vửng: không-ổn-định, sự-bất-ổn, không-chắc-chắn, khó-chịu
nam-châm: 
hút: hấp-thụ, ngâm
đạo-Hồi: 
nhón-gót-chân: ngón-chân, sẳn-sàng, sẵn-lòng
màng: 
cạo-râu: 
đàn-ghi-ta: 
sáng: sáng, sáng, rực-rỡ
cây-du: 
bay-lên: đi-lang-thang, hover, họng, chuyến-bay
đại-danh-từ đánh dấu: 
kẹp-giấy: kẹp, dấu-ngoặc, Cần-thiết, căn-bản, căn-bản, chính, chính, cuối-cùng, sơ-cấp
đồ-gia-vị: sự-hăng-hái
tiền-thế-chân: phiếu, sự-bảo-đảm, lời-hứa, Bảo-hành
người-chuyên-chở: vector, nguyên-cáo, nhân-viên-khuân vác
sự-rung: cộng-hưởng
chọc-tức: cám-dỗ, làm-phiền, kích-thích, làm-mồi
cái-cày: giải-quyết, cuốc-đất, không-tặc
sinh-lý: cơ-thể
Máng-xối: cống
sao-chổi: người-phạm-tội
trung-cổ: ở-giữa
chim-se-sẻ: 
bù-lại: tặng-thưởng, đền-bù, bù-lại, chuộc-lại, trang-điểm, trang-điểm
Nhựa: 
chú-thích: 
quĩ-đạo: lớp, lớp-học, quỹ-đạo
thanh-đạm: khiêm-tốn
golf: 
số-không: vô-giá-trị
Chip: cái, miếng, lát, đoạn
áp-bức: đàn-áp,-kìm nén, đàn-áp, xô, áp-đảo
ngáp: bốc-hơi
bất-bình-đẳng: 
nốt-ruồi: vừng, đất-sét
đồ-gốm: 
bà-nội-trợ: 
lúa-mạch: 
không-tuân-theo: xâm-phạm
khoan-dung: lòng-khoan-dung
phôi-thai: lốp-xe, lốp-xe, thai-nhi, thai-nhi, trung-tâm
thợ-mỏ: nhỏ
tán-thưởng: cảm-kích, vỗ-tay, tiếng-vổ-tay
men: men-tiêu-hóa, bột
phí-bảo-hiểm: tiền-thưởng, giải-thưởng, phần-thưởng
mận: 
sự-phá-sản: thất-bại
thủy-lợi: 
cây-bạc-hà: Cục-kẹo
nhà-tư-bản: chủ-nghĩa-tư bản
Độ-co-dãn: Mềm-dẻo
cá-mập: 
tuyển-dụng: lừa, chú-tiểu
Lưu-trữ: bảo-tồn, bảo-tồn, cửa-hàng, tiết-kiệm
chủ-nghĩa-hiện thực: 
củ-gừng: 
xe-cấp-cứu: 
có-thể-so sánh: cân-đối, giống
ví: danh-mục-đầu tư
nhăn-nhó: miệng, nụ-cười, sự-uốn-éo
nhà-khoa-học: khoa-học, học-giả, nghiên-cứu-viên, người-điều-tra
ruột: ruột, ruột
bình-thản: 
Radio: đường-bán-kính
không-thích-hợp: trái-ngược, không-thích-hợp, vô-lý, không-quan-trọng
hạt-đậu: hạt, đậu-xanh, củ-lạc, ngũ-cốc
không-chính-thức: 
cháu-gái: cháu-trai, cháu-ngoại, cháu-gái, con-cháu
bất-đồng-ý kiến: sự-phản-đối, tranh-luận, tranh-chấp, không-đồng-ý
miếng-bò-hầm: chặt
nitơ: 
dao-cạo: 
tương-phản: tương-phản, tương-phản, trái-ngược, phản-đối, trái
tuyên-truyền: công-bố, sự-công-khai, Quảng-cáo, quảng-cáo, quảng-cáo
pháo-bông: 
pop: đong-tach, tiếng-nổ
quần-áo-mặc trong nhà: 
luống-cày: 
có-hại: Làm-hại, nguy-hiểm, bất-lợi
đạo-Do-thái: 
bổ-thể: bổ-sung, trang-bị, thêm-vào
ống-kính: một-giống-đậu, đèn-pin
pegative-trường-hợp: 
bệnh-ung-thư: 
cầm-đồ: thế-chấp, lính, lời-hứa
giảng-sư: 
rò-rỉ: tràn, sự-mất, rơi-vãi
đủ-điều-kiện: đủ-điều-kiện, công-đức, xứng-đáng, có-đủ-năng lực, năng-lực
tỉ-trọng: Đông, cường-độ
sự-cảm-ứng: 
nhai: 
lắm-lời: giao-tiếp
tôm: 
chiết-khấu: miễn, giảm-giá, tô-giới
xe-tắc-xi: 
hệ-thống: khả-năng-lãnh đạo, hệ-thống
ngọc-bích: 
tiếng-cằn-nhằn: 
con-thằn-lằn: 
thác-nước: 
thất-vọng: chán-nản, thất-vọng, thất-vọng, thất-vọng, bẩn-thỉu
phủ-quyết: từ-chối, dấu-vết, Từ-chối, bỏ-qua, phản-đối, cá-cược, lực-kéo
tổng-thống: tổng-thống
người-mua: quý-khách-hàng
gallon: 
muỗi: 
độ-lệch: lệch, méo-mó, bù-lại
vật-lộn: cạnh-tranh
khảm: 
phích-cắm: kết-nối, chứng-từ
ngồi-xổm: co-rúm
tạp-hóa: 
cộng-sản: 
làm-kinh-ngạc: thật-ngạc-nhiên, kinh-ngạc, kinh-ngạc, lừa-dối, gây-nhầm-lẫn, làm-choáng-váng, làm-sai
prosecutive-trường-hợp: 
chòm-sao: Thiên-hà
nhà-độc-tài: 
sự-lo-lắng: việc-làm, lo-ngại, lo, liên-quan
vệ-tinh: 
dép: dép
phụ-âm: 
ước-chừng: xấp-xỉ, khoảng, approximative
người-thất-nghiệp: việc-làm
người-ủng-hộ: phụ-tá, phụ-tá, chịu-được, dấu-ngoặc
sen: 
rau-diếp: rau-xà-lách, rau-bina
clorua: 
vi-khuẩn: nấm, vi-khuẩn
dính: nhớt
thành-phần: 
hạt-nhân: 
đặt-chuyện: giả-bộ, mô-phỏng
byte: 
sự-tiết: tiết
một-cách-rõ ràng: thông-suốt, mở, rõ-ràng, chắc-chắn, chắc-chắn
phù-hợp: phù-hợp, phù-hợp, phù-hợp, phù-hợp, phù-hợp
ba-lê: vây
nước-tiểu: nước-đái
củ-tỏi: 
trôi-qua: quá-khứ, đi-ngang-qua
Kinh-tế-học: nền-kinh-tế, suy-thoái-kinh tế, tiết-kiệm
tầng-lớp-trung lưu: 
nhanh-nhẹn: nhanh-chóng, nhanh-chóng, nhanh, nhanh-chóng
kẹp: cái-xẻng, kẹp
giặt-ủi: giặt-giũ
dâu: 
đô-thị: công-dân
lúng-túng: chán-nản, người-tàn-tật, lúng-túng, làm-sai, gây-nhầm-lẫn
quyển-vở: 
album: 
bóng-chày: 
bị-nghẹt-mũi: 
tiệc-đứng: 
phân-từ: tham-gia, người-mới-vào nghề
nhà-xe: 
chẩn-đoán: chẩn-đoán, chẩn-đoán, nhận-thức, công-nhận
cái-nạng: 
tống-tiền: tống-tiền, nhổ, hạn-chế
đăng-ký: ghi-lại, ghi-danh, ghi-âm, khúc-gỗ
hòa-tan-được: hòa-tan
phốt-pho: 
cấu-trúc: cấu-trúc, cấu-hình, cấu-hình
keo-dán: 
luận-văn: luận-án
thủ-công: thợ-cơ-khí
chuối: 
định-lý: định-lý, thành-thật, hiển-nhiên, rõ-ràng, minh-bạch, nguyên-tắc
xương-sườn: Hộp-số
kền: không-ai
pi: tạm-biệt, bánh, silicon
xe-buýt: để-cho
pháp-quan: sự-kiểm-duyệt
tên-lửa: hỏa-tiển
xúc-xích: bánh-mì-kẹp xúc xích
thao-tác: chạy, vận-dụng, hoạt-động, lừa, gian-lận, tay-cầm
cà-chua: 
củng-cố: củng-cố, tăng-cường, xác-nhận
ổ-cắm-điện: sự-rút-lui, lối-ra, kết-nối, lồng
kali: 
lấy-lại: lấy, bình-phục, khôi-phục, phục-hồi
ảo: có-thật, thực-tế, chính-hãng
đại-số-học: 
bác-sĩ-nha khoa: răng
quang-học: trực-quan
nhúc-nhích: tô-giới, đồng-nhượng-quyền, di-chuyển, động, thay-thế
môn-sinh-học: 
thất-nghiệp: 
sâu-bướm: 
độc-tấu: riêng-biệt, hiện-tượng, gián-đoạn, đất, một-mình
trình-duyệt: 
xa-quá-khứ căng: 
lịch-sử-căng: 
Nguyên-tử: trung-tâm, nguyên-tử
quang-phổ: 
natri: 
thần-kinh-loạn: 
ủy-thác: người-quản-lý
con-tin: thế-chấp, lời-hứa
cây-bầu: quả-bí-ngô, tủy
nếp-nhăn: khuyết-điểm
minh-bạch: minh-bạch, minh-bạch, minh-bạch
mũi-nhọn: cái-nêm, ren, đầu, cái-đinh
sự-ưu-tiên: chú-ý
người-đi-bộ: đang-đi
thuyết-vô-thần: 
màn-hình: đường-ray, giám-sát, đồng-hồ-đeo tay, theo-đuổi
các-cử-tri: cử-tri, cử-tri
không-kiểm-soát được: 
thăm-dò: kiểm-tra, điều-tra--u003e Investigation, cuộc-điều-tra, truy-tìm, điều-tra--u003e Investigation, thăm-dò, dùng-thử
bạch-kim: 
hai-con-số: 
phổi: 
siêu: hiện-tượng, to-lớn, vô-cùng
xe-đẩy-hàng: chuyên-chở, xe-đẩy, toa-xe
tại-địa-phương: địa-phương
xúi-giục: kích-thích, làm-phiền
xăng: xăng
quả-thận: 
cướp-bốc: cướp, sự-ăn-trộm, làm-mồi, cướp-bóc, cướp, lôi
đánh-giá: ước-tính, dự-toán, đánh-giá, cấp
Thạch-tín: 
ốc: vành-tai
Châu-chấu: 
phương-trình: công-thức, bình-đẳng
xã-hội-chủ nghĩa: thân-thích
bộ-lọc: 
cảm-chứng-cớ tâm trạng: 
mở-rộng: phát-triển, rộng, thêm-vào, nâng-cao, tăng-cường, gia-hạn, mở-rộng, độ-phân-giải, sự-mở-rộng, sự-bành-trướng
xông-lên: phóng, ném, xông-lên, bắn, để-cho
buộc-bằng-dây xích: cho-thuê, dây-đeo
Quan-thoại: 
nài-ngựa: 
viêm-phổi: 
tinh-thần-đoàn kết: liên-Hợp, tập-hợp, thân-thuộc, thống-nhất, sự-giống-nhau
bản-lề: chi-tiết, vòng
theo-chiều-dọc: theo-chiều-dọc
cổ-tức: phân-bổ
giày-trượt-băng: trượt-tuyết
số-mũ: mục-lục, mũ
khuyết-tật: người-tàn-tật, không-có-khả năng, khuyết-điểm, không-hoàn-hảo, tàn-tật, lỗ-hổng, khuyết-điểm
sự-ám-ảnh: quấy-rầy
sự-phân-phối: phân-bổ, chỉ-định, cung-cấp, hạn-ngạch, phân-công
nhiếp-ảnh-gia: nhiếp-ảnh
đồng-bằng: tham-dự
kỹ-thuật-số: con-số, số, bằng-số
chó-cái: 
mí-mắt: 
đường-chéo: 
tiềm-thức: 
lông-mày: 
hắt-xì: 
vui-vẻ: người-vui-vẻ, niềm-vui, vui-vẻ, buồn-cười, giải-trí, vui, lừa-quân-địch, khôi-hài, nực-cười
ấn-độ-giáo: 
người-tị-nạn: di-trú
đưa-đón: tàu-không-gian, chuyên-chở, giao-thông-vận tải, phương-tiện-vận chuyển
chất-đạm: Lòng-trắng-trứng
bãi: chồng-chất, cây-rơm, đày, rác, rác
lọc: 
chất-mửa-ra: 
gen: gen, di-truyền
sinh-viên-năm đầu: 
xã-hội-học: 
bí-đao: quả-bí-ngô, nghiền-nát
người-câu-cá: 
khu-vực: quận, diện-tích, vùng, khu-vực, khu-vực, khu-vực, chu-vi
vận-động-khó khăn: 
quá-khứ: quá-khứ, sự-tự-xét
vòi-rồng: 
sự-đảo-ngược: đảo-ngược, trái, đối-ứng, ngược
TV: tivi, phim-ảnh
hình-lập-phương: 
năng-suất: buổi-biểu-diễn, đầu-ra
cà-rốt: 
phân-tử: phân-tử, chất-nền
tập-đoàn: đảng-phái, nhóm, cụm
kế-toán: người-kiểm-tra
quả-dưa-chuột: Tùy-chọn, họng
orgy: 
hòa-tan: hòa-tan
phosphate: 
mồi: mồi, người-quen, sự-giới-thiệu
kiềm: 
môn-thể-dục: thể-dục
dấu-phẩy: hôn-mê, buổi-tiệc
vận-động-xuống dốc: 
sẩy-thai: sự-phá-thai, thấp, thất-bại
pod: vỏ-trứng, vỏ-kiếm, lột-vỏ
nhà-tài-trợ: 
mangan: 
nhà-tâm-lý học: 
clo: 
bàn-phím: 
ưu-tú: 
ngoặc: 
bóng-bầu-dục: 
ung-nhọt: nhức-nhối, vết-thương, vết-thương, sôi-lên
biến-cách: 
gặm-cỏ: 
lượng-tử: lượng, số-lượng, hạn-ngạch, tỷ-lệ
áo-len: Áo-khoác
tiến-hóa: phát-triển, tiến-hóa
ký-hiệu: biển-báo, biểu-tượng, chú-ý
tung-lên: bùng-nổ, nhảy
sự-mổ-xẻ: chỉ-định, mục
bộ-nhớ-cache: 
tuyến-tính: minh-bạch
antimon: 
superessive-trường-hợp: 
bướu: bướu, số-lượng-lớn, băng
xói-mòn: 
alpha: 
lỗ-rốn: bụng, cực
miễn-dịch: sự-thở, chống-lại
cúm: bệnh-cúm, chảy-nước-mũi, cảm-sốt, gây-ảnh-hưởng
nhà-máy-bia: 
đơn-giản-hóa: 
giãm-bớt: giới-hạn, nhốt, hạn-chế
sứt-mẻ: Cục-bướu, băng, răng
làm-xiêu-lòng: bắt, làm-mồi
ép-buộc: hạn-chế, lực-lượng, thi-hành, thi-hành
bít-tất: 
bộ-phim: phim-ảnh, Rạp-chiếu-bóng, dây-băng, băng, sọc
vũ-trụ: vũ-trụ
gây-ô-nhiễm: sự-ô-nhiễm, lây-nhiễm
ở-thành-đoàn: 
dương-vật: tình-dục
lâm-nghiệp: 
nhôm: nhôm
sự-dao-động: biến-động
lá-số-tử vi: 
trục-xuất: huyền, trục-xuất, trục-xuất, trục-xuất, tiết, thay-thế, trừ
bao-gồm: ghi-âm, hội-nhập, nhúng, bao-gồm, bao-gồm, bao-gồm, Hàm-ý, liên-quan-đến, tham-gia
người-thụ-hưởng: phận-sự, người-dùng
cá-heo: 
kẻ-giết-người: 
động-vật-có vú: 
Chỉ-số: tư-thế, mục-lục, tiêu-chí, ngón-trỏ, gauge
dioxide: 
Dấu-hai-chấm: 
quan-liêu: quan-liêu
xuyên-tạc: lừa-dối, chen-lấn,-xô đẩy, méo-mó
tủ-lạnh: tủ-lạnh
khảo-cổ-học: khảo-cổ-học, khảo-cổ-học, hóa-thạch
không-thể-chấp nhận được: không-chấp
đặc-điểm-kỹ thuật: qui-tắc, tiêu-chuẩn-hóa
tờ-rơi: thông-tin, Bản, tấm
nhân-chủng-học: 
ngon: thơm-ngon
tha: tha, quá-trình-chuyển đổi
khúm-núm: bò
hướng-dương: 
con-rận: đánh-dấu, một-chút
ion: 
du-lịch: du-khách, du-lịch
modem: 
sự-tăng-tốc: khuyến-khích, tạo-điều-kiện, sự-khuyến-khích
làm-sai: làm-sai, rèn-luyện
phát-thải: dơ-bẩn, vấn-đề
bắt-cóc: không-tặc, sự-dẫn, cướp
chồng-chéo: sự-tương-tác, tương-tác
thợ-làm-tóc: 
văn-hóa-dân gian: lúa-mì
mao-mạch: 
dân-tộc-chủ nghĩa: quốc-tịch
mông: hông, mông-đít
motif: chủ-đề, chủ-đề, động-cơ, lý-do
làm-ăn-da: 
sự-thất-bại: thất-bại, tuyệt-vọng, thất-vọng, bối-rối, hủy-bỏ
coban: 
vênh-váo: 
vận-động-thượng nguồn: 
hậu-môn: 
giống-bò: 
lật: dịch, dịch
dư: nhiều, dư, thặng-dư, bỏ-qua, giải-tán, miễn
video: 
tẩy-chay: quận, tẩy-chay, bỏ-bê
đố: thử, thi, bảng-câu-hỏi
khúc-côn-cầu: 
du-kích: 
magiê: 
radar: 
con-đười-ươi: 
sự-đáng-tin cậy: tin-tưởng
hình-chữ-nhật: 
tảo-bẹ: 
tổng-quát: khái-quát
Lệnh-giới-nghiêm: 
đồng-tính: 
kịch-bản: kịch-bản, cảnh-quan
xây-dựng: xây-dựng, xây-dựng, xây-dựng, từ-ngữ, sự-sáng-tạo, sự-hình-thành, Xây-dựng
sự-đầu-thai: 
khơi-dậy: 
uranium: 
catcher: thụ
phối-hợp: sự-phối-hợp
người-trả-thuế: 
tích-hợp: tích-phân
phát-biểu: góc-nhìn, ý-kiến, chú-ý
gamma: 
Safari: dap-xe, hành-trình, chuyến-đi, hành-trình
vận-động-phía hạ lưu: 
hệ-số: cấp, hệ-số
tiêu-đề: tiêu-đề, chủ-đề
phân-tích: phân-tích
chiếu-tướng: 
trung-tâm-mua sắm: siêu-thị
thanh-diên: 
bưu-thiếp: Lời-chào
hội-tụ: xấp-xỉ, tập-trung
lạc-đề: rút-lui, khởi-hành
cổ-đông: bạn-đồng-hành
vi-trùng: 
cơ-quan-sinh dục: 
hình-thái-học: di-truyền, hình-thái-học
beta: 
Quần-jean: 
cơ-sở-dữ liệu: 
máy-tính: máy-tính
tia-X: 
phân-tích-cú pháp: 
môi-trường: cảnh-quan, môi-trường-xung quanh, môi-trường, bối-cảnh, sinh-thái-học, khu-vực-lân cận, khu-vực-lân cận, đường-viền
sigma: 
phân-ly: cô-lập, khoảng-cách, phá-vỡ, phá-vỡ
chương-trình-nghị sự: chương-trình, chương-trình, chương-trình-giảng dạy
thị-thực: 
cơ-sở-hạ tầng: 
con-đom-đóm: 
phát-hiện: 
thích-nghi: 
sinh-vật-học: 
ghép-mộng: đóng-dấu, tu-chính, đính-kèm, kết-nối
một-hóa-chất: 
sự-che-chở: 
nấc-cục: 
phấn-màu: tái-nhợt
vườn-bách-thú: 
phòng-khám: 
ý-nghĩa: Hàm-ý, Ý-nghĩa, ngữ-nghĩa, khái-niệm, khái-niệm, ý-nghĩa, bối-cảnh
yoga: tổng-số
hiệu-sách: tủ-sách
trị-liệu: điều-trị, xử-lý, chữa, phương-thuốc, trị-liệu
dân-tộc: dân-tộc
chém-đầu: 
vâng: Vâng
có-vấn-đề: vấn-đề, vấn-đề, biến-chứng
nhạc-jazz: 
vonfram: 
khủng-bố: chiến-đấu, khủng-bố
chảy-nước-dãi: đất-bùn
sự-trao-đổi chất: 
tiền-trợ-cấp: 
cuối-tuần: 
cây-cúc: 
vắc-xin: bình-luận, bảo-hiểm
xe-gắn-máy: xe-máy
thần-chú: 
học-kỳ: kỳ-hạn
heroin: 
thư-mục: 
âm-cực: 
tư-tưởng: nghĩ
bãi-đỗ-xe: 
theta: 
anticlimax: thất-vọng
selen: 
đạp-xe: sự-lưu-thông, vòng, tuần-hoàn, Xe-đạp, xe-đạp
vỏ-cây: vỏ, vỏ-trứng, lột-vỏ
sự-tương-đương: bình-đẳng
hiện-tại-liên quan đánh dấu: 
phi-trường: 
cưa-đi: làm-gián-đoạn
bóng-rổ: 
Kẻ-lừa-đảo: 
con-gián: 
cơ-rôm: 
lít: lít
dù-sao: Tuy-nhiên, chưa, Tuy-nhiên, dù-sao
kích-thích-tố: 
thiếu-sót: thiếu-sót, thiếu-sót, không-hoàn-hảo, lầm, sai, thiếu-xót
khoan-lổ: khoan
thuyết-tâm-linh: 
đa-giác: góc
nữ-quyền: 
liên-hợp: giốc, liên-hệ
Đồng-euro: 
nhân-sâm: 
thuật-toán: 
tia-laser: 
nhà-thuốc: 
milimet: milimet
uốn-cong: bẻ-cong, uốn-cong, linh-hoạt, thuận-tiện, cáp
dương-cực: 
sắc-thái: Bóng
bán-thời-gian: 
độ-nhạy: 
người-đi-biểu tình: 
heli: 
nói-hai-thứ tiếng: 
từ-viết-tắt: ngắn-gọn, một-thời-gian ngắn, co-lại
initialism: 
động-từ-tiến hành cách: 
huyết-tương: 
nhiễm-sắc-thể: 
thứ-tự: giao-lộ, hàng, bình-thường, nối-tiếp
km: km
fax: 
di-truyền-học: di-truyền, gen
đốm-trên-da: 
cái-vặn-vít: cái-mỏ-lết
bông-cải-xanh: 
preterite: 
vitamin: 
cadmium: 
máy-bay-ném bom: 
đồ-họa: 
titan: 
làm-oai: làm-phách
lambda: 
bạn-gái: bạn-đồng-hành, bạn-trai, người-tình, con-gái
giao-cấu: 
đồng-hồ-cát: 
đồng-cảm: sự-cảm-thông, lòng-trắc-ẩn, hiểu-biết
bằng-tố: 
máy-bay-lên thẳng: 
tên-chất-hóa học: tên-chất-hóa học, tên-chất-hóa học
hạn-chót: kỳ-hạn
căn-chỉnh: 
centimet: 
molypden: 
lithium: 
đa-phương-tiện: 
cập-nhật: hiện-đại-hóa, làm-mới
nhiệt-lượng: 
người-máy: 
bài-tập-về nhà: 
đối-số: 
con-bọ-ngựa: 
lắp-đặt: núi, lắp-vào, tổng-hợp
amin: 
glyph: cứu-trợ
thì-QUÁ-KHỨ: vô-định
sinh-thái-học: sinh-thái-học
pha-rượu: cướp-bóc
cần-sa: 
vi: khôn-khéo, nhỏ, bé-nhỏ, nhỏ-xíu, microphone
kg: 
ăn-nhiều-quá: 
dự-đoán-được: dự-đoán, dự-đoán, dự-báo
bánh-pizza: 
rình: 
ngôn-ngữ-học: ngôn-ngữ-học
cắt-tóc: 
iridium: 
kỳ-thị-chủng tộc: chủng-tộc
tối-ưu: đỉnh, tối-ưu
công-nghiệp-hóa: công-nghiệp-hóa, công-nghiệp, chế-tạo
trụ-sở-chính: trụ-sở-chính, chỗ-ngồi
kim-thuộc-làm măm sông đèn: 
thích-đáng: thân-thiện, phù-hợp, thuận-tiện, tương-hợp, giống
bộ-phận-ngữ trường hợp: 
băng-cassette: băng
ý-chí: ý, sẽ
không-gian: kích-cỡ, hình-thù, kích-thước, không-gian
tham-số: 
đồng-bộ-hóa: đồng-bộ-hóa
tối-đa-hóa: tối-đa, tăng-cường, nói-quá
Hội-thảo: xưởng
sàn-nhảy: đĩa
neon: 
chất-mể: 
hiển-linh: 
ăn-cắp-của người khác làm của mình: trộm
tạo-tác: 
lò-phản-ứng: 
rau-oregano: 
plutonium: 
hóa-yt-tri: 
chử-dùng-thêm ý: 
tên-truy-nhập: 
sau-đại-học: 
cánh-phải: 
chất-a-gon: 
ám-ảnh: kinh-sợ, kinh-sợ, ám-ảnh, thù-ghét
xã-hội-hóa: giao-tiếp, tương-tác
toàn-cầu-hóa: 
bước-sóng: 
mã-hóa: Mã
tái-chế: đã-qua-sử dụng
khởi-động-lại: khởi-động-lại
viêm-gan: 
hình-xuyến: Cục-bướu
hóa-trị: Tôn-giáo
modulo: khuôn, mô-đun
proton: 
đĩa: 
một-phần-ngàn gờ ram: 
điểm-ảnh: 
tantali: 
tan: quyết-định
diệt-chủng: 
động-vật-ăn thịt: dữ-tợn
hóa-ga-li: 
zirconi: 
determiner: xác-định, định-nghĩa, người-điều-tra
phi-tuyến: 
thuốc-trừ-sâu: 
bé-ryl: 
nơron: 
nhận-chắc: quả-quyết
quần-lót: Nội-y
giai-thừa: giảng-viên
neutron: 
chất-ni-op: 
hóa-géc-man: 
á-kim: phi-kim-loại
đặt-trên: 
prolative-trường-hợp: 
đa-dạng-sinh học: 
cần-điều-khiển: 
kháng-sinh: 
ac-tin-chất phát quang tuyến: 
phi-hành-gia: khoảng-trống
ngoài-trái-đất: người-ngoài-hành tinh
crackpot: dốt-nát, điên, khùng, điên, dị-thường
marathon: 
ytterbium: 
tự-kỷ: 
ion-hóa: 
radon: 
nerium: 
dịch-tễ-học: 
tuổi-già: người-già
cắm-trại: cắm-trại
sọc: sọc, kế-hoạch, kế-hoạch
indium: 
đích-thật: chân-thành, nguyên-chất, lưới
trang-mạng: trang-mạng, nơi, Hồ-sơ
kinh-Koran: 
flatware: 
thứ-n--root: 
lawrenci: 
quyền-công-dân: 
điện-thoại-di động: điện-thoại-di động, điện-thoại-di động
tê-liệt: 
protactini: 
sự-bức-xạ: phát-sáng
tùy-theo-trên: 
chất-hóa-học nguyên tử: chất-hóa-học nguyên tử, chất-hóa-học nguyên tử, chất-hóa-học nguyên tử, chất-hóa-học nguyên tử, chất-hóa-học nguyên tử, chất-hóa-học nguyên tử, chất-hóa-học nguyên tử, chất-hóa-học nguyên tử, chất-hóa-học nguyên tử, chất-hóa-học nguyên tử
Quần-jean-xanh: 
cây-nhà: 
cá-nhân: cá-nhân, cá-nhân, cá-nhân, riêng-biệt
dòng-chảy-hiện tại: 
ba-điểm: 
cơ-thể-con người: 
vật-lí: thể-chất, thể-chất
bán-lẻ-cửa hàng: 
hóa-chất-cê ci: 
Dài-cách-đây: 
bảng-tính: 
đơn-vị-của khối lượng: 
biên-soạn: 
nhị-phân-có giá trị: 
Nhân-loại-được: 
qua-phương-tiện của: 
depan-dari: 
praseodymium: 
các-tông: Thẻ
có-hạn-động từ: 
thử-nghiệm-con số: 
pro-kết-án: pro-cụm-từ
nhà-phê-bình: chỉ-trích, phê-bình
bao-bì: gói, đóng-gói
vô-thường: không-ổn-định
tại-phần-lớn: 
mô-tả: miêu-tả
neodymium: 
hữu-nghị: thân-thiện, đồng-minh
đọc-chỉ-có: 
sáng-lập: 
châm-ngôn-tâm trạng: 
đơn-âm: 
tính-hợp-lý: ý-thức, Logic
âm-vị-học: 
ăn-uống-phòng: 
sống-phòng: 
trung-tâm-trường hợp: 
thuộc-về-ngày nay trước: 
bệnh-nhân-trường hợp: 
xiên-trường-hợp: 
nông-thôn-khu vực: 
recurse: 
ở-giữa-giọng nói: 
meitneri: 
ngươi-đưa-thư: 
không-hứa-hẹn: bằng-phẳng
chứng-khoán-thị trường: 
nhận-biết: nhận-biết, nhận-định
mục-tiêu-cò súng: 
một-giây: 
lative-trường-hợp: 
khẩu-phần: phần
không-Nhân-loại: 
sống-Điều: 
quá-ít: 
rạp-chiếu-phim: Rạp-chiếu-bóng
Hassi: 
attenuative: 
multal-con-số: 
milky-đường: 
neptuni: 
người-viết-mướn: 
xuyên-số: 
đánh-lừa-xung quanh: 
americium: 
buổi-sáng-quang vinh: 
cứu-hỏa: 
berkeli: 
Thiên-hà-tính: 
nobeli: 
tạm-biệt: tạm-biệt, Tạm-biệt, cho-tới-khi
Phật-giáo: 
fermium: 
cyan: màu-đỏ-sậm
đậu-nành: 
nhà-phân-phối: 
strikebreaker: 
vi-xử-lý: 
abessive-trường-hợp: 
adessive-trường-hợp: 
đến-trường-hợp: tại-trường-hợp, ngẫu-nhiên
agentive-trường-hợp: 
rutherfordi: 
kháng-thể: 
như-nhiều-như: 
đại-lý-cò súng: 
diễn-viên-vai trò: 
ethidium: 
chung-tính: 
accompanier: 
rum: 
franxi: 
hóa-ec-bi: 
thụ-động-giọng nói: 
astatine: 
sự-nhai-kẹo cao su: 
ngôi-sao-tính: 
trích-dẫn-hình thức: 
Curi: 
truyện-tranh: 
mù-màu: 
euler's---số: 
nhìn-tại: 
crosswalk: đường-mòn
chiến-trường: 
người-lái-xe hơi: lái-xe
ngắn-mạch: 
bằng-lời-nói danh từ: 
khóc-ngoài: 
thống-kê: thống-kê
sữa-chua: 
xenon: 
thôi-miên: 
lấy-tắt: 
khoản-đuôi: 
Chỉ-đường-vật: gián-tiếp-vật
tạp-hóa-cửa hàng: 
gồm-có-của: 
ergative-trường-hợp: 
trong-ngôn-ngữ: 
đầu-tay: Chỉ-đường
trường-sở-cách trường hợp: 
Hồ-bơi: hồ-bơi, lưu-vực
thuộc-về-trạng từ trường hợp: 
ngắm-cảnh: chuyến-đi, thanh-tra, sự-lưu-thông
tivi-bộ: 
cuối-cùng-hạt: 
evitative-trường-hợp: 
sự-phục-hồi: 
hồi-quy: trở-về, sự-rút-lui, rút-lui, thất-bại
khối-của-căn hộ: 
thức-lên: 
cảnh-sát-nhân viên văn phòng: 
thề--in: 
Người-phỏng-vấn: phỏng-vấn
rheni: 
aerosol: 
trường-hợp-chiếm hửu trường hợp: trường-hợp-chiếm hửu trường hợp
nominalization: danh-từ
chiếm-hữu-trường hợp: 
sự-bán-giá quá cao: 
phụ-tá-động từ: 
tiểu-học-vật: 
virus-máy-tính: 
doanh-nhân: kinh-doanh-một người, thương-thuyền
một-những-người: người, dân-gian
antessive-trường-hợp: 
thủ-tướng: 
Lutetium: 
europium: 
biểu-hiện-cảm xúc: 
dân-ca: 
thi-sĩ: 
Bưu-điện: bài, email
giả-định: giả-định, giả-định, đoán-chừng, rõ-ràng, rất-có-thể
động-tính: 
subessive-trường-hợp: 
chân-ga: 
tính-phân-cực: cực
xe-cộ-tính: 
khoáng-chất-tính: 
verb--hậu-tố: 
đam-mê: xúc-động, đa-cảm, cảm
samari: 
facilitator: người-điều-hành
tưởng-tượng-đơn vị: 
tốc-độ-ánh sáng: 
không-quân: 
đồng-cảm-vui sướng: 
trọng-điểm: 
toàn-thời-gian: 
hóa-hạp-ni: 
ức-chế: chế-ngự, lề-đường, cản-trở, cấm
thay-đổi-của biến cố: 
holmium: 
khác-nhau-biến cố: 
vũ-trụ-tính: 
địa-bàn-tính: 
ảo-máy-móc: 
nghiên-cứu-tính: 
nghệ-thuật-tính: 
crastinal-căng: 
trừu-tượng-tính: 
exocentric-trường-hợp: 
tha-động-từ: 
hình-vị: 
người-yêu-nước: 
quá-khứ-hoàn bị: 
nghề: đặc-trưng, nghề-nghiệp, nghề, nghề, chuyên-nghiệp
gián-tiếp-phát biểu: 
thứ-hai-ngôn ngữ: 
đến-được: 
nghĩa-địa-sự thay đổi: 
tập-hợp-danh từ: 
absolutive-trường-hợp: 
bệnh-nhân-cò súng: 
tự-sự-tự tin: 
phân: ghế-đẩu, phần-sau-lái tàu, bụi
phản-xạ-giọng nói: 
nhân-hóa-động từ: 
seaborgi: 
không-gian-trắng: 
phương-thức-trường hợp: 
vô-hồn-tính: 
chỉ-nguyên-nhân: 
propositive-tâm-trạng: 
điện-hiện-hành: 
kết-hợp-trường hợp: 
tối-thượng-trường hợp: 
quá-nhiều: 
hành-tinh-tính: 
hoạt-hình-hoạt hình: 
đối-ứng-giọng nói: 
lập-pháp: pháp-luật, lập-pháp, sắp-xếp, tổ-chức
tại-ít-nhất: 
ngữ-pháp-hợp: 
người-dùng: 
cốt-lõi-benefactive: 
thủ-môn: 
:-except-for: 
mẫu-số: 
else-if: 
ngang: qua-một-bên
lẫn-nhau: một-khác, lẫn-nhau
kế-tiếp-điều khoản: 
mặc---ra: 
quần-short: 
dysprosium: 
Sớm-Tương-lai căng: 
si-các-đơn vị: 
tên-một-chất khí: 
mendelevi: 
applicative-giọng-nói: 
antipassive-giọng-nói: 
vừa-liên-tục diện mạo: 
bức-xạ-bệnh: 
necessitative-tâm-trạng: 
Độc-thân-hoạt động động từ: 
Railcar: 
tối-thượng-trình độ: 
hiện-sinh-điều khoản: 
californi: 
hiện-tại-phân từ: 
chói-lọi-cường độ: 
singulative-con-số: 
ngữ-pháp,-đối tượng: 
thụ-động-phân từ: 
quá-đáng-thời gian: 
siêu---chất lỏng: 
lượng-của-vật chất: 
postpositional-trường-hợp: 
không-bắt-buộc lượng hóa: 
gadolinium: 
tháp-tự-hình vị: 
dùng-để-phủ định lượng hóa: 
Einsteinium: 
nhân-tạo-ngôn ngữ: 
liên-kết-hạt: 
xa-Tương-lai căng: 
liên-diển-diện mạo: 
phân-phối-đại danh từ: 
đoạn-văn-đồng ý: 
hói: trần
vùng-ngoại-ô: làng-nhỏ, nông-thôn
thế-giới-lượng hóa: 
máy-vi-tính lập trình: 
tivi-chương-trình: 
floating--point--số: 
hiện-sinh-lượng hóa: 
các-ngày-sau Ngày mai: 
thay-thế-lượng hóa: 
nóng-tính: cộc-cằn
quá-khứ-thụ động phân từ: 
các-ngày-trước hôm qua: 
trường-sở-cách hướng trường hợp: 
đối-chứng-có điều kiện: 
