tạm-biệt: tạm-biệt, chào-bạn, pi, giã-từ
các: 
của: giữa, trong-khoảng, nó-là
đến: đến, cần
trong: 
:-first-person: 
tôi: tôi
:-third-person: 
cái-kia: nó, cái-nào
của-anh-ấy: nó-là, của-bản-thân
anh-ta: nó
cùng-với: 
vì: trong-khoảng, về-phía
như: cái-nào, trường-hợp, làm-cách-nào
:-second-person: 
được: 
cô-ấy: nó-là
trên: gọi-điện, trong-khoảng
tại: con-ngựa
qua: thông-qua, và, trong-khoảng
có: chịu
hoặc-là: cũng-không
từ: 
cái-này: nó
anh-ta: nó-là
bà-ấy: họ, nó
của-tôi: mìn, tôi
của-họ: nó-là, họ
cho-nên: như-vậy, Sớm
một: 
họ: họ, bạn
chúng-tôi: chúng-tôi, tôi
ai: bất-cứ-ai, cái-nào
sẽ: nghĩ, mang-lại
sẽ: ý-chí
Không: không
nếu: cho-dù, cung-cấp
lên: phía-trên, nổi-lên, ngoài, tệ-hơn
trong: một
bất-kì: cụ-thể-là, cái-nào, toàn-bộ, mỗi
của-bạn: của-bạn
cái-gì: cũng-không, cái-nào, Điều
chỉ-thị-tâm trạng: chỉ-thị-khí sắc
Đàn-ông: một-người, chồng, Nam
hơn: hơn, trong-khoảng, làm-cách-nào
của-chúng-ta: mùa-xuân, chúng-tôi
một-số: hơi
trên: sau, phía-trên, ngoài
Tháng-Năm: khả-năng
bây-giờ: hiện-nay
cũng-giống-như: làm-cách-nào, thân-ái, cầm
có-thể: khả-năng, có-thể, cái-hộp
Nên: cần
đã-làm: làm, sự-thật
như-thế: như-vậy
một: một
những: họ, nó
hơn: phía-trên, hơn
nhiều: rất, âm-lượng
Ông: quý-ngài, bậc-thầy
tốt: đẹp, thật-tuyệt, Hiền-hậu
phần-lớn: hơn, phần-lớn, đa-số, rất
phải: cần
những: họ, nó-là
mình: của-bản-thân, cùng-một, mình
cuộc-sống: sống, cả-đời, nguyên-âm, thắt-lưng
không-có: 
chế-tạo: làm, sáng-tạo
giếng: dễ-chịu, bên-phải
đàm-luận-đánh dấu: 
xuyên-qua: thông-qua, xuyên-qua
có-thể: năng-lượng, có-lẽ, có-thể
cũng: rất, cũng
lại-một-lần nữa: sau-đó, trở-lại, một-khi
nhiều: đa-số
tất-cả: mỗi, cái-nào
người: một-người, cộng-đồng, một-những-người
nghĩ: tư-tưởng, ý-kiến, nghĩ
ở-dưới: xuống
còn: hơn
nơi: nơi, vị-trí, Ở-đâu
trong-khi: trong-khi, thời-gian, tạm-thời
chỉ: chỉ, đơn-giản
cũng-thế: cũng, tương-tự-như vậy, hơn
chưa: nhưng, cũng-không, dù-sao, hơn
chống-lại: về-phía, trước
nhận-được: gặp, cầm-lấy, lấy-được
bao-giờ: đời-đời, không-bao-giờ, luôn-luôn
tắt: đóng, cách-xa, ngoài, phủ
khuôn-mặt: bề-mặt, một-trăm, một-người
cái-khác: Cuối-cùng, khác
rời: cách-xa
mới-mẻ: tân, Tiểu-thuyết, tươi, chín, trẻ
Bà: 
đặt: bộ, Cuối-cùng, biếu-tặng
nói: nói-rằng
lí-trí: trí-tuệ, nghĩ
rất-ít: cặp-vợ-chồng, ít
ai: cái-nào, bất-cứ-ai
xa: cách-xa, xa, rất
gọi: nghĩ
toàn-thể: đầy, toàn-bộ
cả-hai: số-hai
Tìm-thấy: tìm-thấy, Tìm-kiếm
nhìn: nhìn-thấy, kiểm-tra, nhìn-thoáng-qua
để-cho: xe-buýt, xông-lên, biếu-tặng, cho-phép
Chúa-tể: bậc-thầy, quý-ngài, Vua
nhà: Nhà
một-cái-gì đó: chẳng-có-gì, hơi
chốc-lát: thời-gian
cha: cha
trong: giữa
phụ-nữ: nữ
mẹ: mẹ
chấm-dứt: đã-kết-thúc, Cuối-cùng, trễ,-muộn
nhỏ: ít, vi
mầy: bạn
muốn: cần
Tuy-nhiên: nhưng, dù-sao, Tuy-nhiên
khá: trọn-vẹn, hơi, rất, đủ
có: cái-nào
tốt: tốt-hơn
bản-thân-mình: tôi, mình
cho-tới-khi: cũng, trước, tạm-biệt
từ: sau-đó, Thứ-nhất, bởi-vì
đã-qua-sử dụng: cũ, tái-chế
hơn: thay-cho, hơi, hơn
ít-hơn: ngắn, xuống, ít-nhất
ở-trong: bên-trong, sâu, trong-nhà
bên-nhau: bộ
lớn: thật-tuyệt, to-lớn
chất: Điều, bộ-môn, câu-hỏi
nhất-định: xác-định, bên-phải
mình: mình
một-nửa: nữa-đường, mài-ngọc, bên
thật: thật, sự-thật, bên-phải
bất-cứ-điều gì: bất-cứ-điều gì, hơi, chẳng-có-gì
giữ: cầm, bộ, giữ-lại
người-vợ: nữ
phương-tiện: đường
gần: thông-qua, gần
tiểu-bang: điều-kiện, vào, đất-nước, chính-phủ
một-mình: cô-độc, độc-tấu, một
trường-hợp: gục-ngã, trường-hợp, bộ-đồ, biến-cố, bởi-vì
ngươi: bạn
cao: phía-trên, mặt-sàn
con-gái: con-gái, nữ, bạn-gái
chắc-chắn-rồi: cam-đoan, bên-phải, thật
quả-thật: thật, sự-thật
bản-thân: mình, của-bản-thân, cho-dù
dọc-theo: liên-quan, Dài, chiều-dài
đất: đất-nước
trở-về: hồi-quy, trở-lại, hoàn-tiền
rời-bỏ: khởi-hành, kì-nghỉ, bị-bỏ-rơi, cách-xa, sự-cho-phép
một-trong-hai: cũng
luật-pháp: bên-phải, hợp-pháp, qui-định
nằm-xuống: bộ, thế-tục, cứu-giúp
chỉ: nơi, hoạt-động, chỉ, đoạn
trẻ-em: bọn-trẻ
mong-ước: mong-ước, khao-khát
nói: nói-rằng, nói-chuyện
trong-suốt: thời-gian, trong-khi
một-số: tá, cặp-vợ-chồng, hơn
kinh-doanh: buôn-bán, cửa-tiệm, Công-ty, công-việc, Quảng-cáo, sự-vận-động
cách-thức: đường, cách-tiếp-cận
thứ-hai: khác
chung: chung, nói-chung, công-cộng
phía-sau: trở-lại
trở-nên: đến
chết: chết, cái-chết
trái-đất: đất-nước
con-trai: Con-trai
cảm: cảm-giác, Nghe
thần-linh: Linh-hồn
sự-thật: sự-thật
mặt-bằng: mặt-sàn, đất-nước, nơi
thực-sự: thật, rất, sự-thật
còn-lại: khác, sự-an-ủi, về-hưu, di-hài, kì-nghỉ
khác: khác-nhau, chênh-lệch, khác
có-thể-được: có-lẽ
con-người: một-người, tình-người
thành-phố: thành-thị
tiếp-theo: bên-cạnh, theo, sau
cần: cần-thiết, cần
gây-nên: lý-do, khiến, bởi-vì
buổi-tối: đêm, buổi-chiều
năm: thứ-năm, năm
khỏe-mạnh: năng-lượng, khả-năng, hung-bạo
quý-bà: nữ
vòng-quanh: xung-quanh, gần, trong-khoảng, mắt
xoay: bên, bộ, gọi-món
ý-nghĩa: có-nghĩa, cảm-giác, ý-nghĩa
chặt-chẽ: đóng, gần
nhân-vật: đặc-tính, nhân-cách, chấm-điểm, bản-chất
loại: phân-loại, Hiền-hậu
thị-giác: thị-giác, phía-trước, bối-cảnh, nhìn-thấy, nhìn-thoáng-qua
buổi-tiệc: tiệc, dấu-phẩy, đất-nước
khỏe: thật-tuyệt, gầy
sẳn-sàng: chuẩn-bị, rồi, nhón-gót-chân, đã-kết-thúc
tài-khoản: lý-do, hóa-đơn, tính, đếm
bằng-văn-bản: viết
lứa-tuổi: cũ, thế-kỷ
khác: khác, Cuối-cùng, nơi-khác, hơn
lực-lượng: năng-lượng, ép-buộc, áp-đặt
ngang-qua: phía-trên, ngược-lại
sớm: sớm, bắt-đầu, nguyên-thủy, Sớm
mặt-trời: 
một-lát-sau: Tương-lai, sau-đó, sau, bên-cạnh
mọi-thứ: toàn-bộ
quá-khứ: trôi-qua, quá-khứ, Cuối-cùng, sau
hành-động: hóa-đơn, động-từ, hoạt-động, công-việc, sự-vận-động
hơn-nữa: phía-trước, hơn, thêm-vào
ngoài: hơn, ngoài
cũng-không: cũng-không, cái-nào
góc-nhìn: phát-biểu, nhìn-thoáng-qua, nhìn-thấy, thị-giác, bối-cảnh, lịch
âm-thanh: giọng-nói
không-ai: chẳng-có-gì, kền
rõ-ràng: mở-ra, hiển-nhiên, nổi-bật, nhẹ
đường: Xa-lộ, đường
có-thật: ảo, sự-thật, Hoàng-gia
Gần: gần, trong-khoảng
hiểu-biết: thông-tin
về-phía: về-phía
tồi-tệ: tệ-hơn, quỷ-quái, nghèo-nàn
sống: sống, thắt-lưng, cả-đời
hòa-bình: căn-phòng
thấp: ngắn, rẻ, sẩy-thai
Bắc: bài-giải, Phương-bắc, nữa-đêm
tự-nhiên: bản-chất
khá: đẹp, rất, đủ
công-bằng: bên-phải, bài-báo-cáo, mười
dịch-vụ: phục-vụ, chăm-sóc
dưới: xuống
Hân-hạnh: sung-sướng
lịch-sử: câu-chuyện, hẹn-hò, lịch-sử
chú-ý: ghi-nhớ, ký-hiệu
mặc-dù: Tuy-nhiên
mặt-trước: ngược-lại, phía-trước, trước
to-lớn: thật-tuyệt, to-lớn
chắc-chắn: nghiêm-khắc, khóa-học, thật
gió: hàng-không, tầng-áp-mái
nhận: biên-lai, cầm-lấy, lấy-được
chú-ý: chăm-sóc, sự-ưu-tiên, chú-trọng, Về-vấn-đề, nhấn-mạnh
sức-mạnh: năng-lượng
có-lẽ: có-lẽ
vui-vẻ: sung-sướng, vui-vẻ, hài-lòng
quan-trọng: cần-thiết, theo-sau
bản-thân-bạn: của-bản-thân, mình
bạn-bè: bạn-đồng-nghiệp, bạn-bè
ý-kiến: phát-biểu, ý-kiến
lòng-tin: tin, lòng-trung-thành
cách-đây: hướng-Đông, sau-đó, trước, phía-trước, trở-lại
tính-phí: số-điện-thoại, kinh-phí, cầm-lấy
cánh-tay: tay, nghèo-nàn, tay-áo, cánh-tay, vai
cuối: Cuối-cùng
vật: mục-đích, chẳng-có-gì, bộ-môn
quý-ông: Nam, quý-ngài, bậc-thầy
cụ-thể: đặc-biệt, cụ-thể-là
hầu-như-không: không, gần, hiếm
chánh: giám-đốc, cái-đầu
cơ-hội: trùng, vị-trí, dịp, xác-suất
giao-dịch: kế-hoạch, cửa-tiệm, đồng-ý
đang-nghĩ: nghĩ
nặng: sự-lập-lại, cân-nặng, nghiêm-túc, chăm-chỉ
trơn: mở-ra, đơn-giản, rỗng
ngay-tức-thì: một-khi, Sớm
miệng: một-người
sợ: sợ-hãi, nỗi-sợ, nóng-lòng
Độc-thân: một, cô-độc
sự-vui-mừng: sung-sướng, hứng-thú
bị-gãy: lưu-huỳnh, cắt-tỉa
trừ-khi: ngoại-trừ
Mang: chịu, mặc, mang-lại, cho-phép
gây-ảnh-hưởng: hiệu-quả, cúm
hiện-ra: hiện-ra, dường-như
ngoài-kia: ngoài, ngoại-trừ
làm-ơn: tử-tế, hỏi
Dáng-vẻ-bên ngoài: hiện-ra, dường-như
chậm-lại: dần-dần, trễ,-muộn
giai-đoạn: giai-đoạn, thời-gian
chị-gái: anh-em
trận-đánh: chiến-đấu,-đấu tranh, chiến-tranh
trước-đây: cũ
thanh-Xuân: trẻ
chỉ: chỉ, đơn-giản, cô-độc
đến: cách-tiếp-cận, Hoàn-thành, đến
hệ-thống: gọi-món, hệ-thống, cơ-quan
bữa-tối: đêm, bữa-ăn-trưa
về-sau: Tương-lai, sau
đi-bộ: bước-đi, đi, mặt-sàn, bàn-chân
ngạc-nhiên: phép-màu, lạ, ngạc-nhiên
bình-thường: nói-chung, chung, luôn-luôn
con-số: kỹ-thuật-số, số-liệu-thống kê, hình, con-số, số-điện-thoại, bức-ảnh
xưa: cũ, cổ-hủ
kính-trọng: Về-vấn-đề, danh-dự, nguy-hiểm, về-phía
thứ-ba: số-ba, thứ-ba
còn-lại: ở-lại
xã-hội: xã-hội, cộng-đồng, Công-ty
kết-quả: lời-kết, hiệu-quả
chỉ-huy: gọi-món
chỉ: chỉ, đơn-giản
bên-cạnh: thông-qua, bên-cạnh, ngoại-trừ
im-lặng: trầm-tính
hoàn-hảo: đúng, thật-tuyệt
đường: đường
văn-bản: viết, lá-thư
gỗ: bằng-gỗ, cây, cây-gậy
Mau: Sớm
nhận-thấy: nhìn-thấy, quảng-cáo, cảnh-báo
sáng: nhọn, nhẹ, sáng, nổi-bật
con-thuyền: con-tàu, phao, du-thuyền
cao-quý: thật-tuyệt, huy-Hoàng
đột-ngột: bỗng-nhiên
giá-trị: giá-trị, cấp, tầm-quan-trọng
vì: bởi-vì
đọc-hiểu: đọc, câu-hỏi
đồng-ý: đồng-ý
chờ-đợi: chờ-đợi, cầm, ở-lại
cái: Chip, phần, căng-ra
ex: cũ
cuộc-hội-thoại: nói-chuyện, cuộc-đối-thoại
cơ-hội: dịp, vị-trí
giá-tiền: kinh-phí, trả
đáng-kể: thật-tuyệt, theo-sau, nổi-bật
ngồi: ở-lại
đỉnh: tối-ưu, cây-rơm, phía-trên, đỉnh
hôn-nhân: có-gia-đình
bước-đi: hoạt-động, bước-đi, giai-đoạn
bắt-đầu: bắt-đầu
mỗi: mỗi, về-phía
cá-nhân: một-người, cá-nhân, nguyên-tử
khó: chăm-chỉ
một-chút: phần, ít, con-rận, miếng
bài-diễn-văn: nói-chuyện
chính-quyền: quyền-tài-phán, năng-lượng
sự-hạnh-phúc: sung-sướng
cung-cấp: cung-cấp, biếu-tặng, cam-đoan
học: học, nghiên-cứu, phòng-thu
cá-nhân: riêng-tư, cá-nhân, nhân-viên
đồng-hồ-đeo tay: kiểm-tra, màn-hình, nhìn-thấy
vừa-lòng: hài-lòng, sung-sướng
nóng: nóng, lửa
sự-cố-gắng: cố-gắng, sự-căng-thẳng
chuẩn-bị: chuẩn-bị, rồi
thử: cố-gắng, đố, dao-gâm
nhanh-chóng: Sớm, nhanh-nhẹn
ở-dưới: xuống, sau
dụng-ý: có-ý-định, chú-trọng, mục-đích
thẳng: trực-tiếp, đơn-giản
rất-có-thể: Dễ-dàng, xác-suất, có-lẽ, giả-định
Sự-công-bằng: bên-phải
đơn-giản: chỉ, đơn-giản
sự-tin-tưởng: tin, lòng-trung-thành
đoạn-văn: phần, đi-qua, cột, thông-qua, căng-ra
đóng: đóng, khung-cửa, phủ
mình: mình
đi-ngang-qua: thông-qua, trôi-qua, đi-qua
Trung-bình: thứ-cấp, có-nghĩa
chiếm-hữu: bất-động-sản
thú-vị: dễ-chịu, Hiền-hậu
hoàn-toàn: trọn-vẹn, thật
thông-thường: chung, nói-chung, có-xu-hướng
phần-mộ: chăm-chỉ
đã-sửa: sửa-chữa, Tuy-nhiên, Tiêu-chuẩn, thường-xuyên
quân-đội: quân-đội
buổi-họp: buổi-họp, hội, gặp
cắm-trại: cắm-trại, cánh-đồng
Quốc-gia: đất-nước, quốc-dân
đời: sự-có-mặt
trả-lời: bài-giải, hoàn-tiền
bầu-trời: bầu-khí-quyển, trời
bằng: cùng-một, bằng
vận-may: số-phận, điều-kiện, bất-động-sản
tên-miền: cánh-đồng
tình-huống: vị-trí, điều-kiện
ở-giữa: có-nghĩa, nữa-đường, thắt-lưng
mùa-đông: lạnh
cho-phép: sự-cho-phép, cho-phép
tái-nhợt: màu-vàng, màu, mờ-nhạt, phấn-màu, mở-ra, nhẹ
chạy-bộ: cuộc-đua, chạy
Tôn-giáo: tôn-giáo, hóa-trị
chì: khiến, mang-lại
di-chuyển: bước-đi, cãi-vã, nhúc-nhích, sự-vận-động, hoạt-động
dừng-lại: gãy, đứng
văn-nói: nói-rằng, bằng-lời-nói, nói-chuyện
bảng: nổi-lên, bảng-điều-khiển, khuyên-bảo, cạnh, tiền-hoa-hồng
hư-không: miễn-phí, trống
sự-mất: bất-lợi, đi-lạc, rò-rỉ
phục-vụ: cung-cấp, đề-xuất, biếu-tặng, tang-vật, phục-vụ, đặc-quyền
lớp: Hiền-hậu, quĩ-đạo, cấp
hoàn-chỉnh: đầy
quyền: Thăm-quan, cách-tiếp-cận, mua-lại
niềm-đam-mê: hăng-hái, cảm-giác
thể-chất: vật-lí, cơ-thể-người
thí-dụ: trường-hợp
bắt-đầu: bắt-đầu
Mặc-dù: Sự-phẫn-nộ
nghiêm-chỉnh: thật-tuyệt, nghiêm-túc, cực
bạc: tiền-bạc, Thứ-sáu
đầy-đủ: đủ
chính: cái-đầu, bậc-thầy, Chìa-khóa, nguyên, kẹp-giấy
quá-tuyệt-vời: lạ, hung-bạo, thật-tuyệt
con-đường: đường
Ý-nghĩa: ý-nghĩa, có-nghĩa, tầm-quan-trọng, bộ-môn
Phù-hợp: bộ-đồ, đúng
rất-nhiều: khối-lượng, rất, số-phận
chỗ-ngồi: chiếc-ghế, sự-bao-vây, trụ-sở-chính
trò-chơi: bài-bạc, chơi
bản-tường-trình: biểu-hiện, bài-báo-cáo
mơ-tưởng: cơn-ác-mộng, ngủ
Cục-đá: cheo-leo, chiếc-váy, Cục-đá
đặc-biệt: đặc-biệt, riêng-tư, chuyên-gia
học-phí: kinh-phí, số-điện-thoại, trả
chia-sẻ: phần, cổ-phần, vai-trò, phân-phát
Lan-tràn: chi-tiết, phổ-biến-rộng rãi, tiêu-tan, lý-do
quang-vinh: danh-dự, khen-ngợi
khoảng-trống: vị-trí, hội-trường, cánh-đồng, phi-hành-gia
bình-thường: chung, đơn-giản
xem-xét: nghĩ, Về-vấn-đề
rất-nhiều: rất, phần-lớn
nhân-viên-văn phòng: chính-thức
tỷ-lệ: Tiêu-chuẩn, danh-dự, khóa-học
biển-báo: ký-hiệu, cử-chỉ, chấm-điểm, nơi
tự-nhiên: bản-chất, nguyên, cư-dân
làm-việc: công-nhân, công-việc
kết-hôn: có-gia-đình
mức-độ: giới-hạn, âm-lượng, bằng
phương-pháp: đường, một-khi, cách-tiếp-cận
Xuất-sắc: tốt-hơn, thật-tuyệt
lòng-tin: tin
chính-xác: thật, đặc-biệt, đầy, trọn-vẹn
rộng-lớn: thật-tuyệt
tưởng-tượng: sự-tưởng-tượng, đẹp
nhanh-chóng: Sớm, nhanh-nhẹn
Vâng: vâng, như-vậy
quyền-tự-do: miễn-phí, sự-độc-lập
hấp-dẫn: rút-ra, Hiếu-kỳ
qua-một-bên: tách, ngang, ngoại-trừ
nguyên-chất: tươi, đích-thật
liên-quan-đến: phía-trên, trong-khoảng, Về-vấn-đề
chứng-cớ: bằng-chứng, hiển-nhiên
xa-xôi: cách-xa, xa
giống: giống-nhau, cùng-một, thích-đáng, có-thể-so sánh
hẹp: gầy, ngắn
hoàn-toàn: trọn-vẹn
trang: bên, cái-sân
đặc-biệt: đặc-biệt
núi: đồi
hãnh-diện: niềm-tự-hào
thông-suốt: một-cách-rõ ràng, mở-ra, hiển-nhiên
giá: danh-dự
bệnh: bệnh
phán-xét: phán-quyết, câu-văn, qui-định, phán-xét, quyền-tài-phán, cuộc-khủng-hoảng
Chấp-nhận: chấp-nhận-được, thừa-nhận, cầm-lấy
loài: Hiền-hậu
tìm-kiếm: Tìm-kiếm
danh-dự: danh-dự
tai: sự-cho-phép
đáy: xuống, mặt-sàn, căn-cứ
viện-trợ: AIDS, cứu-giúp, hỗ-trợ
đầy-đủ: đầy, trọn-vẹn
vui-mừng: sung-sướng, khó-chịu
lượng: lượng-tử, âm-lượng, đám-đông, con-số
có-được: mua-lại, lấy-được, cầm-lấy
thuế-suất: thuê, dòng
băng-qua: đi-qua, thông-qua, quá
người-lạ: khách, lạ, nước-ngoài, Không-biết
dám: lòng-can-đảm
lớn-lên: nổi-lên
sai: nói-dối, sai, bệnh, thiếu-sót
cao: Dài, mặt-sàn
cái-cổng: cánh-cửa
tự-do: sự-độc-lập, miễn-phí, độc-lập, lỏng-lẻo
thổi: sốc, Cú-đánh, bắn, đá
thời-trang: cách-tiếp-cận, đến
hằng-ngày: ngày
phân-phát: phân-phát
sự-giàu-có: tiền-bạc, bất-động-sản
quyền-tự-chủ: miễn-phí, sự-độc-lập
nâng-cao: tiến-trình
dịu-dàng: dịu-dàng, ngọt
chắc-chắn: khóa-học, thật
bảo-mật: an-toàn, bảo-vệ, cam-đoan
chiếm: chiếm, kêu, đính-hôn
sân-khấu: nền-tảng, hoạt-động, giai-đoạn, điều-kiện, bối-cảnh
phần: phần, khẩu-phần
cái-lưỡi: ngôn-ngữ, nước-miếng
tức-giận: Sự-phẫn-nộ
chuyên-chở: huấn-luyện, xe-đẩy-hàng, đưa-đón
thời-tiết: khí-hậu, hàng-không, thời-gian
điều-cần-thiết: tầm-quan-trọng
luyện-tập: bài-tập, hoạt-động, khách-hàng
yêu-cầu: yêu-cầu, bộ-đồ
Hoàng-tử: công-tước
nhóm: bộ, tập-đoàn, đàn, ban-nhạc, bảng-điều-khiển
khắp-nơi: bất-cứ-nơi đâu
thêm-vào: mở-rộng, thêm-vào, tăng
nguyện-cầu: hỏi
hàng-đầu: theo-sau, bậc-thầy
màu-xám: nâu, tro
thường-xuyên: thường, lặp-đi-lặp lại, thường-xuyên
nổi-danh: phổ-biến, ai-cũng-biết, nguyên-âm
quyền-lực: năng-lượng, khả-năng
còn-sống: sống
yếu-ớt: mờ-nhạt, nghèo-nàn
chất-liệu: Nội-dung, bộ-môn
thành-thật: thành-thật, định-lý
hâm-nóng: mùa-hè, nóng
bảo-vệ: bảo-vệ, chăm-sóc
như-nhau: cân-đối, cùng-một, tương-tự-như vậy
một-cách-tự nhiên: bản-chất
đáng-chú-ý: lạ, bất-thường, thật-tuyệt
mặt-trăng: tháng
nhẹ: ít, Dễ-dàng, nhẹ, gầy, ngắn
Phong-cách: nhẹ
nhọn: bán-cầu, nhọn
nguyên-tắc: học-thuyết, định-lý, bắt-đầu
trực-tiếp: Sớm, trực-tiếp
sẵn-lòng: rồi, nhón-gót-chân, dặm
hậu-quả: theo-sau, hiệu-quả, lời-kết
mềm: dịu-dàng, đồng-ý, cuộc-đua
quan-tâm: có-ý-định, làm-quan-tâm, thích thú
phần-tư: bàn-chân
tiên-tiến: phía-trên, phía-trước
rõ-ràng: một-cách-rõ ràng, giả-định, dường-như
hoạt-động: công-việc, hoạt-động
biết: cố-tình, biết
nguy-hiểm: nguy-hiểm, có-hại, đe-dọa
trấn-tĩnh: trầm-tính
Linh-thiêng: thần-thánh, thánh
Vương-quốc: Hoàng-gia
toàn-thể: trọn-vẹn, toàn-bộ, đầy
tốt-đẹp: đẹp
thói-quen: đặc-tính, đường, khách-hàng
Chỉ-đường: hiển-nhiên, trực-tiếp, đầu-tay
thật: thật, sự-thật
thính-giác: Nghe
đang-đi: bước-đi, bàn-chân, người-đi-bộ
ném: xông-lên, đúc, bắn
trí-tuệ: trí-tuệ
lái-xe: chạy-xe, điệp-khúc, thám-hiểm, đẩy, chạy, đĩa
lỗi: khiển-trách, sai
việc: Điều, bộ-môn, quan-hệ
Liên-hệ: sự-tương-hợp, chạm
ga-tàu: đứng, Trung-tâm, mùa-vụ
nghe: Nghe, hỏi, tuân-lệnh
đau: chấn-thương, đau, bị-thương
bày-tỏ: biểu-hiện, giải-thích
ủng-hộ: bên, vẻ-duyên-dáng, nuôi
chiều-cao: chiều-dài
kích-cỡ: không-gian, độ-lớn, đầy
công-việc: hoạt-động, công-việc, nhiệm-vụ
sự-cảm-thông: đồng-cảm, lòng-thương-hại
mặc-quần-áo: bộ-váy
xa-hơn: phía-trước
tàu: nhạc-cụ, con-tàu
tình-cảm: thân-ái
đau-khổ: tra-tấn, đau-khổ, đắng, rắc-rối
thịt: thịt, cơ-thể-người
lớn: to-lớn, thật-tuyệt
bài: cấp, Bưu-điện, sau, gửi-đi, vị-trí
bộ-sưu-tập: tích-lũy, bộ, bộ-sưu-tập, lời-kết
tưởng-tượng: sự-tưởng-tượng, nghĩ
đến: đến
lớn: năn-nỉ, thật-tuyệt, chăm-chỉ
xinh-xắn: đẹp, huy-Hoàng
phi-thường: lạ, bất-thường
xảy-ra: cũng-không
bữa-ăn-sáng: buổi-sáng, bữa-ăn-trưa
dân-số: đám-đông
loạt: chuỗi, bộ
cứu-trợ: AIDS, sự-an-ủi, glyph
ấn-tượng: hiệu-quả, cảm-giác, gây-ấn-tượng, in
sự-hài-lòng: hài-lòng
hình-thù: không-gian, mẫu-đơn, hình
Sinh: chào-đời
sự-xem-xét: ý-kiến, Về-vấn-đề
bình-thường: định-kỳ, lặp-đi-lặp lại, thứ-tự
động: nhúc-nhích, sự-vận-động
bận: đính-hôn
chất-lượng: khối-lượng, bằng
khám-phá: tìm-thấy, Tìm-kiếm, tiết-lộ
bên-trong: bên-trong, sâu, trong-nhà
đất: bùn, mặt-sàn, độc-tấu, đất-nước
hoàn-toàn: trọn-vẹn
lời-nhắn: thông-tin, Tin-tức
cụm-từ: biểu-hiện, câu-văn
đề-cập: Nam
đôi: bên-phải, cặp-vợ-chồng
tiêu-đề: tiêu-đề, cái-đầu, bộ-môn
hiểu-biết: hiểu-rõ, đồng-cảm
chủ-nhật: tuần
điên: crackpot, ngu-xuẩn
chắc-chắn-rồi: trọn-vẹn, nghiêm-khắc
chậm: trầm-tính
nhân-từ: lòng-thương-hại, vẻ-duyên-dáng
chứa: kể-ra, Nội-dung
sự-đau-khổ: nỗi-buồn, đau
lính: quân-đội, cầm-đồ
Trước: hướng-Đông
giải-thích: giải-thích, thông-tin
cầu-nguyện: yêu-cầu
niềm-tin: tin, lòng-trung-thành
hằng-số: lặp-đi-lặp lại, Tiêu-chuẩn, sửa-chữa, thường-xuyên
cuối-cùng: Cuối-cùng, cuối-cùng
dap-xe: cưỡi, Safari, nổi-lên, chạy-xe
chính-sách: chính-trị
bản-vẽ: bức-ảnh, rút-ra, kế-hoạch
qua-đời: cái-chết, chết
nhu-cầu: yêu-cầu, câu-hỏi
phía-trên: phía-trên
tổng-số: và, yoga, con-số
vận-động: sự-vận-động, đề-xuất
hỗ-trợ: hỗ-trợ, cứu-giúp
nhân-phẩm: danh-dự
bắt: cầm, cầm-lấy, quan-niệm
giữa: giữa
hiện-tại: hiện-nay, suối
có-thể: xác-suất, có-lẽ, có-thể
riêng-biệt: tách, chênh-lệch, độc-tấu
tệ-nhất: tệ-hơn, nghèo-nàn
khủng-bố: nỗi-sợ, khủng-bố
kiểm-soát: Quy-định, được-kiểm-soát, kiểm-tra, quản-lý
có-khả-năng: cho-phép, khả-năng, giỏi, kỹ-năng
chắc-chắn: Công-ty, Tuy-nhiên
cấp-trên: tốt-hơn
tinh-thần: tinh-thần, luân-lý, trí-tuệ
bằng-chứng: chứng-minh, bằng-chứng
quan-hệ: quan-hệ, bài-báo-cáo, Về-vấn-đề
liên-quan: chăm-sóc, nóng-lòng, liên-quan
sâu: sâu, chi-tiết
hát: đọc
thân-thiện: thích-đáng, tử-tế, hữu-nghị, Hiền-hậu
cổng-vào: cánh-cửa, biên-lai
cung-cấp: bề-rộng, cung-cấp
lau-sạch: tươi, khéo-léo
bổ-ích: cần-thiết, có-hiệu-lực
tinh-vi: dễ-vỡ, gầy, tao-nhã
gỡ-bỏ: thoát-khỏi, xóa-bỏ, rút-ra
sự-lựa-chọn: chọn, bầu-cử, kiểm-tra
khổng-lồ: to-lớn, thật-tuyệt
không-thể: không-thể, không, Thất-bại
bao-gồm: áo-khoác, bao-gồm, cái-mền, bọc, vỉa-hè
gấp-đôi: sinh-đôi, hai-lần, cặp-vợ-chồng
chiến-thắng: sự-thành-công
liên-tục: thường, lặp-đi-lặp lại, luôn-luôn, tiếp-tục
cấp-độ: Tiêu-chuẩn, điều-kiện, bề-mặt
giải-phóng: phóng-điện, công-bố, miễn-phí
cộc-cằn: tệ-hơn, nóng-tính, bất-lịch-sự
ở-phía-trước: phía-trước, phía-trên
liên-hệ: giới-hạn, đính-kèm, liên-quan, liên-hợp
lợi: mua-lại, Ưu-điểm
thêm-vào: thêm-vào, bổ-thể
phòng: căn-phòng, hội-trường, máy-ảnh
người-quen: quen, mồi
sai-lầm: sai
dựa: căn-cứ, các-điều-khoản
xe-hơi: huấn-luyện
không-ai: bất-cứ-người nào, chẳng-có-gì
năng-lượng: năng-lượng
trần: mở-ra, quán-ba, xấu-hổ, rỗng, hói
từng-phần: nữa-đường, phần, hơi
màu: màu
sự-an-toàn: an-toàn, sự-cứu-rỗi, chăm-sóc
miêu-tả: diễn-tả, thông-tin, mô-tả, Định-nghĩa
ngủ: ngủ
rơi-vãi: nhúng, gục-ngã, rò-rỉ
rực-rỡ: huy-Hoàng, sáng, thật-tuyệt
ngắn-gọn: từ-viết-tắt, ngắn
màu-xám: nâu, tro
cao: rất
bị-kích-thích: hứng-thú, bị-kích-thích
tuyệt-vọng: sự-thất-bại, mờ-nhạt
giảm-bớt: sự-an-ủi, giảm
toàn-bộ: Tổng, toàn-bộ
lòng-tốt: Đức, vẻ-duyên-dáng
hình-tròn: chu-kỳ, chung-cư, tròn, bánh-xe
đần-độn: khoan
mục-đích: có-ý-định, mục-đích
kỳ-hạn: các-điều-khoản, học-kỳ, hạn-chót
triệt-để: dễ-chịu, trọn-vẹn
nộp-đơn: sử-dụng
lao-động: công-việc
Sự-thông-minh: trí-tuệ
tấn-công: tấn-công, nổi-bật
khá,-tương-đối: trọn-vẹn, đủ, rất
tuân-theo: gặp, tuân-lệnh, Nội-dung
biến-cố: biến-cố, dịp, hiển-thị
dịu-dàng: dịu-dàng, tử-tế
sự-liên-kết: kết-hợp, tập-tin-đính kèm, gọi-điện
sự-bảo-vệ: bảo-vệ, che-chở, chăm-sóc
có-ý-thức: thức, cố-tình, cảm-giác
phiên-bản: kinh-phí, in, công-bố, sự-cho-phép
chuyến-bay: chim, bay, bay-lên
đa-dạng: Hiền-hậu, khác-nhau
cách-nhau: tách, cách-xa, ngoại-trừ, độc-lập
kinh-khủng: khủng-khiếp, lòng-thương-hại
mọi-người: toàn-bộ, bất-cứ-người nào
lao-động: công-việc
người-tình: kính-thưa, bạn-gái
ca-hát: bài-hát
háo-hức: khao-khát, nóng-nảy, Hiếu-kỳ, nóng-lòng
yêu-cầu: hỏi, yêu-cầu, năn-nỉ
bất-cứ-khi nào: Khi-nào
thành-công: sự-thành-công
nâng-cao: mở-rộng, nâng, tăng, nổi-lên
phát-triển: tiến-trình
mát: lạnh, đẹp
dùng-thử: thăm-dò, qui-trình, tòa-án
Hải-ngoại: nước-ngoài, tha-hương
hết-lòng: lòng-trung-thành, Trung-thành
Văn-học: Ngữ-văn
nhà-văn: tác-giả
chứng-khoán: cây-gậy, vai-trò, hoạt-động
kiểu: Hiền-hậu, viết, nhấn
nhiều: giàu-có, dư, đủ
tránh-khỏi: ngăn-chặn
ủng-hộ: bên, vẻ-duyên-dáng, nuôi
tâm-thần: trí-tuệ, tinh-thần, bên-trong
thái-độ: nhìn-thoáng-qua, đứng, cử-chỉ, cách-tiếp-cận, sự-phụ-thuộc, đoạn
sự-khâm-phục: khen-ngợi
lo-ngại: nóng-lòng, nỗi-sợ, sự-lo-lắng, hứng-thú
dạy: biết, học
có-thể-nhìn thấy: biết
hướng-dẫn: nhãn-hiệu, bằng-chứng, chạy-xe
thực-tế: ảo, sự-thật, Hoàng-gia
khốn-khổ: không-đủ, buồn, không-hạnh-phúc, đau-khổ, không-nơi-nương tựa
Làm-hại: quỷ-quái, có-hại, chấn-thương, lòng-thương-hại
sự-tha-thứ: tha-thứ, lấy-làm-tiếc, xin-lỗi, vẻ-duyên-dáng
hiếm-khi: thỉnh-thoảng
ghi-lại: đăng-ký, đĩa, lưu-giữ
mập: dầu, dầy
bằng-phẳng: chung-cư, không-hứa-hẹn, kế-hoạch
quà-tặng: giải-thưởng, hiện-nay
chùa: Nhà, thánh-đường
giấy-phép: sự-cho-phép
bằng-lòng: sự-chấp-thuận, sự-cho-phép
đủ: đầy, đủ
vết-thương: chấn-thương, bị-thương, ung-nhọt
Dũng-cảm: lòng-can-đảm, can-đảm
nơi-nào: một-vài-nơi, bất-cứ-nơi đâu
chứng-kiến: bằng-chứng
khờ-dại: dốt, ngu-xuẩn
mọi-người: bất-cứ-người nào, bất-cứ-ai
tự: riêng-tư, mình, của-bản-thân
cực-kì: rất, bất-thường
điều-trị: trị-liệu, chăm-sóc
họng: cái-cổ, bay-lên, quả-dưa-chuột
bệnh-nhân: bệnh
Tăng-trưởng: tăng
số-lượng: lượng-tử, khối-lượng, đám-đông, liều-thuốc, con-số, độ-lớn
nghiêm-khắc: nghiêm-khắc, hung-bạo, chăm-chỉ
tha: tha-thứ, lý-do, tha, lấy-làm-tiếc
có-nguồn-gốc: nguyên, bản-chất
khán-giả: thụ-động, công-cộng
còn-lại: di-hài
thắng-cuộc: sự-thành-công
hầu-gái: đầy-tớ
nhẹ-nhàng: dịu-dàng, trầm-tính
thực-tế: sự-thật
nơi: bối-cảnh, trang-mạng, nơi
buồm: con-tàu, mạng-che-mặt
cửa-hàng: cửa-tiệm, Lưu-trữ, lưu-giữ
chú-ý: phát-biểu, Về-vấn-đề
tạm-dừng: gãy
quý-báu: giá-trị
vì-thế: như-vậy, vì-thế
cây: nổi-lên, cây, máy-xay
băng: tuyết
tuyệt-đối: đầy, trọn-vẹn
dễ-dàng: Dễ-dàng, Sớm
dữ-tợn: nhọn, hung-bạo, chăm-chỉ, hung-ác, động-vật-ăn thịt, hoang-dã
cơn-thịnh-nộ: Sự-phẫn-nộ
khám-phá: tìm-thấy, Tìm-kiếm, phát-minh, khai-mạc
có-liên-quan: liên-quan
trừng-trị: câu-văn
hơi: ít, Dễ-dàng, hơi
thần-bí: bí-mật, mơ-hồ, tàng-hình
Bóng: bóng, giai-điệu, sắc-thái
tội-giết-người: giết
xúc-động: cảm-giác, đam-mê
sự-phá-hủy: sự-đổ-nát, hủy-hoại
kinh-dị: nỗi-sợ
địa-phương: tại-địa-phương, bên-trong, nơi
phạm-vi: khác-nhau, khoảng-cách, bộ
chủ-nhà: quân-đội, khách, đám-đông
bị-ướt: mưa, ẩm
huyền-bí: bí-mật
có: của-bản-thân, chịu
ý-thức: tính-hợp-lý, cảm-giác, lương-tâm
trước-kia: trước
sản-xuất: sản-xuất
sàn-tàu: cầu
tài-sản: bất-động-sản
thống-trị: Vua, vương-quyền
tuân-thủ: theo, thích-ứng
của-cô-ấy: nó-là
không-may: không-may, trùng, không-hạnh-phúc, lòng-thương-hại, không-đủ
hoa: chi-tiêu, làm-quan-tâm, thích thú, bùn
cảm-ơn: cảm-tạ
thuộc-về: bất-động-sản, kể-ra
chợ: mua
mũ-lưỡi-trai: cái-mũ, điên-điển
vui-mừng: sung-sướng
Hộ-gia-đình: gia-đình, Nhà
hạm-đội: con-tàu, Hải-quân, phao
bé-con: bọn-trẻ, búp-bê
khu: cánh-đồng
chính-xác: bột-mì, đúng, đầy, cẩn-thận
hình-ảnh: bức-ảnh
sự-nghi-ngờ: nghi-ngờ, khả-nghi
từ-chối: chối-bỏ, phủ-quyết, chất-thải
trách-nhiệm: nhiệm-vụ, khiển-trách
hổ-thẹn: xấu-hổ
bữa-ăn: món-ăn, ăn, bột-mì
tình-trạng: vị-trí, điều-kiện
biểu-thị: vào, hiển-thị
thơ-ca: thơ-ca, bài-hát
nảy-sinh: hiện-ra, nổi-lên
hành-trình: Safari, thám-hiểm
tham-gia: tham-gia
đủ-khả-năng: mua, biếu-tặng, chịu
tặng: Góp-phần, biếu-tặng
nghề-nghiệp: công-việc
tiến-hành: tiếp-tục, tăng, tiến-trình, thông-qua
hối-hận: lấy-làm-tiếc
nguy-cơ: nguy-hiểm
nhanh: Sớm, nhanh-nhẹn
riêng-biệt: tách, chênh-lệch
đúng-mực: đúng, dễ-chịu
danh-tiếng: khen-ngợi
số-ít: hiệp, đơn-vị
lỗi: sai
uy-tín: khen-ngợi
Kháng-cáo: rút-ra, gọi-điện
thiếu-sót: cắt-tỉa, thiếu-sót, vắng-mặt
vũ-lực: hung-bạo
trả-lại: làm, giới-thiệu, biếu-tặng
nghề-nghiệp: chuyên-nghiệp, công-việc
thiết-kế: quan-niệm, kế-hoạch
gợi-ý: câu-văn, đề-xuất
utter: phát-âm, đầy
độ-phân-giải: phán-quyết, lời-kết, nghiên-cứu, mở-rộng
thay-thế: luân-phiên, thêm-vào, thay-thế, thương
trong-nước: dân-sự, bên-trong, cư-dân, quốc-dân
tài-liệu-tham khảo: tham-chiếu, ký-ức
hiện-hữu: sự-có-mặt, hiện-nay
vấn-đề: có-vấn-đề, các-điều-khoản, rắc-rối, bộ-môn, câu-hỏi, phát-thải
cung-cấp: cung-cấp, biếu-tặng
ngọn-lửa: lửa
dốt-nát: dốt, bỏ-qua
thỉnh-thoảng: thỉnh-thoảng, lặp-đi-lặp lại
đang-bay: bay
tấm-vải: vải, quần-áo
lợi-nhuận: Ưu-điểm
thứ-tư: bốn, thứ-tư, căn-phòng
chuông: báo-thức, giờ
lợi-ích: Ưu-điểm
chương: cánh-cửa, phần, cái-đầu, mùa-vụ, nguồn-vốn, mình
lỗ-thủng: khoan, hố
hợp-lí: đúng, khôn-ngoan, hợp-lý
đường: người-say-rượu, đường
sự-thay-thế: thay-thế, thay-cho, phụ-cấp, luân-phiên, trao-đổi
đẩy: năn-nỉ, dệt-kim, trả, đẩy, xung
khung: tỉ-lệ, hợp-pháp, bắn
vật-chất: bộ-môn
e-mail: gửi-đi
phân-công: phần
chế-độ-nô lệ: nô-lệ
thơ: thơ-ca, đoạn
chắc-chắn: có-lẽ
đau-đớn: đắng, đau
mãi-mãi: luôn-luôn, đời-đời
đại-dương: biển
phía-sau: sau, trở-lại, đảo-ngược
lãnh-đạo: cái-đầu, giám-đốc, Nhạc-trưởng, nhãn-hiệu
quan-tâm: có-ý-định, nóng-lòng, nhọn
vận-may: số-phận
hiển-nhiên: hiển-nhiên, định-lý
vội: Sớm, bò-con
kế-hoạch: kế-hoạch, sọc, biểu-đồ
vô-dụng: chất-thải
Tuy-nhiên: Tuy-nhiên, dù-sao
mịn-màng: dịu-dàng
chắc: chỉ-thị, thành-lập, Tuy-nhiên, chắc
thiết: cần, cần-thiết
xây-dựng: sáng-tạo, cao-ốc, xây-dựng
cố-gắng: cố-gắng, dao-gâm
tương-đương: cùng-một
mới-đây: gần-đây, hiện-đại, Cuối-cùng
du-lịch: Thăm-quan, du-lịch
buổi-trưa: buổi-chiều, hướng-Nam
nằm: gục-ngã
thông-báo: quảng-cáo
ngưng: ngăn-chặn
tình-huống: điều-kiện, phong-bì
lều: lều, bối-cảnh
Thường-xuyên: lặp-đi-lặp lại, thường
đọc-lớn-tiếng: giọng-nói
độc-lập: sự-độc-lập, lỏng-lẻo, độc-lập
Cần-thiết: cần-thiết, kẹp-giấy
quan-sát: quan-sát
lòng-biết-ơn: cảm-tạ
bảo-tồn: giữ-lại, Lưu-trữ, bảo-vệ
diện-mạo: thành-phần, bên
kinh-sợ: nỗi-sợ, ám-ảnh, sợ-hãi
thông-minh: giỏi, khôn-ngoan
huyện: sống
thất-bại: Thất-bại, sai, sự-phá-sản, sẩy-thai
phần-trăm: đồng-xu, phần-trăm, một-trăm
Tâm-lý: cảm-giác
đại-lý: có-nghĩa
tuyệt-vọng: mờ-nhạt
công-đoàn: liên-minh, hiệp
ban-cho: thừa-nhận
đánh: nhân, đá, sự-thành-công
to-lớn: thật-tuyệt, to-lớn
lòng-tin-chắc: câu-văn
cảm-sốt: lửa, cúm
xử-lý: trị-liệu, qui-trình, chữa-lành
của-chúng-tôi: mùa-xuân, chúng-tôi
lầm: sai, lạm-dụng, thiếu-sót
lý-tưởng: tốt-hơn
gấp-rút: đám-đông, Cú-đánh
chính-xác: đúng, bên-phải, Trung-thành, sửa-chữa
thực-hiện: hiển-thị, làm
bằng-cách-nào đó: hơi
khái-niệm: quan-niệm, ý-nghĩa, ý-kiến
thảo-luận: bàn-luận, cãi-vã
kiên-quyết: thành-lập, Tuy-nhiên
vững-chắc: Tiêu-chuẩn, sửa-chữa, thích-hợp, thường-xuyên
đế-chế: Hoàng-gia
cây-bút: bút-chì, cái-đầu
giấy-phép: sự-cho-phép
duy-trì: cầm, bảo-vệ, giữ-lại
Đông: đám-đông, tỉ-trọng
sự-hạn-chế: giới-hạn, sự-hạn-chế
kinh-khủng: khủng-khiếp
cảng: Bến-cảng, cánh-cửa
có-kinh-nghiệm: Trải-qua, giỏi, chuyên-gia
phản-đối: phản-đối, ngược-lại, về-phía, tương-phản
Hiệp-ước: Biên-bản-ghi nhớ, đồng-ý
xảy-ra: đến
tìm-kiếm: van-xin, Tìm-kiếm
thiết-thực: gần, thật, Thực-hành
dấu-vết: chấm-điểm, phủ-quyết
người-vui-vẻ: sung-sướng, vui-vẻ
sắp-xếp: gọi-món, bố-trí, tổ-chức, đồng-ý
tây: hướng-Tây
sức-ép: nhấn-mạnh, in, đẩy, cân-nặng
chính-trị: chính-trị
khoa-học: khoa-học, nhà-khoa-học
công-đức: khen-ngợi, đủ-điều-kiện, giá-trị
phỏng-vấn: Thăm-quan, Người-phỏng-vấn
lãnh-thổ: cánh-đồng
tình-dục: dương-vật, tình-dục, sáu
sự-sáng-tạo: sáng-tạo, xây-dựng, thành-lập
đường-mòn: chấm-điểm, bầu-cử, đường
tương-lai: mong-ước, xác-suất, thị-giác, bối-cảnh
hoạt-động: trôi-giạt, qui-trình, hoạt-động, bác-sĩ-phẫu thuật
sâu: sâu
phù-hợp: bài-bạc, phù-hợp, trùng, cuộc-đua
bộ-đồng-phục: bộ-váy
món-nợ: khiển-trách, tôn-giáo, nhiệm-vụ, thẻ-tín-dụng
mạo-hiểm: phiêu-lưu, đầu-tư, Công-ty
chấp-hành: hoạt-động
khí-sắc: cảm-giác, hài, bố-trí
đội: nhân-viên
nhận-thức: hiểu-rõ, quan-niệm, nhìn-thấy
khai: giải-thích
phiên-bản: bản-sao, tế-bào
số-lẻ: lạ, bất-thường
tri-ân: cảm-tạ
vô-hạn: đời-đời, bất-định-cách
an-ninh: an-toàn, chăm-sóc
hợp-lý: khôn-ngoan, hợp-lý, nhạy-cảm
nhà-tranh: túp-lều, lều
sức-chứa: khả-năng, kỹ-năng, âm-lượng
giải-quyết: ở-lại
tham-gia: đính-hôn, tham-gia
hội-đồng: khuyên-bảo
kiểm-tra: thăm-dò, kiểm-tra, chọn
Thép: bàn-là
kiểm-tra: kiểm-tra, cố-gắng
từ-thiện: thân-ái
rụng: đổ-vào, đúc
giao-tiếp: sự-tương-hợp, quan-hệ
có-ai: bất-cứ-ai, một-người, bất-cứ-người nào
hàng: dòng, thứ-tự, bộ, chính-phủ, gọi-món
nghèo-nàn: nghèo-nàn
mãnh-liệt: cạnh, cực, hung-bạo
cuộc-tranh-cãi: chiến-đấu,-đấu tranh
có-thể-dùng được, có sẵn: cung-cấp, hiện-nay
sức-đề-kháng: phản-đối
bất-thường: bất-thường, chung
hoang-vu: bị-bỏ-rơi, hoang-mạc
biểu-quyết: chọn, giọng-nói
chịu-được: chịu, người-ủng-hộ, Cuối-cùng, chịu-đựng
thành-công: sự-thành-công
Chân: bàn-chân, khúc-xương
thầu: đề-xuất, yêu-cầu
Nội-địa: bên-trong
nhẹ-nhàng: Dễ-dàng, nhẹ
trưng-bày: hiển-thị, tang-vật, màn, bối-cảnh, bằng-chứng
hạn-chế: có-hạn, chỉ
mục-tiêu: mục-đích, chú-trọng
chỉ-trích: cần-thiết, nhà-phê-bình
cái-cặp-sách: túi-quần, bao, cái-giỏ
lặp-lại: sự-lập-lại, trở-lại, lặp-đi-lặp lại
đường-ray: màn-hình, bài-hát, đường, theo
nơi-cư-trú: che-chở
niềm-vui: sung-sướng, vui-vẻ, giải-trí
bảo-vệ: bảo-vệ
nặng-nề: cân-nặng, nghiêm-túc
chuyện: Nội-dung, các-mặt-hàng, Điều
mục: phần, sự-mổ-xẻ
giải-quyết: đồng-ý, che-chở, Quy-định
đĩa: bảng-điều-khiển, đĩa, sàn-nhảy
khắc-phục: đương-đầu, quá, tiêt-tâu
lý-do: lý-do, các-điều-khoản, motif
đá-cẩm-thạch: Cục-đá
khả-năng: khả-năng, kỹ-năng, năng-lực
làn-sóng: thủy-triều, mơ-hồ
dân-gian: một-những-người, phổ-biến
khả-năng: xác-suất, khả-năng
bơ: dầu
hận-thù: sự-khinh-thường, chán-ghét
theo-đuổi: Tìm-kiếm
kéo: rút-ra, kéo
dấu-hiệu: cử-chỉ, chấm-điểm, mật-khẩu
an-toàn: an-toàn
đốt-cháy: cháy, hút-thuốc
bài-học: giáo-dục, bộ-môn, khóa-học
hàng-năm: năm
Thẻ: các-tông, bản-đồ, ngắn, giấy
đơn-xin: sử-dụng, phần-mềm, yêu-cầu
thông-minh: trí-tuệ, khôn-ngoan
quận: tẩy-chay, khu-vực, thành-thị, đất-nước
định-dạng: mẫu-đơn, đúc
Dòng-chảy: suối
hư-hại: sự-đổ-nát, chấn-thương, lòng-thương-hại
hơn-thế-nữa: thêm-vào, cũng, hơn
thương-nghiệp: buôn-bán
Nam-Bộ: hướng-Nam
ngoài: ngoài
Trung-bình-cộng: thứ-cấp, có-nghĩa
trần-truồng: xấu-hổ
rõ-ràng: hiển-nhiên, mở-ra, định-lý
nền-tảng: căn-cứ, nền-tảng
liên-quan: chăm-sóc, nóng-lòng, liên-quan, làm-quan-tâm, thích thú, sự-lo-lắng
ma-thuật: quyến-rũ
chiến-dịch: sự-vận-động, thám-hiểm
tự-do: hào-phóng
thường: chung, thường, nói-chung
săn-bắn: săn-bắn
giáo-viên: tác-giả
một-thời-gian ngắn: Sớm, ngắn, gần
phước-lành: ban-phước
bé-nhỏ: ít, vi
mạnh: tốc-độ, nhọn, nghiêm-túc
ngực: nhũ-hoa
chiều-sâu: sâu
buổi-biểu-diễn: hiển-thị, năng-suất
sự-phồn-thịnh: mọc-lên, sự-thành-công, phúc-lợi
nhân-viên-bán hàng: công-nhân, chính-thức
quyết-định: phán-quyết, xác-định, quyết-định, tan
nạn-nhân: săn-bắn, sự-hy-sinh, số-điện-thoại
động-cơ: có-ý-định, motif, động-cơ, mục-đích, kích-thích-kinh tế
xác-định: xác-định, hiển-nhiên
xu-hướng: đặc-tính, dặm, bố-trí, trôi-giạt
hoàn-thành: đã-kết-thúc, màu
lá-cờ: cờ, biết
quản-lý: qui-định, quản-lý
hiếm: hiếm
chính-hãng: ảo, nguyên
tập-huấn: giáo-dục, giảng-bài
xấu: sai, rất, tệ-hơn, quỷ-quái, bệnh
nuôi: ăn, nuôi, món-ăn
trung-tâm: Trung-tâm, liên-bang
tương-phản: tương-phản, phản-đối, cuộc-xung-đột
cấu-trúc: cao-ốc, cấu-trúc, cơ-quan
thanh-toán: trả
tốc-độ: tốc-độ
điều-tra--u003e Investigation: thăm-dò, yêu-cầu, Tìm-kiếm
bất-cứ-nơi nào: Ở-đâu
nợ: phạm-tội, nhiệm-vụ
tay-cầm: qui-trình, quản-lý, đương-đầu, thao-tác
chuyến-đi: Thăm-quan, Safari, ngắm-cảnh, thám-hiểm
bắn: bắn, tha-hương, xông-lên
việc-làm: người-thất-nghiệp, sự-lo-lắng, công-việc
cắt: cắt-tỉa
chống-cự: phản-đối
xác-định: determiner, xác-định, quyết-định, áp-đặt, sửa-chữa
thương-thuyền: người-chia-bài, doanh-nhân, buôn-bán
sống: sống
gió: hàng-không
họ-hàng: anh-chị-em họ
bằng-cách-ấy: như-vậy
cung-cấp: giới-thiệu, cung-cấp, phúc-lợi, sự-phân-phối, bố-trí
về: trong-khoảng, Về-vấn-đề
nhặt: chọn, cầm-lấy
hủy-hoại: hủy-hoại
giao-hàng: biếu-tặng, giới-thiệu
bất-ngờ: bất-ngờ
bàn: bàn, văn-phòng
đường-nhỏ: dòng, ban-nhạc
đại-diện: Tiêu-biểu, trường-hợp
đáng-kính: danh-dự
trách-nhiệm: nhiệm-vụ, khiển-trách
thất-vọng: Hoài-bão, thất-vọng
phù-hợp: phù-hợp, đúng
phụ-thuộc: sự-phụ-thuộc, giới-hạn
khổng-lồ: thật-tuyệt, con-quái-vật
sự-hiểu-biết: hiểu-rõ, chiếm
đến: đến, Hoàn-thành
sự-đơn-giản: đơn-giản, khiêm-tốn
mùa-thu: gục-ngã
vắng-mặt: vắng-mặt, cách-xa
bóng-tối: bóng-tối
nghi-ngờ: phỏng-đoán, nghi-ngờ, khả-nghi
sự-quyết-tâm: xác-định, phán-quyết, bài-báo-cáo, Định-nghĩa
căn-cứ: căn-cứ, các-điều-khoản
xem-xét: quan-sát, kiểm-tra, nghiên-cứu
giải-thưởng: giải-thưởng, phí-bảo-hiểm
mua: mua
một-ai-đó: một-người, bất-cứ-người nào, Tuy-nhiên
nhận-ra: Hoàn-thành, hiểu-rõ
đánh-bại: tiêt-tâu, chuỗi-hạt, Thất-bại
hình-sự: máu
ngốc-nghếch: ngu-xuẩn, dốt
hồi-tưởng: ghi-nhớ
nghề: bố-ráp, chuyên-nghiệp, nghề, hung-hăng
đàm-luận: hiện-đại, nói-chuyện
hỗ-trợ: cứu-giúp, hỗ-trợ, sự-hợp-tác
giảm-giá: bán-đấu-giá, bán, chiết-khấu
lời-mời: mời, gọi-điện
dưới: không-đủ, xuống, tệ-hơn
công-nhận: thừa-nhận, chẩn-đoán
Chân-dung: bức-ảnh
đề-nghị: đề-xuất, giả-sử
thất-vọng: sự-thất-bại, Hoài-bão, anticlimax, thất-vọng, đếm
công-trình-xây dựng: cao-ốc
nhiệt-tâm: hăng-hái, siêng-năng
chịu-trách-nhiệm: nhiệm-vụ
chữa: trị-liệu, chữa-lành, chăm-sóc
bao-gồm: kể-ra, vào, bao-gồm, hiểu-rõ, Nội-dung
làm-vui-lòng: gặp, hài-lòng, Nội-dung, thưởng-thức
sự-đau-đớn: đắng
dốt-nát: crackpot, dốt, ngu-xuẩn
sự-hưởng-thụ: hưởng-thụ
giấu: giấu
đúng: đúng, đầy
giả-sử: van-xin, giả-sử, Về-vấn-đề
ước-tính: đánh-giá, phỏng-đoán
tuyến-đường: đường
du-khách: du-khách, khách, quan-sát-viên
không: không
dây-điện: dòng
đa-phần: đặc-biệt, phần-lớn
vô-ý-thức: mờ-nhạt
lẫn-nhau: lẫn-nhau, chung
ngoài: ngoài, nước-ngoài
vũ-trụ: vũ-trụ, thế-giới
đồng-hồ: giờ
chỉ-dẫn: giảng-bài, chiều-hướng, nhãn-hiệu
nhức-nhối: ung-nhọt, bệnh, đau
kỷ-luật: bộ-môn
sự-giới-thiệu: giới-thiệu, cung-cấp, khuyến-mãi, mồi, nhập-khẩu
nơi-hoang-vu: hoang-mạc
bối-rối: lo-lắng, sự-thất-bại
kết-hôn: có-gia-đình
thay-mặt: Tiêu-biểu, bên, vẻ-duyên-dáng, phần
tính: tin, tính, đếm
không-chắc-chắn: tính-không-chắc chắn, không-vửng, mơ-hồ
hôn-ước: đính-hôn, đề-cử
dơ-bẩn: phát-thải, Tổng
bác-sĩ: Bác-sĩ
bao-gồm: phủ, bao-gồm, mái-nhà, bọc
chân-thành: thành-thật, thật, đích-thật
cảm-giác: cảm-giác
đặc-biệt: đặc-biệt, riêng-tư, chuyên-gia
quán-trọ: khách-sạn
cứng: chăm-chỉ
hộ-tống: theo
ghi-bàn: chấm-điểm, bài-báo-cáo
gái-trinh: con-gái
đói: đói
yêu-thích: yêu-thích
Hải-quan: truyền-thống, inch, nhiệm-vụ, khách-hàng
ấn-tượng: cảm-giác
làm-mồi: săn-bắn, cướp-bốc, sự-hy-sinh
âm-nhạc: Âm-nhạc, nhạc-sĩ
thỏa-đáng: Căn-bệnh
nực-cười: dốt, vui-vẻ
tấm: giấy, lá-cây, tờ-rơi
ghét-bỏ: xấu-hổ
ban-đầu: nguyên
tiền-lương: trả
rộng: phổ-biến-rộng rãi, sâu
giải-trí: giải-trí, trống, về-hưu, sự-thư-giãn
cái-cằm: râu
phát-sáng: chói, nhẹ, sự-bức-xạ, đèn-flash
lòng-ghen-tị: ghen-tuông
đường-sắt: đường-sắt, huấn-luyện
pao: sách
phương-Đông: hướng-Đông
công-dân: dân-sự
bờ-biển: bờ-biển
tính-năng: thành-phần, đặc-tính, bất-động-sản
dự-trữ: giữ-lại, sách
kêu-la: tiếng-ồn
kỳ-lạ: lạ
vỏ: vỏ-cây, da
tiếp-nhận: chào-mừng, biên-lai
làm-hài-lòng: khó-chịu, Hiền-hậu
thức: thức
nghiên-cứu: nghiên-cứu, Tìm-kiếm
vua: Hoàng-đế, Vua
quần-áo: vải, bộ-váy, quần-áo
bệnh: Căn-bệnh, bệnh
đùa: câu-nói-đùa, trớ-trêu, cười
bình-luận: giải-thích
kim-khí: bàn-là, khoáng-chất
biện-pháp: sửa-chữa, phán-quyết, bài-giải
thuốc-lá: thuốc-lá, hút-thuốc
thực-thể: nhạc-cụ, đơn-vị, sự-có-mặt, cơ-quan, Công-ty, một-người
khởi-hành: khởi-hành, lạc-đề, vết-nứt, đi
cay-đắng: đắng
Hòa-Bình: trầm-tính
báo-động: nóng-lòng
lừa: tuyển-dụng, bước-đi, ngu-xuẩn, thao-tác, xảo-quyệt
tài-chính: tiền-bạc, kinh-tế
sự-chuẩn-bị: chuẩn-bị
vỏ-trứng: pod, vỏ-cây, da
lồng: sống, ổ-cắm-điện
nhận-thức: quan-niệm, hiểu-rõ, nghĩ
cuộc-hẹn: đề-cử, lời-hứa
lấy: mang-lại, lấy-lại, cầm-lấy
cây-nến: nhẹ, sáp
xúc-phạm: tấn-công, tội-phạm, khối-lượng
hỗn-hợp: hỗn-hợp
kiểu-mẫu: trường-hợp
khuyết-điểm: khiển-trách, nếp-nhăn, khuyết-tật
sự-phản-đối: bất-đồng-ý kiến, phản-đối, sự-mâu-thuẩn
nghề: môn-vẽ, nghề, kỹ-năng
bỏ-bê: bỏ-qua, bị-bỏ-rơi, bỏ-xót, tẩy-chay
dữ-liệu: thông-tin
vũ-khí: cánh-tay, súng
màu-hồng: bông-hồng
người-dùng: trong-khoảng, người-thụ-hưởng
ông-ngoại: tổ-tiên, ông-bà
vô-giá-trị: số-không, trống
mạnh-mẽ: hung-bạo
sấm-chớp: điện-tử, chớp, đèn-flash
thể-thao: sự-vận-động, bài-tập
phấn: bột-mì, bụi-bẩn
bức-tranh: bức-ảnh, bảng-điều-khiển
kêu-la: tiếng-ồn, dao, khóc
bất-cẩn: táo-bạo, thờ-ơ
phái-sinh: lấy-được
cửa: cánh-cửa
thuận-tiện: đơn-giản, Thực-hành, dễ-chịu, Dễ-dàng, đúng
email: Bưu-điện, lá-thư
Sơn: màu
đầu-hàng: truyền-thống
thiết-lập: giới-thiệu, thành-lập, sửa-chữa
ôn-hòa: dịu-dàng, nhẹ
nhanh-chóng: một-khi, đúng
phòng-ban: phần
xứng-đáng: giá-trị, đủ-điều-kiện
bỏ: bị-bỏ-rơi, hiện-ra, vết-nứt, đúc
sự-bảo-đảm: cam-đoan, tiền-thế-chân
gương: ly
Thửa: âm-mưu, kế-hoạch, câu-chuyện
trở-lên: hơn
thật-đáng-buồn: buồn, không-may
khiêm-tốn: chung, đơn-giản, khiêm-tốn, thanh-đạm
món-ăn: tòa-án, món-ăn, ăn
lưới: web, đích-thật, thánh
hơi-nóng: hăng-hái, nóng
bồn-chồn: nóng-lòng
làm-thí-nghiệm: Phi-công, Trải-qua, cố-gắng
hôm-nay: ngày
rất-lớn: khủng-khiếp, thật-tuyệt, to-lớn, rất
sự-cải-thiện: cải-cách, sửa, tiến-trình, phục-hồi, chữa-lành
tranh-chấp: bất-đồng-ý kiến, cãi-vã
mệnh-đề: đề-xuất, câu-văn
có-lẽ: có-lẽ, có-thể
súng-trường: súng
che-chắn: bảo-vệ
thuê: thuê, sử-dụng
không-giống: khác-nhau
bình-phục: lưu-giữ, lấy-lại, phục-hồi
người-bạn-đời: nước-miếng, bạn-đồng-nghiệp, bạn-bè
sắp-xếp: gọi-món, lập-pháp, tổ-chức
ủy-ban: bảng-điều-khiển, tiền-hoa-hồng
già: cũ
con-ma: Linh-hồn
sự-tiết-lộ: biểu-hiện
sự-thừa-nhận: thừa-nhận, lời-thú-tội
đất-sét: bùn, nốt-ruồi
Thân-cây: bộ-lạc, hành-lý, khởi-động
quản-lý: quản-lý, chạy-xe
khôi-phục: giữ-lại, trở-lại, phục-hồi, lấy-lại
phản-đối: phản-đối, tháng-Ba
chồng-chất: bãi, cổ-phần, đám-đông
vừa-phải: thứ-cấp, có-nghĩa
Đánh-vần: quyến-rũ, chính-tả
diện-tích: cánh-đồng, khu-vực, bề-mặt
chính-thức: chính-thức
Biên-tập-viên: tác-giả, nhà-phát-hành
công-nhận: lời-thú-tội, thừa-nhận
phương-thuốc: thuốc-chữa-bệnh, trị-liệu, sửa-chữa
theo-đuổi: thưởng-thức, màn-hình, chi-tiêu, theo
cực: lấy-làm-tiếc, cột, cực, lỗ-rốn
quan-trọng: cần-thiết, quyết-định, Chìa-khóa
chủ-tịch: cái-đầu
khu-vực: cánh, khu-vực, phần
Cô: 
cổ-vũ: hình-trái-tim, hăng-hái
hợp-lý: hợp-lý, bên-phải, biện-hộ
ngưỡng-mộ: khen-ngợi
mở: một-cách-rõ ràng, mở-ra, khai-mạc
sự-sửa-đổi: sự-thay-đổi, thích-ứng
kịch: kịch, chỉ-thị
lên-lầu: phía-trên, tệ-hơn
thay-đổi: khác-nhau
hạ-xuống: bản-chất
đố-kỵ: ghen-tuông
phụ-tải: cân-nặng, sự-căng-thẳng, quán-ba, bộ-lạc
giả-bộ: đặt-chuyện, kịch
nội-bộ: bên-trong
bức-màn: mạng-che-mặt, màn
khỏe-mạnh: Sức-khỏe
che-khuất: mơ-hồ, che-khuất
Trung-tâm: Trung-tâm
Cuộc-thi: cuộc-đua
thay-đổi: chuyển-đổi, sự-thay-đổi, thay-thế
nhìn-thoáng-qua: nhìn-thoáng-qua, thị-giác
hợp-đồng: Biên-bản-ghi nhớ, gọi-món, cầm, đồng-ý
tiết-kiệm: lưu-giữ, Lưu-trữ, Kinh-tế-học
chuỗi: dây, chuỗi, bộ
sự-kết-hợp: trùng, hỗn-hợp, bộ, gọi-điện
bắt-giữ: đóng-lại, quan-niệm
nhiệt-độ: nóng
khắt-khe: nghiêm-khắc, nhọn, chăm-chỉ
chuyên-nghiệp: chuyên-nghiệp, nghề
bị-thương: bị-thương, chấn-thương
khu-vực-lân cận: xung-quanh, sống, môi-trường
hút-thuốc: hút-thuốc, thuốc-lá
Y-khoa: Bác-sĩ
báo: báo
đáng-chú-ý: phổ-biến, đáng-ghi-nhớ, theo-sau, Chìa-khóa, ai-cũng-biết
tổ-chức: tổ-chức, Công-ty, cơ-quan
đóng-gói: bọc, đóng, bao-bì
đau-khổ: đắng, đau-khổ, đau, nỗi-buồn
chắc-chắn: hiển-nhiên, mở-ra, một-cách-rõ ràng
bắt: làm-xiêu-lòng, cầm-lấy, quan-niệm
phong-phú: đủ, không-đủ
phòng-ngủ: căn-phòng
thuần: chỉ, trọn-vẹn, thánh
chung: chung, hỗn-hợp, gọi-điện
tham-khảo: tham-chiếu, tham-khảo
nhận-định: bản-sắc, nhận-biết, sửa-chữa
ghế-dài: ngân-hàng
giải-thoát: phục-hồi, lưu-giữ
giới-hạn: giới-hạn, giãm-bớt
hy-vọng: chờ-đợi
chương-trình: kế-hoạch, chương-trình-nghị sự
điện: điện-tử
khoảng-thời-gian: tạm-thời, gãy
đuổi-theo: săn-bắn
chiếm: cầm-lấy, chiếm
áo-choàng: áo-khoác, bộ-váy, bộ-đồ
Khóa: Lâu-đài
đề-nghị: đề-xuất, câu-văn, kế-hoạch, lời-kết
hạnh-phúc: sung-sướng
tiếp-theo: bên-cạnh
khó-chịu: không-vửng, khó-chịu, nóng-lòng, chăm-chỉ
chiếu-sáng: chói, đèn-flash
máy-móc: cơ-khí, máy, cơ-chế
hấp-dẫn: có-từ-tính, rút-ra, ao-ước
sản-phẩm: các-mặt-hàng
bệnh-tật: Căn-bệnh
động-cơ: động-cơ, máy
họ: họ
da: da
khôn-khéo: vi, gầy
độ-dốc: dặm, nhúng, khuynh-hướng
lo: nóng-lòng, sự-lo-lắng
dữ-dội: chăm-chỉ
xác-định: xác-định
gỗ: bằng-gỗ, cây-gậy, cây
tính-toán: tính, đếm
giết-người: giết
buồn-cười: lạ, vui-vẻ
sự-sỉ-nhục: sự-khinh-thường, xấu-hổ
không-có-khả năng: khả-năng
ăn-cơm-trưa: ăn
nhạy-cảm: nhạy-cảm, Chìa-khóa
thèm-ăn: khao-khát
lịch-sự: lịch-sự, danh-dự
khu-vực: cánh-đồng, quả-bóng, khu-vực
danh-dự: danh-dự
có-tội: phạm-tội, tội-phạm, khiển-trách, tội
thơm-ngon: ngon, mùi-vị
lúa-mì: văn-hóa-dân gian, ngũ-cốc, ngô
hài: hài
gặp-gỡ: đương-đầu, gặp, hẹn-hò
Hoàng-hôn: rạng-sáng
công-viên: vườn
nền-kinh-tế: kinh-tế, Kinh-tế-học
quản-lý: quản-lý, qui-định, bậc-thầy
sự-hình-thành: giáo-dục, xây-dựng
gầy: dặm, gầy
đập: do-dự, vuốt-nhẹ, tiêt-tâu
thống-nhất: hiệp, đơn-vị, tinh-thần-đoàn kết
chính: tiên-phong, Chìa-khóa, Cha-mẹ, thật-tuyệt, kẹp-giấy
sơ-bộ: khai-mạc, nguyên
biên-giới: giới-hạn, cạnh
thở: hơi-thở
miễn: miễn-phí, thoát-khỏi, tha-thứ
giàu-có: giàu-có
cảm-hứng: xung, cảm-hứng
mọi-người: toàn-bộ
phong-phú: giàu-có
họa-sĩ: họa-sĩ
kính-mắt: ly
chụp: bắn, săn-bắn
toa-xe: huấn-luyện, xe-đẩy-hàng
cho-mượn: biếu-tặng, thẻ-tín-dụng, Trích-dẫn
đảm-đương: bắt-đầu, làm
niêm-phong: chiếc-nhẫn
giáo-sĩ: thầy-tu
núi: lắp-đặt, tăng, đồi
mảng: cột, bộ, gọi-món
tạp-chí: nhấn
thô: chăm-chỉ, nghiêm-khắc
mặc-dù: Tuy-nhiên
chật: nghiêm-khắc
cảnh-quan: kịch-bản, môi-trường, thị-giác
bỏ: bị-bỏ-rơi
nghệ-thuật: môn-vẽ
phần-lớn: đặc-biệt, phần-lớn
trung-thành: lòng-trung-thành, thành-thật, Trung-thành
phù-hợp: thích-đáng, phù-hợp, đúng
Khuyến-cáo: khuyên-bảo, cố-vấn
ổn-định: thành-lập, xác-định, Tiêu-chuẩn
tối-đa: tối-đa-hóa, cực
cam-kết: lời-hứa, làm
có-ảnh-hưởng đến: hiệu-quả, gây-ấn-tượng
nông-dân: người-nông-dân
đáng-kể: rất, theo-sau
gia-hạn: chi-tiết, mở-rộng, căng-ra
cá-nhân: cá-nhân, riêng-tư, của-bản-thân
đạo-đức: luân-lý
cuộc-nổi-loạn: phiến-loạn, Cuộc-cách-mạng
sợi-chỉ: dòng, quay
đồng: thau
phản-ứng: sự-phản-ứng, bài-giải
hoàng-đế: Hoàng-gia
chỗ-trống: trống, rỗng, màu-trắng
nhỏ: thứ-cấp, ít, thợ-mỏ
mặc-cả: buôn-bán, dịp
mệt-mỏi: mệt, sự-căng-thẳng
không-thích: sự-khinh-thường, chán-ghét, miễn-cưỡng
bình-thường: chung
phác-họa: dàn-bài, kế-hoạch
đức-hạnh: Đức
dù-sao: dù-sao, rồi
lái-xe: người-lái-xe hơi, chạy-xe, Nhạc-trưởng
tờ-khai: quảng-cáo
thặng-dư: thêm-vào, dư
khoảng-cách: phân-ly, khoảng-cách, tách
thù-ghét: sự-khinh-thường, ám-ảnh, chán-ghét
đúng: cùng-một, đúng
bao-vây: đám-đông, khối-lượng
không-cần-thiết: chất-thải, cần
lông: da, áo-khoác
khuyến-khích: cảm-hứng, đẩy
cống-vật: thuê
giải-tỏa: giảm, thoát-khỏi, tha-thứ
pháp-luật: lập-pháp, qui-định, cơ-quan-lập pháp
dự-án: kế-hoạch
bà-tiên: Thiên-thần, màu-xanh-da trời, Biệt-thự
kết-luận: cầm, lời-kết
may-mắn: sung-sướng
vạt-áo: đầu-gối, khăn, tròn
cướp-bóc: cướp-bốc, sự-đổ-nát, pha-rượu
chịu-trách-nhiệm: Dễ-dàng, có-xu-hướng, nhạy-cảm
chu-đáo: cẩn-thận, nóng-lòng, khôn-ngoan
thuận-tiện: thích-đáng, uốn-cong, ao-ước
thiếc: ngân-hàng
phụ-thuộc: sự-phụ-thuộc, đính-kèm, công-nhân
trát: cam-đoan, biện-hộ, Biên-bản-ghi nhớ
lời-phàn-nàn: màu-trắng
hội-nghị: Biên-bản-ghi nhớ, đồng-ý
góc: góc, đa-giác
rộng-rãi: phổ-biến-rộng rãi, rất, nói-chung, phần-lớn
bò: gia-súc
định-kiến: chán-ghét
cổng: hội-trường, ban-công
thật-ngạc-nhiên: lạ, làm-kinh-ngạc, bất-ngờ, nổi-bật
Đài-phun-nước: nguồn
thích-hợp: đúng, bộ-đồ, thích-hợp
chắc-chắn: lòng-can-đảm, an-toàn, tin
đàn-organ: nhạc-cụ, hội-viên, thành-phần, cơ-thể-người
sự-lựa-chọn: chọn, đề-cử, bầu-cử
kinh-sợ: ám-ảnh, nỗi-sợ
so-sánh: sự-so-sánh
quan-hệ: đóng-lại, cái-móc, quan-hệ, liên-quan
tự-phụ: tin, phỏng-đoán, giả-sử, Về-vấn-đề
mất-tích: đi-lạc
hợp-thời-trang: hiện-đại, tao-nhã
tích-cực: khả-quan
lý-luận: ý-kiến, cãi-vã
làm-phiền: lo-lắng, hung-hăng, gây-trở-ngại, làm-phiền
bạn-đồng-hành: bạn-gái, chung, cổ-đông
sự-kết-hợp: kết-hợp, Về-vấn-đề
cháu-gái: cháu-trai, cháu-gái
cơ-thể: sinh-lý, cơ-thể-người
giảng-viên: trường-đại-học, giai-thừa
súng-thần-công: quả-bóng, Súng-đại-bác, súng
bơi-thuyền: con-tàu, mạng-che-mặt
thông-minh: khôn-ngoan
nhỏ-mọn: chiếc-nhẫn, tầm-thường, ít
chú-ý: cảnh-báo, chăm-sóc
bản-viết-tay: hóa-đơn
quân-nhân: anh-hùng
chất-lỏng: nước
khái-niệm: quan-niệm, ý-nghĩa
đặc-biệt: đặc-biệt
nhảy: bay, nhảy, gót-chân, tung-lên
không-sẵn-sàng: có-ý-định
thêm: thêm-vào
sân-cỏ: vỉa-hè, giai-điệu, không
vụng-về: không-đủ, lạ
cảm-kích: tán-thưởng, hưởng-thụ
sống-sót: sống, ở-lại
một-thời-gian ngắn: từ-viết-tắt, ngắn
cơm: thau
anh-chàng: một-người
cư-xử: đặc-tính, hạnh-kiểm
nhận-nuôi: giả-sử, cầm-lấy
thường-xuyên: thường, lặp-đi-lặp lại, thường-xuyên, đúng
cuộc-điều-tra: thăm-dò, Tìm-kiếm
theo-hiến-pháp: hiến-pháp
muộn-nhất: Cuối-cùng
học-sinh: học-sinh
hoàn-toàn: trọn-vẹn
xoắn: khuynh-hướng
khác-nhau: tách, chênh-lệch, khác-nhau
thảm-họa: sự-đổ-nát
cá-cược: cổ-phần, điều-kiện, phủ-quyết
sống: sống, nguồn, Tổng, màu-xanh-lá
khúc-gỗ: vào, đăng-ký, câu-lạc-bộ
Hiếu-khách: hào-phóng
xe-đẩy: huấn-luyện, xe-đẩy-hàng
y-phục: bộ-váy
thuê: đính-kèm, sử-dụng, thuê, giữ-lại
bầy: đàn
sưu-tầm: quây-quần
cái-chảo: nồi
tấn-công: tấn-công, bố-ráp
lừa-dối: ngu-xuẩn, phản-bội
tang-chế: nỗi-buồn
rút: thoát-khỏi, rút-ra, về-hưu
điệu-nhạc: bài-hát, hài-hòa
lòng-trắc-ẩn: đồng-cảm, lòng-thương-hại
đóng-giả: giấu
phiên-mã: bản-sao
tài-liệu: Hồ-sơ
hàng-xóm: xung-quanh
chặn: ngăn-chặn, âm-lượng
nghĩa-vụ: nhiệm-vụ
suy-giảm: chối-bỏ, gục-ngã
tham-vọng: Hoài-bão
ngày-lễ: kì-nghỉ, tiệc
nắm-tay: Thứ-nhất
chim-ưng: chim-ưng, bó-lại
đáng-kính-trọng: danh-dự
quan-trọng: cần-thiết, theo-sau, nổi-bật
dầy-đặc: chắc, dầy
viễn-tưởng: Tiểu-thuyết, sự-tưởng-tượng, câu-chuyện
giới-thiệu: đề-xuất, giới-thiệu, khuyên-bảo
giáo-dục: giáo-dục
trở-lên: hơn, phía-trên
sừng: ngô
quỹ: cái-hộp, nguồn-vốn
lều: túp-lều, Hồ-sơ, lều
trang-phục: bộ-váy, bộ-đồ, khách-hàng
giá: thuê, đi, bản-đồ
vỗ-tay: tán-thưởng, sự-chấp-thuận
nhắc-lại: ghi-nhớ, giống-nhau
cái-gối: con-sông
hư-không: nơi
tử-thi: cơ-thể-người
Bản-chất: tế-bào, sinh-vật
độ-cao: dốc
vương-quốc: cánh-đồng, thế-giới
cầu-thang-gác: cầu-thang, tỉ-lệ
phù-hợp: Biên-bản-ghi nhớ, chắc, bộ-đồ, phù-hợp, đồng-ý
ren: mũi-nhọn, mức-thu-nhập
học-giả: học-sinh, nhà-khoa-học
cái-thước: công-tước, thống-đốc
khùng: crackpot, ngu-xuẩn
giải-trí: chào-mừng, làm-cho-vui, giải-trí
Lời-chào: chào-mừng, bưu-thiếp
giống-cái: nữ
quái-dị: con-quái-vật, khủng-khiếp
cơ-sở: thiết-bị
cướp: lấy-trộm, cướp-bốc
thang: cầu-thang, Nhạc-trưởng, tỉ-lệ, ngôi-trường
cuối: Cuối-cùng
chia-ra: chênh-lệch, phân-phát
không-thể-tin được: lạ, bất-thường
hình-cung: cây-cung
trúng-tuyển: bầu-cử, chọn
e-thẹn: nhút-nhát, xấu-hổ
sương-mù: sương-mù
màu: màu
cảnh-báo: cảnh-báo, khiến
cạn: sâu
sự-khuyến-khích: kích-thích-kinh tế, sự-an-ủi
không-thường-xuyên: chung, bất-thường
trung-thành: lòng-trung-thành, Trung-thành, đúng
chuyển-giao: dịch
căn-bản: căn-cứ, kẹp-giấy
bó-lại: đóng, chất-xơ
bi-thảm: khủng-khiếp
kiểm-tra-lại: sửa-đổi, sự-chỉ-trích
khủng-khiếp: khủng-khiếp, rất, tệ-hơn
nấu-nướng: đầu-bếp, nhà-bếp
làm-loạn: phiến-loạn, Cuộc-cách-mạng
cải-thiện: sửa-chữa, chữa-lành
tàu-chìm: hủy-hoại
sự-thuyết-phục: khuyên, cam-đoan
bát: ly-uống-nước
hình-minh-họa: trường-hợp, bức-ảnh
thần-kinh: tĩnh-mạch, lòng-can-đảm, lo-lắng
nhìn-chằm-chằm: sửa-chữa
xác-định: biết, cam-đoan, xác-định, kiểm-tra, sửa-chữa
lời-hứa: cam-đoan, lời-hứa, con-tin, tiền-thế-chân, cầm-đồ
kiếm-được: phục-vụ
lựa-chọn: chọn
công-nghiệp: công-nghiệp-hóa, ngành-công-nghiệp
sự-giải-thích: dịch
thách: gọi-điện
ngăn-cấm: ngăn-chặn, chối-bỏ
chủ-đề: motif, bộ-môn
nhận-vào: biên-lai
hồ-bơi: Hồ-bơi, hố
hội-nghị: buổi-họp, hội
bình-đẳng: phép-loại-suy, cân-đối, sự-tương-đương, phương-trình
mới: tân, gần-đây, Tiểu-thuyết
môi-trường-xung quanh: môi-trường, xung-quanh
cuộc-xâm-lược: tấn-công, bố-ráp
họa-tiết: trường-hợp, một-khi, Tiêu-chuẩn, mẫu-đơn
tiết-lộ: tiết-lộ, phản-bội
giải-quyết: lỏng-lẻo, sửa-chữa
thuyết-giáo: bài-thuyết-giáo
bà-ngoại: cô-dâu, ông-bà
len: bông
giao-tiếp: cuộc-đối-thoại, xã-hội-hóa, quan-hệ
chủ-yếu: các-điều-khoản
đối-lại: phản-đối
mẫu: trường-hợp
kéo: rút-ra, kéo
trồng-trọt: cây-trồng, mùa-gặt, cắt-tỉa
chính-xác: đúng, bột-mì, cẩn-thận
khu-nghỉ-mát: cầm-lấy, che-chở, gãy
sự-từ-chối: chối-bỏ, chất-thải
phiếu: Chìa-khóa, tiền-thế-chân, liên-hiệp-tiếp từ
thông-cảm: lòng-thương-hại
tiền-lương: trả
liên-tiếp: tiếp-tục
kích-thích: khiến, xúi-giục
wildly: hoang-dã, hung-bạo
nỗi-buồn: nỗi-buồn, thảm-kịch
đồng-minh: hiệp, liên-quan
trần-nhà: cái-mền, mái-nhà
khung-thành: chú-trọng, mục-đích
tiền-mặt: tiền-bạc
trống: mở-ra, miễn-phí, trống, lỏng-lẻo, mơ-hồ
khinh-khi: sự-khinh-thường
cỏ: cỏ, đồng-cỏ
Thổ-Nhĩ-Kỳ: 
hàng-xóm: xung-quanh
cuối-cùng: Cuối-cùng, cực, cuối-cùng, kẹp-giấy
nộp-hồ-sơ: tuân-lệnh, gửi-đi
lối-vào: vào
uyên-thâm: sâu, đầy
phấn-khởi: rút-ra, Hiếu-kỳ
chiến-thắng: sự-thành-công
bảo-thủ: chánh-thống, thống-đốc
hăng-hái: hăng-hái, nóng-lòng
tầng-dưới: xuống
sôi-lên: đầu-bếp, ung-nhọt
đẹp: nét-đẹp, đẹp
Ngày-mai: hôm-qua
không-thoải-mái: nóng-lòng, khó-chịu
dụng-cụ: thiết-bị
đòi: năn-nỉ
sự-bày-tỏ: phát-âm, biểu-hiện
đường-sắt: đường-sắt, huấn-luyện
không-hoàn-hảo: đầy, khuyết-tật, thiếu-sót
mua: mua-lại, lấy-được, mua
phản-cảm: bố-ráp, tấn-công, hung-hăng
lạnh-lùng: lạnh
bài-giảng: khóa-học
theo-đó: Ở-đâu
sự-nhận-thức: cảm-giác, nhìn-thoáng-qua, quan-niệm
phát-triển: kỹ-lưỡng
chức-năng: Lễ, công-việc, Hoạt-động
đạn: máy-tính-bảng, bắn, quả-bóng
buộc: đóng-lại, giới-hạn
giống-hệt-nhau: cùng-một
trọng-yếu: chỉ-thị, thật-tuyệt, theo-sau, nổi-bật
số-lượng-lớn: khối-lượng, độ-lớn, âm-lượng, bướu
kéo-dài: Dài, kéo-dài
khó-chịu: bị-kích-thích, khó-chịu
buồn-bã: lo-lắng, buồn
xăn-lên: liên-hiệp-tiếp từ, ban-nhạc
cỏ-khô: cỏ, rơm
tranh-luận: bất-đồng-ý kiến, cãi-vã
sự-yên-lặng: khoảng-lặng
từng-phần: ngoại-lệ, phần
thịt-bò: thịt
liên-Hợp: tinh-thần-đoàn kết, yên-cương, hòa-giải, tham-gia
lưỡi: lá-cây, Gươm, dao
Nha-may: máy-xay
vô-giá-trị: số-không, trống
tạp-chí: báo, nhấn
nói-thật-là: lòng-trung-thành, thành-thật
hợp-pháp: hợp-pháp
giọng: phát-âm, nhấn-mạnh, chú-trọng
chân-thành: nghiêm-túc
liên-đoàn: liên-minh
phê-duyệt: sự-chấp-thuận
chân-tay: hội-viên, cực
người-quản-lý: giám-đốc, đầy-tớ
tiến-hóa: cải-cách, tiến-hóa
khảo-sát: kiểm-tra, Tìm-kiếm
đồng-thời: hiện-đại
scandal: tham-nhũng
cố-ý: cố-tình
biểu-tượng: ký-hiệu, cử-chỉ
giặt-giũ: rửa, giặt-ủi
tóm-lược: đúng, bột-mì, cẩn-thận
xảy-ra: biến-cố, dịp
thân-cây: rãnh, vai, cây
thân-cây: khô, bộ-lạc, gốc-cây
công-ty: Công-ty, cơ-quan
sự-ưa-thích: đặc-quyền, thích-hơn, Ưu-điểm, chọn
thúc-giục: khiến, xung, khao-khát
loại-bỏ: khoảng-cách
quả-quyết: sự-chấp-thuận, nhấn-mạnh
truy-cập: Thăm-quan, tìm-thấy
hài-kịch: hài
tuôn-ra: màu, hứng-thú
Mã: cái-sân, mã-hóa
đầy-đủ: đủ, đúng
chẻ: phân-phát
sử-gia: lịch-sử
cường-độ: tỉ-trọng, sự-căng-thẳng
chế-độ-dân chủ: cộng-hòa
tín-điều: lời-thú-tội
sức-hút: quyến-rũ, nghiêm-trọng
buổi-hòa-nhạc: lễ-hội
đi-xuống: xuống
ống: kênh, ống
nhanh-chóng: Sớm, yêu-cầu, nhanh-nhẹn
huy-chương-đồng: thau, nâu
quần-áo: quần-áo
sự-hối-hận: buồn, lòng-thương-hại
độc-quyền: độc-quyền, riêng-tư
nhân-viên-khuân vác: mặc, người-chuyên-chở
dấu-gạch-ngang: dòng
dải: ban-nhạc
cuối-cùng: cuối-cùng
đội: điệp-khúc
mắc-tiền: kính-thưa
trụ-sở-chính: trụ-sở-chính, Trung-tâm
nhọn: nhọn
bối-rối: lo-lắng, xấu-hổ
con-cái: bọn-trẻ
mạng-lưới: web
máy-bay: chim, bề-mặt, máy
một-phần: phần
tự-hào: niềm-tự-hào
sân-thượng: ban-công, mái-nhà
nắm-chặt: cầm, bẩy
vụ-nổ: nổ
quân-đội: quân-đội, quân-sự
chặt-chẽ: nghiêm-khắc
hình-phạt: lòng-thương-hại, câu-văn
bụi: ẩm, phân, bùn
kỷ-nguyên: mùa-vụ
đại-sứ: sứ-giả
giống: nhân, cuộc-đua
sự-can-thiệp: gây-trở-ngại, điều-khó-chịu, xáo-trộn
gồm-có: thông-qua, Nội-dung
chấp-thuận: chấp-nhận-được, sự-chấp-thuận, biên-lai
kĩ-sư: cơ-khí
tạm-dừng-lại: bàn-chân
thay-thế: luân-phiên, thay-thế
con-tem: chiếc-nhẫn
phản-đối: đĩa, phản-đối, ngược-lại
sao-Kim: Thứ-sáu
tưởng-tượng: sự-tưởng-tượng
leo: nổi-lên, leo
thu-hút: rút-ra, gây-ấn-tượng
kinh-ngạc: bất-ngờ, nổi-bật
cuộc-thi: đối-thủ
pha-lê: ly
vòi-hoa-sen: bồn-tắm, mưa
triết-học: nhà-triết-học, triết-lý
ồn-ào: tiếng-ồn
Thiết-bị: thiết-bị
giao-thông-vận tải: giao-thông, đưa-đón
sau-cùng: cuối-cùng
ghê-sợ: rất, khủng-khiếp
sự-trầm-tư: phản-chiếu, sự-phản-xạ
chế-tạo: ngành-công-nghiệp, sản-xuất
thoải-mái: dễ-chịu
triển-lãm: tang-vật, bài-báo-cáo
nông-nghiệp: nông-nghiệp, nông-trại
sự-tìm-kiếm: Tìm-kiếm
sự-mở-rộng: chi-tiết, mở-rộng
tranh-cãi: sự-mâu-thuẩn, cãi-vã
khoảng: gần
trên-không: phía-trên
chế-ngự: ức-chế, ngăn-chặn, sự-hạn-chế, giữ-lại
sự-bảo-tồn: lưu-giữ, chăm-sóc, giữ-lại
quán-rượu: quán-ba
lưu-vực: thung-lũng, Hồ-bơi, bồn-nước
giai-điệu: giai-điệu
Thuê: thuê
lo-lắng: nóng-lòng, lo-lắng
người-già: tuổi-già, cũ
trường-đại-học: trường-đại-học
cẩn-thận: cẩn-thận
trước: hướng-Đông, trước
phức-tạp: phức-tạp, chăm-chỉ, kỹ-lưỡng
lời-xin-lỗi: xin-lỗi, lấy-làm-tiếc
sợ-hãi: sợ-hãi, nỗi-sợ
thay-thế: luân-phiên, phụ-cấp, thay-thế
sử-dụng: sử-dụng
phục-hồi: sửa, phục-hồi, lấy-lại
hàng-rào: hàng-rào
sơ-cấp: bậc-thầy, căn-cứ, nguyên, kẹp-giấy
chùm-tia: cá-đuối
chuyến-du-lịch: Thăm-quan, thám-hiểm
phóng-đại: muối
có-thẩm-quyền: cho-phép, khả-năng
khẩn-cấp: Sớm, làm-kết-tủa
báo-động: cảnh-báo, báo-thức, thức
lò-nướng: bếp
làm-tròn: tròn
thông-thường: chung
biện-hộ: van-xin, biện-hộ
dây: dây
bên-cạnh: song-song, bên-cạnh, kết-hợp
giải-nén: Trích-dẫn, nước-ép
cái-bật-lửa: nhẹ
pint: bia
ống: ống
đại-lộ: dịp
hiệu-quả: giỏi, có-hiệu-lực, hiệu-quả
pha-trộn: hỗn-hợp, sự-náo-động
băn-khoăn: xáo-trộn, điều-khó-chịu
chấp-hành: giám-đốc
thứ-mười: mười
tương-đối: sự-so-sánh
sáng: buổi-sáng, sáng
lồng: Lâu-đài, tế-bào
nhà-tù: nhà-tù, chuỗi
khéo: giỏi, xảo-quyệt, khả-năng
hét-lên: khóc
sự-thỏa-hiệp: đồng-ý, hài-hòa
đạn-dược: bắn
phụ-tá: người-ủng-hộ, cứu-giúp
cây-gậy: cây-gậy
tranh-luận: bàn-luận, năn-nỉ
Logic: cãi-vã, hợp-lý, tính-hợp-lý
hoảng-loạn: nỗi-sợ
sự-lưu-thông: đạp-xe, chu-kỳ, giao-thông, ngắm-cảnh
căng-thẳng: sự-căng-thẳng
sự-tiêu-thụ: sử-dụng, tiêu-thụ, ăn
chịu-được: hỗ-trợ, giữ-lại, cầm, chịu-đựng
tai-nạn: gục-ngã, cuộc-xung-đột
thiếu-xót: không-đủ, cắt-tỉa, thiếu-sót
từ-từ: dần-dần
nghiền-nát: hủy-hoại, nghiêm-trọng, bí-đao
hiện-tượng: biến-cố, Điều
thi-hành: chạy, hoạt-động
chào: Sức-khỏe, chào-mừng, kêu
chế-độ-quân chủ: Hoàng-gia, bất-động-sản
hành-xử: sống
rào-chắn: trở-ngại, ngưỡng
đường-cong: cây-cung
tin-cậy: đếm
tiện: Dễ-dàng, sự-an-ủi
cừu: con-cừu, leo
logic: hợp-lý
chế-độ-ăn kiêng: món-ăn
tư-pháp: tòa-án, hợp-pháp
không-tin-tưởng: nghi-ngờ, lòng-trung-thành
lông-chim: mùa-xuân, lòng-thương-hại
tình-nguyện: Tình-nguyện
Áo-khoác: áo-khoác, áo-len
bơi-lội: bơi
ấn-tượng: nổi-bật
bên-dưới: xuống, sau
tỉnh: nông-thôn, tỉnh
đền-bù: bù-lại, phụ-cấp
người-hầu-bàn: đầy-tớ
khuyến-khích: sự-tăng-tốc, khuyến-mãi, nuôi, đẩy, Góp-phần
cống-hiến: có-ý-định
thù-địch: thù-nghịch
trồng: nông-trại, vườn-ươm
vạch-trần: dàn-bài, tiết-lộ, mở-ra
vá: nơi, tập-tin-đính kèm
gián-đoạn: gãy, điều-khó-chịu
ngón-tay-cái: inch
nhà-cách-mạng: Cuộc-cách-mạng
kinh-ngạc: lạ, làm-kinh-ngạc
đầu: bán-cầu, mũi-nhọn, cực, râu, đỉnh, khuyên-bảo
mối-đe-dọa: đe-dọa, nguy-hiểm
rừng-nhiệt-đới: khu-rừng
điển-hình: chung, đặc-tính
nhiên-liệu: dầu
yên-tịnh: trầm-tính
nơi-đến: sự-lập-lại, mục-đích, số-phận
ghim: bí-mật, cây-kim
Hỏa-Tinh: tháng-Ba
kết-hợp: liên-quan, bạn-đồng-nghiệp, kết-hợp, chung, song-song, đính-kèm
luẩn-quẩn: trái-với-đạo đức, quỷ-quái
đãi-tiệc: tiệc
chi-tiết: kỹ-lưỡng, sâu, bản-lề, chi-tiết, cẩn-thận
tủ-quần-áo: buồng
lập-pháp: lập-pháp, cơ-quan-lập pháp
lề: cạnh, cánh-đồng
nhà-vô-địch: anh-hùng
mạch: xung
trốn: chạy, bỏ-trốn
điều-khoản: suối, đoạn
phức-tạp: kết-hợp, phức-tạp
thắt-nút: cầm, dệt-kim
mối-quan-hệ: quan-hệ, bài-báo-cáo, Về-vấn-đề
cơ-quan: cơ-quan, Công-ty, văn-phòng
nụ-cười: nụ-cười, nhăn-nhó
cuộc-biểu-tình: hiển-thị, tháng-Ba
Phiền-muộn: nỗi-buồn
xe-cộ: máy
mượn: thẻ-tín-dụng, Trích-dẫn
sưng-tấy: sưng-lên
chủ-đề: motif, bộ-môn, tiêu-đề
phán-quyết: phán-quyết, qui-định
Sa-bát: thứ-bảy
nhận-biết: nhận-biết, bản-sắc, Định-nghĩa
ảnh-chụp: bức-ảnh, bắn
đồng-minh: bạn-bè, hữu-nghị, hiệp
đường: đường, căng-ra, cãi-vã
dây-băng: ban-nhạc, bộ-phim
cộng: hơn
minh-bạch: minh-bạch, hiển-nhiên
nước-hoa: mùi
làm-phiền: rắc-rối, gây-trở-ngại, làm-phiền, điều-khó-chịu
có-đủ-năng lực: khả-năng, đủ-điều-kiện, giỏi
bài-văn: bài-báo, bài-báo-cáo
lái: hiệp-sĩ, cưỡi
sự-cô-đơn: cô-độc
cổ-tay: tay
tinh: dịu-dàng, gầy, cuối-cùng
vô-giá-trị: số-không, trống
lên-án: câu-văn
quai-hàm: cây-thông
độc-nhất: hiệp
chắc-chắn: không-thể-tránh khỏi
trống: nhảy, trống
thùng-rác: cái-hộp, cái-giỏ
thời-gian: tạm-thời, thường-xuyên, thời-gian, chiều-dài
cân-nặng: đo, cân-nặng
tu-viện: tu-viện
công-bố: công-bố, phân-phát, tiết-lộ
sáng-suốt: thị-giác
chắc-chắn: hiển-nhiên, nghiêm-khắc, khóa-học, thật, một-cách-rõ ràng
sự-thay-đổi: sự-thay-đổi
tối-nay: ngày
hệ-số: lý-do, công-nhân, hệ-số
hỗn-độn: hung-hăng, xáo-trộn, nhầm-lẫn
luyện-tập: bài-tập, hoạt-động
Thánh-địa: bàn-thờ
co-lại: từ-viết-tắt, quây-quần
chi-tiêu: kinh-phí, sử-dụng, chi-tiêu
đáng-khích-lệ: hình-trái-tim, cảm-hứng
Phơi-bày: biểu-hiện, tang-vật, bài-báo-cáo, hiệu-quả
thô: Tổng, màu-xanh-lá
vé: cờ, bản-đồ
ngược: trở-lại
giày: giày-dép, khởi-động
gian-lận: ảo-giác
tiếng-nổ: nổ
lò-sưởi: ống-khói
bình: ly, chai, bình, nồi
nước-xốt: nước-sốt
hư: lười-biếng, trái-với-đạo đức, nghèo-nàn
cư-xử: đặc-tính, hạnh-kiểm
cho-vay: thẻ-tín-dụng, Trích-dẫn
vô-lý: hợp-lý, vô-lý
ham-muốn: Hoài-bão
hàng-năm: năm
chất-lỏng: nước
con-nít: bọn-trẻ
điên: crackpot, ngu-xuẩn
lật-đổ: đổ-vào
thành-tích: sự-thành-công, cấp, khai-thác
giả-định: giả-sử, sự-tưởng-tượng, giả-định
khôi-hài: hài, vui-vẻ
sự-ngây-ngất: hăng-hái
nghỉ-hưu: về-hưu, sự-từ-chức, tiền-cấp-dưỡng
nghị-viện: cơ-quan-lập pháp, Thượng-nghị-viện
khẩn-cấp: nóng-lòng, cuộc-khủng-hoảng
Bưu-kiện: bọc, phần, đóng
ngăn-kéo: cái-hộp, cầu-thang
sự-đóng-góp: Góp-phần, cổ-phần
liên-kết: tập-tin-đính kèm
nhổ: lòng-can-đảm, tống-tiền
in-ấn: công-bố, in, nhấn
biện-hộ: luật-sư, biện-hộ, bị-cáo
môi-trường: bầu-khí-quyển, môi-trường
xác-nhận: chứng-minh, cam-đoan, củng-cố
thông-báo: tiết-lộ, công-bố
từ-bỏ: sự-từ-chức, về-hưu
Từ-chối: chối-bỏ, phủ-quyết
khó-khăn: chăm-chỉ, hung-ác
miếng: Chip, miếng, sắt-vụn, căng-ra
thiền: chăm-sóc, phản-chiếu
vết-bẩn: nơi
an-táng: tang-lễ, chôn
giả-thuyết: giả-sử
giả-tâm-trạng: đầu-cơ-tâm trạng, kiêu-căng-tâm trạng, có-điều-kiện tâm trạng
Giao-dịch: Hoạt-động, buôn-bán
xúc-phạm: Sự-phẫn-nộ, sự-khinh-thường, xấu-hổ
khác-nhau: biến-số, khác-nhau, thay-thế
luật-sư: luật-sư, Tiêu-biểu
phạm-tội: phạm-tội
gói: bọc, túi-quần, đóng
cổ-điển: cổ-điển
trang-trại: nông-trại
bánh: bánh-ngọt, pi
chính-xác: bên-phải, tính-chính-xác, nghiêm-khắc
quăng-ra: đúc
ở-biển: Hải-quân, biển
ca-sĩ: độc-giả
điện: điện-tử, suối
người-ngoài-hành tinh: nước-ngoài, khách, ngoài-trái-đất
nứt: nổ, vết-nứt
chán-nản: buồn, nỗi-buồn
dày: dầy
phải-chăng: lý-do, hợp-lý
cáp: rỗng, uốn-cong
minh-họa: giải-thích, phản-chiếu
nhận-con-nuôi: sự-chấp-thuận, biên-lai
khét-tiếng: ai-cũng-biết
tổn-thương: chấn-thương
đúng: tính-chính-xác, đúng, bên-phải
ăn-cỏ: liễu, đồng-cỏ
sâu: mặt-nạ, sâu
dự-toán: đánh-giá, phỏng-đoán
quần-áo: cơ-quan, quần-áo, thiết-bị, bộ-váy
không-may: không-hạnh-phúc, không-may
thứ-tám: tám
thư-giãn: sự-an-ủi, sự-thư-giãn, trầm-tính
liền-kề: gần, xung-quanh
cao-cấp: cựu-chiến-binh, Cha-mẹ, cái-đầu
hoảng-sợ: báo-thức
gia-sư: Huấn-luyện-viên
cướp: cướp-bốc, lấy-trộm
thương-mại: buôn-bán, Quảng-cáo
bị-tiêu-diệt: biến-mất
Cục-bướu: khối-lượng, hình-xuyến, sứt-mẻ
bất-ngờ: ngẫu-nhiên, tạm-thời, trùng, bất-ngờ
cơ-sở: Nhà, nơi, cao-ốc, trong-nhà
giao-hàng: giới-thiệu
uốn-cong: khuynh-hướng, uốn-cong
sản-xuất: nhà-chế-tạo, sản-xuất
sưng-lên: sưng-lên
trồng-trọt: nuôi, nông-trại
sự-biến-đổi: sự-thay-đổi, chênh-lệch
phản-đối: đối-thủ, phản-đối
cháu-trai: cháu-gái, cháu-trai
cái-đinh: móng-tay, mũi-nhọn, chớp
lòng-nhân-từ: hào-phóng, phúc-lợi, Đức, vẻ-duyên-dáng
độ-chính-xác: tính-chính-xác
dấu-hiệu: chấm-điểm
giảm: giảm, cắt-tỉa
bụng: Dạ-dày, lỗ-rốn
chán-ghét: chán-ghét
soạn-nhạc: viết, sáng-tạo
hành-khách: du-khách
sự-chua-chát: dao-gâm, đắng, cắn
đồng-loạt: Trong-khi-đó
tập-phim: theo-sau, phần
cố-chấp: thích-hợp, tiếp-tục, thường-xuyên
chết-đói: đói
Tư-vấn: tham-khảo, khuyên-bảo
chua: chua
nhấn-mạnh: năn-nỉ, nhấn-mạnh
phô-trương: tháng-Ba
nón-bảo-hộ: cái-mũ
công-bố: tuyên-truyền, công-bố
chỗ-ở: khách-sạn
Xịt-nước: thuốc-chữa-bệnh
chính-thức: chính-thức
phiền: lo-lắng, gây-trở-ngại, nóng-lòng, làm-phiền
dự-đoán: kỳ-vọng, chờ-đợi
cấp: cầu, hệ-số, cấp, đánh-giá, bằng
ghế-đẩu: phân, chiếc-ghế
sự-biện-hộ: biện-hộ
người-nước-ngoài: nước-ngoài, khách
phương-tiện-vận chuyển: giao-thông, đưa-đón
sự-hiểu: hiểu-rõ
giám-đốc: giám-đốc, cái-đầu
thời-gian: tạm-thời, thời-gian
tốt-đẹp: đẹp
thi-hành: áp-đặt, ép-buộc, cho-phép, công-an
toàn-diện: sâu, đầy
hăm-dọa: đe-dọa
cấp-tiến: tiến-trình, cấp-tiến
tài-nguyên: nguồn
nhốt: có-hạn, chiếm, giãm-bớt, giảm
khen-ngợi: khen-ngợi
bảo-hiểm: an-toàn
bổ-nhiệm: mắt
làm-gián-đoạn: trở-ngại, cắt-tỉa, gây-trở-ngại, cưa-đi, gãy
đàn-áp,-kìm nén: áp-bức, ngăn-chặn
lớp: cột
đầu-mối: bằng-chứng, Chìa-khóa
răng: răng, bác-sĩ-nha khoa, sứt-mẻ
Bảo-hành: cam-đoan, tiền-thế-chân
phương-pháp: qui-trình, cơ-chế, hoạt-động, cách-tiếp-cận
sự-giới-thiệu: khuyên-bảo
lỗ-hổng: gãy, khai-mạc
nghĩa-là: có-nghĩa
đính-kèm: đính-kèm, ghép-mộng, đóng-lại
tư-thế: cử-chỉ, Chỉ-số, vị-trí, đứng
bộ: cánh, bộ, chung-cư
ngọc-đá-quý: Châu-báu, mọc-lên
đa-cảm: cảm-giác, đam-mê, nhạy-cảm
bê-tông: chỉ-thị, thích-hợp
kết-hợp: liên-minh, kết-hợp
đỉnh: đỉnh
tiền-tệ: tiền-bạc, tiền-xu
mục-tiêu: mục-đích, chú-trọng
đài-kỷ-niệm: ký-ức, cảnh-báo
riêng-biệt: tách, chênh-lệch, cá-nhân, cô-độc
cái-khay: đĩa
chiều-ngang: cân-đối
hiến-chương: hiến-pháp, giấy, thuê
mặt-hàng: các-mặt-hàng, bài-báo, thành-phần, giọng-nói, Hiền-hậu, vị-trí
sự-bành-trướng: chi-tiết, mở-rộng
xoắn: chớp, quay, trớ-trêu
cổ-truyền: truyền-thống, cổ-điển
liên-quan-đến: kể-ra, bao-gồm, Nội-dung
thói-quen: chung, cơ-chế
giải-quyết: cái-cày, lỏng-lẻo, sửa-chữa
cám-dỗ: chọc-tức, khiến
không-thành-công: Thất-bại
chính-trị-gia: chính-trị
Nắp: mái-nhà
sự-vi-phạm: chấn-thương
giao-lộ: thứ-tự, đi-qua
ông-chủ: chủ-nhân, giám-đốc, nhà-tuyển-dụng, cái-đầu, người-ăn-trộm
phần-cứng: thiết-bị
sợi: bờ-biển, ban-nhạc
bờ-vực: cạnh, cheo-leo, môi
hàng-hóa: buôn-bán, các-mặt-hàng
đứng-cách-xa: tách, cách-xa, xa
nhà-thương-điên: bệnh-viện, che-chở
xác-nhận: chứng-minh, cam-đoan
lịch-trình: bàn, lịch, biểu-đồ, bố-trí
mương: rãnh
thành-phố: thành-thị
bạo-loạn: sự-náo-động
chứng-tỏ: chứng-minh
thuộc-về-mẹ: Có-thai, mẹ
điêu-khắc: bức-tượng
vị: mùi-vị
nhãn-hiệu: nhãn-hiệu, chấm-điểm
Hành-lý: hành-lý
rác: vô-lý, sắt-vụn, bãi
dụng-cụ: nhạc-cụ
hỗn-loạn: xáo-trộn, nhầm-lẫn
truy-tố: bộ-đồ
căng: lo-lắng, thời-gian
con-gà-mái: gà
tỉa: trang-trí, giảm, cắt-tỉa
kín-đáo: khôn-ngoan
thương-tiếc: khóc
thổ-ngữ: đánh-bóng
tiểu-học: căn-cứ
vận-tải-hàng hóa: hành-lý, quán-ba, xe-tải
lau: quét
sự-từ-chối: chối-bỏ
bí-mật: bí-mật
Trung-gian: kiểm-tra
công-thức: phương-trình, nhấn
gian-lận: ngu-xuẩn, thao-tác
ám-ảnh: do-dự, ám-ảnh
ghi-danh: danh-sách, đăng-ký
vô-định: mơ-hồ, thì-QUÁ-KHỨ
số-dư: thêm-vào
làm-bể: rung-rinh
mô: cơ-quan, web, vải
bản-nháp: dàn-bài
đồ-chơi: búp-bê, chơi, bài-bạc
cầu-thang: cầu-thang, tỉ-lệ
quá-trình-chuyển đổi: nhiễm-trùng, sự-thay-đổi, tha, đi-qua
nút: Chìa-khóa
tàn-nhẫn: bất-lịch-sự
chương-trình: kế-hoạch, chương-trình-nghị sự
chế-tạo: công-nghiệp-hóa, máy-xay, sản-xuất
vùng: cánh-đồng, khu-vực, ban-nhạc
thứ-chín: chín
rượu: rượu
tham-lam: Hoài-bão, tham-lam
chỉ-đạo: quản-lý
có-ảnh-hưởng: có-hiệu-lực, xuyên-qua
bao-quanh: cổ-áo, sự-bao-vây
chết-chìm: bồn-nước, góc
trượt: trượt
lợn-nái: nổi-lên, bánh-mì, con-heo
có-ưu-thế: thật-tuyệt, bố-ráp
khả-năng-lãnh đạo: hệ-thống, nhãn-hiệu
Nhật-kí: báo, lịch
tán-dương: khuyên
làm-phiền: hứng-thú, tiếng-ồn, làm-phiền, nhầm-lẫn
Phó: Tiêu-biểu, luân-phiên
xe-hơi: động-cơ
sửa-đổi: sửa-đổi, sự-thay-đổi
theo-chiều-dọc: đứng, theo-chiều-dọc
không-đủ: không-đủ, đủ
chê: gầy
suy-luận: phỏng-đoán, lời-kết
suy-luận-khí sắc: dòng-cảm-điện khí sắc
Quảng-cáo: quảng-cáo, Quảng-cáo, tuyên-truyền
trộm: lấy-trộm, ăn-cắp-của người khác làm của mình
tự-phát: bản-năng, độc-đoán
hữu-ích: cơ-quan, sử-dụng, nhạc-cụ
kết-nối: đóng-lại, cái-móc, ghép-mộng, tham-gia
đi-xuống: xuống
sự-can-thiệp: gây-trở-ngại
hồi-sinh: sống-lại, phục-hồi
Internet: buôn-bán
thể-chất: vật-lí, cơ-thể-người
chấm: nơi
sửng-sốt: sốc
thô-bạo: bất-lịch-sự
cân-bằng: thích-hợp
mục-lục: số-mũ, danh-sách, Chỉ-số
chuyển-giao: gửi-đi, phân-phát
lên: phía-trên, ngoài, phía-trước
trò-chuyện: nói-chuyện, số-liệu-thống kê
hổ-phách: màu-vàng
tấn: giai-điệu
thông-suốt: dễ-chịu
sức-ép: sự-căng-thẳng, hứng-thú
cá-voi: bầu-cử
độc: chất-độc
tô-giới: nhúc-nhích, đặc-quyền, chiết-khấu
người-làm-việc: công-nhân
giốc: nhúng, liên-hợp
cầu-tiêu: buồng
xúc-phạm: tấn-công, tội-phạm
mối-ác-cảm: chán-ghét, trả-thù
nghị-lực: kiên-nhẫn, lòng-can-đảm
biết-trước: mong-ước, chờ-đợi
nhịp: tiêt-tâu
chuột-cống: chuột
trao-đổi-thư tín: sự-tương-hợp, bộ-đồ, đúng, bài-giải
giam: ngăn-chặn, chiếm, giữ-lại
giải-thích: giải-thích
phòng-khách: hội-trường
chạy: thao-tác, công-việc, chạy, hoạt-động
cống: Máng-xối, chạy
tiền-lương: trả
bẩn-thỉu: chán-ghét, quỷ-quái, khó-chịu, thất-vọng, xấu-xí
nghĩa-trang: tang-lễ
thạch-cao: phấn-viết-bảng
vòi-nước: ống, sữa
bỏ-qua: bao, bỏ-qua, chối-bỏ, phủ-quyết, phân-biệt, dư, tha-thứ
chọc-giận: hứng-thú, bị-kích-thích
cư-trú-tại: ở-lại, sống
trang-trí: trang-trí
ngón-chân: nhón-gót-chân, bàn-chân, ngón-tay, quấu
không-có-khả năng: khuyết-tật, yếu-đuối
phát-minh: phát-minh
định-nghĩa: determiner, kỹ-lưỡng, diễn-tả
hạn-chế: có-hạn, giới-hạn
cái-tủ: buồng, giá-để-hàng
giá-đỡ: giá-để-hàng
người-quản-lý: Nhạc-trưởng, viên-thanh-tra
sự-trình-bày: giới-thiệu, hiển-thị, tang-vật, khuyến-mãi
cao-su: quả-bóng, dây-cao-su
loại-trừ: tước-đoạt, xóa-bỏ, phân-biệt
đặc-quyền: đặc-quyền
ẩn-sĩ: khổ-tu
vết-trầy: làm-trầy, bắt-đầu
Đinh-ốc: chớp
khám-phá: quan-sát, khai-thác
bảo-đảm: cam-đoan
hình-trụ: đĩa
Tổng-kết: dàn-bài, trừu-tượng
không-chắc: xác-suất
leo-lên-cây: đàn, Con-trai
có-hệ-thống: cơ-chế
hầu-như: thật, gần, Thực-hành
khách-hàng: khách-hàng, khách
mục-lục: danh-sách, bàn
hóa-học: hóa-chất
nướng: bánh-mì, đầu-bếp
khoan: dao-gâm, xuyên-qua, khoan, khoan-lổ
cướp: nước-mắt, chiếm, bắt-cóc
phóng: xông-lên, đúc
nông-nghiệp: nông-nghiệp
nữ-diễn-viên: diễn-viên
nhà-hát: nhà-hát, hội-trường
ma-túy: thuốc-chữa-bệnh
bất-lợi: tệ-hơn, bất-lợi, đảo-ngược, phủ-định, có-hại
Cục-kẹo: cây-bạc-hà, sô-cô-la, ngọt
dán: bộ, chuỗi-hạt
người-bị-kết án: bẩy, trừng-phạt, phạm-tội
truy-tìm: thăm-dò, quan-sát, kiểm-tra
đóng-hàng: bọc, bộ, đóng
bò: leo, khúm-núm
đong-tach: pop, nhấp-chuột, bức-ảnh, thủy-triều, Sớm
lốp-xe: phôi-thai, chiếc-nhẫn
đáng-chú-ý: nổi-bật, hiển-nhiên
cốt-lõi: căn-cứ
người-tiền-nhiệm: tổ-tiên
tương-tự: tương-tự-như vậy, cùng-một
đê: bụi-bẩn
trơn: trượt
sự-biến-đổi: sự-thay-đổi
viền-tua: cạnh
vị-trí: vị-trí, nơi
cụm: tập-đoàn, khối-lượng, ban-nhạc
bảng-báo-giá: Trích-dẫn
canh-giữ: siêng-năng, chăm-sóc
chính-đáng: chấp-nhận-được
quăng: đúc
thanh-ngang: bước-đi
nồng-độ: tích-lũy, chú-trọng
tiện-dụng: Thực-hành, dễ-chịu
mồi: mùi-vị, mồi
khác-nhau: khác-nhau
lát: Chip, đĩa, miếng
máy-khoan: khoan, đào
đáp-ứng: sự-phản-ứng, hoàn-tiền, bài-giải
số-tử-vong: cái-chết
cỏ-dại: cỏ
tương-đối: âm-lượng
toán-học: toán, Khỏe-mạnh
đạo-đức: luân-lý
giựt-mình: thở-dài, hơi-thở
cuộc-đua: cuộc-đua
cô-lập: phân-ly, tách
thỉnh-thoảng: thỉnh-thoảng
người-lớn: chín-chắn
khó-nhọc: đắng, đau-khổ, rắc-rối, điều-khó-chịu
lời-đồn: ngồi-lê-đôi mách, giọng-nói
chịu-được: giữ-lại, chịu, Cuối-cùng
em: trẻ
đan: dệt-kim
Không-trực-tiếp: trực-tiếp
tiền-lệ: trường-hợp
gian-hàng: cá-đuối, hội-trường, đi-qua
mâu-thuẫn: sự-mâu-thuẩn, chối-bỏ
chuộc-lại: lưu-giữ, bù-lại
đường-mòn: đường, crosswalk
Hộp-số: thiết-bị, răng, xương-sườn, chạy
lễ-kỷ-niệm: tiệc
dự-bị: nóng, dễ-chịu
xuất-bản: công-bố, phân-phát
quý-khách-hàng: khách, người-mua
tấm-thảm: thảm, mặt-sàn, cái-mền
vách-ngăn: đếm
triển-vọng: nhìn-thoáng-qua, thị-giác
thẩm-mỹ: nét-đẹp
tức-giận: chán-ghét
đặt-ra: đề-xuất, khiến, đứng
hài-lòng: hài-lòng
sinh-vật: sinh-vật
khó-hiểu: hiểu-rõ
đọc-nhấn-mạnh: nhấn-mạnh
giữa-trưa: buổi-chiều, hướng-Nam
cây-huệ: đọc
danh-từ: nominalization, tên-gọi
gấp: gập-lại, khuynh-hướng
Hữu-ích: cứu-giúp
kiên-gan: năn-nỉ, tiếp-tục, Cuối-cùng
lối-ra: lối-thoát, ổ-cắm-điện, khởi-hành
thừa-kế: người-kế-thừa
vận-tốc: tốc-độ, làm-kết-tủa
lăng-nhục: bằng-lời-nói
thiếu-sót: không-đủ, cắt-tỉa, bỏ-xót, thiếu-sót
chắc-chắn: cam-đoan
bất-công: bên-phải
phụ: thay-thế
cái-xô: thùng-rượu, cái-muỗng
cơ-quan: cơ-quan
chủ-yếu: đặc-biệt
nghi-lễ: Lễ, tôn-sùng
bắp-vế: giăm-bông, bàn-chân
tủ-quần-áo: quần-áo, buồng
kết-cấu: cơ-quan
náo-động: hung-bạo
đầm-lầy: đầm-lầy
không-biết: dốt
lúc-đầu: khai-mạc, nguyên, bắt-đầu, Thứ-nhất, nguyên-thủy
tối-thiểu: ít-nhất
điều-chỉnh: cải-cách, sửa-đổi, sửa
bỏ-qua: bỏ-qua, quên
nhất-trí: hiệp
carbon: than-đá
xôn-xao: Hồ-sơ, lăn, quăn
khô-teo-đi: dễ-vỡ, nhọn
ngữ-vựng: tự-điển
đi-dạo: đi-lang-thang
thể-dục: bài-tập, môn-thể-dục, điều-kiện
quốc-tịch: dân-tộc-chủ nghĩa, quốc-dân
vị: mùi-vị
không-quan-trọng: cần-thiết, tầm-thường, không-thích-hợp
cú-đấm: tiêt-tâu
đi-bước-dài: tiến-trình, bước-đi
trục: vai, in
đáp-ứng: Căn-bệnh, hài-lòng
đáng-tin-cậy: Trung-thành
kinh-tởm: chán-ghét, xấu-xí
đạo-đức: luân-lý
phá-dỡ: gục-ngã
gối: con-sông
làm-sai: làm-sai, hủy-hoại, làm-kinh-ngạc, Thất-bại, lúng-túng
chuyện-thần-thoại: câu-chuyện, huyền-thoại
quyền-sở-hữu: bất-động-sản
khủng-khiếp: sợ-hãi, khủng-khiếp, nỗi-sợ
phanh: gãy
hạt: hạt-đậu, hạt
phóng-to: sưng-lên, tăng
năng-lượng-mặt trời: ánh-nắng-mặt trời
mỏ: môi, đơn-vị
cho-thuê: buộc-bằng-dây xích, thuê
tỉ-lệ: quan-hệ, sự-so-sánh, tỉ-lệ, bài-báo-cáo, phép-loại-suy
chải: chải, vai, cây-rơm
dịch: dịch, lật
giải-trí: giải-trí, kì-nghỉ, sự-thư-giãn
ý-thích: màu
hàng-mẫu: trường-hợp, cố-gắng
số-nhiều: khối-lượng
sáng-kiến: kế-hoạch, cố-gắng
thạch: mứt, sữa
tình-trạng-hổn loạn: xáo-trộn
Hồ-sơ: dàn-bài, Hồ-sơ, trang-mạng
tài-chánh: tiền-bạc
căn-bản: căn-cứ, kẹp-giấy
đày: bãi, bố-ráp
điện: điện-tử
thảo-mộc: cỏ
phát-đạt: mọc-lên
sự-giống-nhau: phép-loại-suy, giống-nhau, tinh-thần-đoàn kết
riêng-tư: riêng-tư
đấu-trường: cánh-đồng
du-khách: du-khách
hạt: nguyên-tử, hạt
thiên-phú: nguyên
dân-cư: cư-dân
ống-sáo: Còi
sinh-sản: khả-năng-sinh sản
nhịp-cầu: chiều-dài
rau-xà-lách: rau-diếp, năng-lượng
thuốc-nhuộm: màu
chứng-minh: chứng-minh
đạo-đức-học: luân-lý
chính-thức: chính-thức
làm-phiền: gây-trở-ngại, làm-phiền, chọc-tức, xúi-giục, khoan
trượt: trượt
đặc-điểm: đặc-tính, bất-động-sản, căng-ra
người-soạn-nhạc: nhạc-sĩ
bóng-đá: đá
công-ty: sự-hợp-tác, liên-minh, Góp-phần
tiếp-tục: tiếp-tục
dị-thường: bất-thường, crackpot
trình-tự: chuỗi
ép: đẩy
giải-quyết: chiếm, đương-đầu, thiết-bị
lề-đường: ức-chế, vỉa-hè, sự-hạn-chế
quảng-cáo: quảng-cáo, tuyên-truyền
sự-rút-lui: hồi-quy, ổ-cắm-điện, lời-kết
thế-chấp: con-tin, thẻ-tín-dụng, cầm-đồ
sự-kiêng-cử: kiên-nhẫn, chịu
đàn-áp: ngăn-chặn, áp-bức
vợ-hoặc-chồng: chồng
có-hiệu-lực: có-hiệu-lực
van: van
xây-dựng: sáng-tạo, cao-ốc, xây-dựng, giai-đoạn
hơi-nước: Hơi-nước, cặp-vợ-chồng
con-dơi: cây-gậy, câu-lạc-bộ, phía-trước
trái-ngược: sự-mâu-thuẩn, không-thích-hợp, tương-phản
tự-động: trực-tiếp
minh-bạch: mở-ra, minh-bạch, định-lý
hiệu-quả: có-hiệu-lực, hiệu-quả
sự-tín-nhiệm: sự-phụ-thuộc
thanh-tra: quan-sát, kiểm-tra, ngắm-cảnh, nghiên-cứu
kỳ-quặc: lạ, bất-thường
lôi: rút-ra, cướp-bốc
lúng-túng: xấu-hổ, lúng-túng
tàn-tật: khuyết-tật, thụ-động
kiêu-căng: niềm-tự-hào
curl: quăn, chiếc-nhẫn
ngọc: Cục-đá, mọc-lên
ngày-kỷ-niệm: ngày-sinh-nhật
uy-tín: thẻ-tín-dụng
sơ-suất: bỏ-xót, sự-khinh-thường, thờ-ơ
tự: riêng-tư
phân-biệt: ngoại-lệ, phân-biệt
lục-địa: lục-địa
Mục-tiêu: mục-đích
gian-hàng: cửa-tiệm, đứng
đầu-tư: đầu-tư
hành-trình: con-tàu
tập-hợp: tinh-thần-đoàn kết, hoạt-động
lời-đồn: ngồi-lê-đôi mách, giọng-nói
tích-cực: nghiêm-túc
kiểm-tra: kiểm-tra
ngăn: chung-cư
đặc-biệt: đặc-biệt
tiếng-nổ: pop, nổ, bắn
tập-hợp: Tổng, chung
phần: phần, cổ-phần
bất-hợp-pháp: bất-hợp-pháp, hoang-dã
hòa-tan: xóa-bỏ, hòa-tan-được, hòa-tan
thế-cân-bằng: cân-đối
thăm-dò: thăm-dò, nghiên-cứu
củ-hành: cây-cung
thân-thuộc: phép-loại-suy, tinh-thần-đoàn kết, sự-phụ-thuộc
không-trung-thực: Trung-thành
sự-xung-đột: cuộc-xung-đột, sốc, gây-trở-ngại
Ghế: chiếc-ghế, ghế-sô-pha
bột: bột-mì, khối-lượng, men, bánh-ngọt
tham-gia: tham-gia
trance: thị-giác
sự-từ-chối: chối-bỏ, chất-thải
đúng: chênh-lệch, đúng, sự-mâu-thuẩn
hấp-thụ: da
tập-hợp: khối-lượng
kịp-thời: thời-gian
xâm-chiếm: tấn-công
giải-tán: bao, dư
đáng-kể: phần-lớn
thực-nghiệm: Phi-công
phim-ảnh: bộ-phim, TV, bức-ảnh
sự-công-khai: tuyên-truyền, khuyến-mãi, quảng-cáo
phát-triển: mở-rộng, chi-tiết
tình-trạng-lộn xộn: tình-cờ-gặp, gục-ngã, nhúng, quần-áo
rèn-luyện: sáng-tạo, làm-sai
hóa-thạch: dầu, khảo-cổ-học
hạn-chế: trở-ngại, Quy-định, sự-hạn-chế
sự-hăng-hái: hăng-hái, đồ-gia-vị, Trải-qua, mùi-vị, da
khó-tánh: làm-phiền
làng-nhỏ: vùng-ngoại-ô, làng
bùng-nổ: mọc-lên, tung-lên, nổ
tái-sản-xuất: bản-sao, theo-gương
Hội-nghị: hội
quả-nho: rượu
xưởng: phòng-thu, Hội-thảo
giảm-bớt: giảm, cắt-tỉa, gục-ngã
cách-phát-âm: phát-âm
phán-xét: phán-quyết, câu-văn, qui-định, phán-xét, quyền-tài-phán, cuộc-khủng-hoảng
tập-trung: cẩn-thận, chú-trọng
hủy-bỏ: tiết-lộ, trở-lại
phà: du-thuyền, con-tàu
minh-bạch: đơn-giản, trực-tiếp, Dễ-dàng, minh-bạch, tuyến-tính
độ-cao: chiều-dài
chứng-tỏ: hiển-thị, có-nghĩa
xuất-khẩu: lối-thoát
người-phạm-tội: sao-chổi, phạm-tội
phản-đối: phản-đối, phủ-quyết
mệnh: cặp-vợ-chồng, cân-đối
bỏ: xóa-bỏ
điều-chỉnh: sửa-đổi, sửa-chữa, thích-ứng
thành-viên: hội-viên
gauge: đo, tỉ-lệ, độ-lớn, gầy, Chỉ-số
tha-thứ: tha-thứ
hông: mông, thắt-lưng
tham-gia: theo, tham-gia, cây-gậy, giữ-lại
đẩy-lui: ngăn-chặn
lo-âu: xáo-trộn
trinh-tiết: tính-chính-xác, tinh-khiết
lỏng: sự-thư-giãn, lỏng-lẻo
co: nhút-nhát
nhà-báo: phóng-viên
triệu-chứng: tang-vật
Xe-đạp: đạp-xe, chu-kỳ
dầu-hắc: vỉa-hè
xoắn-ốc: quay
bình-luận: vắc-xin, Định-nghĩa
truyền-dẫn: nhiễm-trùng
phiếu: giọng-nói, bầu-cử
tiềm-năng: khả-năng
đủ-điều-kiện: khả-năng, bên-phải, đủ-điều-kiện, đúng
vòng: đạp-xe, bản-lề, chiếc-nhẫn
người-lao-động: công-nhân
truy-tố: khiển-trách
giấy-phép: sự-cho-phép
từ-chức: phóng-điện
bản-ngã: mình, hơi-thở
huyền: trục-xuất, chim, suối
xâm-phạm: không-tuân-theo, cắt-tỉa
nghiện: sự-phụ-thuộc
Sự-sống-còn: cả-đời, nguyên-âm
Đông-lại: đông-lạnh
cách-dệt: dệt-kim
phận-sự: thành-lập, người-thụ-hưởng
lạt-lẽo: thờ-ơ
tổ-chức: cơ-quan, chuẩn-bị, lập-pháp, tổ-chức
đoán-chừng: có-lẽ, giả-định
dây-nhau: đồng-ý
chảy-máu: máu, dính-máu
khám-phá: tìm-thấy, Tìm-kiếm, tiết-lộ
Smash: hủy-hoại, gãy
tạo-điều-kiện: sự-tăng-tốc, nuôi, Góp-phần
tần-số: chu-kỳ, do-dự
khâu: May
thư-mục: bằng-chứng
chặt: cắn, cắt-tỉa, miếng-bò-hầm
sưởi: nóng
chán-nản: thất-vọng, buồn
đảo-chính: Cuộc-cách-mạng, bắn, Cú-đánh
thương-xót: lòng-thương-hại
người-suy-nghĩ: trí-tuệ
ngân-sách: cân-đối
công-dân: dân-sự, đô-thị
chèn: vào, tăng
suy-nghĩ: phản-chiếu, nghĩ
linh-hoạt: đơn-giản, uốn-cong, dây-cao-su
slab: bảng-điều-khiển, máy-tính-bảng, bếp
năng-lực: năng-lực, đủ-điều-kiện
công-tắc-điện: đảo-ngược, chuyển-đổi, Chìa-khóa
khăn-tắm: vải
thập-kỷ: mười, cầm
nhiều: khác-nhau, hơn
băng-bó: nước-sốt, đóng-lại
dọn-dẹp: khéo-léo
tiếng-vổ-tay: vuốt-nhẹ, tán-thưởng
cây-phong: cây-cọ
cái-cào: quét
sự-trống-rỗng: trống
tủy: dầu, não-bộ, cây-bầu
vỏ-kiếm: áo-khoác, phong-bì, pod
hấp-thụ: khai-thác, hút, ôm-hôn
dự-đoán: dự-đoán-được, phỏng-đoán
giáo-dục: giáo-dục, huấn-luyện, giảng-bài
điều-tra--u003e Investigation: thăm-dò, yêu-cầu, Tìm-kiếm
quyền-thống-trị: qui-định
của-cha-mẹ: Cha-mẹ
tham-dự: đồng-bằng, tham-gia, đính-hôn
thang-máy: nâng
ở-bên: bên
hoãn-lại: chậm-trễ
sự-không-ưa: sự-khinh-thường, chán-ghét
trung-tâm: Nguyên-tử, tế-bào, phôi-thai
ẩn-dụ: trường-hợp
nhỏ-xíu: ít, vi
bom: máy-bơm
phê-bình: sâu, nhà-phê-bình
rỉ-sét: thông-qua
đặt-phòng: giữ-lại, chiếm
may: May
nhà-hóa-học: hóa-chất
phòng-chờ: gãy, hội-trường
tấn-công: bắt-đầu, bố-ráp, tấn-công
lặn: nhúng
không-thân-thiện: thù-nghịch
điều-tra-dân số: tính
tố-cáo: tố-cáo, câu-văn
cây-gai: lanh
đình-chỉ: ngăn-chặn
cái-tát: tiêt-tâu
thư-giãn: sự-thư-giãn
sự-tán-gái: cái-sân
hàng-hóa: các-mặt-hàng
liên-tục: kết-hợp
đối-ứng: trao-đổi, sự-đảo-ngược
toa-thuốc: thuốc-chữa-bệnh, bản-sao
bong-bóng: bọt
cái-xẻng: kẹp, chèo
sử-dụng: khai-thác, sử-dụng, chi-tiêu, yên-cương, tiêu-thụ
bền-chặt: Dài
nòi-giống: quen
kẽm: bồn-nước
bất-cứ: bất-cứ-điều gì, cái-nào
có-hạn: có-hạn, cuối-cùng, đã-kết-thúc
phụ-tá: người-ủng-hộ, AIDS
chen-lấn,-xô đẩy: xuyên-tạc, chiến-đấu,-đấu tranh, Cú-đánh
học-tập: giáo-dục
lốp-xe: phôi-thai, chiếc-nhẫn
người-tiêu-thụ: sử-dụng
giá-trị: giá-trị, thẻ-tín-dụng
khoảng: gần, ước-chừng
dệt-kim: dệt-kim
kính-hiển-vi: kính-viễn-vọng
thường-dân: dân-sự
dây-đeo: buộc-bằng-dây xích, dây
biểu-tượng: cử-chỉ, bản-sắc
phỏng-theo: thích-ứng, đương-đầu, chép-lại
khả-năng: xác-suất, khả-năng
chủ-quan: tinh-thần
đại-danh-từ: lương-tâm
sai: sai, lạm-dụng
chán-nản: lúng-túng, Hoài-bão
người-mới-đến: khách
vô-cực: bất-định-cách
đồ-họa: biểu-đồ
sung: hình, bức-ảnh
thích-hợp: thích-hợp, Chìa-khóa
thất-vọng: thất-vọng, phản-bội, Thất-bại
chiếu: kế-hoạch, hiển-thị
giải-phóng: phóng-điện, sự-cứu-rỗi
công-thức: kích-thích-kinh tế
nhượng-quyền-thương mại: đặc-quyền
vô-lý: vô-lý, không-thích-hợp, không-đủ
vòng-quay: chu-kỳ, Cuộc-cách-mạng, quay
nhô-lên: đọt-non
mét: đo
sự-hạn-chế: giới-hạn, sự-hạn-chế, Quy-định
thể-loại: cộng-đồng, cấp
chủng-tộc: cuộc-đua, kỳ-thị-chủng tộc
thay-thế: thay-cho, thay-thế, sự-thay-đổi
sự-đổi-mới: phát-minh
đối-chất: đương-đầu
cấm-chỉ: chối-bỏ
trang-trí: trang-trí
hành-lang: khiến, hội-trường
quăn: đúc, quăn
cuộn-giấy: sách, lăn, quăn
thợ-cơ-khí: cơ-khí, thủ-công
xâm-lược: tấn-công, hung-hăng, quá
ê: chào-bạn, chào-mừng
sự-đo-lường: đo
cạnh-tranh: vật-lộn, đối-thủ
học-viện: trường-đại-học
chú-tiểu: tuyển-dụng, tươi
đã-ly-dị: ly-hôn
sữa: sữa
hồ-chứa: xe-tăng
mua-sắm: cửa-tiệm, buôn-bán
ngầm: thích-hợp
chiến-lược: chiến-lược
khuôn: modulo, mẫu-đơn, in, đúc
diễn-tập: bài-tập, sự-lập-lại
khăng-khăng: năn-nỉ
đứng-trước: trước
ở-giữa: trung-cổ, nữa-đường, thắt-lưng
du-khách: du-khách, du-lịch
đồ-uống: uống
lưu-ý: cẩn-thận
rõ: giải-thích, biểu-hiện
lại: sau-đó, trở-lại
tu-chính: sửa-đổi, sự-thay-đổi, thay-thế, ghép-mộng, cải-cách
giản-đồ: biểu-đồ, bản-đồ
suy-luận-tâm trạng: dòng-cảm-điện khí sắc
áp-đảo: áp-bức
di-động: Điện-thoại, tế-bào
nâng: khuyến-mãi, nâng
nghịch-lý: sự-mâu-thuẩn
nói-quá: muối, tối-đa-hóa
tóc-vàng: màu-vàng
cây-cơ-bida: chấm-điểm, mật-khẩu, cây-gậy
người-chạy: hội-trường
đàm-phán: nói-chuyện, bàn-luận
chế-độ: qui-định
lòng-khoan-dung: khoan-dung, chịu
Tùy-chọn: luân-phiên, quả-dưa-chuột
cuộc-vận-động: sự-vận-động
dịch: thảm-kịch, dịch
kỹ-thuật: kĩ-thuật, cách-tiếp-cận, kỹ-thuật, thiết-bị
cuối-cùng: cuối-cùng
tốt-nghiệp: thông-qua
đầu-ra: kinh-phí, lời-kết, công-bố, khởi-hành, năng-suất, lối-thoát
xác-định-vị trí: nơi
mặc-định: bỏ-xót, Tiêu-chuẩn
bối-cảnh: môi-trường, bối-cảnh, ý-nghĩa
sự-liên-minh: liên-minh
lỗ-hổng: khiển-trách, sai, khuyết-tật, bất-lợi
công-nhận: thừa-nhận
phát-sóng: công-bố, gửi-đi
quay-số: chọn, chiếc-nhẫn, quây-quần
tỷ-lệ: phổ-biến
lên: toàn-bộ
biến-đổi: sự-thay-đổi, chuyển-đổi
cánh-diều: con-rồng
mơ-hồ: mơ-hồ, sự-mâu-thuẩn
quán-cà-phê: cà-phê, quán-ba
phần-thưởng: giải-thưởng, phí-bảo-hiểm, thừa-nhận
nhãn: phòng-thu, chấm-điểm
phê-duyệt: sự-chấp-thuận, thừa-nhận
thân-thích: phép-loại-suy, xã-hội-chủ nghĩa
hiện-thực: thật
loài-bò-sát: con-rắn
ngoài-trời: ngoài, mở-ra
chính-trị: chính-trị
chất-cặn: di-hài, chất-thải
băng: băng-cassette, ban-nhạc, bộ-phim
dịu-dàng: dịu-dàng, ngọt
miệng: bằng-lời-nói, môi
đầu-cơ: phỏng-đoán
trục-xuất: trục-xuất, phóng-điện
khuyết-điểm: nơi, khuyết-tật
nhảy: nhảy, chi-tiêu
miệng: ly-uống-nước, nhăn-nhó
cái-nêm: mũi-nhọn, cổ-phần, góc
miễn: chiết-khấu, ngoại-lệ, dư
di-động: ít
gói: bao-bì, bọc
sáng-chói: năng-lực, nét-đẹp, chói
vây: chèo, ba-lê
lầm-bầm: thì-thầm
berry: vịnh
nhập-cư: di-cư
cuốc-đất: cái-cày
Phẫu-thuật: bác-sĩ-phẫu thuật
tích-trữ: tích-lũy, gửi-tiền, quây-quần
phần-sau-lái tàu: phân, ống
bụng: Dạ-dày
Hàm-ý: ý-nghĩa, bao-gồm, lời-kết
khuyến-khích: kích-thích-kinh tế
cái-mỏ-lết: cái-vặn-vít, Chìa-khóa
nông-thôn: nông-thôn, vùng-ngoại-ô, cánh-đồng, làng
làm-suy-giảm: hủy-hoại, giảm
bản-địa: bản-chất, nguyên, cư-dân
cây-rơm: bãi, cây-rơm, ống-khói
đĩa: đĩa
khuynh-hướng: hạnh-kiểm, chiều-hướng, khuynh-hướng, bố-trí, trôi-giạt
đoàn-thể: Công-ty, chung
làm-xong: thoát-khỏi
không-ổn-định: không-vửng, vô-thường
tương-hợp: thích-hợp, song-song, thích-đáng
điện-thoại: Điện-thoại
Khoảng-chân-không: trống
vồ-lấy: dao-gâm, cầm-lấy, chiếm
chứng-động-kinh: động-đất, nổ
buồn-chán: chán, khoan, làm-phiền
danh-mục-đầu tư: bộ, ví
đường-nứt: vết-nứt
biến-chứng: có-vấn-đề, số-điện-thoại
can-thiệp-vào: gây-trở-ngại
cực: tính-phân-cực, cực
đại-biểu: Tiêu-biểu, sứ-giả
ý: ý-chí, khao-khát
dự-đoán: dự-đoán-được, phỏng-đoán
lạc-quan: mong-ước, tin
lột-vỏ: da, pod, vỏ-cây
khắc: cắn
hover: phao, bay-lên, do-dự
khu-vực: cánh-đồng, ngành-công-nghiệp, khu-vực, phần
họ: tên-gọi, họ
tổ-chức: tổ-chức, Công-ty, cơ-quan
khẩn-cấp: nóng-lòng
thú-vị: Hiền-hậu
ngăn-cản: ngăn-chặn
sự-phủ-nhận: chối-bỏ
người-chiến-thắng: sự-thành-công
hỗn-hợp: hỗn-hợp
va-chạm: hiệu-quả, cuộc-xung-đột
chất-xơ: chất-xơ
một-hớp: nuốt
trực-quan: quang-học, bối-cảnh
móng: quấu
nguyên-cáo: diễn-viên, người-chuyên-chở, lý-do
lấy-làm-ân hận: lòng-thương-hại
lừa-dối: xuyên-tạc, làm-kinh-ngạc, ngu-xuẩn
cấm: ức-chế, ngăn-chặn, chối-bỏ
độ: diễn-viên, họa-sĩ, người-chơi
giải-đấu: cuộc-đua
yêu-cầu: yêu-cầu, điều-kiện
dấu-trừ: ít-nhất
Lộn-xộn: táo-bạo
truyền-nhiễm: nhiễm-trùng
nhấn-mạnh: năn-nỉ, nhấn-mạnh
quân-dai: quần
gây-nhầm-lẫn: câu-đố, làm-kinh-ngạc, lúng-túng
dâng: Tình-nguyện, có-ý-định
phẫu-thuật: bác-sĩ-phẫu thuật
tính-trung-thực: sự-thật, tính-chính-xác
thứ-một-trăm: một-trăm
dốc: dốc, nhúng, khuynh-hướng
lân-cận: gần, Sớm, xung-quanh
thường: chung, thường, nói-chung, có-xu-hướng
khó-hiểu: sự-mâu-thuẩn, câu-đố, nhầm-lẫn
cân-đối: có-thể-so sánh, cân-đối
không-đồng-ý: bất-đồng-ý kiến
kích-thích: Sự-phẫn-nộ, gây-trở-ngại, chọc-tức, bị-kích-thích
nổi-bật: tốt-hơn, nổi-bật
bắt-đầu: bắt-đầu
sự-kết-tủa: làm-kết-tủa
làm-khủng-khiếp: báo-thức
sở-thích: giải-trí
ngữ-pháp: ngữ-pháp
bằng-số: con-số, kỹ-thuật-số
tiêu-chuẩn: Tiêu-chuẩn
dự-báo: dự-đoán-được, phỏng-đoán
không-tán-thành: chối-bỏ
kỳ-lạ: nước-ngoài, lạ
bóng-đèn: đèn
tăng-cường: mở-rộng, tăng, tối-đa-hóa, chữa-lành
dung-hợp: làm-tan, gọi-điện
bỏ-phiếu: bầu-cử
có-tài: năng-lực, giỏi
làm-cho-tan: làm-tan
thẳng: căng-ra, sửa-chữa
trang-hoàng: trang-trí
tổng-thống: tổng-thống
băng: sớm, nhân, đá, sứt-mẻ, bướu
Xin-chúc-mừng: khen-ngợi
quét: quét
cho-phép: cho-phép, bên-phải
cá-cược: điều-kiện
kỹ-thuật: kĩ-thuật, kỹ-thuật
kinh-nghiệm: Trải-qua
thống-trị: bậc-thầy
quảng-cáo: quảng-cáo, tuyên-truyền
khuếch-tán: phân-phát, công-bố
gặm-cỏ: làm-trầy
bộ-dụng-cụ: thiết-bị, cái-hộp, bộ
học-viên: Bác-sĩ, Huấn-luyện-viên
ngâm: hút, nhúng
bảo-tồn: bảo-vệ, lưu-giữ, chăm-sóc
đất-bùn: bùn, vỉa-hè, chảy-nước-dãi
thách-thức: chăm-chỉ
sự-ô-nhiễm: gây-ô-nhiễm, tham-nhũng
hóa-học: hóa-chất
hàng-loạt: đàn, xung, âm-lượng
mẹ: mẹ
khủng-khiếp: khủng-khiếp, đe-dọa
chuyên-gia: chuyên-gia
khao-khát: khao-khát
phòng-tắm: bồn-tắm
cờ-bạc: bài-bạc, chơi, phiêu-lưu
tích-phân: cần-thiết, tích-hợp
loại-bỏ: thoát-khỏi, xóa-bỏ
đậu-xanh: hạt-đậu
phụ-lục: tập-tin-đính kèm, thêm-vào, phụ-cấp
lưu-thông: phân-phát
bao-hàm: hiệp
người-buôn-bán: người-chia-bài
quấy-rầy: lo-lắng, gây-trở-ngại, sự-ám-ảnh
nổ-tung: nổ
nâng-lên: sự-tò-mò, đòn-bẩy
tràn: rò-rỉ, đổ-vào
không-lấy-tiền: miễn-phí
thành-phần: thành-phần
hụt: mở-ra
khó-chịu: lo-lắng, làm-phiền, khó-chịu, buồn, xáo-trộn
nhà-ở: Nhà
nhiếp-ảnh: giai-đoạn, bức-ảnh, nhiếp-ảnh-gia
côn-trùng: côn-trùng
viên-thuốc: máy-tính-bảng
hiện-hành: hiện-nay
phương-tiện-truyền thông: nhấn
vật-đổ-nát: sự-đổ-nát
văn-thể: cơ-thể-người, bộ
thực-đơn: danh-sách
gãy-xương: vết-nứt
diễn-đàn: nền-tảng, khoan, tòa-án
đà: tốc-độ, xung
xiên: trám-bằng-nhựa, khuynh-hướng
gạch: gạch
tủ-sách: thư-viện, hiệu-sách
tính-toán: tính
người-sản-xuất: nhà-chế-tạo
tiền-tệ: tiền-bạc
miêu-tả: diễn-tả, phản-chiếu, giới-thiệu
sự-lạm-phát: sưng-lên
biên: cạnh
ảo-tưởng: sự-tưởng-tượng
phá-hoại: hủy-hoại
kết-hợp: nghiêm-khắc, kết-hợp, thích-hợp
cơ-bản: các-điều-khoản
có-ý: cố-tình
người-sống-sót: gia-đình
tuôn-ra: con-sông, suối
cạnh-tranh: đối-thủ
đồ-kim-hoàn: trang-trí
có-chất-rượu: say, rượu
phân-biệt: phân-biệt
chiến-đấu: cấp-tiến, khủng-bố, quân-sự
giải-giới: cánh-tay
quyết-định: cần-thiết, quyết-định
phân-công: công-việc, bài-tập, nhiệm-vụ, sự-phân-phối
hạn-ngạch: đặc-quyền, sự-phân-phối, lượng-tử
moi-lên: hố, đào
canxi: đá
kỷ-niệm: khuyên
lịch-sử: lịch-sử
Chào: chào-bạn, chào-mừng, sự-cứu-rỗi
loại-bỏ: thoát-khỏi, bỏ-xót, xóa-bỏ
căng-thẳng: khéo-léo
thư-giãn: sự-an-ủi, dễ-chịu, sự-thư-giãn
hiệu-quả: có-hiệu-lực, hiệu-quả, kỹ-năng
dễ-bị-tổn thương: nhạy-cảm
lực-sĩ: Khỏe-mạnh
sọc: sọc, dòng, ban-nhạc, bộ-phim
mặt-ngoài: mặt-nạ, thị-giác
kẹp: kẹp-giấy, kẹp
nguyên-mẫu: trường-hợp, nguyên
bù-lại: đương-đầu, bù-lại, độ-lệch
vô-giá-trị: số-không, trống
hạn-chế: ngăn-chặn, giãm-bớt, giảm
đánh-dấu: chấm-điểm, con-rận
vat: xe-tăng
hãm-hiếp: quá
vô-giá-trị: số-không, trống
có-điều-kiện: đính-kèm
văn-hóa: nền-văn-hóa
Công-nghệ: kĩ-thuật, thiết-bị
thị-trường: buôn-bán
cà-ra-vát: bó-lại
kinh-tế: kinh-tế
người-quản-lý: giám-đốc, ủy-thác
miêu-tả: diễn-tả, giới-thiệu
cháu-ngoại: cháu-gái, cháu-trai
hai: số-hai, cặp-vợ-chồng, sinh-đôi
tổng-hợp: nguyên, lắp-đặt, bộ
đặc-trưng: nghề, đặc-tính
kỳ-quái: lạ
đơn: ứng-cử-viên
ngôn-ngữ-học: ngôn-ngữ, ngôn-ngữ-học
nấm: điên-điển, bọt-biển
quả-bí-ngô: bí-đao, cây-bầu
sự-nhướng: nâng, nổi-lên, tiến-trình
hiện-tượng: bất-thường, độc-tấu, siêu
năng-động: năng-lượng
xem-lại: sửa-đổi, sửa-chữa, kiểm-tra
phá-vỡ: phân-ly, gục-ngã, nghiên-cứu
mệt-mỏi: mệt
khuôn-viên: trường-đại-học, ngôi-trường
luận-án: luận-văn
thống-kê: số-liệu-thống kê, thống-kê
Xây-dựng: chuẩn-bị, xây-dựng
sandwich: bánh-mì
vô-giá-trị: số-không, trống
sự-khuyến-khích: sự-tăng-tốc, hứng-thú, bị-kích-thích
sự-kiểm-duyệt: pháp-quan, Quy-định
trang-bị: bổ-thể
chỉ-định: đề-cử, đề-xuất
hủy-bỏ: xóa-bỏ, sắt-vụn, sự-thất-bại
mét: đo
xô: áp-bức
quí-ông: quý-ngài, bậc-thầy
xây-lại: sửa, phục-hồi
trọng-tài: qui-định, phán-xét
nguyên-tử: nguyên-tử, Nguyên-tử
gây-tranh-cãi: sự-mâu-thuẩn
tinh-vi: phức-tạp, hiện-đại
làm-co-rút: nhún-vai
không-thích-hợp: không-thích-hợp, không-đủ
trầm-tích: làm-kết-tủa
mũi-tẹt: sự-khinh-thường, khiển-trách
biến-thể: khác-nhau
chỉ-trích: sự-chỉ-trích
nhàm-chán: chán, điều-khó-chịu, đau-khổ
hợp-tác: sự-hợp-tác, kết-hợp
phân-tích: nghiên-cứu, phân-tích
lượng-mưa: mưa
đâm-chồi: đọt-non
phi-cơ: chim
vị-cay: nhọn
Mềm-dẻo: Độ-co-dãn
hỏa-tiển: tên-lửa
trạng-từ: phong-bì
sự-bất-ổn: không-vửng
bị-tước-quyền: tước-đoạt, bất-lợi
co-rúm: ngồi-xổm
phát-ra: sản-xuất, sáng-tạo
xấp-xỉ: ước-chừng, cách-tiếp-cận, hội-tụ
tinh-thần: thức, luân-lý, tinh-thần
lạc-quan: mong-ước, tin
phân-loại: phân-loại, phân-phát
chương-trình-giảng dạy: khóa-học, chương-trình-nghị sự
ngoài-trời: ngoài
phản-ứng: sự-phản-ứng, động-từ
kịch-bản: kịch-bản, dòng, thánh-kinh
tống-tiền: tống-tiền
tiền-thưởng: giải-thưởng, phí-bảo-hiểm
tài-sản: bất-động-sản, sự-có-mặt, Ưu-điểm, nguồn-vốn
biến: chênh-lệch
mơ-hồ: mơ-hồ, sự-mâu-thuẩn, tính-không-chắc chắn
vô-giá-trị: số-không, trống
giữ-thái-độ trung lập: Trung-lập
người-tàn-tật: lúng-túng, trở-ngại, khuyết-tật, bất-lợi
nhiếp-ảnh: bức-ảnh
sự-thiếu: cắt-tỉa, vắng-mặt
thay-thế: thay-thế
nấm: vi-khuẩn, bọt-biển, điên-điển
từ-ngữ: xây-dựng, bản-văn
nhà-ngoại-giao: ngoại-giao, sứ-giả
khởi-đầu: giới-thiệu
hợp-nhất: yên-cương
làm-tiêu-tan: gãy
hít-vào: cảm-hứng
cái-ròng-rọc: vai-trò
gầy: gầy
cử-tri: các-cử-tri
liên-đoàn: liên-bang
di-động: sự-vận-động
dỡ-bỏ: phóng-điện
môi-trường-sống: che-chở
gợi-lên: sự-náo-động, khiến
pha-loãng: gầy
Tạm-biệt: tạm-biệt, giã-từ
phá-hủy: hủy-hoại
cú-pháp: tiền-cấp-dưỡng
móng-ngựa: con-ngựa
méo-mó: độ-lệch, xuyên-tạc
ăn-hết: tiêt-tâu
thích-hợp: thích-hợp, đúng, liên-quan
chức-năng: Thực-hành, công-việc
thay-thế: thay-thế, trục-xuất, nhúc-nhích
quyền-tự-trị: sự-độc-lập
mùi-hôi: mùi
phân-biệt: phân-biệt
sẵn-có: mua-lại
đại-học: học-sinh
đồ-thị: biểu-đồ, bản-đồ
làm-mồi: làm-xiêu-lòng, chọc-tức
dễ-thương: đẹp, ngọt
bụng: Dạ-dày
trình-độ-học vấn: giáo-dục
sợi-tổng-hợp: nhân-tạo
huấn-luyện-viên: Huấn-luyện-viên
bảo-tồn: Lưu-trữ, lưu-giữ, bảo-vệ, giữ-lại
rác: sắt-vụn, bãi, chất-thải
hình-chụp: bức-ảnh, bắn
sách-giáo-khoa: nhãn-hiệu, sách
củng-cố: củng-cố
hạn-chế: ép-buộc, có-hạn, tống-tiền
kinh-tế: kinh-tế
điền-kinh: Khỏe-mạnh, bài-tập
sự-uốn-éo: nhăn-nhó
iốt: khoáng-chất
lây-nhiễm: nhiễm-trùng, gây-ô-nhiễm
nhà-thiết-kế: xác-định
tiết: sự-tiết, giấu, trục-xuất, bí-mật, phân-biệt
rau-bina: nuôi, rau-diếp
chuyên-sâu: cực, hung-bạo
vửng-chắc: chỉ-thị
khởi-đầu: Thứ-nhất, bắt-đầu
thứ-một-ngàn: một-ngàn
trong-nhà: bên-trong, sâu, trong-nhà, phủ
hủy-bỏ: tước-đoạt
độ-lớn: độ-lớn
kích-thước: chiều-hướng, sau, không-gian, bên-cạnh
kinh-thánh: thánh-kinh
áp-phích: cờ, web
đẩy-nhanh-tiến độ: làm-kết-tủa
tăng-cường: củng-cố, khuếch
sự-phá-thai: sẩy-thai
thường: nói-chung, chung, thường, có-xu-hướng
cam-kết: lời-hứa
sắp-hàng: cái-đuôi, gọi-món
dấu-ngoặc: kẹp-giấy, khuỷu-tay, cái-móc, người-ủng-hộ, hỗ-trợ
nghiệm: cũ
ngược: đảo-ngược, sự-đảo-ngược
bốc-hơi: làm-tan, ngáp
hàng-không: bầu-khí-quyển, hàng-không, bay
sự-tương-quan: sự-so-sánh
dân-tộc: dân-tộc, quốc-dân
chém: cắt-tỉa, giảm
khôn-lanh: xảo-quyệt, kỹ-lưỡng, phức-tạp, chăm-chỉ
đặc-tính: diễn-tả, đặc-tính
đóng-dấu: ghép-mộng, song-song
phân-tử: phân-tử
cấu-hình: bố-trí, cấu-trúc, hội
sự-tương-tác: nói-chuyện, chồng-chéo
định-lượng: âm-lượng
sự-tự-xét: quá-khứ
phương-đông: hướng-Đông
tinh-dịch: hạt
thừa-nhận: hỗ-trợ, thừa-nhận, sự-chấp-thuận
không: cũng-không, không
tin-tưởng: lòng-trung-thành, sự-đáng-tin cậy, thẻ-tín-dụng
sự-lật-đổ: sự-đổ-nát
lệch: trôi-giạt, độ-lệch
chích-thuốc: cây-kim
dép: dép, giày-dép
đoạn: Chip, đoạn, căng-ra
tivi: TV
ngũ-cốc: ngũ-cốc, hạt-đậu
thùng-hàng: nhạc-cụ, xe-tăng, nồi
di-cư: di-cư, đi-lang-thang
thuật-ngữ: các-điều-khoản
cử-tri: các-cử-tri
tẩy-xóa: xóa-bỏ, hủy-hoại
trung-gian: hòa-giải
chủ-nghĩa-tư bản: nhà-tư-bản
trượt-tuyết: giày-trượt-băng
giải-tỏa: bài-bạc, sự-cho-phép
tuyển-chọn: chọn
tĩnh: Tiêu-chuẩn
tập-trung: gặp, hội-tụ, chú-trọng
thuộc-về-mẫu tự: bảng-chữ-cái
toàn-cầu: quốc-tế, thế-giới
tai-nạn: sự-hy-sinh
được: cùng-một, sửa-chữa, rất
thực-dụng: Thực-hành
trọng-tài: qui-định, phán-xét
vi-phân: chênh-lệch
xông-lên: xông-lên, hơi-thở
đầu-nguồn: nước
cố-định: thích-ứng, thiết-bị
lắp-vào: lắp-đặt, thành-lập, đóng
cộng-hưởng: sự-rung
theo-truyền-thống: truyền-thống
lớp-học: quĩ-đạo
giao-thức: đồng-ý
tính-toán: tính, hóa-đơn
gram: nóng, cỏ
xăng: xăng
Thiên-hà: chòm-sao
thanh-niên: trẻ
nhào: rắc-rối
đường-bán-kính: Radio
loãng: gầy
Máy-bay: chim
bàn-đạp: bước-đi
circa: gần, trong-khoảng
đèn-pin: ống-kính
va-li: cái-hộp, hành-lý
đổi: trao-đổi
không-bắt-buộc: khách-hàng
ma-trận: Dạ-dày
vai: vai, bức-ảnh
trước: hướng-Đông, trước, đồng-cỏ
quảng-cáo: quảng-cáo
làm-choáng-váng: làm-kinh-ngạc
tỷ-lệ: biến-cố, nhúng
té: đổ-vào, hình-trái-tim
cảm: cảm-giác, đam-mê
sự-đồng-thuận: đồng-ý
giám-sát: quản-lý, màn-hình, công-an
ghép: luân-phiên
nhôm: nhôm
biến-động: sự-dao-động
mô-phỏng: theo-gương, đặt-chuyện
phức-tạp: phức-tạp
người-cố-vấn: cố-vấn, Huấn-luyện-viên
khe: khai-mạc
cờ-bạc-gian lận: con-quạ, cái-tháp, Lâu-đài, súng
vận-dụng: thao-tác, sự-náo-động
ăn-chay: rau
qui-tắc: đặc-điểm-kỹ thuật, Tiêu-chuẩn, qui-định
xe-điện-ngầm: đường-hầm
hô-hấp: hơi-thở
mô-phỏng: theo-gương
ống-tiêm: cây-kim
sự-biến-đổi: sự-thay-đổi, chuyển-đổi
Nội-y: quần-lót, lanh
âm-đạo: vịnh
phân-biệt: phân-biệt, chênh-lệch
mùa: mùa-vụ
dân-làng: nông-thôn
vừng: nốt-ruồi
hôn-mê: dấu-phẩy
đảo-ngược: sự-đảo-ngược, đảo-ngược
giám-sát: quan-sát-viên, nhãn-hiệu
trục-xuất: trục-xuất
kiểm-tra: kiểm-tra, sửa-đổi
đi-lang-thang: bay-lên, đi-lang-thang, nâng
quỹ-tích: nơi
suy-thoái-kinh tế: Kinh-tế-học
sự-ăn-trộm: cướp-bốc
khẩu-hiệu: mật-khẩu
thai-nhi: phôi-thai
hội-nhập: sự-hợp-tác, bao-gồm
màu-đỏ-sậm: màu-tía, cyan
giảm-thiểu: ít-nhất, giảm
khu-dân-cư: che-chở
số: kỹ-thuật-số, con-số
mặn: muối
vô-giá-trị: số-không, trống
lý-thuyết-gia: học-thuyết
bể-nuôi-cá: cá
lực-kéo: phủ-quyết
cái-dù-bay: ô
Quan-trọng: cần-thiết
tổng-thể: nói-chung, toàn-bộ, chung
hư-hỏng: thúi
vô-giá-trị: số-không, trống
tình-dục: tình-dục
ống-chỉ: âm-lượng, bọc
chủ-yếu: phần-lớn
nhớt: dính
ruột: ruột
khảo-cổ-học: khảo-cổ-học
củ-lạc: hạt-đậu
sự-ghép-lại: phụ-cấp
nồi-cơm-điện: bếp, nhà-bếp
quần: quần
tiêu-chí: Tiêu-chuẩn, Chỉ-số
tổng-quan: dàn-bài
định-tính: đặc-tính
kính-mắt: ly
di-truyền: hình-thái-học, di-truyền-học, gen
tham-gia: tham-gia, vai-trò, phân-từ
tiết-mục: năng-lực, phần-mềm
quay: chu-kỳ, quay
bố-cục: cơ-quan, kế-hoạch, bố-trí
chứng-từ: phích-cắm, biên-lai
định-lý: câu-văn, học-thuyết, định-lý
nhận-thức: chẩn-đoán
làm-rõ: kỹ-lưỡng, giải-thích
chất-độc: chất-độc
nhấn-mạnh: nhấn-mạnh
bút: cây-kim
sụt-giảm: cuộc-khủng-hoảng
cung-cấp: phục-vụ, cung-cấp, cam-đoan
chống: phản-đối
chống-lại: mãn-tính, phản-đối, miễn-dịch
snack: bánh-mì-nướng
Rạp-chiếu-bóng: bộ-phim, rạp-chiếu-phim
vòi: ống
đánh-dấu: chấm-điểm
chu-vi: xung-quanh, khu-vực
quả-quyết: xác-định, nhận-chắc, hung-hăng, quyết-định, bướng-bỉnh
nút: dệt-kim
béo-phì: dầy
trừ: trục-xuất, giảm, rút-ra, tước-đoạt
tự-động-từ: cần-thiết
vành-tai: ốc, quăn
Cookie: bánh-quy, bánh-ngọt
lạm-phát: sưng-lên
hàng-điện-tử: điện-tử
viết-lại: chép-lại
phòng-thí-nghiệm: phòng-thí-nghiệm
nghề-nghiệp: chuyên-nghiệp, Quảng-cáo, nghề, công-việc
Gradient: dặm, nhúng
nhiều-màu-sắc: màu
bảo-hiểm: phủ, vắc-xin, chăm-sóc, cái-mền, mái-nhà, Về-vấn-đề, âm-lượng
tham-gia: tham-gia, bao-gồm
sự-định-hướng: chiều-hướng
chế-tạo: sáng-tạo, sản-xuất
nhiệt: dầu
khuôn-mẫu: ngoại-lệ
công-nghệ: kĩ-thuật
dư: di-hài, dư
xe-vận-tải: xe-tải
sân-vận-động: cánh-đồng
sự-phối-hợp: phối-hợp
vi-khuẩn: vi-khuẩn
giao-diện: cách-tiếp-cận
silicon: pi
học-thuộc-lòng: ký-ức, lưu-giữ, ghi-nhớ
chẩn-đoán: chẩn-đoán
giáo-trình: trừu-tượng
sự-dẫn: dòng, bắt-cóc
triệu: triệu
người-bán-lẻ: người-chia-bài
bối: quán-ba
chính: Chìa-khóa, thứ-cấp
đầy-ý-nghĩa: có-nghĩa, theo-sau
âm-thanh: giọng-nói
khái-niệm: quan-niệm
lưới: web
không-gian: bầu-khí-quyển, không-gian
thi: đố
trung: thứ-cấp, thắt-lưng
trang-điểm: bù-lại
gián-đoạn: tách, độc-tấu
cản-trở: ức-chế, ngăn-chặn
đa: khác-nhau, hơn, rất
oi-bức: ẩm, nóng
hình-thái-học: hình-thái-học
chẩn-đoán: chẩn-đoán
bệnh-cúm: cúm
đồ-họa: biểu-đồ
hình-vành: Căn-bệnh
mông-đít: mông, giăm-bông
lưu-trữ: Hồ-sơ
đối-đầu: chiến-đấu,-đấu tranh, cuộc-xung-đột, sự-so-sánh
vận-tải-hàng hóa: xe-tải
tối-ưu: tối-ưu, thật-tuyệt
về-cơ-bản: các-điều-khoản
động-lực: kích-thích-kinh tế
hòn-dái: trứng
lưu-huỳnh: lưu-huỳnh
hoạt-động: thao-tác, hoạt-động
quỹ-đạo: quĩ-đạo, đường
liên-quan: liên-quan, tầm-quan-trọng, quan-hệ
xe-đạp: đạp-xe, chu-kỳ, bánh-xe
chỉ-thị: chỉ-thị
đường-hàng-không: chim, hàng-không
lít: lít
thất-bại: sự-thất-bại, sốc, hồi-quy, Thất-bại, trở-ngại
hợp-nhất: yên-cương, hòa-giải
lập-trường: đứng, vị-trí, đoạn
tối-thiểu: ít-nhất
tuần-hoàn: đạp-xe, định-kỳ
chất-nền: phân-tử
dưới-nước: tàu-ngầm
thẩm-định: Trải-qua, kỹ-năng
vô-giá-trị: số-không, trống
điện-tử: điện-tử
tương-tác: chồng-chéo
ban-đầu: nguyên
sự-phá-hoại: hủy-hoại
tương-tác: nói-chuyện, xã-hội-hóa
toán: toán
thai-nhi: phôi-thai
hiện-đại-hóa: hiện-đại, cập-nhật
cực-đoan: cấp-tiến, cực
nước-đái: nước-tiểu
ôm-chặt-vào lòng: ôm-hôn
đuợc: sửa-chữa, rất
swipe: lấy-trộm
cố-ý: cố-tình
bán: nữa-đường, bán, mài-ngọc, bề-rộng
thần-kinh: lo-lắng
chống: phản-đối
một-giống-đậu: ống-kính
gần: gần
chất-bổ-dưỡng: khoáng-chất, món-ăn
không-rõ: mơ-hồ, hiển-nhiên
vết-thương: sốc, chấn-thương, ung-nhọt
sự-đổi-chác: trao-đổi
vector: người-chuyên-chở
chiến-thuật: cách-tiếp-cận
đánh-giá: đánh-giá
vô-giá-trị: số-không, trống
bản-sao: bản-sao
khả-thi: Ưu-điểm, có-hiệu-lực
nhân-rộng: bản-sao
phản-ứng: sự-phản-ứng
thời-gian-biểu: lịch, thời-gian, bố-trí
thuộc-về-cú pháp: số-phận
ổn-định: trầm-tính
bất-đồng-chính kiến: đối-thủ
thông-tin-phản hồi: sự-phản-ứng
bảng-câu-hỏi: đố
oxy-hóa: gọi-điện
milimet: milimet
tâm-thần: trí-tuệ
hội-chứng: Căn-bệnh
mô: trường-hợp
hoạt-động: cho-phép, làm, hoạt-động
ngẫu-nhiên: ngẫu-nhiên, trùng, đến-trường-hợp
tẩy-chay: tách, tẩy-chay
tập-hợp-con: phần
phương-pháp-học: đường, cách-tiếp-cận, một-khi
tác-phẩm-nghệ thuật: công-việc
nối-tiếp: thích-hợp, thứ-tự
nhốt: cầm, chiếm, đóng
km: km
đa-quốc-gia: quốc-tế
kế-hoạch: người-thuê-nhà, sọc, kế-hoạch
mũ: số-mũ
để-lộn-chổ: mất
nghiên-cứu-viên: nhà-khoa-học
siêu-thị: trung-tâm-mua sắm
chỉ-định: sự-phân-phối, phân-biệt, phân-phát, sự-mổ-xẻ
vô-giá-trị: số-không, trống
bóng-đá: đá
quyền: bên-phải, đúng
thức-ăn-thừa: di-hài, chất-thải
bền-vững: Tiêu-chuẩn
tàu-không-gian: đưa-đón
kinh-nghiệm: Trải-qua
ngữ-nghĩa: ý-nghĩa, bộ-môn
nội: bên-trong, hội-viên
tấn: giai-điệu
mô-đun: modulo, đơn-vị, âm-lượng
men-tiêu-hóa: men
lối-sống: cả-đời
mỳ-ống: khối-lượng
ký-túc-xá: che-chở
thiếu-niên: trẻ
Điểm-nổi-bật: chấm-điểm
phủ-nhận: chối-bỏ, hủy-hoại
bạn-trai: bạn-gái, bạn-bè
hành-vi: hạnh-kiểm
cảm-ơn-bạn: cảm-tạ
chủ-mưu: não-bộ, Linh-hồn
sinh-thái-học: sinh-thái-học, môi-trường
di-trú: người-tị-nạn
nhúng: bao-gồm, nhúng, chôn
photocopy: bản-sao, bức-ảnh
hoạt-động: hoạt-động
Áo-thun: áo-sơ-mi
trị-liệu: Bác-sĩ, trị-liệu
ông-trùm: Vua
sự-đánh-thức: hứng-thú
đồng-bộ-hóa: đồng-bộ-hóa
có-tính-axit: chua
từ-nguyên-học: tự-điển, lời
cuộc-đột-nhập: gãy
phân-loại: phân-loại
avant-garde: tiên-phong
Chủ-tịch: cái-đầu
Bản: tờ-rơi
lôi-cuốn: quyến-rũ
tên-chất-hóa học: tên-chất-hóa học
hướng-dẫn: nhãn-hiệu
giả-định: giả-sử, giả-định
tủ-lạnh: tủ-lạnh
khởi-động-lại: khởi-động-lại
động-não: lắc, ý-kiến
tái-tạo: bản-sao, theo-gương, sự-lập-lại
angst: nỗi-sợ
ngưng-bắn: cuộc-hưu-chiến
điều-lầm-lỗi: bỏ-xót, sai
công-nghiệp-hóa: công-nghiệp-hóa, ngành-công-nghiệp
anh-chị-em ruột: anh-em
phát-ngôn-viên: cái-loa, Tiêu-biểu
không-tặc: bắt-cóc, cái-cày
phi-kim-loại: á-kim
chảy-nước-mũi: cúm, ẩm, chạy
mặt-nhỏ: chiều-hướng, hình, bên
từ-trường-hợp: 
lòng-tốt: Đức, Ưu-điểm
lãng-mạng: lỏng-lẻo, miễn-phí
sau-đó: Tương-lai, sau-đó, sau
khó-khăn: rắc-rối
đội-hình: ban-nhạc
mở-rộng: bề-rộng, mở-rộng, nói-chung
tương-quan: liên-quan, cái-móc
theo-như: trở-lại
vô-giá-trị: số-không, trống
thông-tin: tờ-rơi, thông-tin
không-chấp: sự-chấp-thuận, không-thể-chấp nhận được
bồn-tắm: bồn-tắm
giải-trí: giải-trí, làm-cho-vui, vui-vẻ
ngoài-ra: ngoại-trừ
sự-xuất-hiện: hiện-ra, lối-thoát, nổi-lên
vô-giá-trị: số-không, trống
gò-má: chơi
phải: cần, nhiệm-vụ
phần-trăm: phần-trăm
kiện-tụng: bộ-đồ
vô-giá-trị: số-không, trống
qua: thông-qua, phía-trên
soprano: trẻ-con
vui: vui-vẻ
PM.: buổi-chiều, đêm
Lòng-trắng-trứng: chất-đạm
đổ-máu: dính-máu
chất-hóa-học nguyên tử: chất-hóa-học nguyên tử
bẻ-cong: khuynh-hướng, uốn-cong
mối-liên-kết: kết-hợp
có-ý: có-ý-khuyến khích
chất-hóa-học nguyên tử: chất-hóa-học nguyên tử
thuê: thuê
trang-điểm: bù-lại
wisecrack: câu-nói-đùa
cấu-hình: cấu-trúc
các-quá-khứ: Cuối-cùng
to--chia: phân-biệt, phân-phát
giáo-sư: bậc-thầy
chất-hóa-học nguyên tử: chất-hóa-học nguyên tử
tiểu-bang-đánh dấu: 
khoảng-trống-đánh dấu: 
quan-liêu: quan-liêu
dây-lưng: ban-nhạc, yên-cương
vô-giá-trị: số-không, trống
nhân-viên-bán hàng: người-chia-bài
vô-giá-trị: số-không, trống
tên-chất-hóa học: tên-chất-hóa học
đối-tượng-trường hợp: chủ-đề-trường hợp
xây-dựng: sáng-tạo, xây-dựng, nhà-chế-tạo
vô-giá-trị: số-không, trống
giống-cái: nữ
người-kiểm-tra: viên-thanh-tra, kế-toán
microphone: vi
bên-ngoài-của: ngoài, ngoại-trừ
ghi-âm: bao-gồm, đăng-ký
ngón-trỏ: Chỉ-số
tài-trợ: học-bổng, chăm-sóc
dốt: dốt
vô-giá-trị: số-không, trống
tiêu-chuẩn-hóa: đặc-điểm-kỹ thuật, Tiêu-chuẩn
giờ: nơi, giờ
địa-chủ: chủ-nhân
người-điều-tra: determiner, nhà-khoa-học, thám-tử
loe: cháy
vô-giá-trị: số-không, trống
ủy-quyền: cho-phép
phòng-thủ: chăm-sóc
hành-lang: hội-trường
đàm-phán: nói-chuyện
làm-mới: tươi, cập-nhật
uốn-khúc: khuynh-hướng
trở-đi: Thứ-nhất, bên-cạnh, phía-trước
sự-thở: miễn-dịch, hơi-thở
vô-giá-trị: số-không, trống
sự-phát-triển: tiến-trình
tự-động-từ: cần-thiết
phơ: hăng-hái
rộng: mở-rộng, bề-rộng, phổ-biến-rộng rãi
tự-động-từ: cần-thiết
tương-phản: tương-phản, đương-đầu
ngạc-nhiên: ngạc-nhiên
giới-thiệu: giới-thiệu
con-cháu: quen, cháu-gái, thế-hệ
kem: kem
bán-kính: cá-đuối
cách-khác: nếu-không-thì
khu-vực-lân cận: xung-quanh, sống, môi-trường
đã-từng: khách-hàng
sự-lúng-túng: xấu-hổ, xáo-trộn
đáng-kể: phần-lớn
tươi: tươi, gần-đây, gốc-cây
khiêu-vũ: chơi, nhảy
vô-giá-trị: số-không, trống
lượng-đánh-dấu: 
xã-hội-đánh dấu: 
bài-phê-bình: sự-chỉ-trích
chất-hóa-học nguyên tử: chất-hóa-học nguyên tử
cuộc-tranh-đấu: chiến-đấu,-đấu tranh, cuộc-xung-đột, chiến-tranh
khiếu-nại: trong-khoảng
vô-giá-trị: số-không, trống
chất-hóa-học nguyên tử: chất-hóa-học nguyên tử
thiến-tính: đàn-ông-tính
chất-hóa-học nguyên tử: chất-hóa-học nguyên tử
hành-trình: Thăm-quan, Safari, thám-hiểm
đàn-ông: Nam
vô-giá-trị: số-không, trống
phát-triển: tiến-hóa, tiến-trình
ứng-dụng: Thực-hành
đóng: đóng
làm-phách: làm-oai
lạc-hậu: trở-lại
các-hiện-tại: hiện-nay
vô-giá-trị: số-không, trống
randomize: ngẫu-nhiên
hợp-tác: bạn-đồng-nghiệp
về-hưu: về-hưu
vô-giá-trị: số-không, trống
lừa-quân-địch: sung-sướng, vui-vẻ, làm-cho-vui
approximative: ước-chừng
cặp-đôi: nhị-phân
bổ-sung: bổ-thể, thêm-vào
giao-tiếp: sự-tương-hợp, lắm-lời
vô-giá-trị: số-không, trống
tại-trường-hợp: đến-trường-hợp
chất-hóa-học nguyên tử: chất-hóa-học nguyên tử
phá-vỡ: phân-ly, nghiên-cứu
màu-da-bị sạm nắng: nâu
vấn-đề: có-vấn-đề, rắc-rối
dịch: dịch, lật
vô-giá-trị: số-không, trống
chất-hóa-học nguyên tử: chất-hóa-học nguyên tử
đảng-phái: tập-đoàn, nhấp-chuột
dễ-dàng: Dễ-dàng, đơn-giản
người-điều-hành: facilitator, giám-đốc
xã-hội: xã-hội
phù-hợp: bộ-đồ, phù-hợp
Tai-nạn: biến-cố
đó---đó: cái-nào
thú-vị: rút-ra
lộn-ngược: đảo-ngược
thuốc-diệt-cỏ: chất-độc
vô-giá-trị: số-không, trống
người-mới-vào nghề: phân-từ
Ví-dụ-như: trường-hợp
bướu: bướu
phân-rã: thúi
vô-giá-trị: số-không, trống
trang-mạng: trang-mạng
to-lớn: to-lớn, rất, siêu
sẽ-là: 
họ-hàng-trường hợp: họ-hàng-trường hợp
khách-quan-trường hợp: nơi-đến-trường hợp
tặng-thưởng: bù-lại, trả
đối-xử-tàn tệ: sai
bím-tóc: cây-rơm, dệt-kim
thay-vì: thay-cho
khảo-cổ-học: khảo-cổ-học
kết-nối: liên-hiệp-tiếp từ, phích-cắm, tập-tin-đính kèm, ổ-cắm-điện
vô-giá-trị: số-không, trống
khái-quát: tổng-quát
chất-hóa-học nguyên tử: chất-hóa-học nguyên tử
chất-hóa-học nguyên tử: chất-hóa-học nguyên tử
chưa-bao-gồm: ngoại-trừ
vô-giá-trị: số-không, trống
rút-lui: lạc-đề, hồi-quy, về-hưu
người-về-hưu: về-hưu
một-khác: lẫn-nhau, khác
rộng: phổ-biến-rộng rãi
máy-tính: tính, máy-tính-bàn, máy-tính
kinh-doanh-một người: doanh-nhân
bánh-mì-kẹp xúc xích: xúc-xích
ưu-thế: hiệu-quả, năng-lượng, Ưu-điểm
unquote: Trích-dẫn
trường-hợp-chiếm hửu trường hợp: tánh-cách-trường hợp, trường-hợp-chiếm hửu trường hợp
gen: gen, di-truyền-học
đồng-nhượng-quyền: nhúc-nhích, dịu-dàng
gián-tiếp-vật: Chỉ-đường-vật
cấm-khí-sắc: cấm-tâm-trạng
tập-thể-dục: bài-tập, công-việc, kỹ-lưỡng
phân-định: có-hạn, tách
trái: đảo-ngược, phản-đối, ngược-lại, sự-đảo-ngược, tương-phản
leo-lên: nổi-lên
vô-cùng: bất-thường, siêu
vô-giá-trị: số-không, trống
đóng-kín: đóng, khung-cửa
rẻ: rẻ
Tranh-sơn-dầu: vải, web
giáo-dục: giáo-dục, lịch-sự
động-vật-hoang dã: bản-chất, hoang-dã
phản-đối: phản-đối, ngược-lại, về-phía
vô-giá-trị: số-không, trống
đào: đào
nhiễm: nhiễm-trùng
vô-giá-trị: số-không, trống
vũ-trang: cánh-tay
ví-dụ:: cụ-thể-là
không-một-ai: chẳng-có-gì
sự-tuyên-thệ: xin-thề, lời-nguyền
thon: gầy, hình-nón
nghệ-sĩ: giải-trí, họa-sĩ
vv: 
ngoài---từ: ngoại-trừ
đường-viền: dàn-bài, môi-trường, mẫu-đơn
điện-thoại-di động: điện-thoại-di động, tế-bào
Hoa-hậu: cắt-tỉa, mất, chi-tiêu
đáng-báo-động: khủng-khiếp, nóng-lòng
các-Tương-lai: Tương-lai
thuộc-về-tiếp tục pháp tâm trạng: có-điều-kiện tâm trạng, nguyện-vọng-pháp tâm trạng
phải: cần
xe-máy: xe-gắn-máy, động-cơ
thẻ-tín-dụng: thẻ-tín-dụng
vô-giá-trị: số-không, trống
các-công-cộng: công-cộng
điện-thoại-di động: điện-thoại-di động, tế-bào
vô-giá-trị: số-không, trống
ruột: ruột
triển-khai: phân-phát, tiêu-tan, tiêu-thụ
trục-xuất: trục-xuất
tỷ-lệ: cổ-phần, phần, lượng-tử
thẩm-quyền: kỹ-năng, quyền-tài-phán
chủ-đất: Thiên-thần
thuộc-về-tiền trì từ trường hợp: 
phân-bổ: sự-phân-phối, cổ-tức, phụ-cấp
đáng-lo-ngại: nóng-lòng
được-rồi: cùng-một, rất
thi-hành: ép-buộc
pro-cụm-từ: pro-kết-án
thụ: catcher
chích: giới-thiệu
kinh-ngạc: làm-kinh-ngạc, nổi-bật
ho: ho
bên-cạnh: bên-cạnh
