动词不定式: hnit
主格外壳: hnak
宾格外壳: hkak
主题外壳: htak
父: hmat
爸: hpap
妈妈: hmam
您好: hnat
祖先: htat
祖父母: hyat
饥饿: hcac
所有格外壳: hnik
形容词: hcit
和: hwan
我: hmic
您: hnan
我们: hnam
它: hyic
目的地外壳: htas
格外壳: htik
室内背景: htis
人背景: hpak
依赖的条款: htan
完成式方面: htap
过去紧张: hkat
男性性别: hsan
comitative外壳: hmik
当下紧张: hyan
benefactive外壳: hpik
essive外壳: swik
不: hnic
其: hsis
表面背景: hsak
adpositional案件: hpan
位置案件: hwak
空间背景: hnos
办法案件: hrak
仪器的外壳: hsik
哪: hkan
疑问心情: hnim
和要么: htam
异或: hkit
资源外壳: hsok
夺格外壳: hlak
指示代词: hdit
但: hlan
所有: hsut
女人性别: hnin
他们: hwin
复数数: hlun
一: hyik
未来紧张: hwet
社会背景: hson
什么时候: hkap
未完成方面: hmap
那里: hkac
有条件的心情: hcan
更多: hdoc
出: htac
相对的外壳: hrik
illative外壳: hlik
做: hkas
指示心情: hden
道义心情: hdim
题字: hwac
系词: hkok
人: hpon
男: hman
可以: kwat
其他: hcon
数: hnoc
非常: tcac
时间: htim
时间背景: htos
颞外壳: hmak
关于: hkam
认知心情: hsim
只要: htun
小: hcak
然后: pcan
忠告的心情: hton
回顾方面: hrip
大: hcat
意愿式心情: hlim
之前: hsec
必须: pcic
二: htut
看到: tcan
知道: hsat
向下: hcin
后: hcas
第一: hpas
拥有: hpun
离间的所有权: hlic
决不: hnac
不可分割所有权: hkic
旧: hwat
审议心情: hcim
日: htin
哪里: hnap
来: hlat
方法: hyas
工作: hkaf
元音: hwaf
走: hkun
perlative外壳: pwik
进步方面: hpip
长: hlac
说: hsac
怎么样: hkin
甚至: hpit
背部: hwap
这里: hcic
认为: hcik
相同: hsam
持续: kcac
远: twan
下背景: hnas
采取: htit
发现: hfan
手: cyat
年轻: hyac
虽然: hyap
给: hkik
神: hmac
delative外壳: lwak
没什么: hmin
对: hyit
一旦: hyam
semelfactive方面: fwip
部分: hpat
锯: htic
房子: hfas
世界: tcat
头: hcaf
三: tyin
新: hnon
焦点: hcok
爱: hpac
总是: hsit
晚: hwit
每: hmit
王: hyak
之间: hsin
心: cyin
paucal数: plom
因为: hyok
因果外壳: ksak
事情: hkis
组: swat
名称: hnem
正确名词: hran
忠告的: hrat
国家: hlit
问: hput
可见证据: crit
更好: pcac
侧: psac
课程: hkus
女: hfin
够了: kyat
不久: hpuc
充分: hcun
房间: hfac
几乎: hlap
不能: nyat
水: hwik
desiderative心情: hdin
光: lyak
也不: hnun
字: slat
门: tyan
使用: hpus
早上: hsap
终结外壳: twik
功率: hkuk
他们自己: hmis
当下: hyin
语音: hwas
白色: hpis
钱: tlan
下一个: kyak
较差的: hyis
死亡: hmut
形成: hfam
内格外壳: nwik
类: tyac
经常: tsan
年: nwan
朋友: myat
订购: hyut
势在必行心情: hpim
回合: hcut
相信: hban
上市: hpin
州背景: hsas
儿子: psat
百: hmas
孩子: hcis
从而: tyak
希望: hcap
以上: hyip
亲爱: pyin
读: pyac
市: hsic
已经: hpic
事实: hfat
事实性证据: hfit
听: hsun
最小: hmim
也许: pyat
打开: kcat
体: tcic
空气: cwac
性质: nyit
帮帮我: mlat
信: lyat
四: ksat
表愿望的心情: hpam
火: hfak
因此: hyif
小时: hcam
自由: tyit
战争: syat
是否: hsaf
原因: kyan
联合的: hnut
呼叫: hkuc
为什么: hwam
迷路: hkut
千: tsas
家庭: hfic
灵魂: twam
题: swac
关心: kcan
realis心情: hlin
意味着: mwit
潜在心情: hten
向: cyan
allative外壳: lwik
择性别: hrin
短: kyut
能够: hyuk
生活: hkip
学科: hsek
相同学科标记: hcek
不同学科: hfek
回答: tsat
海: mwat
恐惧: hcoc
理解: pcat
硬: kyin
术语: tyut
怀疑: hdac
dubitative心情: twin
问: psan
武器: tcas
黑色: clis
带来: tyat
美丽: ksis
黑暗: tcak
保持: psak
十: htaf
显示: pyan
故事: hkif
共同: kwan
书: hkup
电子: lyin
谈论: plak
标记: myac
利益: nyis
写: kcit
床: pwat
必要: syis
理念: hwis
艺术: klat
vialis外壳: hlas
哥哥: pyak
有时: ksas
线: lyan
表: tlas
河: nwit
眼: kyac
信息: fyin
突然: tfan
奇怪: hgan
深: ksan
更改: hrit
感觉: nwac
遇到: mlit
目的: htuc
快乐: hcuc
似乎: syit
血液: cyac
玫瑰: kwas
南: swan
冷: tlat
前锋: myik
位置: psis
晚了: tyam
站: syan
假设: nlas
女儿: pyit
矿: myan
切: hkim
复制: hfap
丈夫: hgat
六: hlis
记得: twat
影响: hyaf
秋季: htuk
除: hsip
头发: hpaf
通过: pyas
版权: pcit
军队: cyit
跑: kcak
马: kcas
未来: hwic
西: pcak
工资: plit
红: hyun
金: tcun
欲望: hdan
玩: plin
主: mwas
办公室: hfus
政府: syak
教会: kyas
长度: hlen
公司: ksin
纸: kyis
可能性: hbin
特别: cyas
熊: pcas
窗口: cyak
协议: hgac
美女: syac
责任: tfac
发送: fyan
距离: htif
沉默: slan
脚丫子: fyat
野生: kyik
死: myam
保存: pfan
绿色: kcin
麻烦: mlan
微笑: myak
错误: clat
各个: pcin
睡觉: slit
quotative外壳: kwik
开始: cwan
行动: kfan
访问: fwat
遵循: nlan
尝试: tcis
存在: psit
甜: tlit
丰富: tcin
敌人: tcam
船: hcip
条件: kyit
包含: hkum
包容性人: hlon
秘密: kwit
precative心情: pwim
有礼貌寄存器: hbit
邪恶: pwac
游行: myas
随你: kwac
留: hlam
代替: plat
蓝: plan
不可能: psap
学校: hsuk
场合: ksac
已婚: nwat
食品: hcuk
二十: tsis
安静: tcit
容易: hnis
预期方面: hrap
语言: lyac
表达: syas
周: hsus
大厅: hcum
危险: kcic
属性: myit
天生: nyan
法庭: kcut
通常: tyap
格言方面: hmip
价值: tyas
简单: syap
树: pyic
斗争: pyap
壁: twit
天堂: cwak
发端的方面: htip
命令的心情: hjin
音: twun
看待: klan
预期: pcik
月: hmaf
经验: nyap
完全: nyac
新鲜: tsac
公爵: hnuk
覆盖: kwak
界: hyim
东: tyuk
石: pwan
有些: kfat
方向: tlac
椅子: kwis
支持: syut
日期: tyic
村: klac
领域: clit
允许: nwin
宽容心情: hmom
成功: slak
正确: hric
山: clin
音乐: ksik
远端指示代词: hdat
下午: htup
哭: hyuc
荣誉: hnaf
七: swit
私人: pfat
新闻: nwas
现场: slac
花园: cyam
种族: htus
分配的外壳: twak
学习: clan
政治: syik
谎言: kcun
投: tsak
吃: kcam
地板: hlaf
生病: pwin
原版的: mlin
夏季: kyam
宗教: tlam
图片: ksit
逃逸: plap
作者: hlut
棕色: pyun
决心: htem
疼痛: hdon
弹簧: psin
世纪: syic
柔软的: mwan
角: kyun
生产: psas
笑: cyaf
忘记: flat
欧洲: hyup
八: lwat
连衣裙: lwac
可怕: cyap
气息: syaf
明智: hbas
所有格标记: srak
记忆: myin
现代: fwan
点: tcap
上升: hyus
打破: pyik
五十: hfis
岛: tlap
触摸: hsuc
承诺: pcam
承诺性心情: mwin
度: tfat
计划: plac
进行: nyak
惊: cran
分钟: hmun
射击: hwut
更坏: pcap
玻璃: klak
例: tlin
安全: hsif
医生: tsit
completive方面: hmep
反复: tyun
军事: slin
暖: nyam
喝: pfin
问题: pcaf
愤怒: nran
直: tyik
帽子: hcup
狗: kwap
仆人: hnuc
自豪: hram
人群: tcuc
培养: nyin
道德: myut
关联: kyim
输入: fyak
规则: nyas
剑: cwat
攻击: kfak
健康: clac
段: pyaf
社会: hsum
退: tfit
抱歉: hpec
勇气: krac
恩典: hnen
官方: hfaf
提供: tsik
请求: pwit
一瞥: klas
运动: hyon
期望: cwit
对面: psam
十二: tyaf
订婚: nyut
葡萄酒: hwun
味道: swut
铁: fyac
分发: syin
贸易: myap
优点: twac
衣服: kfip
法官: fwak
差分: tfaf
急: kcis
队长: kwin
完: nlat
戒烟方面: hsep
好奇: kyic
国外: kwic
增强: hnif
重要性: myun
最后: hfim
法案: fwin
证明: hpuk
防止: flan
颈部: cyun
法律: hfik
干: swak
服务: syam
失去: pcut
证据: pyut
证据外壳: hdak
进展: pyis
建造: klit
搜索: syuc
伤心: hrac
罪: psip
三十: tfis
诚实: tsin
关闭: kyap
银行: pcun
命运: cyik
森林: hfun
测量: mlac
除此以外: htoc
流: lyam
面包: hpup
额外: tfak
选择: twas
动物: nwam
宙性别: hzin
eventive心情: hwim
相同事件标记: hcom
乘法外壳: tlak
厚: hmus
生物: hyum
雨: myic
表面: pfas
圣: swis
七月: clim
报告: hfut
滨: pwas
文件: hfif
肩: cwut
感到惊讶: kran
王室的: klik
歌曲: hkuf
安慰: kfaf
任何人: nyic
草: kcap
绘制: cwik
开盘: cyic
六月: cwun
鱼: mlic
资本: klin
乳房: cyut
雪: hcif
教育: tlik
尖锐: tcaf
怜悯: hdam
费用: fyas
你的: hmuc
百万: mlun
累: tcik
杀: ksam
阴影: cwap
重量: plas
质量: mlas
既定: tlip
勇敢: pyam
薄: plic
满意: srat
查: kcik
美德: hdet
国民: nyaf
神圣: swin
谷: clak
猜测: kwam
投机心情: hken
黄色: clas
遗迹: mwac
弯曲: nlac
框: pwak
季节: tsim
科学: slas
孔: kcuc
叔叔: hmuk
名单: lyit
八月: ksut
流行: hlup
未知: fyit
熟: flak
熟寄存器: krit
读者: tsut
途径: pcuc
两次: tsap
知识分子: tfik
真: tsam
牧师: pcis
负伤: fran
悲哀: hpom
宫殿: kfas
击败: clap
是吗？: hnec
傻子: myuk
边缘: pfac
九: nwun
爆裂: psut
遭受: tfas
噪声: hcus
文学: lyic
忠告: swas
空: kcuk
秩: psik
风暴: tcut
口袋: kyip
想像力: nlin
句子: cwas
十一月: nwap
十二月: tsip
缺席: psic
感谢: ryak
地址: tyis
鸟: pyuc
所有者: mlik
涂层: kwut
准备: tyip
关系: lwan
抽烟: htum
一月: nwak
机: clic
内容: nyik
牙齿: tlis
耻辱: hcet
湾: kcaf
脑: pyuk
环: klic
短语标记: frak
广场: ksap
水果: fyut
茶: tsic
说明: slam
欢迎: cwam
诗: pwis
购买: klam
可信: hdic
激动: hcen
四十: klis
四月: pyip
和蔼: kfit
十月: kfap
苦: kyuc
奴隶: tlaf
松: hluk
文本: tsus
信用: cyip
十五: pfit
残忍: kcim
加入: cluc
处理: hpif
犯罪: kyaf
灰尘: tsuc
实用: plik
颜色: nlak
破坏: nyuc
增加: lyas
鼻子: hnus
承认: tyim
昨天: kfac
hesternal紧张: tlen
失败: slap
继续: tcim
穿: pwam
盲: nlit
打: tsun
飞: fyap
赞美: cwin
魔鬼: cwaf
逐渐: twic
牺牲: kyif
行使: cyis
良心: tfin
理论: tlic
部长: myis
讨厌: hnet
湖: cwic
中央: syun
晕: pfic
合理的性别: hron
小心: fwac
享受: nlam
崇拜: pwap
产品: twap
皮肤: twaf
屋顶: tlut
冠: gyan
城堡: klap
王座: tcus
附: nlaf
英里: mlim
极端: krim
监狱: fyis
杯: kcip
会员: mlam
国内: syim
到处: tsaf
明显: tfic
一对: pwaf
卷: clam
习俗: ksaf
弓: ksun
适合: slut
肉: mwak
牛奶: hluc
植物性性别: hwen
视力: slic
罕见: nlap
表姐: ksic
桥: pwut
保护: pfak
盐: swam
无辜: hwus
女王: kwim
计数: kcus
好奇心: hras
舞蹈: tyus
饭店: clut
填: flin
囚犯: psun
店: hjan
楼梯: sric
求: hmen
砂: sran
暴力: hgit
九月: hsem
离开: prac
废墟: crin
技能: krin
黄牛: hwec
设备: hwip
厨房: hkon
卖: hbak
速度: hsot
结论: clon
计算机: hkot
永恒: hsen
有限: mrit
图书馆: hbek
基础: hbac
混乱: hrun
辉煌: cris
同样: hjic
受惊: hbic
不快乐: prin
文章: hrek
厨师: kfin
带: hbat
沙漠: hget
吻: hbun
球: hbot
棒: hpot
论据: hrut
守: nrak
祝福心情: hbim
引人注目: hrim
有罪: hdis
枪: hgin
警察: plis
隐藏: hzan
远征: srin
无知: nrin
慷慨: drac
云: blan
浪费: htek
二月: frif
疾病: hren
花: bwan
资源: sron
倡议外壳: hnok
姨妈: hbam
延迟: dlic
延迟势在必行: hlip
报道证据: prat
午夜: dyit
英雄: nrac
哲学: hfof
手指: hjit
自在: hzat
某处: hmoc
按: bran
员工: hraf
奖励: rwan
怪: dlac
苦难: krat
前额: htec
广告: glan
天使: htet
单数数: hgam
黎明: hbon
商业的: krak
原谅: pran
羊: hcec
忍耐: hpen
农场: crac
参考: hrec
玉米: mran
键: kcif
多数: hmot
弱点: hdut
大气: traf
叹: tcoc
人类: mlis
反对: pric
磁盘: hdik
孤独: hket
艺术家: nrat
骑士: cwis
魅力: tran
决定: drin
州长: gran
科: rwac
性格: hsoc
热情: tsum
归纳的心情: hdum
社区: hmum
油: hyen
管: hbap
打印: trat
哦: dyoc
演讲背景: hros
呼外壳: hwok
舱: ksen
报警: plam
紧张: hnes
常驻: hset
刀: ksuk
丝: slik
鄙视: grin
地狱: nrik
分离: plen
认真地: mrat
杂: mrik
木: mrak
比较喜欢: hpet
警告: trin
警告心情: htom
冲动: hmos
志向: mrac
拒绝: hnek
宪法: swic
仪器: srit
连续方面: hnip
潮: hgas
学院: klen
尾: hkek
代: nric
猫: blat
直接证据: hret
弃: trac
十一: hyec
本能: nlik
特性: trit
部落: hgik
忧虑心情: pcim
庇护: crat
无礼: hruc
骑术: hris
摇: hmon
行业: hdot
职业: hres
灯: hdap
咖啡: kfif
服从: htot
北方: nrit
护士: nris
保证: hjat
链: ryin
教学: cric
鞋: hgut
码: mram
模糊: hmec
别处: hlet
公寓: pret
活动: twot
星期六: cram
阳光: hduc
寡妇: hwuc
元件: hlem
反射: hfen
组织: hgis
星: tram
事件: hgon
来宾: hgip
酒吧: brap
瓶: hbet
保佑: blak
搅拌: crak
内: trik
固定: krik
派生: prit
空洞: hcot
省: hpos
文明: srac
挂: hgak
休克: crok
例外: swap
应变: tren
标准: ryan
主动: dran
RID: hruk
发誓: kses
宝: zran
种子: hbis
塔: tras
喜爱: fwit
最近: hcem
最近过去紧张: hrot
醒: srik
家具: mrin
绳: hkos
冒险: hdas
王权: ryit
盛宴: dyat
描述: dras
六十: hses
规模: hkem
仪式: srec
狩猎: clik
耳语: psus
主要是: ryat
基督教: ksim
律师: hwif
详情: drit
公主: hrus
坛: dlat
卷筒纸: hwes
紫色: brin
收集: hkoc
选举: hben
概念: kren
醉: crik
倒: brac
电梯: hlif
手势: hjis
管理: rwin
交换: tcen
定文章: hdek
皇帝: mras
远程: hroc
丑陋: clup
无害: cras
滚: hrof
英寸: nlic
报纸: grat
胡子: dric
撕: srim
佣金: kson
而: grak
路口: kcoc
独立: htes
闻: hwon
十八: hdec
历史的: tris
毛: krut
根: hrok
泥: hbik
新娘: dlan
面纱: pras
剧院: tret
对照: kras
对手: rwis
平衡: slen
教练: kron
幽默: hnum
小说: rwas
复仇: hbaf
妒: ryut
轮: hlok
焦: glat
闪: flac
创建: hkec
冲突: hnot
诅咒: hlos
咒诅心情: pram
无助: hces
正: hzit
俱乐部: klup
洪水: nras
粮食: gwan
漠不关心: hdun
地平线: crim
憍心情: hsom
陡: htop
和谐: mron
雷: hgot
童年: htok
膝盖: hgun
软件: pwen
伤: kram
收据: ryis
启用: nlim
条件从句: hpoc
滑: slok
革命: hrif
农民: hjim
行程: trak
平台: hpof
信使: hmes
特权: hpek
有组织的: hyot
学生: clen
洞穴: hgec
传统: rwat
悲剧: tses
告别: hjap
批评: ryik
棉: krap
医院: slot
出租: kris
气体: hges
必然: pwic
致命: hgim
叶: glit
发布: plun
敌对: tsup
翻译: dwan
葬礼: jran
面粉: mrun
对应: ryon
浪漫: hrom
棚屋: clun
提出: psot
模仿的: hmet
美元: dlon
日光: hjac
十六: hsos
部件: hzac
殖民地: klon
翼: gyin
狮子: hles
文化: klut
柱: hkom
狡猾: glak
戏剧: dram
开玩笑: hjuc
薄雾: hdus
医学: dwas
十四: hkes
酸: sram
亦即: hyet
收入: hmok
主教: hbip
橙: tron
浴: byan
原始: rwit
篮: ksek
秘书: sris
稻草: prak
不耐烦: pfif
救恩: slon
hodiernal紧张: dlin
打算: zrin
蒸汽: tcip
毒: hwoc
天赋: tlon
气候: lwim
有效: fric
区分: tcif
洗: dwac
自白书: kfis
废话: hjas
煤炭: kyon
独木舟: kwon
临时: tric
定界方面: hdip
骨: hcos
星期一: nwic
星期二: glac
星期三: bwac
联邦: frin
合意: hzic
代表: ryic
麻布: lwin
水槽: swuk
外甥: bwin
血腥: kric
围城: cren
胃: hpem
黄铜: pcon
首脑: hzik
第五: pfik
廉价: brat
独家人: kwen
抢占: zrat
篱笆: hzas
雕像: tfam
炮兵: tlep
拥抱: mrap
周围: sren
严格: srot
鹿: hluf
衬套: hbuc
铁路: hrep
卸货: hduk
继承者: mris
橡木: blun
不愉快: pren
发明: hgic
钢琴: pyon
说服: swen
无形: gric
知名: ryun
残酷: kluk
诱惑: hyoc
TELIC方面: hlep
经济: kfik
国际: troc
干扰: tcek
哲学家: flif
优雅: gyit
福利: kyen
钓鱼: mlak
偷: truc
唇: hloc
退休: ryac
伸展: sras
画廊: glen
平行: zlan
atelic方面: htep
大陆: trap
令人望而却步心情: nrim
领带: dwat
细胞: slep
蛋: dyan
人造: jrat
与此同时: nwis
危机: ksot
有礼貌: sloc
午餐: lyon
松树: pwon
推: hcef
联盟: lyen
腰部: hkop
奇迹: hmek
水手: slis
纯度: prut
共和国: hguk
电话: tfen
鞭: krip
衬衫: cyim
介绍: ryas
沙发: hsof
扫: hsup
贼: ksif
保留: nrec
渠道: kcen
个性: klim
改革: kfam
危险的: hzim
棕榈: plim
扬声器: hzak
阈: dwic
促使: pris
矛: bzak
整齐: syec
会议: cwen
拷打: crot
潮湿: tcum
岭: grit
游客: hyek
磨: mwik
地图: jrac
领: klok
更换: klif
故意: drat
啤酒: hbif
丝绒: hwem
重力: gwit
讲道: hpum
滥用: glas
群: hgen
十三: tres
辩解: jyit
星期五: crum
刷: broc
下载: dlas
奶油: krem
悬崖: klaf
陪审团: jrin
怪物: ksos
冻结的: hgoc
锅: pfot
一分钱: psen
咬定: srut
苹果: hpep
讨论: drak
背景: prun
录制: trim
定期: prik
娱乐: nren
病毒: bris
幼稚: blit
反映: flit
兑换: kcet
轮廓: kluc
歌剧: hpop
赞同: nron
背叛: rwak
惩治: hzen
弯头: kcon
附件: tcet
修复: hrop
可疑: cyec
七十: swet
圣经: srip
坑: grac
紊乱: dlak
二进制: byin
僧院: bjan
箭头: tcec
趋向: trec
阐述: frat
忠诚: hlot
硬币: syip
颤抖: tcem
流亡: gwin
机械: myim
陷阱: crap
蛋糕: kyek
先生: cyes
迟疑: sret
十七: syet
蜂蜜: myon
赌注: dzat
踏: hjam
砖: brit
八十: hpes
不幸: pcen
请教: kcot
传说: lwen
收成: hfos
提升: pfon
火炉: hsop
反叛: bric
过时: hnom
膨胀: cron
沼泽: swot
敷料: hdes
苦行者: pces
经理: mren
合唱: cros
有理: tson
处理: pson
狼: blaf
地毯: hgap
古代: hjak
沃: frut
哨: slif
起司: twis
咬: byat
邀请: jwan
大教堂: kyet
港口: brak
漫步: djan
作物: tsos
海军: nlen
面具: mrok
铅笔: pses
蔬菜: sroc
展示: hzet
长裤: tlun
腐败: hrup
内阁: nram
汤: srup
外科医生: syon
津贴: tcot
间谍: gyas
鲁莽: hlec
闲话: gyic
象征: hzon
抽象: srok
星期四: cwim
交通: ryaf
建筑: ryek
裂纹: rwaf
装饰: rwon
相反: lwas
游玩: mwun
复苏: ksus
路面: plut
决定性: dyin
负: nraf
节: hfec
减少: hrum
叛逆: zyan
猎人: djin
蛇: syen
电池: bret
蜡: flam
侦探: dlit
分析: nlis
重点: hzot
游泳: twen
信封: lwaf
谁: hgek
卷烟: jrit
马达: mrot
志愿者: hwot
反应: ryif
行李: blam
聋: hboc
汁: hjus
谦逊: jlit
部: mret
有性: hjon
直径: dyam
斧头: blac
钻石: dlam
备用: hlek
回声: hgus
克制: swon
身分: hdaf
屏幕: krun
懒: lwis
momentane方面: hmop
紧凑: kfot
漂移: hdif
消失: hgaf
射线: ryen
墨水: mwic
大规模的: mraf
地窖: dyac
难忘: nrun
强光: klek
参议院: slet
棺材: tfap
饶恕: frac
吞: nlun
放纵: nlot
摆动: swun
草地: gram
复杂: klos
辞职: hzis
谦卑寄存器: nret
阴谋: swim
胡椒: prip
小马: pron
候选人: hzam
狐狸: flik
烟囱: tcon
管辖权: drik
农业: rwic
准确性: tcuk
前任的死者: brim
民主的: mrek
芽: hbos
毯: bwat
冰雹: hgep
猪: srus
成形: krek
象牙: craf
古典: ksok
观察者: nwet
象: lwit
钉子: nwus
蜜蜂: hmif
埋葬: dzan
演员: bzat
汗: zwan
抛光: ploc
错觉: hlus
不确定: pcet
次要: syif
折: tsot
乡村: grun
呻吟: nyen
类似: slec
引用: hzun
解雇: cyek
烦恼: fren
针: hjun
受控: nroc
鸡: truk
一贯: kwot
桶: bras
惯常的方面: hcep
专家: ksec
印: blin
橄: zlin
面包车: myen
障碍: bwak
点头: kcec
培育: plaf
定义: fyic
生日: gjin
锤: hcof
香: hfon
重: trun
不重要的: twut
踢: hjik
挖: kwaf
宠物: plot
头骨: hcop
立法机关: dlik
脚跟: cruk
皱眉: crun
专利: plet
十亿: blim
化学: fyik
飞行员: pyot
模拟: mlot
短裙: kwet
异常: srap
每周: jwik
技术: tfip
植被: tset
乌鸦: kraf
日出: sruc
一生: glin
有助于: hyom
钩: hdok
虎: blic
穿透: crut
袖: slun
公路: jras
民兵: mlip
沟: kroc
廉正: kret
十九: dzin
有机: rwik
神学: flic
浮动: flut
巫婆: byac
无聊: hwuk
外交: dyik
工作室: twos
超过: kcok
香槟酒: cyen
启发: crif
旗帜: hbes
离婚: lwon
螺栓: hbut
静脉: jyan
被动: psif
泡沫: hgum
碎石: grik
围裙: tyen
行星: gren
架: claf
风扇: flon
热带: hjip
相: fwas
随意: rwen
发音: kfun
汞: krok
爬行: hrem
自杀: tcos
记者: prot
剥夺: hpok
熟练: klun
阳台: blik
叉: fras
雇员: mlek
雇主: myot
宽度: jrak
恼怒的: djit
控: klot
养老金: pyen
动词: kres
猴: mwon
接受: hwek
签名: tlim
正统: rwos
讽刺: fron
苗圃: nrap
不情愿: jlan
进口: tyot
火炬: croc
语法: gjak
存款: gyat
殖民: plon
游艇: jyat
后果: kwec
拱顶: kwun
厚度: hfot
顽固: cyon
肌肉: hmup
大小: ryam
擦: ryos
胆小: rwam
马具: gwac
烤面包: tros
鼠标: myus
音节: slim
拍: prap
对话: dlaf
中性: nrot
勤勉: dwin
矛盾: trot
实现: kfic
山羊: byak
繁荣: hfet
强加: mlon
匿名: nwim
正式寄存器: frit
小牛: hbof
手册: mwut
熔化: hjec
删除: flas
伞: gras
靴: bzut
矿物: mrim
休战: crus
鸭: hbok
规划: pfam
肥皂: hsuf
娃娃: gwak
骨架: klet
别墅: blis
针线活: jlin
调和: dyak
水壶: kset
成熟: mruc
兔子: kruc
导体: nwot
依赖: djat
播放机: jlic
昆虫: pset
餐厅: cret
猫头鹰: lwun
激进: djik
居民: zwin
龙: dron
听觉证据: drot
渴: kyos
萦绕: dren
计算: glun
规: ryim
市长: mlap
少数民族: mric
获得: dwon
老将: bren
乐队: ryes
熏肉: bjin
坏处: zwat
布: frap
音乐家: gzik
精神上: hnep
连词: nyon
不足: nrip
建筑师: tsek
柠檬: nyim
咳嗽: kcos
头痛: crek
承租人: ryet
生育能力: srun
愈合: hfoc
九十: nwon
随机: hbec
勺: kcek
气球: blon
粉笔: hfip
推理证据: nlet
出版者: pcot
醋: sruk
灰: fyec
脏话: slek
复活: nrut
易感: kfim
隧道: tfun
难题: hpef
机制: mwim
数学: gzit
褪色: frun
肝: jwin
至格外壳: bwik
蘸: dris
单元: twim
垄断: hnop
赌博: hgup
潜艇: bzin
地震: hbem
实验室: brot
软木: kruk
自控制: syot
佛: hbus
针织: bjat
大使馆: blas
最远: sres
陈述心情: drim
刺激物: tyuc
巧克力: clot
巧合: tyon
手套: gwat
下跪: hjek
地理: hjif
投资: nwes
口头: mrec
类比: nlip
世俗: srek
鹰: blap
心理学: nloc
系: gjan
废料: krep
角色: cyum
剂量: hdos
三文鱼: slom
布丁: pwun
磁性: gyik
泵: pcom
氧: ksip
证书: tfot
勋章: hmem
修辞: trok
刮: rwap
桨: dyas
望远镜: trip
项链: clek
拼字: prif
威士忌酒: hwos
柳: hwof
骆驼: hlum
业余: myet
出口: crec
传: brif
驴: gzac
每月一次: mwis
忽略: nruk
假期: byit
点击: lyik
椭圆: twon
弹: lyet
字典: kfon
火腿: gzam
彩虹: rwun
消耗: kcum
吐: tcup
坦克: trek
同事: clok
蝴蝶: trif
图表: graf
双: jwat
独立地: trem
竹: hbum
零售商: jlat
积累: kles
检查员: nyet
一口: hyos
恶梦: hbom
果酱: gjam
博物馆: mrem
字母: lwam
分散: zras
袭击: crip
透露: clus
腐烂: fraf
侵略性: gris
摩擦: mroc
码头: gyac
蜘蛛: brik
土豆: trut
调整: cwon
贪心: jlac
过早: ryot
乘: gzan
纺: pcip
统计: tsok
日历: klem
提名: nwen
兆: tlos
阁楼: tlok
肯定心情: rwim
应用: pfen
公称: nlon
不满: sraf
感染: hfok
投手: krot
耸: cyok
先锋: gzin
省略: nlif
卷心菜: glic
竞技: tlet
酒醉: mrut
idiophone: hdof
杠杆: lwek
参议员: syem
鸢尾花: nrif
蚂蚁: mwam
错误: hbop
孕: grim
沉淀: hjet
踝: tcok
分类: glik
变量: prim
包: ryap
卷曲: krec
硫: hsef
听写: dwik
出现: brun
青蛙: fram
过多外壳: twek
海绵: hjen
恼人的: djon
松鼠: slip
研磨: zyin
非现实心情: flim
火山: glam
在室内: gron
利用: kloc
地质: jlik
护照: psop
不道德: mlet
饼干: hbuk
合作: kros
片剂: tlot
松弛: kces
原子: trom
艾滋病: hzip
金字塔: psim
周期: swok
盹: hnup
非法的: hjaf
爪子: pfap
害羞: crom
蚀: klip
琵琶: lwap
扫帚: srum
面板: mwen
天文学: tcom
迷宫: blen
奖学金: bwit
龟: kfuc
顾问: dwak
纤维: fwic
蟋蟀: jrik
鸽子: ksom
适应: dyon
三角形: tfon
出纳员: tsen
氢: jron
脆弱: hfuk
打印机: pyet
呛: tcof
慢性: gzon
应付: slaf
困境: dlim
工程: jyin
相机: hkef
道歉: pluc
舔: lwet
舞蹈家: dret
迁移: mres
网球: tces
脊柱: clip
炒: zrac
织布机: tfuc
刺: twuc
密码: psaf
半球: praf
战略: zrit
石英: krus
剪刀: jris
巡逻: proc
冰川: lwic
半: dwam
备忘录: mwap
锥体: kwuc
对称: hzut
生产厂家: zrak
被告: fwik
清真寺: djis
棋: cres
收费: htof
樱桃: tref
广泛: kfen
绊倒: tfok
卡车: ryok
芥末: mros
百分: pfet
拍卖: jlam
筛: srif
不稳定: swoc
磁铁: gjat
吮吸: syus
伊斯兰教: slum
脚尖: twip
膜: mlen
刮胡子: clet
吉他: gjit
闪亮: bzan
榆树: hyem
翱翔: kcom
代词标记: ryec
钉书针: pcus
香料: zlat
保释: jlas
支架: zyac
振动: bron
逗: trus
犁: hlom
生理: zlik
排水沟: hgok
彗星: cyet
中世纪: dyic
麻雀: grec
补偿: twet
塑料: psuk
脚注: cyot
轨道: rwot
节俭: twum
高尔夫球: hgof
零: zrun
芯片: tcep
压迫: prok
打哈欠: gjac
不等式: gwas
痣: tloc
陶器: frik
家庭主妇: hgif
黑麦: rwem
违: hyes
宽容: glon
胎: brec
矿工: jren
鼓掌: zlac
酵母: lyim
额外费用: pfim
李子: plem
破产: byas
灌溉: rwif
薄荷: nyun
资本家: glis
弹性: hlef
鲨鱼: gyak
招: drut
存储: zren
现实主义: cles
姜: djic
救护车: blus
可比: kwip
钱包: bjap
鬼脸: glim
科学家: gyis
胆: grot
泰然处之: hwum
无线电: href
不相干: zlit
豆: bwam
非正式的: frim
孙女: gyut
异议: dloc
牛排: tfek
氮: zron
剃刀: hjut
对比: krom
宣传: pcoc
烟花: fris
流行的: pcop
脱衣服: crop
畦: cruc
有害: hzaf
犹太教: hjum
补充: pluk
透镜: lyes
pegative外壳: pwek
癌症: kfes
典当: pyek
讲师: zyat
泄漏: hzuk
修饰: krif
密度: djot
感应: dyis
嚼: htuf
贫嘴: bzit
龙虾: hgos
折扣: dyut
出租车: tsuk
等级制度: crem
玉: gyec
搞乱: glaf
蜥蜴: lyis
瀑布: crof
令人失望: djak
否决: frot
总统任期: ryip
买方: mrif
加仑: jlen
蚊子: mruk
偏差: dwen
搏斗: lyut
镶嵌: myok
插头: plok
蹲: pcuk
杂货: ksoc
共产: myos
惊奇: mwek
检举外壳: rwuk
星座: nlos
独裁者: dwit
当务之急: tyet
卫星: tlec
拖鞋: hlop
辅音: fyon
近似: tsif
失业的: byet
支持者: sros
莲花: lwot
生菜: sles
氯化物: lwok
菌: bwic
黏: pcek
零件: bwon
核心: klec
假装: bjak
字节: bzet
分泌: sruf
明确地: pres
重合: mloc
芭蕾舞: blet
尿: mrus
大蒜: lyun
过去: hguc
经济学: kcem
中产阶级: hdom
敏捷: gjic
钳: htef
洗衣店: lyoc
草莓: srem
城市的: pcos
阻碍: mlaf
笔记本: tfut
专辑: zlam
棒球: hbep
吸气: sluc
自助餐: hbuf
分词: rwip
车库: grek
诊断: djas
拐杖: ksuc
勒索: srom
注册: psuc
易溶: jlun
磷: psof
结构: rwut
胶: glum
论文: twes
工匠: clif
香蕉: bwas
公理: kyom
肋骨: psos
镍: nyek
圆周率: pyim
总线: bwos
审查: swes
导弹: mlus
香肠: slos
操作: nlut
番茄: tfet
加强: kfut
插座: syok
钾: tsom
取回: prup
虚拟: zwit
代数: gjas
牙医: dzit
光纤: pcok
让步: bzen
生物学: bwim
失业: byim
毛虫: krum
独奏: slof
浏览器: bjac
远程过去紧张: nyot
历史性紧张: crep
核: nluk
光谱: pyem
钠: syom
歇斯底里: syes
受托人: tyos
人质: byik
葫芦: gluk
皱纹: kwuk
透明度: tfif
穗: swip
优先: pcif
行人: dyen
无神论: tsem
监控: mwot
选民: nlec
失控: hkof
探测: grok
铂: plip
双重数: dlun
肺: pcep
超: syup
手推车: trop
本地: lyot
煽动: gzat
汽油: plif
肾: grif
抢劫: bzac
评定: dlen
砷: syek
蜗牛: nrok
蚱蜢: tsec
方程: fwen
社会主义的: swos
过滤: flot
感觉的证据心情: hxin
扩大: kyot
发射: mwet
皮带: pwet
普通话: drun
骑师: hjok
肺炎: hnof
团结: gret
合页: cyif
纵: nruc
股利: dwun
滑冰: hkep
指数: slop
失能: dlif
困扰: bwen
配股: pfun
摄影师: trof
三角洲: dlet
数字: djim
婊子: brut
眼皮: hyop
对角线: dyun
潜意识: byon
眉: bruc
喷嚏: pcec
欢闹的: dlis
印度教: nwum
难民: nyif
穿梭: cwot
蛋白: pwot
倾倒: hdop
提炼: flen
呕吐: hwom
基因: gyen
大一: hdem
社会学: syoc
壁球: kwoc
费舍尔: hfuc
区域性: jyen
运动上坡: hvok
回顾: hxik
龙卷风: gyon
逆温: nwos
电视: twif
立方体: kfet
生产率: pwuk
胡萝卜: krop
分子: mwuk
集团: glet
会计: ksum
黄瓜: kyok
狂欢: drok
溶剂: jlet
磷酸盐: psef
底漆: gwik
碱性: flis
体操: jyas
逗号: kwom
运动下坡: hvat
流产: jwac
荚: tcop
捐赠者: dzon
锰: hzem
心理学家: syos
氯: clos
键盘: kyoc
精英: zyit
插入语: pfaf
橄榄球: rwoc
溃疡: jlon
屈折: hxit
蚕食: nres
量子: fwam
毛线衣: swek
发展的: fwis
符号: nyoc
弹跳: tcuf
解剖: drec
高速缓存: kcep
线性: lyec
锑: trum
superessive外壳: psek
瘤: twom
侵蚀: cyos
α: flaf
脐: nwip
免疫的: myip
流感: flun
酿酒厂: bjit
简化: slef
删节: bram
凹痕: djen
着迷: dwim
胁迫: brok
袜子: bzas
电影: fyim
宇宙: klom
污染: hpuf
群居: gjen
阴茎: zyis
林业: lyif
铝: lwum
振荡: zlon
星座运势: ksop
喷射: dlek
包容: nluc
受益: byic
海豚: dlip
凶手: cyus
哺乳动物: myaf
指示符: swif
二氧化碳: dwis
结肠: zlen
官僚: brus
歪曲: jric
冰箱: frip
考古学的: cluk
不可接受: kwok
规范: pfis
传单: pfut
人类学: nlom
可口: kyec
及物: txit
退缩: kwus
向日葵: hzuc
虱: glus
离子: lyos
旅游: tyum
调制解调器: myom
促进: jrun
伪造: tsoc
排放: hmef
绑架: drap
交叠: hwep
理发师: pfes
民俗学: floc
毛细管: plek
民族主义: nlum
臀部: nros
主题: hmuf
升华: slem
挫折: xras
钴: kwos
燕麦: gwam
运动上游: trup
肛门: gyam
牛: bwun
翻动: flip
冗余: dzun
视频: hwop
抵制: bjik
测验: cwif
曲棍球: cwok
游击队: grip
镁: hgem
雷达: drek
黑猩猩: hzif
可靠性: kwif
矩形: tyec
海带: klep
概括: jlak
宵禁: kfec
同性: mlok
脚本: srop
公式: flus
投胎: nrom
点燃: zlak
铀: ryum
捕手: kwes
坐标: kyop
纳税人: nwaf
集成: trep
opined: hzap
伽马: hxam
野生动物园: fwim
运动下游: ht6n
系数: kfus
标题: zlic
分析人士: nles
将死: hzes
购物中心: hmof
铋: bzim
明信片: psok
收敛: bros
离题: djet
股东: ksem
微生物: mrip
生殖器: jwit
形态: mluk
公测: byot
牛仔裤: gjis
数据库: tles
计算器: klus
X-射线: ksef
解析: zram
环境的: zyen
西格玛: zyim
脱节: hxon
议程: gres
签证: bzis
基础设施: nyuk
萤火虫: gyun
探测器: tyek
自适应: dyip
生物学家: byis
拼接: pyec
溴: brom
钯: plum
嗝: kfok
柔和: psec
动物园: zwac
诊所: lyok
意义: nwoc
瑜伽: hjoc
书店: byun
治疗: grap
民族主义者: zlis
斩首: zlet
是啊: swec
问题: byam
爵士乐: dzas
钨: tsof
恐怖分子: gwis
运球: droc
代谢: tlem
赡养费: lyaf
周末: hfom
菊花: gzim
疫苗: byap
摩托车: tyok
口头禅: dyot
学期: myes
海洛因: gwon
夹: flap
阴极: kfoc
思想: dlec
停车: prek
THETA: fret
虎头蛇尾: hxis
硒: clem
循环: blek
皮层: pros
等价: swaf
当前关联标记: hxak
机场: cwoc
截肢: gyet
篮球: bwet
冒名顶替: mwip
蟑螂: tlek
铬: hgom
升: hl6t
尽管如此，: nwec
激素: cwom
有缺陷: tluc
穿孔: prec
万物有灵论: nyom
多边形: cloc
女权主义者: hfes
共轭: kcop
欧元: dros
参: hjes
算法: hlof
激光: lwes
药店: dlot
毫米: mlem
柔性: flek
阳极: nlok
细微之处: hzus
兼职: prem
灵敏度: nyec
示威者: drom
氦: clum
双语: dzic
首字母缩写: hqim
首字母缩略词: nl6m
动名词: gros
等离子体: psem
染色体: rwom
序数词: rwok
公里: klum
传真: tfes
遗传学: nwek
雀斑: frek
螺丝刀: dres
西兰花: blok
过去式: xrit
维他命: tyem
镉: kyem
轰炸机: bwoc
图形: gjik
钛: dyim
挥霍: clec
拉姆达: lwem
女朋友: pcem
媾: kyuk
滴漏: tlus
同情: mlif
硼: bres
直升机: cwet
碲: tlum
截止日期: jyic
对齐: gwic
厘米: hfem
钼: mlom
锂: tfim
多媒体: myum
更新: dyet
卡路里: clom
机器人: ryoc
功课: groc
对数: grom
螂: gzas
安装: nwut
氨基: myoc
字形: glif
不定过去: pyos
生态: plec
阅历: flok
大麻: bjam
微: mrom
公斤: lwom
吃得过多: jrot
预测: dzik
比萨: zyas
窃听: zris
语言学: bwis
理发: braf
铱: ryom
种族主义: gwim
最佳: gyim
工业化: drif
总部: krup
铈: zrim
全等: nrum
表分词外壳: pxik
暗盒: ksep
意志: blot
尺寸的: dzen
参数: rwet
同步: nrop
最大化: dzim
研讨会: mwec
迪斯科: dyok
氖: nyok
锇: hzom
顿悟: hp6n
抄袭: lyap
神器: rwek
反应堆: fyet
牛至: ryop
钚: pwum
钇: tyom
强化的: hxat
用户名: mrum
研究生: zrot
右翼: dwaf
氩: jros
恐怖症: hxot
周旋: sluk
全球化: bluc
波长: hnef
编码: kfom
回收: psoc
重新开始: nrek
肝炎: pyes
花托: fros
化疗: myep
模: mwok
质子: zwot
软盘: dwet
毫克: mlum
像素: psep
钽: twem
溶质: hjot
种族灭绝: nyos
捕食者: rwes
镓: glem
锆: hzum
确定: txin
非线性: nlem
农药: pyif
铍: brem
神经元: nrus
表语: pxit
内裤: tlif
阶乘: kref
中子: zrut
铌: nwom
锗: hjem
非金属: tlop
放上: dlap
prolative外壳: hl6k
生物多样性: jwic
操纵杆: jyok
抗生素: twok
锕: gjim
宇航员: srof
外星人: tyes
疯子: hwup
马拉松: mrof
镱: zwim
自闭症: tyif
电离: nlof
氡: cwos
夹竹桃: nrem
流行病学: pwip
老年: lyuc
露营: kyep
条纹: drip
铟: nyum
不虚伪: hvik
网站: bwes
可兰经: kwek
餐具: fwet
第n根: tfec
铹: lyem
公民权利: glip
移动电话: mlof
瘫: twoc
镤: prum
辐射: hd6n
依靠上: pxin
钍原子: hxim
蓝色牛仔: bjun
室内植物: hxas
逐个: dvit
流流: lwuk
三相点: ht6t
人体用: hn6n
物理: bzik
零售商店: hxan
铯: hs6m
长前: hqan
电子表格: hxet
单位质量的: hn6m
编: ml6n
二值: vrim
人的存在: nyus
通过手段的: hvan
depandari: pxat
镨: pyom
纸板: kxat
有限动词: hqik
审讯数: hr6n
亲句子: hr6t
评论家: hk6k
包装: pxas
无常: pxan
在最: txas
描述符: drop
钕: nyem
友谊: hvit
读只要: xyak
创立: xwan
格言心情: kxin
音素: hxom
理性: xlit
音韵: xlin
用餐房间: hxac
活的房间: hxic
中心外壳: zrik
预hodiernal: hx6n
患者外壳: hqak
斜外壳: bwok
乡村区: hqat
递归: hr6s
中间语音: dyos
䥑: hm6m
邮递员: hvak
不置可否: kxit
股票市场: xrak
识别: hxap
目标触发: krof
一秒: hxen
lative外壳: dvak
配给: hr6c
非人的: hg6n
活的事情: hvic
太小: hxut
电影院: hvin
𨭆: xyim
衰减性: ty6t
multal数: ml6m
乳白色办法: txam
镎: nwem
代笔: txik
反式数字: ts6s
傻瓜左右: hqun
銤: myem
早上荣耀: txan
消防队员: xran
锫: blem
星系性别: kxan
锘: blum
再见: hvac
佛教: hfum
镄: frem
青色: xyan
黄豆: syof
经销商: qrit
罢工破坏者: txak
处理器: ples
abessive外壳: bvak
adessive外壳: dvik
至外壳: kxak
施事外壳: dvek
rutherfordium: hr6m
抗体: txip
如许多如: hjos
代理人触发: hg6t
演员角色: xram
溴化乙锭: txim
共同性别: hk6n
accompanier: kl6n
红花: kxam
钫: fyam
铒: ry6m
被动语音: xyis
砹: hqit
咀嚼胶: hqam
星性别: hqin
引用形成: ht6m
锔: jrim
漫画条: kxis
色盲: hqon
euler's号码: hl6m
看在: kxas
人行横道: pwok
战场: txat
司机: vrit
短路: txok
口头名词: hvis
哭出: hk6t
统计学: xyit
酸奶: txot
氙: hs6n
催眠: hxif
采取离: hxaf
从句尾: hxok
直接目的: dwot
杂货商店: kxun
由的: hm6t
作格外壳: gvik
在语言: txic
第一手: pxam
方位外壳: hqok
游泳池: slup
状语外壳: vlak
观光: hqas
电视组: ht6s
最终粒子: xlik
evitative外壳: hvek
复原: xlat
回归: xris
块的公寓: kxot
唤醒向上: hxup
警察官: ps6s
发誓式: vran
访问者: qrat
铼: ryem
气雾剂: xres
所有格案件: kxik
名词: mlec
附身案件: dzak
过度充电: pxak
辅动词: xyik
主目的: mlut
计算机病毒: prus
商务人士: hqis
一个人: hqen
antessive外壳: ts6k
总理: pxis
镏: lyum
铕: rwum
表现感情: xrot
民间音乐: zyik
诗人: vwit
邮政局: pxot
按说: hvas
赋予生命性别: hven
subessive外壳: bvik
油门踏板: glep
极性: pr6t
车辆性别: vlin
矿物性别: xrin
动词后缀: hvif
多情: pc6n
钐: sr6m
主持人: hs6t
虚数单位: xyin
光速: kxac
空军: hxes
移情喜悦: pfec
临界点: qyit
全职: hxem
铪: xyam
抑制: hn6s
更改的事件: qrin
钬: xlim
不同事件: hf6t
宇宙性别: hvip
局部性性别: kxen
虚拟机: hvim
研究性别: txen
艺术的性别: ts6n
crastinal紧张: sl6t
抽象性别: srep
exocentric外壳: zrek
及物动词: txif
词素: tfom
沙文主义: dvis
过去完成式: xrat
专业: hy6n
间接言语: tyoc
第二语言: draf
至是: txis
墓地转移: vrak
集体名词: hxos
absolutive外壳: bvuk
患者触发: tr6t
自置信度: hs6s
屎: hzos
反思语音: hf6s
非人的动词: hxek
seaborgium: br6m
空白: hxep
语气外壳: dlok
老成性别: hj6n
致病: qran
propositive心情: psom
电动当前: tr6n
联想外壳: nwok
最高级外壳: tluk
太许多: xyut
行星性别: pxen
动画动画片: nwuk
倒数语音: vrik
立法: hqaf
在最小: vlas
语法情况: qrak
用户: pxut
核心benefactive: kfef
守门员: hgop
:ExceptAs Buddha: kcef
分母: dvan
否则，如果: lyek
侧身: hx6s
彼此: dles
连续条款: lyuk
磨损: hxun
短裤: ht6k
镝: prom
不久未来紧张: rwec
SI单位: vyin
氪: kxon
钔: dlem
合用的语音: hp6s
antipassive语音: tsef
接续方面: ht6p
辐射病: hr6k
necessitative心情: hn6t
单行动动词: hqek
轨道车: xlak
最高级度: tlup
存在条款: hs6k
锎: kf6n
当下分词: vrat
发光的强度: hc6t
singulative数: slus
语法对象: hy6t
被动分词: vris
过多为期: kxic
超临界流体: sr6t
量的物质: ks6t
后置外壳: pxok
选修量词: lwif
钆: dl6n
epenthetic词素: hp6m
否定性量词: nwif
锿: ny6n
人造语言: txac
结缔组织粒子: qrik
远程未来紧张: twec
重复型成对方面: hfep
分配的代词: bvin
训示协议: hk6m
秃: blos
市郊: syum
普遍量词: vlit
计算机程序设计: mr6m
电视程序: tr6m
浮点数: hvun
存在量词: tl6t
该日后 明天: dwek
替代量词: lw6t
易怒的: hdup
过去被动分词: hp6t
该日之前 昨天: txet
方位定向外壳: tc6k
反有条件的: ht6c
