infinitive: it:, infinite, it:, infinity, he:, origin, he:, source
nominative-case: te:, prepositional-case
accusative-case: 
topic-case: hi:, subject-case
parent: tr:, parental, pt:, major, fi:, senior, mr:, spinach
dad: hi:, father
mom: zh:, mum, sw:, mother, tr:, maternal
hello: hi:, bye, hi:, hi, de:, hey
ancestor: hi:, predecessor, sw:, grandfather
grandparent: ar:, grandfather, pt:, grandmother
hungry: zh:, hunger, hi:, starve
genitive-case: zh:, postessive-case
adjective: 
and: zh:, sum, sw:, by, jv:, an
me: zh:, myself, ar:, i, id:, my, sr:, we, te:, lick
you: de:, them, sv:, thee, ar:, thou, ko:, ya
us: zh:, we, ar:, our, ar:, ours
it: ar:, he, tr:, that, tr:, she, fr:, this, lt:, these, te:, which
destination-case: id:, objective-case
dative-case: 
realis-mood: 
deontic-mood: 
conditional-mood: ar:, subjunctive-mood, el:, hypothetical-mood
epistemic-mood: 
instrumental-case: 
interior-context: 
person-context: 
dependent-clause: 
perfective-aspect: 
past-tense: 
masculine-gender: ta:, neuter-gender
comitative-case: 
present-tense: 
benefactive-case: 
essive-case: 
not: hi:, no, de:, non, id:, hardly, id:, unable, fr:, pitch, bn:, never, bn:, nor, bn:, none, pa:, rather, pa:, neither, te:, cannot, mr:, miss
its: zh:, their, de:, his, id:, her, ru:, him, fa:, those, it:, hers, el:, of, ja:, whose, jv:, independent
surface-context: 
adpositional-case: 
location-case: 
space-context: 
way-case: 
interrogative-mood: 
and-or: 
exclusive-or: 
source-case: 
ablative-case: 
demonstrative: hi:, solid, hi:, substantial, hi:, concrete, hi:, cogent, vi:, directive, fa:, dramatic, pa:, express, pa:, apparent, pa:, articulate
but: sw:, yet, ar:, however, pa:, though, pa:, although, pa:, nevertheless
all: de:, everyone, sv:, everybody, vi:, total, tr:, entire, tr:, overall, ru:, whole, ru:, everything, fi:, any, sr:, increasingly, jv:, altogether
feminine-gender: 
they: zh:, them, de:, she, sv:, those, id:, their, id:, theirs, vi:, surname, el:, these, jv:, same, jv:, fair, jv:, similar, mr:, to
plural-number: 
one: hi:, single, de:, a, ta:, into, lt:, alone, pa:, an, jv:, turn, ko:, however
who: zh:, somebody, zh:, whoever, hi:, which, sw:, whose, sv:, as, id:, whom, lt:, anything, lt:, anybody, jv:, that, jv:, their, jv:, those, jv:, sing, mr:, ya
future-tense: 
social-context: 
when: lt:, whenever, mr:, ever
imperfective-aspect: 
there: jv:, exist, jv:, thursday
more: sw:, over, sw:, most, sw:, further, sw:, beyond, sw:, upward, sw:, upwards, de:, multi, vi:, than, vi:, rather, ta:, also, ta:, moreover, fr:, plus, pl:, still, pl:, yet, pl:, else, sr:, several, sr:, multiple, pa:, other, pa:, otherwise, jv:, another, jv:, rest
out: hi:, outside, sw:, outer, sw:, external, sw:, outdoor, sw:, outdoors, de:, off, ar:, outside-of, vi:, beyond, it:, up, it:, upon, it:, onto, pa:, forth, jv:, quit, jv:, exit
elative-case: zh:, inelative-case
illative-case: 
do: sw:, make, sw:, perform, sw:, undertake, de:, render, ar:, activate, id:, did, id:, commit, bn:, put, pa:, what, pa:, react, jv:, anything, jv:, whether, jv:, whatever, jv:, working
directive-mood: zh:, indicative-mood
question-word: 
copula: hi:, connector, tr:, bond, ru:, bunch, mr:, link
person: zh:, man, zh:, people, hi:, individual, sw:, somebody, sw:, someone, ar:, guy, ru:, human, el:, face, ja:, personality, jv:, him, jv:, them, jv:, personally, jv:, pedestrian, ko:, fellow
male: de:, masculine-, ar:, mention, id:, gentleman, ta:, man, jv:, gentle, te:, female
could: id:, can, vi:, might, vi:, possibly, tr:, maybe, ja:, possibility, ja:, likelihood, jv:, may, jv:, possible, jv:, able
number: id:, amount, id:, sum, vi:, figure, ta:, numerical, ta:, numeral, fi:, quantity, jv:, numbers
very: zh:, greatly, zh:, extremely, zh:, awfully, hi:, much, hi:, too, hi:, terribly, sw:, widely, ar:, highly, id:, really, id:, badly, id:, tremendous, id:, considerably, tr:, lot, tr:, multi, tr:, enormously, ta:, most, ta:, quite, ta:, fairly, fa:, far, fa:, pretty, cy:, ok, cy:, okay, cy:, all-right, pa:, extreme, pa:, sore, pa:, abundant, pa:, unusually, he:, incredibly, jv:, excellent, jv:, weak, jv:, strongly, jv:, sharply
time: sw:, while, sw:, moment, sw:, during, sw:, timely, vi:, duration, vi:, temporal, fa:, tense, it:, timetable, fi:, period, sr:, weather, pa:, repeating, ja:, hour, ko:, sight
time-context: 
temporal-case: 
about: zh:, regarding, id:, concerning, ru:, nearly, ru:, circa, it:, of, it:, by, it:, than, fi:, around, el:, for, lt:, on, bn:, almost, ja:, approximately, jv:, thing, jv:, respect, jv:, chapter, ko:, drug
literal: cy:, literally, pa:, real, pa:, original, pa:, absolute, he:, verbal, te:, literary, ko:, exact, ko:, accurate, ko:, precise
only: hi:, just, hi:, merely, hi:, simply, vi:, point, vi:, mere, tr:, purely, lt:, confined, pa:, barely, ko:, bay, mr:, alone, mr:, bare
little: zh:, small, zh:, tiny, hi:, slight, hi:, slightly, id:, bit, tr:, minor, tr:, petty, ta:, diminutive, ta:, portable, cy:, few, pa:, lightly, te:, short
then: hi:, again, hi:, ya, sv:, since, sv:, ago, sv:, sedan, id:, later, id:, afterward, pa:, nonetheless, he:, afterwards, he:, subsequent, ja:, subsequently, mr:, after
hortative-mood: 
retrospective-aspect: 
great: zh:, large, zh:, big, hi:, noble, sw:, serious, sw:, vast, sw:, loud, sw:, enormous, sw:, giant, sw:, tremendous, sw:, dominant, sv:, good, sv:, fine, id:, considerable, id:, huge, id:, substantial, tr:, wonderful, fa:, excellent, pt:, optimum, fi:, grand, cy:, major, lt:, perfect, lt:, remarkable, lt:, brilliant, jv:, trunk, jv:, macro
volitive-mood: 
before: sw:, prior, sw:, pre, tr:, ago, tr:, precede, ru:, until, ru:, till, ta:, front, fi:, formerly, lt:, against, lt:, versus, pa:, forward, pa:, advance, pa:, farther, pa:, ahead, ja:, previous, jv:, previously
must: hi:, should, sw:, necessarily, sw:, unnecessary, sv:, have-to, vi:, need, ru:, shall, ru:, ought-to, ta:, want, he:, ought
two: sw:, dual, ta:, both, jv:, apart, ko:, couple
see: hi:, look, sv:, view, id:, sight, id:, notice, id:, perceive, ta:, watch, jv:, gaze, te:, refer, ko:, meet
know: sw:, ascertain, ar:, aware, ar:, teach, ar:, flag, ta:, visible, jv:, understand
down: zh:, downward, zh:, downwards, hi:, under, hi:, below, hi:, beneath, hi:, underneath, sw:, less, sw:, bottom, tr:, inferior, ta:, downstairs
first: sw:, debut, tr:, initial, ta:, since, ta:, onwards, pa:, firstly, jv:, initially
own: sw:, himself, sw:, yourself, de:, possess, id:, personally, fa:, his, fa:, itself, fa:, self, ko:, personal
alienable-possession: 
inalienable-possession: 
old: zh:, used, de:, ancient, de:, aged, id:, elderly, tr:, former, tr:, ex, cy:, age, pa:, prior, pa:, predecessor
deliberative-mood: 
day: sw:, daily, bn:, let, ko:, working, ko:, affair, ko:, job
where: zh:, wherever, sw:, whereby, cy:, place
come: vi:, to, vi:, till, vi:, reach, vi:, arrival, vi:, arrive, fi:, become, sr:, occur
way: zh:, method, zh:, methodology, hi:, walkway, sw:, means, sw:, path, sw:, route, sw:, tract, sw:, pathway, de:, trail, sv:, manner, ar:, road, vi:, street, vi:, sugar, fa:, track, fa:, trajectory, fi:, habit, ko:, how, ko:, process, ko:, mode, mr:, creed
work: zh:, job, hi:, assignment, sw:, active, sw:, task, sw:, labor, sw:, labour, sw:, career, sw:, function, sw:, operate, sw:, functional, ar:, business, ar:, act, id:, work-out, tr:, employment, tr:, occupational, ta:, working, fr:, artwork
vowel: tr:, famous, ta:, life, ta:, survival, he:, movement, he:, motion, he:, traffic, jv:, alphabet, te:, mold
go: sv:, walk, fr:, fare, it:, depart, pa:, departure, jv:, migrate
perlative-case: 
progressive-aspect: 
long: sw:, prolonged, sw:, durable, sv:, tall, it:, along, te:, period, te:, era, te:, tense, mr:, away, mr:, portray
say: zh:, spoken, hi:, tell, sw:, speak, ko:, represent, ko:, relate, mr:, called
even: hi:, also, hi:, either, ar:, until, ar:, till, id:, moreover, vi:, too, pa:, likewise, ja:, further, ja:, furthermore, te:, itself
back: sw:, behind, sw:, rear, sw:, backwards, sw:, backward, id:, return, tr:, restore, tr:, undo, ta:, again, ta:, repeat, cy:, ago, cy:, according-to, pa:, withdraw, te:, recover, te:, retrieve
here: mr:, at
think: hi:, thinking, vi:, thought, tr:, consider, tr:, imagine, tr:, conceive, tr:, meditate, ta:, would, ta:, called, cy:, mind, bn:, feel, bn:, seem, pa:, indicate, mr:, consideration
every: zh:, everything, sw:, each, fa:, any, fi:, which, bn:, towards, bn:, per, pa:, everybody, pa:, denominator, he:, whole, jv:, average
last: sw:, end, sw:, latter, sw:, final, sw:, ultimate, ar:, another, ar:, else, ar:, latest, tr:, recent, tr:, ending, ta:, past, fi:, endure, pl:, persist, pa:, previous, jv:, late
under-context: 
take: zh:, resort, sw:, occupy, id:, fetch, id:, adopt, id:, grab, tr:, get, tr:, receive, tr:, pick, fa:, catch, fa:, capture, lt:, charge, bn:, accept, pa:, bring, pa:, carry, jv:, shoot, mr:, apply, mr:, assign, mr:, applied
found: zh:, find, zh:, discover, zh:, discovery, zh:, detection, sw:, accessible, bn:, get, jv:, meet
hand: sw:, arm, sw:, wrist, jv:, arms
young: sw:, youth, id:, junior, tr:, adolescent, tr:, teenager, el:, new
give: hi:, lend, sw:, provide, sw:, offer, sw:, providing, sw:, deliver, id:, render, fi:, afford, cy:, put, cy:, donate, pl:, let, pa:, grant, jv:, award, ko:, periodic, ko:, cycle, mr:, admit, mr:, owe
god: ja:, divine
delative-case: 
nothing: sw:, something, sw:, object, id:, no-one, ta:, anything, fi:, none, lt:, nobody, pa:, some, pa:, few, pa:, certain, pa:, somewhat
right: zh:, pair, hi:, correct, hi:, accurately, sw:, fair, sw:, justice, sw:, justified, sw:, unfair, sw:, eligible, sw:, entitlement, de:, law, ru:, correctly, fa:, true, pt:, certain, pt:, sure, cy:, entitle, pl:, well, jv:, across, mr:, due, mr:, proper, mr:, properly, mr:, suitable, mr:, appropriate
once: sw:, immediately, sw:, promptly, ta:, method, ta:, pattern, ta:, methodology
semelfactive-aspect: 
left: ta:, away, ta:, leave, pa:, skip
part: zh:, section, zh:, partially, sw:, portion, sw:, partly, sw:, parcel, sw:, fraction, sw:, segment, sv:, share, ar:, bit, id:, piece, id:, passage, id:, subset, tr:, chapter, tr:, department, tr:, episode, ta:, partial, fa:, division, fa:, ward, fa:, sector, fi:, proportion, cy:, behalf, pa:, participate, mr:, quantum
house: hi:, home, hi:, premises, sw:, temple, sw:, housing, tr:, household
world: id:, realm, ta:, global, fa:, universe
head: sw:, title, sv:, main, id:, chief, ru:, chapter, ta:, leader, ta:, president, ta:, chairperson, fr:, director, it:, boss, cy:, pen, jv:, headache, ko:, hair
three: sw:, third, pa:, ninth, ko:, tax
focus: sw:, intended, sw:, aim, sw:, goal, sw:, objective, ar:, concentrate, ta:, attention, fa:, concentration, pl:, converge, te:, vision
love: sw:, affection, sw:, charity, fr:, like, jv:, crush
always: hi:, forever, id:, constantly, ta:, ever
night: id:, evening, ta:, dinner, ta:, p.m., pa:, tonight
king: ar:, reign, id:, lord, id:, monarch, id:, tycoon, mr:, prince
between: id:, among, id:, amongst, tr:, of, bn:, in, bn:, into, bn:, within, te:, middle, te:, mid, mr:, during
heart: sw:, cheer, sw:, encouraging, ar:, topple, mr:, coronary
paucal-number: 
because: ar:, due, fi:, since, cy:, case, cy:, cause, bn:, reason
causal-case: 
name: sw:, surname, tr:, noun, mr:, craft
proper-noun: 
country: zh:, nation, sw:, land, sw:, earth, id:, state, fi:, ground, sr:, soil, lt:, party, pa:, countryside
asked: jv:, ask, jv:, consult, te:, urge, ko:, questions
visible-evidential: 
better: hi:, superior, sw:, best, sw:, excellent, sw:, ideal, sw:, outstanding, jv:, further, jv:, farther, te:, good
side: zh:, lateral, hi:, favour, hi:, favor, hi:, behalf, sw:, turn, de:, page, ar:, aspect, fi:, half, fi:, facet, te:, towards, mr:, beside, mr:, aside
course: zh:, curriculum, ar:, lesson, id:, lecture, ta:, certainly, ta:, surely, ta:, definitely, lt:, rate, bn:, path, jv:, confident
enough: hi:, sufficient, hi:, sufficiently, hi:, adequate, sw:, ample, id:, fairly, id:, plenty, id:, insufficient, fr:, quite, fr:, pretty, pa:, considerable, pa:, considerably, pa:, substantial, pa:, significantly, pa:, substantially, jv:, reasonable, te:, put, ko:, fully
soon: zh:, shortly, hi:, quick, hi:, prompt, sw:, quickly, sw:, fast, sw:, immediate, sw:, rapid, sw:, hurry, sw:, urgent, ar:, so, id:, immediately, id:, readily, tr:, nearby, it:, early, lt:, snap
full: zh:, fully, zh:, sufficiently, hi:, absolute, sw:, complete, sw:, imperfect, ar:, whole, tr:, exactly, tr:, exact, tr:, utter, tr:, precisely, tr:, thorough, ta:, entire, fr:, comprehensive, fi:, size, pa:, entirely, pa:, completely, pa:, totally, te:, finished, mr:, accomplished, mr:, accomplish, mr:, implicit, mr:, fulfill, mr:, cater
room: zh:, chamber, pt:, fourth, pt:, bedroom, pl:, peace, jv:, compartment, te:, cellar, mr:, depth
water: sw:, liquid, sw:, fluid, sw:, watershed
desiderative-mood: 
light: sw:, glow, sv:, bright, sv:, candle, vi:, slight, fa:, style, fa:, lightly, cy:, pale, pl:, clear, he:, daylight, jv:, exposure
word: ta:, lexical, bn:, sound, ja:, vocabulary, jv:, phrase, jv:, verb, jv:, noun, jv:, wording, te:, term
door: zh:, gate, hi:, doorway, sw:, entrance, ar:, chapter, pt:, port, ko:, portal
use: hi:, utilize, sw:, usage, sw:, consumption, sw:, expenditure, sw:, consumer, id:, engage, ta:, application, ta:, utility, fi:, apply, fi:, employ, mr:, consume
morning: hi:, a.m., ta:, breakfast
terminative-case: 
power: hi:, strength, hi:, energy, sw:, might, sw:, strong, sw:, force, sw:, powerful, sw:, dynamic, ar:, salad, id:, dominance, el:, authority
themselves: sw:, ourselves, de:, yourself, id:, himself, id:, myself, id:, herself, id:, itself, id:, self, id:, ego, jv:, alone
voice: sw:, sound, sw:, aloud, id:, ballot, tr:, audio, ru:, vote, it:, item, it:, rumour, it:, rumor, mr:, noise
white: fr:, blank, cy:, complaint
money: hi:, wealth, sw:, silver, sw:, financial, sw:, cash, sw:, currency, sw:, finance, sw:, monetary
next: vi:, beside, vi:, alongside, vi:, next-to, ru:, following, fa:, later, fa:, dimension, fa:, onwards, sr:, subsequent, te:, after, te:, afterwards, te:, subsequently, te:, afterward, mr:, forth, mr:, forward, mr:, farther, mr:, ahead, mr:, proceed
poor: de:, arm, vi:, poverty, fi:, bad, sr:, weak
death: zh:, mortality, hi:, dying, sv:, dead
form: de:, shape, de:, mold, ar:, format, fi:, contour, sr:, pattern, pa:, farm, ja:, shaped, ko:, morphology
inessive-case: 
together: hi:, simultaneously, sw:, along, sw:, joint, sw:, collective, fr:, set, te:, alongside, te:, conjunction, mr:, combine
matter: hi:, case, hi:, affair, sw:, thing, sw:, phenomenon, id:, problem, fa:, material, fa:, substance, pt:, subject, cy:, issue, lt:, question, te:, stuff, te:, topic, mr:, interestingly
often: zh:, frequently, zh:, constantly, zh:, regularly, id:, frequent, vi:, commonly, vi:, normally, vi:, typically
friend: hi:, ally, de:, boyfriend, vi:, fellow, cy:, mate, he:, associate
order: hi:, system, hi:, arrangement, hi:, arrange, de:, contract, pt:, array, cy:, command, sr:, turn, sr:, row, sr:, queue, pa:, sequence, pa:, sequential, he:, invite, jv:, so, jv:, let, jv:, avoid, ko:, spell
imperative-mood: 
round: id:, rounded, sr:, circle, sr:, lap, mr:, sphere
keep: zh:, hold, zh:, maintain, hi:, lay, sw:, put, sw:, set, sw:, paste, de:, retain, id:, guard, tr:, engage, fi:, like, el:, preservation, el:, conservation, cy:, preserve, cy:, detain, cy:, adhere, jv:, stay, jv:, remain, jv:, fixed, ko:, maintenance
wife: sw:, spouse, fa:, female
believe: zh:, trust, hi:, reckon, hi:, presume, sv:, faith, sv:, belief, ta:, confidence, ta:, confident, ta:, optimism, ta:, optimistic, mr:, dependence
near: hi:, pass, hi:, beside, sw:, almost, sw:, around, sw:, close, sw:, nearly, sw:, adjacent, sw:, virtually, sw:, nearby, vi:, proximal, it:, neighbour, it:, neighbor
public: ta:, general, fr:, audience, jv:, common, jv:, commonly
state-context: 
son: tr:, swarm, fi:, boy
hundred: sw:, hundredth, tr:, face, fr:, cent, he:, century
children: zh:, kid, sw:, offspring, sv:, child, sv:, baby
thus: zh:, thereby, sw:, so, sw:, hence, sr:, such, lt:, yes, pa:, therefore
hope: zh:, wish, hi:, prospect, hi:, anticipate, sw:, optimism, sw:, optimistic, pa:, expected, pa:, expect, ko:, expectation
above: hi:, up, hi:, over, hi:, upstairs, sw:, high, sw:, top, sw:, advanced, sw:, upper, de:, across, de:, concerning, de:, via, id:, upon, id:, overhead, id:, onto, ta:, ahead
dear: tr:, lover, it:, expensive
read: hi:, reading, fa:, sing, fr:, lily, jv:, reader
city: hi:, town, id:, municipal, fa:, county, jv:, urban
already: sw:, ready, sw:, prepared, sw:, willing, tr:, anyway, jv:, pre
fact: sw:, truth, sw:, reality, sw:, truthfulness, tr:, true, tr:, real, tr:, actual, ta:, indeed, ta:, really, ta:, actually, fr:, did
factive-evidential: 
girl: sw:, maid, vi:, daughter, ta:, female, ta:, lady, sr:, girlfriend, pa:, alone
hear: zh:, listen, sw:, hearing, it:, feel
least: zh:, minimal, hi:, minimum, hi:, minimize, fr:, minus, lt:, less, ja:, lowest, jv:, most, jv:, best, jv:, highest, jv:, optimum
perhaps: hi:, probably, hi:, maybe, sw:, presumably, ar:, might, ar:, possibly, id:, possible, id:, likely, id:, probable, pa:, supposedly
open: sw:, clear, sw:, plain, sw:, clearly, sw:, bare, sw:, obviously, sw:, vacant, sw:, explicit, tr:, obvious, tr:, outdoor, tr:, deficit, cy:, openly, cy:, expose, jv:, load, jv:, reveal
body: sw:, flesh, sw:, bodily, ta:, physical, ta:, physically, it:, corpus, fi:, organ, cy:, corpse
air: hi:, wind, hi:, breeze, vi:, aviation, tr:, weather, lt:, airline, pa:, flight
nature: sw:, natural, sw:, native, sw:, naturally, sw:, origin, sw:, descent, sw:, indigenous, it:, wildlife, lt:, character
help: sw:, assist, sw:, helpful, de:, aid, de:, assistance, ta:, assistant, lt:, lay, mr:, relief
letter: sv:, mail, sv:, letterhead, ru:, writing
four: sw:, fourth
optative-mood: tr:, subjunctive-mood
fire: sw:, hot, sw:, flame, tr:, fever, jv:, fireplace, ko:, buddha
free: zh:, liberty, zh:, freedom, hi:, exempt, hi:, gratis, sw:, vain, de:, freely, de:, vacant, ru:, loosely, fa:, release
war: sw:, battle, tr:, struggle, bn:, fight, pa:, battlefield, jv:, wrestle
second: sv:, other, id:, both, it:, according-to, fi:, another, pa:, secondly
united: sw:, singular, sw:, unity, sw:, inclusive, id:, union, fa:, allied, fa:, ally, sr:, unique, lt:, unanimous, pa:, joint, pa:, composite, ko:, coalition, ko:, federation
call: ru:, challenge, fa:, oxidize, fr:, appeal, pt:, on, pl:, connection, pl:, combination, pl:, joint, pl:, fusion, sr:, invitation, pa:, lifetime, he:, conversation, jv:, phone
why: pa:, similar, pa:, similarly
lost: tr:, loss, jv:, lose, jv:, missing, jv:, disappear
thousand: sw:, thousandth, ko:, clothes, ko:, cloth
family: zh:, household, fi:, survivor
soul: hi:, spirit, fa:, ghost, fi:, mastermind
care: zh:, concerned, zh:, concern, hi:, attention, hi:, meditation, sw:, service, ar:, sponsorship, ta:, guard, ta:, safety, ta:, protection, ta:, security, ta:, defense, ta:, preservation, ta:, conservation, ta:, coverage, ta:, defence, pt:, caution, it:, cure, fi:, treatment, pl:, custody, mr:, worry, mr:, worried, mr:, worrying
mean: zh:, imply, sw:, sense, sw:, meaning, sw:, meaningful, fi:, denote, el:, middle, el:, agent, lt:, medium, lt:, average, lt:, moderate, jv:, essentially, te:, understand
different: zh:, distinct, zh:, differ, hi:, various, hi:, varied, hi:, multiple, sw:, difference, sw:, separate, sw:, variation, sw:, separately, sw:, variability, sw:, differential, ar:, unlike, ar:, variant, id:, vary, id:, diverse, vi:, other, vi:, else, ru:, another, bn:, several, jv:, differently, te:, variety
potential-mood: 
allative-case: 
anthropic-gender: 
five: sw:, fifth, vi:, year, ta:, for
live: zh:, life, sw:, survive, sw:, behave, de:, living, sv:, nest, ar:, district, ar:, neighborhood, ar:, neighbourhood, id:, alive, vi:, lively, vi:, raw, pa:, straight, pa:, straightforward, jv:, inhabitant, te:, direct
different-subject: 
answer: hi:, north, hi:, reply, sv:, response, cy:, solution, pl:, correspond, pl:, respond, mr:, northern, mr:, replication
sea: sw:, ocean, id:, marine, ta:, seafood
fear: zh:, dread, sw:, afraid, sw:, terror, sw:, awe, sw:, scared, sw:, panic, de:, anxiety, de:, angst, tr:, horror, el:, scare, jv:, frightened, te:, phobia
hard: hi:, difficult, sw:, stiff, sw:, complicated, de:, harsh, id:, loud, id:, violently, tr:, fierce, tr:, tough, fa:, strict, fr:, challenging, it:, tricky, bn:, solid, ko:, tight
terms: zh:, term, zh:, terminology, sw:, issue, ta:, based, ta:, grounds, ta:, basis, ta:, essentially, ta:, fundamentally, ta:, basically, pa:, property
doubt: zh:, suspicion, zh:, distrust, id:, hesitation, vi:, suspect, he:, supplier
dubitative-mood: 
black: te:, block
beautiful: sw:, good, sw:, nice, de:, lovely, de:, beautifully, de:, nicely, ar:, pretty, id:, fancy, tr:, cool, ta:, cute
dark: vi:, gloom, pa:, darkness
sort: zh:, classification, zh:, classify, zh:, classifier, hi:, kind, sw:, species, sw:, variety, el:, item
ten: zh:, decade, sw:, tenth, cy:, fair
show: zh:, display, hi:, perform, hi:, performance, hi:, demonstration, hi:, presentation, id:, indicate, id:, denote, ta:, event, el:, projection, he:, exhibit, jv:, art, jv:, image, jv:, sketch, jv:, screenshot
story: sw:, myth, de:, history, sv:, narrative, fa:, fiction, pl:, plot, pa:, tale, ko:, talk, ko:, topic
book: sw:, scroll, sv:, reserve, fr:, pound, el:, textbook
electronic: zh:, electronics, zh:, electron, sw:, lightning, sw:, electric, sw:, electricity, sw:, electrical, sw:, electrician, he:, email, ko:, former
account: hi:, reason, hi:, cause, ar:, calculate, ar:, computation, tr:, calculus, pt:, bill, el:, calculation, cy:, count, cy:, reckon, he:, arithmetic
mark: zh:, marker, hi:, trace, hi:, trail, sw:, score, sw:, logo, sv:, highlight, ar:, tick, id:, tag, tr:, sign, tr:, signal, tr:, indication, tr:, cue, pt:, brand, fi:, character, sr:, label, bn:, impression, pa:, symbolic, jv:, alert, mr:, symbol, mr:, icon
interest: id:, flower, ta:, interested, fa:, concern
write: hi:, compose, sw:, writing, ar:, type, fr:, written, jv:, stationary
bed: 
necessary: zh:, essential, sw:, important, sw:, useful, sw:, critical, sw:, vital, sw:, significant, sw:, unimportant, sw:, integral, sw:, crucial, sw:, importantly, id:, need, id:, necessarily, fa:, intransitive, fa:, ditransitive, fa:, detransitive, pa:, urgent, pa:, sticky, ja:, necessity, te:, required, te:, require
idea: hi:, thought, hi:, consideration, vi:, opinion, cy:, notion, sr:, brainstorm, ko:, thinking, mr:, imagine, mr:, imagination
vialis-case: 
brother: hi:, sibling, id:, sister, he:, fireplace, ko:, colleague
sometimes: hi:, seldom, hi:, occasionally, sw:, sometime
line: zh:, wire, zh:, thread, sw:, row, sw:, lane, de:, conduction, id:, dash, id:, stripe, ta:, tax, fa:, script, pa:, lines, pa:, headline
table: vi:, desk, ta:, schedule, ta:, catalogue, ta:, catalog
river: sw:, pillow, sw:, cushion, de:, flux
eye: ar:, appoint, sr:, around, ko:, snow
information: zh:, message, sw:, explanation, sw:, description, vi:, bulletin, tr:, knowledge, fi:, data, jv:, rank, mr:, inform
suddenly: zh:, sudden, pa:, unexpected
strange: zh:, strangely, zh:, surprising, zh:, oddly, hi:, odd, sw:, wonder, sw:, wonderful, sw:, remarkable, sw:, extraordinary, sw:, incredible, sw:, amazing, sw:, bizarre, de:, funny, ar:, stranger, ar:, exotic, tr:, awkward, pa:, unusual, ja:, weird, jv:, mysterious, ko:, curious
deep: zh:, deeply, sw:, depth, sw:, extensive, sw:, shallow, sw:, thorough, sw:, detailed, sw:, comprehensive, sw:, critically, de:, profound, id:, within, id:, inside, id:, indoor, vi:, worm
change: hi:, modification, hi:, variation, hi:, transformation, hi:, transform, hi:, mutation, sw:, shift, sv:, alter, sv:, amend, ta:, transition, pa:, convergence, ko:, variations, ko:, variance, ko:, variability
feeling: zh:, feel, zh:, sensation, hi:, perception, sw:, impression, sw:, emotion, sw:, mood, sw:, impressed, sw:, emotional, sw:, sensory, de:, sentiment, sv:, sense, ta:, passion, ta:, conscious, ta:, consciousness, pa:, impulse, te:, notion, te:, conception, te:, concept
purpose: zh:, object, zh:, aim, zh:, objective, id:, goal, id:, destination, vi:, intention, ta:, intended, ta:, motive, fa:, target, te:, advantage, te:, benefit
happy: zh:, cheerful, hi:, amused, sw:, pleasure, sw:, glad, sw:, joy, sw:, happiness, sw:, delight, sw:, delighted, sw:, fun, sw:, happily, de:, lucky, id:, pleased, pa:, emoticon, jv:, frequently, jv:, enjoy, jv:, prefer, te:, unhappy
blood: sw:, bleed, jv:, bloody, jv:, bloodshed
rose: it:, pink
south: hi:, southern, pl:, noon, pl:, midday
cold: sw:, winter, sw:, cool, de:, coldly
position: zh:, location, hi:, situation, hi:, status, sw:, chance, sw:, opportunity, sw:, space, pt:, stance, it:, posture, el:, place, el:, post, pl:, item, pa:, orientation, ko:, lay, ko:, located, mr:, locus
stand: zh:, station, hi:, vertical, ar:, attitude, ar:, stance, el:, stop, el:, posture, el:, pose, pl:, stall, bn:, be, bn:, stay, bn:, remain, bn:, exist, ko:, versus
suppose: zh:, assumption, zh:, hypothesis, sw:, assume, sv:, adopt, ar:, presume, ar:, hypothesize, he:, lay, ko:, household, ko:, supposedly
mine: sw:, my
cut: hi:, lack, hi:, lacking, hi:, reduction, hi:, deficiency, hi:, decrease, hi:, shortage, hi:, miss, sw:, cutting, ar:, interrupt, id:, chop, id:, slash, pt:, crop, cy:, broken, cy:, violate, mr:, conspiracy
copy: zh:, reproduce, zh:, replication, zh:, replicate, hi:, transcription, sw:, photocopy, vi:, clone, fa:, version, fa:, prescription, sr:, blueprint, ko:, wealth
husband: de:, man, ar:, spouse
six: sv:, sex
low: hi:, less, hi:, short, id:, cheap, id:, cheaply, tr:, miscarriage, ta:, minimal, fr:, bottom, fi:, shallow, jv:, dull, jv:, deficiency, mr:, ease, mr:, reduce, mr:, decrease, mr:, minimize
remember: sw:, note, de:, recall, de:, remind, fi:, memorize
effect: zh:, influence, zh:, affect, hi:, impression, hi:, impact, hi:, dominance, vi:, efficient, vi:, effectively, vi:, effectiveness, ta:, consequence, el:, result, lt:, exposure, mr:, outcome, mr:, implication
fall: zh:, autumn, de:, case, ar:, located, id:, crash, id:, tumble, id:, breakdown, fa:, collapse, fi:, drop, el:, decline, pl:, decrease
except: sw:, unless, tr:, outside, tr:, besides, tr:, apart-from, tr:, outside-of, ru:, apart, ta:, excluding, sr:, aside-from, bn:, without
copyright: 
army: zh:, troops, hi:, troop, sw:, host, id:, soldier
run: sw:, flee, sw:, drain, id:, running, id:, execute, vi:, operate, fi:, drive, pl:, gear, ko:, operations, ko:, operational, mr:, defend
horse: sw:, horseshoe, tr:, at, ko:, remark, ko:, utterance
future: sw:, later, sw:, afterwards, sw:, afterward, jv:, winter
west: zh:, western
pay: zh:, wages, zh:, wage, hi:, salary, ar:, thrust, ar:, payment, id:, remunerate, fa:, fee, fi:, cost, mr:, let
red: jv:, reduction
gold: 
desire: hi:, volition, sw:, eager, sw:, appetite, ar:, wish, vi:, yearn, fi:, urge, ja:, lust
play: sw:, dancing, de:, gamble, fa:, game, fr:, cheek, el:, toy, jv:, roll, jv:, spin, jv:, rotate
master: zh:, lord, zh:, primary, ar:, main, fa:, professor, pt:, dominate, fi:, govern, el:, mr, el:, gentleman, el:, leading, el:, mister, bn:, owner, pa:, mastermind, he:, control
office: fi:, agency, el:, desk, he:, ministry
government: ta:, state, pl:, row
church: 
length: sw:, height, sw:, altitude, fa:, span, cy:, along, cy:, duration, bn:, tall
company: zh:, firm, zh:, corporation, de:, society, sv:, business, id:, corporate, ta:, entity, ta:, institution, ta:, agency, ta:, institute, lt:, venture, jv:, enterprise
paper: sw:, sheet, it:, card, it:, charter, he:, newspaper
probability: zh:, possibility, zh:, likelihood, hi:, likely, sw:, possibly, sw:, unlikely, ar:, prospect, lt:, chance, jv:, probable, jv:, variables, mr:, odds
especially: zh:, special, zh:, specially, zh:, specifically, hi:, particularly, sw:, particular, sw:, exactly, sw:, mainly, ar:, mostly, id:, primarily, vi:, specific, te:, importantly, mr:, typically
bear: sw:, carry, ta:, endure, fa:, forbearance, fa:, tolerance, lt:, have, lt:, possess, lt:, afford, mr:, tolerate
window: 
agreement: zh:, protocol, hi:, settlement, hi:, compromise, sw:, consensus, id:, treaty, vi:, agree, tr:, deal, tr:, accord, ta:, tender, it:, chord, fi:, contract, fi:, convention, el:, arrangement, mr:, bargain
beauty: sw:, beautifully, sw:, brilliance, fa:, aesthetic
duty: zh:, liability, zh:, responsibility, hi:, obligation, sw:, responsible, sv:, customs, id:, task, id:, assignment, ru:, debt, fr:, owe, fr:, have-to, jv:, employ, te:, fate
send: zh:, transmit, fa:, submission, it:, post, fi:, broadcast, lt:, email, ja:, transmission, jv:, should, jv:, deliver, jv:, submit
distance: de:, removal, id:, range, vi:, separation, ko:, street, mr:, gap
silence: ta:, stillness, pa:, quiet, pa:, silent, jv:, loneliness, mr:, peace
foot: hi:, leg, sw:, halt, sw:, thigh, id:, toe, ta:, quarter, ja:, paw, jv:, running, jv:, properly, mr:, step
wild: de:, wildly, id:, illegal, el:, fierce, pa:, wildlife, te:, jungle
die: zh:, dead, sw:, dying, jv:, off, jv:, shut
save: zh:, saving, zh:, preservation, sw:, recover, de:, conserve, ar:, conservation, ar:, memorize, id:, store, tr:, redeem, it:, rescue, fi:, record, bn:, protection, he:, preserve, ko:, rid
green: lt:, raw, lt:, crude
trouble: zh:, bother, sv:, issue, sv:, problem, id:, hardship, id:, difficulty, fi:, knead, el:, suffering, pa:, problematic, jv:, obstacle, te:, embarrass, te:, embarrassment
smile: zh:, grin
wrong: zh:, mistake, zh:, error, zh:, mistaken, sw:, badly, sw:, mistreat, de:, false, sv:, fault, sv:, failure, sv:, flaw, id:, wrongly, fa:, gaffe
sleep: vi:, asleep, fa:, dream, jv:, nap
quotative-case: 
beginning: zh:, begin, zh:, start, hi:, undertake, sw:, scratch, sw:, onset, id:, early, id:, initial, vi:, initiation, fr:, debut, el:, principle, pa:, embark, pa:, initiate
action: hi:, task, sw:, point, sw:, step, sw:, stage, sv:, act, ar:, procedure, vi:, active, vi:, operation, vi:, operational, vi:, activate, vi:, activist, ta:, move, fa:, practice, fa:, practise, fa:, operate, it:, stock, cy:, execution, cy:, execute, jv:, conduct
visit: zh:, access, zh:, interview, zh:, accessible, hi:, travel, hi:, trip, hi:, journey, sw:, tour, bn:, philosophy, he:, criticize, mr:, meeting, mr:, gift
follow: sw:, compliance, id:, adhere, fa:, following, fa:, pursue, fi:, track, fi:, accompany, pa:, obey, ja:, subsequent, ja:, persist
try: zh:, attempt, ar:, attempted, ta:, effort, ta:, initiative, pt:, experiment, el:, test, pl:, sample, pa:, diligence, jv:, trial, ko:, examination, ko:, exam
presence: zh:, existence, zh:, exist, tr:, entity, tr:, asset, pa:, occurrence, jv:, sight, mr:, attendance
heavy: zh:, repetition, hi:, heavily, de:, difficult, de:, severe, id:, weight, tr:, seriously, pa:, enormous, he:, liver, te:, huge, te:, massive
sweet: tr:, dessert, pt:, candy, it:, gentle, pl:, bland, sr:, cute
mouth: vi:, oral, vi:, mug, ta:, sip, bn:, face
rich: zh:, plenty, zh:, abundant, hi:, wealthy, jv:, dress, ko:, generous
enemy: pa:, hostile, jv:, opponent, jv:, versus
ship: zh:, boat, sw:, sail, sw:, fleet, sw:, sailing, de:, vessel, ta:, cruise, fa:, ferry, ko:, belly, mr:, steer
condition: hi:, bet, hi:, betting, sw:, state, sw:, situation, sw:, circumstance, tr:, status, ru:, fortune, ta:, stage, ta:, level, fi:, fitness, sr:, requirement
including: zh:, contain, hi:, include, hi:, involve, id:, belong, jv:, consist, jv:, excluding
inclusive-person: 
appear: zh:, appearance, zh:, arise, zh:, emerge, zh:, emergence, hi:, visible, tr:, seem, jv:, look, ko:, haunt
secret: sw:, mysterious, sw:, mystery, sw:, pin, vi:, underground
please: hi:, kindly, el:, ask, bn:, grace
precative-mood: 
polite-register: 
evil: hi:, harm, de:, nasty, ta:, vicious, fa:, bad, fa:, badly, jv:, awful, ko:, ill, mr:, worse
march: zh:, parade, sw:, protest, sw:, demonstration, fr:, mars
slowly: hi:, gradually, sw:, slow, ta:, gently, ta:, softly, el:, late, mr:, gradual
instead: zh:, instead-of, hi:, rather, sw:, besides, sw:, replacement, sw:, substitution, ja:, alternatively, ko:, behalf
blue: te:, cyan
impossible: 
school: pt:, campus, cy:, ladder
occasion: hi:, opportunity, sw:, event, sw:, occurrence, id:, chance, id:, avenue, pl:, bargain, ja:, o'clock
married: sw:, marriage, ta:, marry, mr:, wedding
food: hi:, meal, hi:, diet, vi:, dish, el:, feed, pa:, dine
twenty: 
easily: zh:, likely, zh:, readily, zh:, liable, zh:, easy, sw:, convenience, de:, slight, de:, slightly, de:, lightly, id:, convenient, id:, straightforward, ja:, briefly
prospective-aspect: 
language: zh:, linguistic, tr:, tongue, jv:, base
expression: zh:, express, tr:, statement, tr:, phrase, tr:, articulate, ta:, exposure, it:, utterance, pa:, equation, ja:, representation
week: sr:, sunday, jv:, weekly
hall: sw:, theater, sv:, hallway, id:, space, id:, chamber, tr:, salon, tr:, lounge, pt:, aisle, pt:, runner, el:, lobby, ja:, hole, ja:, haul
danger: zh:, dangerous, sw:, risk, sw:, hazard, de:, respect
usual: zh:, generally, hi:, general, hi:, common, hi:, routine, hi:, generic, sw:, usually, sw:, ordinary, sw:, unusual, sw:, commonly, sw:, modest, sw:, normal, sw:, irregular, sw:, conventional, sw:, typical, sw:, casual, sw:, normally, sw:, typically, sv:, mainstream, id:, regular, id:, habitual, fi:, plain, pa:, roughly, te:, simple, ko:, moderate
born: hi:, birth, pa:, rebirth, ko:, innate
court: sw:, judicial, de:, dish, el:, forum, jv:, litigation
gnomic-aspect: 
worth: hi:, deserve, sw:, value, sw:, valuable, vi:, validity, el:, merit, bn:, cost, bn:, price
tree: vi:, plant, ru:, wood, fr:, shaft, sr:, timber
wall: 
heaven: de:, sky
inchoative-aspect: 
jussive-mood: 
tone: id:, pitch, vi:, melody, tr:, ton, tr:, tonne, fi:, shade, el:, tuna, jv:, sound
regard: hi:, respect, id:, assume, id:, presume, fa:, attention, fa:, consideration, fr:, consider, el:, relation, el:, association, el:, relationship, cy:, remark, cy:, coverage, pa:, relations, pa:, relate, ko:, associated, ko:, related, mr:, concerned, mr:, belong, mr:, regarding, mr:, corresponding, mr:, correspond, mr:, relevant
month: id:, moon
experience: zh:, empirical, zh:, experiential, sw:, experienced, ar:, expertise, ta:, zest, fa:, experiment
circumstances: bn:, scenario, pa:, circumstance, ja:, situation, jv:, loosely
fresh: zh:, freshly, sw:, pure, sw:, clean, sw:, cleaner, ta:, new, ta:, novice, pa:, latest
duke: hi:, ruler, pl:, prince, mr:, peer
covered: zh:, covering, zh:, coverage, tr:, off, tr:, closed, tr:, indoor, pa:, cover, ko:, govern
bound: hi:, extent, hi:, limitation, hi:, limit, hi:, border, hi:, restriction, ar:, restricted, tr:, connected, tr:, depend, cy:, bind, ko:, boundary, ko:, confine
east: zh:, eastern, hi:, ago, hi:, previous, hi:, prior, hi:, pre, fa:, orient
stone: sw:, marble, sv:, rock, tr:, gem
direction: zh:, orientation, sw:, dimension, ar:, trend, tr:, facet, cy:, instruction
chair: sw:, seat, de:, armchair, ru:, stool, te:, lounge
support: zh:, sustain, hi:, endorse, sw:, assistance, vi:, assist, it:, bracket, fi:, aid, mr:, basis, mr:, crutch
date: ar:, history, pt:, encounter
village: ar:, hamlet, sr:, countryside
field: zh:, sphere, zh:, realm, hi:, region, hi:, territory, hi:, area, hi:, zone, hi:, sector, sw:, domain, sw:, arena, sw:, stadium, tr:, space, ru:, margin, pt:, countryside, it:, camp, mr:, farm
wait: vi:, expect, pt:, hold, cy:, stay
permission: zh:, allow, ar:, ear, id:, permit, id:, clearance, el:, leave, el:, license, el:, licence, cy:, consent, lt:, edition, he:, possession, te:, approval
permissive-mood: 
success: zh:, successful, zh:, succeed, sw:, prosperity, sw:, achievement, ta:, victory, ta:, win, ta:, hit, ta:, winning, ta:, winner, mr:, prosper
hill: zh:, mountain, pt:, mount, jv:, volcano
music: zh:, musical, te:, classical
distal-demonstrative: 
afternoon: zh:, p.m., hi:, noon, hi:, midday, el:, evening
cry: hi:, mourn, fr:, shout, el:, scream
honour: zh:, honor, sw:, respect, sw:, dignity, sw:, respectable, sw:, honorable, vi:, honorific, ta:, courtesy, fi:, glory, el:, rate, el:, price
seven: 
private: sw:, personal, sw:, self, sw:, personally, ar:, special, id:, privacy, tr:, specific, tr:, exclusive
sit: sw:, stay, sw:, settle
news: ta:, message
scene: zh:, site, ar:, sight, vi:, context, ta:, display, ta:, visual, fa:, stage, fi:, view, fi:, prospect, el:, tent, mr:, appearance
garden: sw:, gardener, id:, park
race: zh:, racial, hi:, racing, sw:, running, fa:, contest, fa:, tournament, it:, tender, fi:, breed, el:, match, bn:, nation, pa:, scramble, ja:, lace
distributive-case: 
learn: id:, study, cy:, teach, mr:, intentional
political: zh:, politics, zh:, politically, ar:, politician, fr:, policy
speech: sw:, lecture, tr:, talk, tr:, conversation, ru:, discourse, ta:, spoken
lie: sw:, false, jv:, deceive, jv:, cheat, jv:, manipulate
cast: zh:, hurl, sv:, throw, sv:, fling, sv:, toss, fa:, format, fa:, mold, it:, launch, lt:, shed, lt:, quit
eat: id:, meal, id:, feed, tr:, dish, tr:, dine, cy:, consumption
floor: sw:, rug, de:, ground, de:, bottom, de:, soil, pt:, walk, lt:, high, lt:, tall, pa:, destination
summer: hi:, heat, jv:, hot, jv:, heating
religion: zh:, religious, ar:, debt, pa:, creed, pa:, foster
picture: hi:, portrait, hi:, painting, sw:, image, sw:, photograph, sw:, photographic, sw:, photography, sw:, photo, ar:, photocopy, id:, drawing, ta:, snap, ta:, film, fa:, illustration, fa:, portrayal, fi:, fig, el:, figure
escape: sv:, flee
author: hi:, writer, ta:, teacher, ta:, editor
brown: hi:, gray, hi:, grey, ta:, suntan, pl:, bronze, jv:, chocolate, te:, wheat
determined: zh:, determination, sw:, decide, sw:, determine, sv:, definite, sv:, assertive, ar:, designer, vi:, specified, vi:, ascertain, tr:, stable, ru:, certain, ja:, decision, ja:, determiner, ko:, fixed
pain: vi:, hurt, ru:, anguish, ta:, painful, fr:, grief, pl:, sore, mr:, agony
spring: de:, feather, sv:, our, sv:, ours
soft: hi:, concessive, sw:, smooth, sw:, finely, id:, tender, id:, gently, id:, softly, vi:, gentle, vi:, bland, ru:, mild, jv:, delicate, jv:, innate
corner: id:, angle, jv:, wide
trademark: zh:, lately, zh:, alike, zh:, electronically, zh:, applicable, zh:, defective, zh:, accordingly, zh:, steadily, zh:, silently, zh:, convey, zh:, furnish, zh:, proofread, zh:, meantime, zh:, abide, zh:, inquire, zh:, incomplete, zh:, donation, zh:, loudly, zh:, sue, zh:, ma'am, zh:, beforehand, zh:, subscribe, zh:, aboard, zh:, attain, zh:, compliment, zh:, anyhow, zh:, sunny, zh:, excellence, zh:, scenery, zh:, monument, zh:, escort, zh:, appreciation, zh:, excessive, zh:, attendant, zh:, petition, zh:, disposal, zh:, wisely, zh:, exclusively, zh:, newsletter, zh:, paperwork, zh:, thrill, zh:, await, zh:, guidance, zh:, repeatedly, zh:, profitable, zh:, patron, zh:, inspection, zh:, luncheon, zh:, popularity, zh:, baker, zh:, sleepy, zh:, payable, zh:, circuit, zh:, energetic, zh:, fortunately, zh:, explanatory, zh:, resume, zh:, intently, zh:, superb, zh:, confidential, zh:, housekeeper, zh:, spacious, zh:, renew, zh:, dispose, zh:, oblige, zh:, pamphlet, zh:, detach, zh:, familiarity, zh:, terrific, zh:, attire, zh:, antique, zh:, founder, zh:, exceptional, zh:, excursion, zh:, snowy, zh:, accomplishment, zh:, icy, zh:, inconvenience, zh:, banker, zh:, discontinue, zh:, signify, zh:, yearly, zh:, permanently, zh:, rainy, zh:, beneficial, zh:, reluctant, zh:, termination, zh:, renown, zh:, circus, zh:, advancement, zh:, completion, zh:, unlimited, zh:, interpreter, zh:, instruct, zh:, spectator, zh:, imperative, zh:, refreshment, zh:, temporarily, zh:, dispatch, zh:, omit, zh:, dock, zh:, infer, zh:, foreman, zh:, courier, zh:, cloudy, zh:, hereby, zh:, editorial, zh:, fiscal, zh:, willingness, zh:, poorly, zh:, administer, zh:, economical, zh:, chilly, zh:, administrative, zh:, subscription, zh:, unfamiliar, zh:, conform, zh:, affirmative, zh:, considerate, zh:, invaluable, zh:, accommodate, zh:, apprentice, zh:, unreal, zh:, vacancy, zh:, needy, zh:, apprehensive, zh:, terminate, zh:, conveniently, zh:, cleanliness, zh:, distraction, zh:, incur, zh:, descriptive, zh:, hazardous, zh:, cumulative, zh:, refresh, zh:, basement, zh:, celebrity, zh:, windy, zh:, daytime, zh:, drought, zh:, collector, zh:, dedication, zh:, expiration, zh:, healthful, zh:, cooler, zh:, translator, zh:, tow, zh:, occupant, zh:, bankrupt, zh:, transit, zh:, consistently, zh:, evenly, zh:, broker, zh:, designate, zh:, enclose, zh:, protective, zh:, prescribe, zh:, homeless, zh:, faulty, zh:, jewelry, zh:, query, zh:, punctual, zh:, distract, zh:, lengthy, zh:, urgently, zh:, verify, zh:, enthusiast, zh:, recur, zh:, introductory, zh:, shorten, zh:, journalism, zh:, reunion, zh:, recipient, zh:, reminder, zh:, postal, zh:, duplicate, zh:, booth, zh:, overnight, zh:, consecutive, zh:, expire, zh:, fluent, zh:, explorer, zh:, advisor, zh:, postage, zh:, authorize, zh:, drawback, zh:, seaside, zh:, cartridge, zh:, proficiency, zh:, intonation, zh:, contractor, zh:, notify, zh:, accessory, zh:, ballroom, zh:, unpaid, zh:, discard, zh:, generator, zh:, skim, zh:, inefficient, zh:, salesman, zh:, concierge, zh:, auto, zh:, frustrate, zh:, tuition, zh:, installation, zh:, accustom, zh:, caller, zh:, handbook, zh:, rehearse, zh:, nutrition, zh:, junk, zh:, quarterly, zh:, periodically, zh:, culinary, zh:, illogical, zh:, collaboration, zh:, unattended, zh:, thunderstorm, zh:, serial, zh:, tablecloth, zh:, discrepancy, zh:, sewer, zh:, certify, zh:, paraphrase, zh:, locker, zh:, reconsider, zh:, pant, zh:, evacuate, zh:, graduation, zh:, occupancy, zh:, hygiene, zh:, shipment, zh:, seeker, zh:, downtown, zh:, jog, zh:, congestion, zh:, inexpensive, zh:, teller, zh:, diploma, zh:, waive, zh:, humidity, zh:, subscriber, zh:, unreliable, zh:, yen, zh:, disruption, zh:, spa, zh:, genre, zh:, acclaim, zh:, documentary, zh:, auditorium, zh:, economize, zh:, expedite, zh:, browse, zh:, disable, zh:, ideally, zh:, organizer, zh:, overdue, zh:, authorization, zh:, reopen, zh:, broaden, zh:, classmate, zh:, vacate, zh:, vendor, zh:, itinerary, zh:, deduct, zh:, warranty, zh:, mileage, zh:, appliance, zh:, overtime, zh:, invoice, zh:, provider, zh:, dental, zh:, oversee, zh:, pharmacy, zh:, enroll, zh:, rearrange, zh:, reimburse, zh:, revolutionize, zh:, worldwide, zh:, teen, zh:, respondent, zh:, debit, zh:, amenity, zh:, mower, zh:, diner, zh:, caterer, zh:, flyer, zh:, mandatory, zh:, coupon, zh:, turnover, zh:, someday, zh:, hesitant, zh:, homemade, zh:, additionally, zh:, cancellation, zh:, devastate, zh:, appraisal, zh:, stockholder, zh:, certification, zh:, businessman, zh:, hardworking, zh:, venue, zh:, unsure, zh:, firework, zh:, footwear, zh:, rebate, zh:, vend, zh:, gym, zh:, brochure, zh:, taker, zh:, managerial, zh:, disconnect, zh:, merger, zh:, contestant, zh:, commute, zh:, nationwide, zh:, payroll, zh:, developer, zh:, placement, zh:, disrupt, zh:, anytime, zh:, refinery, zh:, ongoing, zh:, internationally, zh:, entrepreneur, zh:, medication, zh:, adapter, zh:, pharmaceutical, zh:, weekday, zh:, unspecified, zh:, knowledgeable, zh:, doorman, zh:, subsidize, zh:, informative, zh:, factual, zh:, intern, zh:, technician, zh:, cookbook, zh:, creativity, zh:, e-book, zh:, workplace, zh:, memo, zh:, innovative, zh:, sticker, zh:, cafeteria, zh:, mini, zh:, upgrade, zh:, renter, zh:, takeover, zh:, copier, zh:, organizational, zh:, obligate, zh:, lightweight, zh:, overpay, zh:, stereo, zh:, paperback, zh:, relocation, zh:, penalize, zh:, upcoming, zh:, freelance, zh:, prestigious, zh:, streamline, zh:, newsstand, zh:, opt, zh:, deluxe, zh:, validate, zh:, lunchtime, zh:, malfunction, zh:, overcrowd, zh:, salespeople, zh:, promotional, zh:, paycheck, zh:, trainee, zh:, environmentally, zh:, realtor, zh:, preview, zh:, layoff, zh:, publicize, zh:, condominium, zh:, hotline, zh:, wristwatch, zh:, allergy, zh:, customize, zh:, restroom, zh:, reschedule, zh:, finalize, zh:, redecorate, zh:, headphone, zh:, announcer, zh:, advisory, zh:, enrollment, zh:, costly, zh:, getaway, zh:, airfare, zh:, renewal, zh:, affordable, zh:, fundraise, zh:, advertiser, zh:, remodel, zh:, automotive, zh:, unplug, zh:, fluctuate, zh:, flextime, zh:, rental, zh:, showroom, zh:, outdate, zh:, reviewer, zh:, inventory, zh:, cheeseburger, zh:, renovate, zh:, paralegal, zh:, dependable, zh:, departmental, zh:, relocate, zh:, distractor, zh:, healthcare, zh:, repairperson, zh:, shopper, zh:, worthwhile, zh:, redesign, zh:, reassure, zh:, dissatisfy, zh:, recreational, zh:, downturn, zh:, hourly, zh:, downsize, zh:, unused, zh:, inexperience, zh:, dealership, zh:, renovation, zh:, résumé, zh:, unavailable, zh:, unauthorize, zh:, outage, zh:, architectural, zh:, recruiter, zh:, reimbursement, zh:, complimentary, zh:, restatement, zh:, café, zh:, entrée, zh:, recruitment, zh:, purchaser, zh:, photocopier, zh:, personalize, zh:, anew, zh:, storeroom, zh:, coworker, zh:, by-law, zh:, boardroom, zh:, misidentify, zh:, workbook, zh:, wellness, zh:, advisable, zh:, cordless, zh:, workforce, zh:, professionally, zh:, internship, zh:, homeowner, zh:, sender, zh:, instructor, zh:, donut, zh:, purser, zh:, videoconference, zh:, underway, zh:, familiarize, zh:, beginner, zh:, hiker, zh:, smartphone, zh:, authentic, zh:, efficiently, zh:, refundable, zh:, drastically, zh:, enthusiastically, zh:, charitable, zh:, timeline, zh:, telecommunication, zh:, automate, zh:, audition, zh:, attendee, zh:, housekeep, zh:, webpage, zh:, assemble, zh:, coordinator, zh:, consignment, zh:, incoming, hi:, the, ru:, an, ru:, a, cy:, submit, cy:, strengthen, bn:, checkup, bn:, raincoat, bn:, extinguisher, bn:, receptionist, bn:, sunscreen, bn:, presenter, bn:, projector, bn:, skateboard, bn:, electrician, bn:, toiletry, bn:, centimeter, pa:, purse, pa:, hesitation, pa:, confirmation, pa:, cab, pa:, cargo, pa:, habitual, pa:, casual, pa:, hazard, pa:, tailor, pa:, violin, pa:, gardener, pa:, carpenter, pa:, vase, pa:, gum, pa:, periodical, pa:, sidewalk, pa:, hurricane, pa:, scarf, pa:, picnic, pa:, vanilla, pa:, badge, pa:, dessert, pa:, arc, pa:, prospective, pa:, warehouse, pa:, cashier, pa:, pad, pa:, pastry, pa:, librarian, pa:, gymnasium, pa:, crane, pa:, chef, pa:, generic, pa:, cleaner, pa:, waitress, pa:, counselor, pa:, stationery, pa:, massage, pa:, bakery, pa:, sedan, pa:, microwave, pa:, plumber, pa:, grill, pa:, stockbroker, pa:, booklet, pa:, hamburger, pa:, heater, pa:, cosmetic, pa:, barbecue, pa:, popcorn, pa:, reflexive, pa:, logo, pa:, tuna, pa:, appetizer, pa:, timer, pa:, pharmacist, pa:, commuter, pa:, carton, pa:, blueprint, pa:, briefcase, pa:, escalator, pa:, lifeguard, pa:, letterhead, pa:, dishwasher, pa:, backpack, pa:, seafood, pa:, wheelchair, pa:, walkway, pa:, volleyball, pa:, conditioner, pa:, stapler, pa:, sauna, pa:, checkout, pa:, toner, ja:, industry, jv:, shake
produce: zh:, production, sw:, generate, vi:, productive, tr:, fabricate, ta:, manufacture, ta:, manufacturing, ja:, crop, ja:, crops, te:, product, mr:, creation, mr:, formation
laugh: lt:, jest, ja:, laughter
forget: fi:, overlook, jv:, deny, jv:, mindful
europe: 
eight: sw:, eighth
passing: zh:, by, zh:, through, zh:, pass, zh:, via, tr:, elapse, ru:, passage, fa:, crossing, lt:, shift, lt:, transition, lt:, aisle
terrible: zh:, awful, zh:, horrible, zh:, terribly, zh:, frightening, hi:, tremendous, sw:, tragic, sw:, alarming, vi:, scare, tr:, monstrous, cy:, awfully
sake: bn:, motive, he:, favour, he:, favor
breath: hi:, respiratory, ar:, breathe, ar:, breathing, tr:, exhale, fa:, ego, it:, gasp, pa:, sigh, pa:, whisper, pa:, inhale, mr:, sniff
wise: sw:, reasonable, sw:, sensible, sw:, discreet, id:, thoughtful, pl:, clever, pl:, smart, lt:, intelligent, pa:, mature, te:, brilliant
possessive-marker: 
pleasant: zh:, pleasing, hi:, enjoyable, sw:, favorable, id:, comfortable, id:, comfortably, vi:, interestingly, fr:, nice, pt:, nicely, lt:, kind, pa:, beautifully, ja:, fun
perfectly: hi:, entirely, hi:, fully, hi:, completely, hi:, totally, sw:, actively, de:, perfect, id:, truly, vi:, altogether, fa:, quite, fa:, exactly, fa:, absolutely, te:, absolute
memory: zh:, memorize, sw:, reference, sw:, memorial, he:, trace
grave: zh:, serious, zh:, severe, zh:, heavily, ta:, cemetery, mr:, critical
modern: sw:, contemporary, sw:, sophisticated, sw:, modernize, sv:, fashionable, ar:, recent, ar:, discourse, bn:, latter, te:, advanced, ko:, nowadays
spot: zh:, point, zh:, dot, zh:, o'clock, hi:, location, sw:, stain, ar:, patch, id:, place, id:, nowhere, id:, premises, id:, locus, vi:, site, pt:, local, it:, locate, el:, sign, jv:, colon
break: zh:, break-in, hi:, brake, sw:, resort, sw:, lounge, de:, interruption, ta:, interval, ta:, gap, fr:, smash, fr:, shatter, pt:, stop, fi:, pause, el:, interrupt, te:, restless
island: 
touch: el:, contact, jv:, tap
equal: hi:, equivalent, sw:, same, sw:, similar, sw:, rightly, sw:, ok, sw:, all-right, sv:, equally, vi:, degree, ta:, par, ko:, identical
shore: ar:, backup, pa:, brink, ja:, coast
promise: zh:, commit, zh:, commitment, sw:, pledge, id:, appointment, he:, assurance
commissive-mood: 
plan: hi:, scheme, sw:, deal, sw:, program, sw:, programme, sw:, initiative, vi:, planner, ru:, blueprint, ta:, proposal, ta:, project, fa:, plot, fa:, sketch, fa:, projection, fa:, layout, pt:, flat, el:, drawing, el:, design, jv:, proposition, te:, planning, mr:, contemplation
surprise: id:, astonishing, vi:, unexpected, vi:, accidental, ta:, surprising, bn:, wonder, pa:, surprisingly, te:, surprised
minute: 
shot: zh:, shoot, zh:, shooting, sw:, bullet, sw:, ammunition, fa:, photograph, fa:, photo, fr:, blow, fr:, bang, fr:, coup, el:, throw, lt:, frame, he:, kick
lead: hi:, leadership, ar:, leading, ar:, steer, tr:, bullet, fr:, drive, cy:, guide, sr:, bring, jv:, lean
glass: sw:, mirror, sw:, crystal, de:, jar, ta:, glasses, jv:, page, jv:, export
board: zh:, slab, ar:, council, id:, up, id:, rise, id:, ride, ta:, group, ta:, committee, ta:, panel, fr:, advice, pt:, edge, el:, commission, he:, tablet, ko:, edition
instance: zh:, example, hi:, illustration, sw:, model, sw:, pattern, sw:, metaphor, sw:, prototype, ar:, as, ar:, represent, id:, specimen, vi:, case, tr:, precedent, tr:, sample, el:, paradigm, pa:, illustrate, ko:, yes
safe: zh:, secure, zh:, safety, zh:, security, sw:, safely, sv:, confident, pt:, insurance, he:, sure, jv:, harmless, jv:, removal
doctor: hi:, physician, hi:, therapist, sw:, practitioner, pt:, medical, pa:, dentist
class: zh:, kind, hi:, orbit, hi:, classroom, de:, grade, ar:, separation, vi:, layer, fi:, category, el:, rank, cy:, district
completive-aspect: 
repeated: sw:, frequently, sw:, regular, sw:, constant, sw:, constantly, sw:, occasionally, sw:, frequent, sw:, regularly, sw:, periodical, te:, repetition, ko:, repeat, ko:, repeating, mr:, revision, mr:, iteration
military: ko:, county
warm: hi:, hot, sw:, heat, sw:, warmth, sw:, temperature, sw:, heating, fa:, gram, fa:, muggy
drink: hi:, beverage, ko:, drunkenness
anger: zh:, angry, zh:, rage, sw:, outrage, ar:, irritate, lt:, spite, jv:, resent, te:, annoyed
directly: hi:, straight, sw:, direct, sw:, indirect, sw:, automatic, sw:, straightforward, vi:, immediate, pa:, straighten, jv:, immediately, jv:, verbal
hat: hi:, cap, sw:, helmet
dog: 
servant: id:, steward, id:, waiter, id:, waitress, tr:, maid, jv:, slave, ko:, domestic
pride: sw:, arrogant, ta:, proud, it:, proudly, pa:, hubris
crowd: hi:, rush, hi:, crowded, hi:, mob, de:, amount, de:, quantity, fa:, population, el:, host, sr:, pile, jv:, much, jv:, many, jv:, numerous, jv:, seriously, jv:, ample, jv:, bulk, ko:, herd
train: hi:, carriage, hi:, car, hi:, wagon, hi:, cart, ta:, railway, ta:, rail, fi:, educate
moral: zh:, morality, zh:, morally, hi:, ethical, sw:, ethics, id:, morale, tr:, spiritual
greek: 
fit: zh:, suit, id:, suitable, id:, suited, id:, compatible, tr:, proper, tr:, convenient, tr:, appropriate, tr:, correspond, tr:, eligible, tr:, relevant, cy:, accord, he:, adjust, jv:, exact, jv:, precise, jv:, coincide
enter: sw:, log, sw:, entry, sv:, state, sv:, indicate, ar:, insert, id:, include, te:, register, te:, registration
rule: sw:, administration, sw:, domination, sw:, regime, ar:, judgment, ar:, verdict, ar:, judgement, ar:, referee, ta:, govern, fa:, law, fa:, legislation, el:, norm, pa:, state, jv:, regulate, te:, reign, mr:, regulation, mr:, prescription
sword: tr:, blade, te:, knife
attack: hi:, invasion, hi:, invade, hi:, aggression, de:, offence, de:, assault, de:, offense, id:, strike, vi:, onset, ta:, offensive, te:, raid
health: zh:, healthy, sv:, greet
paragraph: sw:, verse, id:, clause, vi:, chunk, fi:, point, sr:, attitude, sr:, stance, pa:, par
social: zh:, society, sw:, socially
refund: ar:, reply, ar:, respond
sorry: hi:, regret, sw:, pole, id:, pardon, pt:, excuse, pt:, apology, mr:, pity, mr:, sorrow, mr:, suffer, mr:, suffering, mr:, grief, mr:, anguish, mr:, mourning, mr:, sadness, mr:, mourn, mr:, hardship
courage: hi:, pluck, sw:, bold, sw:, confident, sw:, nerve, sw:, fortitude, tr:, dare, jv:, brave, ko:, vessel
official: sw:, formal, sw:, formally, sw:, officially, ta:, officer, pl:, clerk, te:, bureaucratic, mr:, authorise
provided: zh:, provide, zh:, offer, zh:, providing, ar:, introduction, id:, available, vi:, supply, vi:, provision, vi:, cater, lt:, if
request: hi:, prayer, id:, demand, vi:, claim, vi:, require, vi:, requirement, ru:, inquiry, ru:, enquiry, it:, prompt, cy:, bid, cy:, application, he:, wish
glance: zh:, glimpse, sw:, view, sw:, attitude, sw:, perception, sw:, outlook, ru:, sight, el:, look, pa:, noticeable, he:, gaze, ko:, glare
spread: hi:, detail, hi:, extend, hi:, extension, hi:, expansion, hi:, expand, sw:, widespread, ar:, prevalence, tr:, diffusion, pt:, scatter, te:, penetrate, te:, amplitude, mr:, circulate
opposite: hi:, front, sw:, opposed, sw:, contrary, sv:, opposing, ar:, versus, tr:, across, ta:, counter, pa:, unlike, pa:, contradict, pa:, invert, pa:, flip, he:, against, ja:, opposition, te:, anti, mr:, reverse
twelve: jv:, dozen
engaged: zh:, engagement, hi:, busy, sw:, involved, cy:, participate, pl:, occupied, jv:, engage, jv:, fold, ko:, pragmatic, mr:, inverse
wine: vi:, alcohol, ta:, alcoholic
taste: zh:, flavor, zh:, flavour, sw:, delicious, ar:, bait, it:, zest
iron: sw:, steel, sw:, metal
distribute: sw:, transmit, sv:, deploy, ar:, publish, ar:, publishing, ar:, diffusion, ar:, circulate, vi:, distribution, pt:, allocate, fi:, share, fi:, divide, fi:, split, fi:, to-split, cy:, classify, te:, distributive, mr:, distributions
trade: zh:, trading, hi:, business, hi:, commerce, hi:, merchandise, sw:, internet, ru:, bargain, ru:, transaction, lt:, marketing, te:, commercial
judge: vi:, judgment, vi:, judgement, fi:, referee, jv:, jury
anxious: zh:, emergency, zh:, urgency, hi:, concerned, hi:, alarmed, hi:, worried, sw:, anxiety, sw:, concern, sw:, worry, sw:, thoughtful, sw:, uncomfortable, sw:, worrying, de:, afraid, sv:, keen, ru:, disturbing, ru:, alarming, ta:, enthusiastic, pt:, eager, el:, restless, el:, uneasy, jv:, curiosity, ko:, unrest, ko:, angst
captain: 
cessative-aspect: 
foreign: zh:, abroad, hi:, alien, hi:, foreigner, hi:, exotic, tr:, stranger, fa:, external, pa:, overseas
intensifier: ar:, intensify
importance: sw:, necessity, sw:, relevance, de:, meaning, pa:, significance, jv:, crucial, ko:, emphasis
finally: hi:, ultimately, sw:, eventually, de:, finite, vi:, final, vi:, ultimate, vi:, terminal, ta:, finely, pa:, end, pa:, overthrow
prove: zh:, proof, sw:, confirm, sw:, affirm, vi:, demonstrate, fi:, testify, ko:, understand, mr:, axiom
prevent: hi:, cease, hi:, forbid, hi:, detain, hi:, repress, hi:, restrict, hi:, inhibit, sw:, block, sw:, restrain, sw:, deter, sw:, prohibit, tr:, avoid, cy:, suppress, cy:, suspend, jv:, halt
neck: sv:, throat, ko:, item
interesting: zh:, fun, zh:, amusing, zh:, entertaining, zh:, interestingly, sw:, attractive, sw:, attract, sw:, impressive, id:, draw, id:, appeal, id:, withdraw, id:, exciting, te:, curious
legal: sv:, judicial, id:, law, vi:, legitimate, ta:, frame, he:, theorems
dry: zh:, stem, te:, powder
serve: zh:, service, sv:, earn, id:, cater, vi:, offer
evidence: zh:, evidential, sw:, proof, ar:, guide, ar:, clue, ar:, directory, fi:, display, pl:, witness, jv:, evident, te:, testify
evidential-case: 
distant: hi:, away, hi:, far, sw:, off, sw:, apart, sw:, laptop, de:, remote, id:, aloof, pa:, farthest, pa:, banish
progress: hi:, stride, hi:, progression, sw:, development, sw:, progressive, sw:, developmental, ar:, advance, ar:, proceed, ta:, improvement, ta:, uplift, bn:, growth, pa:, promotion, jv:, manner, jv:, process
narrow: sw:, thin, ar:, tight, ta:, short, pt:, confine, pa:, annoying, he:, minimize, ko:, limited
building: ar:, build, ar:, structure, ar:, construct, pt:, construction, el:, premises, mr:, skeleton
search: hi:, find, hi:, discover, hi:, discovery, hi:, quest, hi:, detection, id:, seeking, fr:, seek, pt:, research, pt:, survey, it:, pursuit, el:, inquiry, el:, investigation, el:, enquiry, pa:, exploration, mr:, invention
sad: hi:, depressed, de:, sadly, id:, miserable, tr:, upsetting, ta:, upset, ta:, remorse, mr:, unhappy
sin: fa:, guilt, te:, sadly, mr:, commit
sick: zh:, ill, id:, sore, vi:, illness, fa:, patient, ja:, sickness
honest: hi:, sincere, sw:, loyal, de:, honestly, id:, frank, he:, straight, jv:, dishonest
bank: de:, bench, ru:, tin
forest: tr:, jungle, te:, forestry
measure: zh:, gauge, zh:, measurement, sw:, weigh, el:, metre, el:, meter
stream: zh:, flow, hi:, clause, de:, current, de:, electricity, id:, flux, pl:, jet
carefully: pa:, closely, te:, careful, te:, cautious
bread: ar:, bake, tr:, sow, ta:, sandwich, pa:, morsel, ja:, pan
additional: zh:, extra, hi:, spare, hi:, moreover, hi:, excess, hi:, surplus, sv:, further, id:, addition, id:, supplementary, vi:, add, tr:, appendix, jv:, supplement, jv:, lateral, te:, bonus
choose: zh:, choice, zh:, selection, zh:, select, zh:, selective, hi:, pick, de:, elect, de:, dial, id:, vote, ta:, examination, cy:, preference, jv:, appoint
animal: mr:, creature, mr:, neuter
zoic-gender: 
eventive-mood: 
multiplicative-case: 
obtain: zh:, gain, zh:, acquire, zh:, acquisition, hi:, receive, sw:, get, sw:, find, sw:, secure, de:, preserve, de:, sustain, id:, derive, ru:, fetch, cy:, have, he:, accomplish, he:, achieve, ko:, marry
cross: hi:, across, sw:, crossing, ta:, pass, fi:, exceed, pa:, penetrate
thick: hi:, obese, de:, thickly, el:, dense, pl:, fat
grow: el:, cultivate, sr:, rise, ko:, growth
rain: sw:, wet, sw:, rainfall, ta:, shower, jv:, precipitation, ko:, non, ko:, broom
quietly: 
surface: sw:, face, fa:, level, fa:, plane, pl:, area, te:, substrate
holy: sw:, sacred, ko:, glorious
july: 
fashion: sw:, fashionable, fa:, manner, fa:, method, fa:, approach, fa:, procedure
report: ar:, determination, ta:, statement, fr:, ratio, it:, relation, it:, relationship, el:, fair, el:, exhibition, el:, essay, el:, exposure
file: zh:, document, id:, lodge, vi:, profile, pt:, archive
shoulder: sv:, shaft, sv:, axis, vi:, portrayal, fa:, comb, pl:, arm
royal: sw:, imperial, sw:, monarchy, id:, kingdom, id:, empire, pt:, real, pt:, actual
song: id:, tune, ta:, track, fi:, singing, sr:, poem, ko:, sing
comfort: hi:, ease, hi:, relaxed, hi:, relaxing, sw:, encouragement, sv:, convenience, ar:, rest, ar:, relief, te:, facility
anyone: zh:, anybody, de:, somebody, de:, someone, tr:, nobody, fa:, everybody, he:, everyone, ja:, whoever
grass: sw:, hay, de:, weed, ar:, herb, vi:, lawn, pt:, gram, te:, straw
opening: hi:, preliminary, hi:, initial, ru:, discovery, fi:, gap, fi:, slot, pl:, openly, te:, early
june: 
fish: ta:, aquarium
capital: el:, chapter, el:, fund, el:, asset
breast: de:, chest, jv:, milk
education: zh:, educate, hi:, lesson, sw:, educational, sw:, literacy, de:, formation, sv:, training, vi:, educated, ta:, academic, pa:, instruction, mr:, teach, mr:, teaching
sharp: sw:, bright, sw:, fierce, sw:, strict, de:, sharply, de:, spicy, ar:, pointed, ar:, acute, id:, keen, fi:, crisp, jv:, clearly, mr:, glare
expense: zh:, fee, hi:, expenditure, sw:, cost, de:, edition, de:, output, id:, charge, mr:, spend
yours: zh:, your
million: sw:, millionth
pray: sv:, ask, ta:, prayer, bn:, beg, ko:, borrow
tired: sw:, fatigue, ar:, tiring
kill: hi:, murder, ar:, killing, ko:, eliminate
shadow: hi:, shade
mass: zh:, quality, hi:, collective, sw:, quantity, sw:, bulk, sw:, plural, sv:, lot, ar:, lump, ar:, cluster, id:, mob, fa:, offence, pt:, dough, pt:, pasta
established: hi:, install, sw:, solid, sw:, firmly, sw:, stable, fa:, creation, fa:, establish, fi:, incumbent, ja:, founds, te:, establishment, te:, formation, te:, setup
satisfied: zh:, pleased, zh:, satisfaction, zh:, contentment, tr:, glad, ta:, satisfy, ta:, satisfying, bn:, content
check: zh:, cheque, sw:, look, sw:, watch, sv:, checkup, ar:, choice, id:, examine, id:, inspect, vi:, examination, vi:, test, vi:, audit, vi:, checkout, tr:, intermediate, fa:, survey, fa:, investigate, fr:, ascertain, fi:, revise, el:, control
virtue: sw:, kindness, sw:, goodness, id:, benevolence, pa:, characteristic, pa:, attribute, pa:, trait
golden: mr:, blonde
national: ta:, nation, ta:, nationality, el:, ethnic, pl:, domestic, te:, nationalist
principal: zh:, prime, ta:, keyword, ja:, major, te:, main, ko:, chief, ko:, leading, mr:, staple
valley: hi:, basin
guess: hi:, inference, de:, suspect, de:, presume, tr:, estimate, tr:, estimation, tr:, prediction, tr:, predict, tr:, forecast, cy:, speculate, he:, divine, ja:, conjecture, te:, expected, te:, assessment, te:, assess, te:, evaluate, mr:, approximation, mr:, predictable
speculative-mood: hi:, hypothetical-mood
yellow: hi:, pale, de:, amber, cy:, blonde
remains: sw:, residue, sw:, residual, id:, remaining, id:, leftovers, fa:, rest
bent: zh:, curved, zh:, bend, vi:, trend, tr:, twisted, el:, slope, el:, slant, cy:, folding, pa:, perception, pa:, assumption
box: sw:, suitcase, sv:, drawer, ar:, fund, id:, kit, tr:, can, tr:, carton, pt:, bin, pt:, cashier, jv:, square, jv:, tile, jv:, grid
season: sw:, seasonal, fa:, chapter, pt:, station, el:, era
science: zh:, scientific, pa:, morphology, pa:, linguistics
apparently: sv:, obviously, vi:, clear, vi:, obvious, ta:, openly, ta:, explicitly, fa:, supposedly, ja:, clearly, te:, evident
bore: zh:, hole, sv:, drill, id:, dull, id:, boring, vi:, pierce, fr:, annoy, it:, forum, pa:, bored, ko:, sightsee
uncle: jv:, aunt
list: hi:, index, hi:, catalogue, hi:, catalog, sw:, menu, id:, register
august: 
calm: hi:, quiet, hi:, tranquil, id:, peaceful, ta:, silent, fa:, slow, fa:, relaxed, el:, stillness, cy:, softly
popular: zh:, prevalence, sw:, famous, sw:, prominent, fr:, folk, te:, leading, te:, veteran
unknown: fr:, stranger
familiar: hi:, acquaintance, sw:, lineage, sw:, descendent, ko:, used
familiar-register: 
walking: zh:, walk, sw:, tread, id:, proceed, fa:, hike, fi:, stroll, pl:, pedestrian
twice: sw:, double
intellectual: sw:, mind, sw:, intelligence, sw:, mental, sw:, intelligent, sw:, psychiatric, ar:, thinker, vi:, wisdom, fi:, spiritual
priest: zh:, clergy
wounded: hi:, injured, id:, wound, lt:, hurt
palace: 
beat: zh:, defeat, de:, punch, de:, slap, sv:, knock, pt:, slam, el:, rhythm, lt:, overcome, he:, strike, ko:, bit, mr:, victory, mr:, win, mr:, winning
fool: hi:, silly, sv:, trick, sv:, deceive, id:, cheat, tr:, stupid, fa:, foolish, fr:, mad, fr:, crazy, fr:, insane, pt:, mislead, jv:, ignorant, jv:, ignorative
nine: sw:, ninth, fr:, new
sympathy: zh:, compassion, zh:, empathy, sw:, pity, sw:, mercy, sw:, sympathetic, sw:, compassionate
burst: hi:, blast, hi:, explosion, hi:, explode, sw:, cracked, id:, boom, id:, convulsion, tr:, bang
dressed: pt:, dress, pt:, gown, pa:, uniform, mr:, clothes, mr:, clothing
literature: sw:, literary, mr:, material, mr:, outfit
collection: sw:, concentration, sw:, accumulation, ar:, set, ar:, group, ar:, combination, ar:, array, vi:, gallery, ta:, suite, ta:, package, ta:, portfolio, ta:, synthesis, fa:, repertoire, cy:, conclusion, cy:, conclude, cy:, inference, ko:, collect
empty: sw:, blank, id:, vacant, vi:, drum, tr:, leisure, tr:, null, fr:, emptiness, fr:, vacuum, lt:, vain, bn:, bare
storm: id:, hurricane, pa:, steer
pocket: de:, bag, ta:, packet
sentence: sw:, judgment, sw:, judgement, de:, proposition, de:, theorem, ru:, suggestion, ru:, proposal, ta:, punishment, ta:, conviction, fr:, phrase, fi:, condemn, fi:, denounce, el:, penalty, mr:, punish
november: 
december: 
happen: zh:, occur, zh:, occurrence, hi:, be, sw:, arise, tr:, what, tr:, nor, tr:, neither, fr:, arrive
absence: zh:, absent, ru:, lack, pl:, shortage
thank: zh:, gratitude, zh:, grateful, hi:, thanks, hi:, thank-you, he:, admit, he:, acknowledge, he:, concede, ko:, appreciate, ko:, auditor
series: ar:, chain, tr:, string, tr:, array, tr:, sequence, fi:, set, el:, turn, el:, range, el:, row
address: pa:, find
bird: sw:, flight, sw:, plane, sw:, jet, sw:, aircraft, sw:, airplane, sw:, airline, jv:, owl
coat: sw:, gown, sv:, cover, ar:, jacket, lt:, fur
prepare: zh:, ready, zh:, prepared, sw:, organize, ar:, preparation, tr:, formulate, pa:, intended, pa:, willing, pa:, eager, pa:, unwilling, pa:, chalk, pa:, equip, pa:, generate, he:, setup, mr:, build, mr:, create
rapidly: jv:, quickly, jv:, fast, jv:, quick, jv:, rapid
smoke: zh:, smoking, pl:, burn, ko:, postpone
january: 
machine: sw:, machinery, id:, engine, fi:, plane
moving: zh:, move, zh:, mobile, id:, budge, el:, movement, el:, motion, ja:, migrate, jv:, tick
teeth: hi:, tooth, id:, gear, ko:, this, ko:, louse
shame: zh:, disgrace, sw:, ashamed, sw:, shy, sw:, embarrassed, sw:, embarrassing, sw:, embarrassment, ar:, bare, ar:, naked, ta:, insult, sr:, outrage
brain: tr:, mastermind, fa:, marrow
ring: sv:, petty, sv:, dial, fa:, curl, fa:, loop, fi:, tire, fi:, tyre
phrase-marker: 
understanding: zh:, understand, zh:, comprehension, hi:, sense, hi:, grasp, sw:, empathy, vi:, knowledge, pa:, perceive, pa:, insight, te:, perception, te:, awareness
fruit: bn:, result, bn:, consequence
tea: pa:, yearn, ko:, car, ko:, quadratic
explain: zh:, explanation, zh:, illustrate, sw:, express, sw:, articulate, de:, declare, id:, clarify, vi:, interpret, fa:, comment, pa:, interpretation, ja:, describe, ko:, descriptor
welcome: zh:, greeting, hi:, reception, sw:, entertain, ar:, hey, ar:, hi, id:, greet
poetry: zh:, poem, zh:, verse, ko:, municipal, ko:, o'clock
buy: sw:, purchase, vi:, acquire, ta:, afford, el:, market, he:, shop, jv:, cheaply, ko:, invest, mr:, shopping
faithful: sw:, dishonest, de:, loyal, de:, faithfully, id:, devoted, ru:, correct, fi:, reliable
excitement: hi:, stimulation, sw:, excited, de:, fuss, sv:, tension, ar:, provoke, id:, joy, pt:, arousal, el:, flush, pa:, enthusiasm, pa:, zeal, pa:, enthusiastic, pa:, urgency, mr:, sensation
april: 
october: 
bitter: zh:, hardship, sw:, agony, sw:, anguish, id:, bitterly, tr:, suffering, tr:, painful, tr:, sting, ko:, written
loose: sw:, independent, de:, loosely, sv:, resolve, sv:, solve, ru:, vacant, cy:, freely
text: sr:, wording
worst: sw:, bad, sw:, worse, sw:, rough, sw:, adverse, ta:, nasty, cy:, spite, pa:, most, pa:, highest, pa:, lowest, te:, rubbish, te:, trash, te:, garbage
credit: sw:, mortgage, vi:, credit-card, ta:, debt, ta:, lend, ta:, borrow, ta:, loan, fa:, prestige, fa:, validity, fa:, credibility
features: sw:, components, sv:, functions, ta:, aspects, bn:, feature
capable: hi:, enable, hi:, competent, sw:, able, sw:, capacity, sw:, ability, sw:, incapable, sw:, potential, id:, afford, tr:, skilled, tr:, talented, ta:, skill, ta:, effectiveness, ta:, competence, el:, skilful, te:, efficiency, ko:, useful
fifteen: 
cruel: ru:, fierce, el:, tough, pa:, unkind
join: id:, participate, vi:, attend, vi:, involved, vi:, embark, vi:, adhere, vi:, participant, vi:, involvement, el:, unite, lt:, connect, pa:, newcomer, jv:, integrate
crime: hi:, guilt, ar:, offence, ar:, offense, te:, criminal
dust: sv:, dam, tr:, powder, te:, dirt
practical: zh:, functional, hi:, pragmatic, de:, practically, de:, convenient, de:, virtually, de:, handy, fa:, applied
colour: zh:, color, hi:, paint, hi:, dye, sw:, pale, sw:, coloured, sw:, colorful, fi:, flush, jv:, street, jv:, coding
destroy: zh:, wreck, zh:, undermine, zh:, sabotage, sw:, degrade, de:, demolish, id:, crush, id:, smash, vi:, ruined, tr:, confound, ta:, erase, ta:, negate, cy:, destruction
increase: hi:, proceed, sv:, enhance, id:, mount, pt:, raise, fi:, add, fi:, insert, pl:, growth, lt:, enlarge, mr:, hike, mr:, boost
nose: te:, beak
friendly: hi:, suited, hi:, favorable, hi:, congruent, de:, kindly, tr:, sincere, ta:, ally, ta:, friendship, fi:, kind
yesterday: hi:, tomorrow, pa:, nowadays
hesternal-tense: 
fail: zh:, failure, hi:, unsuccessful, sw:, defeat, cy:, unable, pl:, confound, pl:, disappoint
continue: zh:, proceed, sw:, continuous, sw:, persistent, vi:, continuation, ta:, constantly, fa:, persist, pa:, allocate, jv:, hold, jv:, onwards, ko:, connect, mr:, begin, mr:, perform
remove: sw:, rid, sw:, withdraw, sw:, eliminate, sw:, elimination, id:, wipe, id:, erase, ru:, delete, fi:, abolish, el:, subtract, cy:, draw, cy:, pull, pl:, expel, ko:, absorb
wear: de:, carry, fr:, porter
blind: 
fly: sw:, flying, sw:, jump, fa:, flight, cy:, aviation
praise: hi:, admiration, hi:, admire, sw:, reputation, sw:, merit, vi:, congratulate, ta:, congratulation
mission: 
sacrifice: de:, victim, lt:, prey, lt:, casualty, ko:, toll
exercise: hi:, work-out, sw:, assignment, ar:, practice, ar:, practise, id:, sport, ta:, fitness, fa:, rehearsal, he:, drill, ko:, movement, ko:, motion, ko:, campaign, ko:, athletic
conscience: ar:, pronoun, fr:, consciousness
theory: hi:, principle, sw:, theorist, ar:, theorem, jv:, theoretical
minister: 
hate: zh:, nasty, zh:, disgusting, sw:, hatred, sw:, dislike, sw:, prejudice, sw:, grudge, id:, resent, vi:, disgusted, tr:, loathing
lake: ko:, mere
centre: zh:, central, zh:, center, sw:, station, tr:, headquarters, jv:, middle
faint: hi:, unconscious, sw:, despair, sw:, desperate, sv:, weak, tr:, pale
rational-gender: 
brief: hi:, briefly, hi:, acronym, de:, short, de:, shortly, sv:, card, pa:, compact, pa:, overview, ko:, economic
worship: sw:, ritual
goods: zh:, product, hi:, cargo, sw:, item, sw:, merchandise, sw:, commodity, id:, stuff, pa:, freight, pa:, mall, mr:, fixture
skin: sw:, leather, sw:, absorption, id:, bark, id:, shell, id:, peel, pt:, fur, cy:, zest
roof: hi:, terrace, sv:, ceiling, pt:, covering, pt:, coverage
crown: 
castle: sw:, cage, ru:, lock, ko:, surname
throne: 
attached: hi:, engage, sw:, conditional, vi:, attach, ta:, connected, fa:, dependent, fa:, associate, te:, pair
mile: ar:, tendency, ar:, slope, ar:, lean, ar:, gradient, fa:, willing
prison: zh:, jail
thoroughly: sw:, well, sw:, comfortable, sw:, properly, sw:, smoothly, de:, thorough, ar:, quite, ar:, entirely, ar:, altogether, ar:, completely, ar:, fairly, ar:, totally, id:, fully, ta:, absolutely, ta:, purely, pl:, exactly, pl:, precisely, pl:, accurately
cup: zh:, mug
member: ar:, organ, ta:, membership, fr:, limb, it:, insider
civil: zh:, domestic, hi:, citizen, hi:, civic, sv:, civilian
everywhere: el:, throughout, jv:, somewhere
comply: zh:, execution, zh:, execute, zh:, enforce, de:, correspond, sv:, accompany, id:, meet, pt:, obey, it:, content, it:, satisfy, pa:, adhere, jv:, subject, mr:, compliance
whilst: te:, while, te:, though, te:, however, te:, although, te:, nevertheless, te:, whereas, te:, nonetheless
volume: sw:, much, sw:, extent, sw:, amount, sw:, relatively, sw:, quantitative, ta:, block, ta:, module, fa:, bulk, sr:, circumference, lt:, coverage, bn:, size, mr:, continent, mr:, clause
custom: vi:, client, ta:, optional, it:, costume, cy:, practice, cy:, habit, cy:, used-to
bow: sw:, arch, de:, arc, ru:, onion, pt:, curve
meat: zh:, flesh, sw:, beef
vegetal-gender: 
rare: vi:, rarely, cy:, hardly, te:, seldom
cousin: ta:, relative
bridge: sw:, grade, fr:, deck, ko:, leg, mr:, pool
protect: zh:, protection, zh:, conservation, sv:, guard, sv:, shield, vi:, defend, tr:, preserve, tr:, maintain, tr:, conserve, ta:, secure, mr:, defense, mr:, defence
salt: sw:, exaggerated, sw:, exaggerate, sw:, salty, he:, sailor
innocent: jv:, clean
queen: 
dance: sw:, drum, ar:, dancing, vi:, jump, vi:, skip
hotel: ta:, accommodation
fill: jv:, content, jv:, contents
prisoner: he:, convict
stairs: zh:, staircase, zh:, stair, sw:, ladder, ar:, drawer
gay: pa:, homosexual
sand: 
violent: zh:, violence, sv:, fierce, ar:, turbulent, id:, wonderful, tr:, severe, ru:, strong, fa:, intense, fa:, vigorous, fa:, wildly, fa:, intensive
september: 
ruin: hi:, destruction, hi:, subversion, sw:, damage, fi:, spoil, el:, disaster, el:, wreckage, he:, wreck, he:, demolish
cattle: sw:, cow
equipment: zh:, apparatus, zh:, device, sw:, stationery, de:, kit, ar:, gear, pt:, outfit, pt:, tackle, lt:, facility, lt:, fixture
perceived: ja:, perception, ko:, aware, ko:, perceive, ko:, recognize, ko:, recognition, ko:, awareness
anywhere: de:, somewhere, id:, wherever, ta:, nowhere, pa:, elsewhere
kitchen: fr:, cooking, el:, cooker
sell: sw:, sale, vi:, semi, pa:, seller, ko:, betray
speed: zh:, velocity, hi:, pace, hi:, momentum, sw:, sharply, pa:, dynamics, mr:, motion, mr:, accelerate
computer: sw:, computing
eternal: sw:, ever, sw:, forever, tr:, infinite, te:, permanent
library: sw:, librarian, fr:, bookcase
confusion: tr:, mess, ta:, chaos, it:, fuss, it:, confusing, pa:, confused, mr:, anarchy
article: zh:, essay, de:, item, he:, section, he:, clause, te:, diameter, ko:, engineer
cook: zh:, chef, id:, cooking, fa:, bake, pl:, boil
band: zh:, belt, de:, ribbon, de:, tape, ar:, squad, ru:, group, fr:, strip, fr:, stripe, el:, zone, pl:, strand, sr:, bunch, sr:, cluster, lt:, lane
desert: id:, wilderness, pt:, deserted
kiss: 
ice: de:, ice-cream, vi:, tape, ta:, snow
ball: sw:, rubber, id:, sphere, fr:, bullet, bn:, force, pa:, infant, he:, pill, ko:, emptiness, mr:, delivery
stick: de:, stock, de:, cane, ru:, adhere, fa:, wood, fa:, timber, pt:, bat, lt:, cue, bn:, staff, mr:, pole
argument: hi:, logic, sw:, move, ar:, controversy, tr:, discussion, tr:, debate, sr:, dispute, sr:, tract, he:, assertion, jv:, question, jv:, questions
observe: hi:, inspect, sw:, examine, sw:, explore, sw:, investigate, vi:, observation
benedictive-mood: 
striking: vi:, outstanding, tr:, stunning, ta:, strike, fa:, considerable, fa:, significant, fa:, substantial, fa:, noticeable, pt:, impressive, el:, surprising, el:, astonishing, mr:, remarkable
guilty: zh:, guilt, sv:, owe, vi:, offend, tr:, offender, ta:, convict, pa:, condemn
gun: de:, rifle, fi:, weapon
police: fi:, enforce, fi:, supervise
hide: hi:, secrete, sw:, disguise
expedition: hi:, campaign, ar:, drive, ta:, trip, ta:, journey, fa:, voyage, fa:, tour, pa:, crusade
cloud: jv:, cyberspace
waste: hi:, useless, hi:, unnecessary, it:, refuse, it:, refusal, it:, rejection, lt:, garbage, jv:, rubbish, mr:, trash
february: 
disease: zh:, illness, zh:, sickness, sw:, coronary, ar:, satisfactory, ar:, satisfying, ta:, syndrome
initiative-case: 
universal: 
estate: de:, well, id:, plantation, vi:, asset, tr:, land, ru:, property, pt:, ownership, lt:, fortune, lt:, wealth
humble: jv:, defeat, ko:, modest
delay: id:, postpone, te:, late
delayed-imperative: 
reported-evidential: 
unfortunate: zh:, unfortunately, hi:, unlucky, sw:, coincidence, sv:, unhappy, ru:, miserable, lt:, inadequate, lt:, incongruous, lt:, inappropriate
midnight: pl:, north
hero: sw:, warrior, ar:, champion
finger: tr:, toe, ko:, digit
press: sw:, media, ta:, magazine, ta:, journal, it:, printing, el:, type, el:, formula, ja:, push
reward: hi:, prize, sw:, gift, tr:, award, fa:, bonus, ko:, compensation, ko:, compensate
blame: hi:, fault, hi:, defect, hi:, flaw, de:, debt, de:, guilt, fa:, snub, fi:, prosecute, el:, liability, el:, responsibility, pa:, accuse, pa:, allege, ko:, condemn, ko:, denounce
misery: hi:, hardship, id:, suffering, vi:, anguish, fa:, miserable, cy:, boredom, pa:, suffer, pa:, grief, pa:, irony
forehead: 
ad: zh:, advertisement, zh:, advertising, zh:, advertise, zh:, advert, sw:, announcement, ta:, publicity, fi:, notice, fi:, declaration, jv:, to, jv:, for, te:, statement, te:, assertion, mr:, promotion, mr:, promote
angel: ar:, landowner, ta:, fairy, jv:, tough, jv:, tricky, te:, messenger
fame: ru:, glory, ta:, reputation, el:, rumour, el:, rumor, he:, advertising, he:, publicity, ko:, prestige
singular-number: 
dawn: de:, twilight
forgive: zh:, excuse, sv:, pardon, vi:, tolerate, lt:, exempt, lt:, relieve, lt:, dismiss, ko:, forgiveness
sheep: sw:, lamb, jv:, goat, ko:, amount, ko:, positive
resolution: hi:, resolve, de:, solution, ar:, decision, ta:, conclusion, el:, analysis, el:, breakdown, el:, break-down, cy:, determination, pl:, decay
patience: hi:, fortitude, sw:, forbearance, jv:, patient, jv:, impatient, jv:, tolerant, te:, tolerance, mr:, restraint
referential: zh:, reference, zh:, refer, bn:, specify, te:, directive
corn: fr:, wheat, cy:, horn, mr:, grain
key: zh:, bond, de:, button, tr:, switch, ta:, main, ta:, vital, ta:, prominent, ta:, sensitive, ta:, major, ta:, niche, ta:, mainstream, fa:, clue, mr:, that
majority: sw:, many, ru:, most
ignorance: zh:, ignorant, sw:, ridiculous, vi:, stupid, ta:, ignorative, ko:, thumb
weakness: el:, inability
profit: hi:, advantage, hi:, gain, hi:, benefit, sw:, viable, fi:, victory, pa:, beneficiary
bell: sw:, alarm, sv:, clock, ta:, hour
atmosphere: hi:, environment, sw:, sky, sw:, aviation, sw:, spatial, pa:, climate, pa:, surroundings
humanity: ta:, human
disk: hi:, disc, de:, slice, sv:, counter, ar:, cylinder, vi:, plate, it:, record, el:, tray
lonely: hi:, alone, sw:, loneliness, ta:, separately, fa:, single, fa:, merely, jv:, quiet, jv:, deserted
artist: de:, performer, vi:, painter, fr:, entertainer
charm: zh:, charismatic, hi:, attraction, ar:, magic, ar:, spell, pa:, aesthetic
slavery: ta:, slave, ko:, bond
governor: ar:, conservative, el:, ruler
branch: 
disposition: de:, arrangement, ar:, configuration, tr:, tendency, tr:, trend, fr:, provision, fr:, layout, el:, mood, sr:, schedule, sr:, timetable, jv:, residence, jv:, destination
luck: hi:, fortune, hi:, fate, sw:, lucky, de:, happiness, tr:, chance, te:, fortunate
derived: pa:, get, pa:, receive, pa:, derive, pa:, fetch, pa:, achieve, pa:, retrieve
inductive-mood: it:, inferential-mood, el:, deductive-mood
community: sw:, society, sw:, category, id:, people
oil: sw:, fat, sw:, fuel, sw:, fossil, sw:, marrow, sw:, thermal, ru:, butter
pipe: zh:, tube, sw:, tap, sw:, faucet, ar:, poop
print: tr:, edition, tr:, pressure, tr:, printing, ta:, axis, ta:, mold, fr:, impression
oh: ar:, ya, mr:, array
discourse-context: 
vocative-case: 
cabin: sv:, cottage, vi:, tent, vi:, lodge, he:, chamber, he:, cell, he:, compartment
nervous: zh:, tense, hi:, confused, hi:, disturb, hi:, upset, hi:, embarrassed, hi:, disturbing, hi:, harass, hi:, upsetting, ar:, neural, vi:, worried, tr:, nerve, ko:, strong, ko:, powerful, ko:, intensive
distinction: zh:, respectively, sw:, differently, sw:, variations, id:, diversity, bn:, differ, pa:, distinguish, pa:, gap, pa:, differentiate, mr:, difference, mr:, contrast, mr:, variation, mr:, variance
burden: bn:, perceive, bn:, load
silk: te:, grasp, te:, grip
contempt: zh:, despise, hi:, hatred, hi:, dislike, hi:, disgust, hi:, loathing, id:, snub, tr:, insult, tr:, outrage, ta:, negligence
hell: 
separated: zh:, separate, hi:, aside, hi:, apart, hi:, distinct, hi:, differ, hi:, separately, hi:, aloof, hi:, discrete, sw:, isolation, sw:, ostracize, tr:, delimited, cy:, separation, te:, distinguish, ko:, isolate, ko:, disjunction
mixed: sw:, mixture, sw:, combination, vi:, composite, fa:, mix, fr:, joint, jv:, fusion
wooden: zh:, wood, sw:, timber
treat: zh:, treatment, zh:, therapy, hi:, cure, sv:, process, ru:, consider, ta:, therapist, fa:, remedy, fr:, deal, sr:, heal, bn:, behave, te:, aid, ko:, chin, ko:, jaw
warning: zh:, caution, zh:, warn, hi:, alert, id:, memorial, cy:, notice
admonitive-mood: 
ambition: sw:, disappointed, sw:, disappointment, sw:, lust, sw:, discourage, ar:, ambitious
yield: pl:, efficiency, jv:, reproduce, mr:, income
somehow: el:, somewhat, te:, something
counsel: vi:, consultant, fr:, hint, bn:, advise, bn:, consultation, he:, advice, he:, tip, ja:, lawyer, ja:, attorney, mr:, advocate
constitution: sw:, charter, ta:, constitutional, mr:, incident, mr:, occurrence
instrument: hi:, tool, sw:, vessel, sw:, entity, sw:, organ, sw:, container, fa:, utility, bn:, device
steady: zh:, stable, zh:, stabilize, hi:, regular, hi:, regularly, ar:, fixed, ar:, constant, tr:, constantly, tr:, continuous, ru:, sustainable, ta:, standard, ta:, static, fa:, fix, cy:, consistent, pl:, permanent, he:, stationary, jv:, relaxed
elements: sw:, factors, bn:, element, bn:, component, bn:, ingredient, bn:, components, pa:, essence, mr:, ally, mr:, factor, mr:, parameter
continuous-aspect: 
online: 
tide: ru:, wave, sr:, snap
college: zh:, faculty, zh:, academy, sw:, campus, vi:, university
tail: tr:, queue, bn:, trail
generation: fa:, descendent
cat: 
direct-evidential: 
abandoned: sw:, neglect, de:, leave, de:, deserted, de:, quit, de:, abandon, te:, dissolve, te:, cancel
eleven: 
instinct: hi:, spontaneous
tribe: de:, trunk, sv:, stem, cy:, load, ko:, lack, ko:, lacking, ko:, deficiency, ko:, deficit, ko:, shortage
apprehensive-mood: 
shelter: hi:, resort, sw:, residence, sw:, settlement, sw:, habitat, sw:, residential, de:, protection, ta:, dorm, cy:, asylum, bn:, harbor
rude: zh:, rudely, id:, rough, id:, unkind, ko:, harsh
riding: hi:, ride, ta:, rider
profession: zh:, occupational, hi:, career, de:, occupation, vi:, professional, te:, vocational, mr:, business
lamp: bn:, candle
coffee: fr:, cafe, pa:, sufficient, pa:, sufficiently, pa:, adequate
nurse: he:, sister
assure: zh:, assurance, zh:, warrant, zh:, pledge, zh:, guarantee, zh:, insure, sv:, ensure, id:, ascertain, id:, confirm, tr:, provide, tr:, cater, ta:, sure, fi:, convince, fi:, affirm, cy:, secure, ko:, palladium
shoes: zh:, shoe, sw:, sandal
crew: sw:, staff, sv:, herd, vi:, team, cy:, bunch, te:, personnel
yard: zh:, code, id:, page, fr:, courtship
vague: zh:, ambiguity, hi:, obscure, hi:, ambiguous, hi:, unclear, ar:, mysterious, tr:, uncertain, tr:, indefinite, fr:, wave, pt:, vacant, pa:, unintelligible
apartment: de:, flat, tr:, circle, el:, compartment, pl:, suite, bn:, wagon
activity: sw:, transaction, ta:, function, te:, operations
saturday: pa:, weekend
holder: 
sunshine: tr:, solar, tr:, sunscreen, pa:, shine, ja:, daylight
widow: 
communication: sw:, contact, sw:, correspondence, sw:, communicative, vi:, communicate, ta:, interaction, ta:, interact, fa:, relation, fa:, relate, fa:, relationship, fa:, correlation, fa:, relevance, el:, notice, el:, announcement, pa:, transaction, pa:, spray, jv:, occupational, mr:, dialogue, mr:, interface, mr:, dialog
reflection: de:, contemplation, ja:, reflex, jv:, imagination
organization: zh:, tissue, zh:, organisation, zh:, organize, hi:, outfit, sw:, corporation, sw:, utility, vi:, agency, ru:, entity, ta:, system, ta:, structure, ta:, texture, ta:, layout, cy:, institution, cy:, institute, he:, association, te:, firm, te:, enterprise, te:, airline, ko:, organized
star: 
guest: sw:, stranger, sw:, visitor, sw:, alien, sw:, foreigner, sw:, newcomer, fr:, client, fr:, customer, it:, host
bar: sv:, bare, tr:, pub, fa:, load, fa:, cargo, fa:, freight, it:, cafe, pl:, barium, pa:, strip, pa:, bandage, pa:, belt
bottle: id:, jar, ko:, sickness
bless: fa:, blessing, he:, greet
stir: id:, manipulate, fr:, mix, fi:, evoke, el:, riot, he:, excite
quarrel: hi:, variance, de:, dispute, tr:, fight, it:, litigation, lt:, argue, mr:, disagreement
inner: zh:, within, zh:, inside, hi:, interior, hi:, internal, sw:, local, sw:, domestic, sw:, indoor, id:, mental, ta:, insider, jv:, main, jv:, major
resistance: sw:, opposition, ru:, opposing, ta:, protest, ta:, resistant, ta:, anti, pa:, resent, he:, objection
hollow: ta:, plain, ta:, bare, ta:, blank, it:, cable, ko:, hole
province: vi:, provincial, he:, district, he:, county, ko:, fat
civilization: he:, culture
hang: bn:, supervise
shock: hi:, blow, ar:, trauma, ta:, shocking, fr:, clash, ko:, impact, ko:, stun
exception: sw:, partial, sw:, discrimination, sw:, stereotype, cy:, exemption, pa:, conflict, he:, outstanding, te:, exempt, te:, deduction
strain: hi:, stress, hi:, tension, sw:, load, fr:, fatigue, it:, effort, el:, intensity, bn:, embrace, te:, racial, te:, ethnic
driving: hi:, drive, tr:, driver, it:, guide, sr:, ride
swear: sv:, swearing, jv:, pledge
treasure: zh:, jewel
seed: sw:, sperm, vi:, nut, vi:, particle, ko:, mr
tower: 
favourite: zh:, favorite
recently: zh:, recent, sv:, freshly, ar:, newly, ja:, nowadays, jv:, afterward
awake: hi:, conscious, sw:, morale, id:, wake, tr:, alert, mr:, excite
furniture: 
rope: zh:, cord, sw:, string, sw:, strap, jv:, bind
adventure: zh:, venture, zh:, hazard, ar:, gamble
royalty: el:, reign
feast: id:, party, ru:, celebration, ta:, banquet, he:, holiday, te:, dinner
annual: sw:, year, sw:, annually
scale: de:, frame, de:, framework, ar:, gauge, vi:, ratio, fr:, ladder, it:, staircase, it:, stair, jv:, size, jv:, criterion, jv:, dimension, te:, level, mr:, extent, mr:, proportional
consequently: te:, consequence, ko:, therefore
foundation: zh:, base, zh:, basis, sw:, based, sw:, fundamental, sw:, primary, sw:, elementary, sw:, core, sw:, basic, sv:, shallow, sv:, undergraduate, ar:, grounds, vi:, platform, pa:, foundations, jv:, fundamentally, ko:, underlie
ceremony: zh:, ritual, hi:, function, bn:, celebration, pa:, concert, ja:, formula, ko:, consciousness
hunting: hi:, hunt, hi:, victim, hi:, prey, fr:, chase, el:, shooting
liberal: hi:, generous, vi:, freely
largely: hi:, substantially, sw:, significantly, vi:, most, vi:, mainly, ta:, mostly, fa:, greatly, pt:, widely, lt:, predominantly, bn:, originally, bn:, essentially, bn:, basically, te:, increasingly
princess: jv:, daughter, jv:, bride
altar: fa:, sanctuary
web: sw:, network, de:, net, ar:, grid, id:, tissue, it:, canvas, ko:, knitting
purple: ru:, magenta
gather: zh:, collect, ar:, accumulate, el:, shrink, lt:, dial, mr:, leftovers
election: hi:, choice, hi:, elect, sw:, trail, sw:, poll, sv:, whale, tr:, selection, pa:, selective
drunk: hi:, alcoholic, pa:, drunkenness
pour: zh:, topple, sw:, shed, tr:, spill, fi:, overthrow
lift: zh:, elevator, sw:, elevate, sw:, uplift, ar:, raise, ar:, hike
gesture: sw:, sign, sw:, signal, sw:, symbol, sw:, symbolic, id:, attitude, id:, posture, pa:, hint, pa:, indication
manage: zh:, management, sw:, supervise, sv:, handle, ar:, administration, vi:, govern, ru:, steer, cy:, control, bn:, operate, jv:, would, jv:, arrange, jv:, organize, jv:, configure, te:, perform, te:, maintain
exchange: zh:, swap, sw:, reciprocal, tr:, swop, pl:, replacement, bn:, commutative, pa:, currency, pa:, monetary, he:, alternate, te:, transplant
definite-article: 
emperor: hi:, monarch
finish: zh:, finished, hi:, ending, sv:, end, ta:, plaster, pl:, over, lt:, decoration, te:, conclusion
ugly: lt:, nasty, lt:, disgusting, jv:, cheerful, jv:, enjoyable, jv:, amusing
genuine: zh:, true, hi:, real, hi:, actual, hi:, virtual, sw:, exact, id:, original, id:, native, id:, innate, id:, indigenous, lt:, certain, lt:, confident, jv:, column, ko:, sincere
inch: de:, customs, fr:, thumb
beard: sr:, chin
tear: de:, snatch, pa:, erosion
resist: zh:, anti, hi:, opposition, hi:, contrast, hi:, protest, hi:, contrary, sw:, oppose, sw:, interrupt, sw:, opposing, id:, refuse, id:, reject, pa:, opposed, he:, object, ko:, endure, mr:, hostility, mr:, contradiction
merchant: de:, dealer, fa:, businessperson, mr:, merchandise
independence: zh:, independent, hi:, liberty, sw:, freely, sw:, freedom, sw:, autonomy, bn:, liberation
smell: ta:, perfume, bn:, flavor, bn:, flavour
eighteen: 
historical: sw:, historically, vi:, history, it:, historian, bn:, historic
gross: hi:, total, hi:, aggregate, id:, dirty, fr:, raw, fr:, crude, jv:, arousal, te:, macro, ko:, eager, ko:, severe, ko:, intense, mr:, dot, mr:, overall
root: tr:, stem, fi:, freshly, ja:, route, mr:, original, mr:, origin
mud: zh:, soil, hi:, slime, sv:, clay, ru:, dirt, fa:, flower
simplicity: zh:, simple, sw:, humility
veil: hi:, curtain, fr:, sail, fr:, sailing, bn:, screen, mr:, membrane
theatre: zh:, theater
comparison: hi:, compare, sw:, comparative, sv:, correlation, id:, ratio, it:, confrontation, he:, comparable
composition: vi:, component, bn:, structure, bn:, formation, ko:, construction, ko:, constitute, ko:, construct, ko:, organize, ko:, configuration, ko:, configure
rival: zh:, opponent, sw:, dissident, ta:, competition, ta:, competitive, pl:, compete, bn:, competitor, pa:, counter, pa:, contradictory, pa:, anti
realize: zh:, achieve, sw:, recognize, sw:, recognition, sw:, identify, sw:, diagnose, id:, unaware, tr:, execute, ta:, feel, ta:, perceive, fi:, understand, fi:, grasp, bn:, accomplish, mr:, memorize
balance: zh:, equilibrium, sw:, equally, sw:, equality, sw:, horizontal, vi:, proportional, fa:, par, it:, budget
coach: de:, trainer, ta:, practitioner, fa:, tutor, fa:, mentor
humour: zh:, humor, zh:, humorous, sv:, mood, ta:, comedy, mr:, joke
novel: zh:, fiction, tr:, new, tr:, newly
revenge: id:, grudge
resources: bn:, asset, pa:, source, pa:, resource, he:, means, jv:, supply
jealous: sw:, jealousy, sw:, envy
wheel: fi:, bike, lt:, circle, pa:, cycle
burnt: cy:, burn
flash: fi:, lightning, el:, glow, el:, shine, ko:, flashlight
suggest: zh:, suggestion, zh:, recommendation, sw:, propose, sw:, recommend, vi:, proposal, el:, nominate, cy:, imply, pa:, feedback, te:, indicate, ko:, proposition
imprecative-mood: 
helpless: 
groups: ja:, group, jv:, deck
club: fi:, bat
flood: he:, overwhelm
enjoyment: zh:, enjoy, de:, pleasure, fa:, joy, fa:, delight, jv:, happiness, mr:, glad, mr:, pleased, mr:, delighted, mr:, cheer
indifference: hi:, apathy, sw:, careless, mr:, neglect, mr:, ignore, mr:, overlook
horizon: 
assumptive-mood: fa:, hypothetical-mood
steep: sw:, elevation, bn:, perpendicular, mr:, much
harmony: sw:, compromise, el:, tune
childhood: 
knee: sv:, lap
mutual: de:, each-other, sv:, reciprocal, sr:, common, sr:, joint, te:, interaction, te:, interactive
software: fa:, application, fi:, repertoire
injury: hi:, hurt, sv:, harm, sv:, damage, sv:, injure, ar:, wound, ru:, trauma, ta:, injured, sr:, violation
receipt: sw:, receive, de:, entrance, id:, reception, id:, admission, id:, acceptance, ta:, voucher
discipline: zh:, subject
slip: zh:, slippery, sv:, slide, sv:, glide, he:, gaffe
revolution: sw:, revolutionary, sw:, coup, sv:, rotation, ar:, revolt, el:, rebellion
farmer: hi:, peasant
stroke: fa:, blow, pt:, coup, it:, rush, it:, scramble
privilege: zh:, privileged, sw:, preference, sw:, quota, ar:, franchise, ta:, offer, ta:, concession
student: hi:, pupil, hi:, scholar, ru:, undergraduate, ko:, academic
cave: 
tradition: zh:, traditional, zh:, traditionally, sw:, customs, el:, surrender
tragedy: sw:, epidemic, ta:, sadness, pa:, paradox
inn: cy:, pub
virgin: jv:, maid
farewell: id:, goodbye, fr:, bye, pa:, byebye
criticism: zh:, criticize, hi:, critique, el:, review
cotton: sw:, wool
hospital: hi:, asylum
rent: hi:, fare, hi:, hire, sw:, tax, sw:, tribute, sv:, lease, vi:, employ, vi:, engage, vi:, rented, fi:, charter
gas: 
inevitable: tr:, inevitably
deadly: ko:, vital
leaf: de:, sheet, sv:, blade
publication: zh:, publish, hi:, publishing, sw:, printing, vi:, proclaim, tr:, broadcast, ta:, release, ta:, output, fa:, diffusion, cy:, announce
translation: zh:, translate, zh:, translative, sw:, interpretation, vi:, epidemic, ru:, transfer, ko:, version
beach: de:, strand, id:, coast
funeral: zh:, burial, id:, cemetery, mr:, bury
flour: sw:, powder, sw:, dough, ar:, exact, ar:, accurate, ar:, precise, lt:, meal
roar: sw:, dramatic, vi:, shout, fa:, noise
romantic: pa:, waist, pa:, hip
hut: hi:, cottage, de:, lodge, ja:, shed
mimetic: 
dollar: 
sixteen: pa:, sixty
assembly: sw:, meeting, sw:, conference, sw:, congress, fi:, configuration, bn:, rally
colony: 
wing: ar:, ward, ar:, suite, bn:, limb, bn:, fin, ko:, flight, ko:, aviation
lion: 
cunning: zh:, tricky, fr:, trick, it:, skilful, pa:, clever, mr:, diplomatic
drama: hi:, pretend, vi:, dramatic
mist: sw:, fog
hypertext: tr:, hyperlink
medicine: hi:, drug, sw:, remedy, sw:, spray, sw:, prescription
fourteen: pa:, without, pa:, exclusive, pa:, sine
acid: zh:, sour, fr:, acidic, ko:, mountain, ko:, mount
namely: ar:, any, ar:, i.e.
user: sr:, beneficiary, lt:, consumer
bishop: 
orange: 
bath: ar:, bathroom, id:, shower, vi:, bathtub
derivative: hi:, compound, id:, transcription, fa:, derive
primitive: fa:, early, fa:, initial, mr:, ancient
basket: pl:, bin, lt:, bag, jv:, basketball
secretary: bn:, editor
salvation: id:, safety, tr:, liberation, fr:, hi, bn:, rescue, bn:, recovery, bn:, retrieve
today: 
hodiernal-tense: 
intend: hi:, intended, hi:, intention, sw:, interested, sw:, keen, sw:, motive, sw:, unwilling, lt:, devote, lt:, dedicate, pa:, determination
steam: 
poison: sw:, poisonous, sw:, toxic, sw:, herbicide, te:, poisson
talent: hi:, brilliance, sw:, talented, vi:, qualification, tr:, ability, ta:, repertoire
effective: zh:, valid, zh:, effectively, sw:, efficient, sw:, effectiveness, tr:, influential, ta:, useful, ko:, active, ko:, available, mr:, impressive
wash: hi:, washing
confession: sw:, acknowledge, sv:, creed, ar:, recognition, bn:, admission, jv:, claim
nonsense: hi:, rubbish, vi:, unreasonable, vi:, incongruous
coal: sv:, carbon
vice: ta:, associative, pa:, bye, he:, deputy
temporary: sw:, interval, sw:, duration, sw:, temporal, sv:, casual, sv:, accidental, ar:, timer, id:, while, ko:, contemporary
delimitative-aspect: 
bone: sv:, leg, pa:, fracture, jv:, skeleton
monday: 
tuesday: vi:, third
wednesday: vi:, fourth
federal: zh:, federation, ta:, central
desirable: tr:, attractive, fa:, favorable
representative: zh:, represent, zh:, behalf, zh:, delegate, hi:, attorney, id:, deputy, el:, spokesperson
linen: pl:, underwear
sink: sw:, drown, fi:, basin, cy:, zinc, pa:, sync
nephew: sw:, niece, vi:, grandson, it:, grandchild
siege: tr:, surround, fr:, seat
stomach: hi:, belly, sw:, abdominal, sw:, matrix
summit: hi:, peak, id:, top, sr:, tip, pa:, convention, te:, ridge
exclusive-person: 
seize: hi:, tackle, ar:, confine, ar:, detain, ar:, reservation, id:, snatch, vi:, occupied, vi:, occupy, it:, impound, el:, grab, pl:, grasp, he:, perceive, jv:, get, jv:, assert, te:, possession
fence: id:, hedge
statue: id:, sculpture
luxury: 
artillery: bn:, shave
arrest: id:, catch, id:, capture, fa:, detain, pt:, fasten, it:, halt, el:, conception
pack: zh:, parcel, zh:, packet, zh:, package, zh:, wrap, ar:, bundle, fa:, closed, fa:, shut, sr:, wrapping, sr:, packaging
surrounding: zh:, around, sw:, neighborhood, sw:, neighbour, sw:, neighbor, sw:, neighbourhood, id:, peripheral, ta:, surroundings, cy:, adjacent, he:, comprehensive, jv:, environment, jv:, environmental
strictly: zh:, strict, sw:, coherent, ar:, accurately, id:, tight, vi:, severe, tr:, certainly, tr:, absolutely, tr:, definitely, fi:, tightly, cy:, harsh, te:, sure, te:, exactly, te:, precisely
remainder: pa:, rest, pa:, remaining, pa:, elapse, ko:, leftovers
deer: 
bush: 
railroad: zh:, railway, hi:, rail
discharge: hi:, liberation, de:, unload, id:, release, id:, relinquish, ta:, expel, ko:, emit
heir: hi:, inherit, pa:, possess
oak: 
unpleasant: id:, delight, id:, pleasing, vi:, uneasy, vi:, annoyed, vi:, upsetting, ru:, nasty, fi:, uncomfortable
piano: 
persuade: zh:, convince, hi:, celebrate, hi:, commemorate
invisible: id:, mysterious, bn:, disappear
well-known: ar:, famous, sr:, notorious, lt:, prominent
cruelty: 
temptation: ko:, tempt
telic-aspect: 
international: sw:, global, sw:, multinational
interfere: zh:, interference, hi:, intervention, sw:, intervene, id:, disturb, id:, bother, id:, disturbing, id:, interrupt, id:, annoy, id:, irritate, id:, harass, pl:, clash, jv:, annoying, ko:, let, ko:, disturbance
subtle: hi:, micro, sw:, trick, sw:, craft, id:, delicate, id:, smooth, id:, finely, tr:, fine, tr:, thin, fi:, discreet, he:, gentle
philosopher: hi:, philosophical
elegant: pt:, fashionable, cy:, delicate, pa:, wonderful, pa:, excellent, pa:, remarkable, pa:, glorious, pa:, incredible, pa:, fantastic, pa:, emphatic, pa:, phenomenal
welfare: ar:, benevolence, tr:, prosperity, ru:, provision
fishing: 
steal: ar:, theft, ta:, rob, fa:, robbery, it:, swipe, he:, plagiarize, mr:, mistreat
lip: sw:, beak, sw:, oral, el:, brink
retire: zh:, retirement, zh:, retired, zh:, retiree, id:, retreat, ta:, rest, ta:, leisure, el:, withdraw, jv:, pension
economy: zh:, economic, zh:, economically, sw:, economics, sw:, recession, fr:, saving, fi:, household, jv:, economist
stretch: sw:, straighten, ta:, extend, it:, tract, it:, trait, cy:, piece, cy:, passage, cy:, fragment, cy:, chunk, jv:, segment, jv:, proportion
parallel: sw:, alongside, sw:, compatible, ta:, associate, ta:, affix, te:, horizontal
atelic-aspect: 
prohibitive-mood: zh:, prhobitive-mood
tie: sw:, eagle
egg: 
artificial: hi:, synthetic
inspiration: hi:, motive, hi:, motivation, sw:, impulse, vi:, inspire, el:, brainstorm, bn:, encouragement, he:, induction, te:, stimulation, mr:, stimulus, mr:, motivate
meanwhile: sw:, simultaneously
crisis: hi:, hazard, pt:, slump, el:, judgment, el:, judgement, cy:, emergency
polite: vi:, courtesy, pt:, educated, jv:, ethical
seal: sw:, stamp, ru:, printing, te:, impression
lunch: fr:, breakfast, cy:, dinner, ja:, ranch, te:, meal, te:, dine
despite: zh:, spite, id:, though, id:, although
landscape: hi:, scenario, sw:, surroundings, sw:, environment, sw:, context, sw:, environmental, de:, countryside, ta:, natural, fa:, view, fa:, vision, fa:, prospect, fa:, outlook
artistic: ta:, art, te:, artwork
alliance: zh:, union, zh:, league, zh:, coalition, hi:, combine, id:, partnership, te:, constellation
maximum: hi:, maximize, ar:, extreme, ar:, ultimate, fa:, most, pa:, than, pa:, over, pa:, exceed
miracle: zh:, wonder
copper: sw:, bronze
purity: pl:, chastity, pa:, accuracy, pa:, precision
republic: el:, democracy
telephone: zh:, phone, sw:, mobile
whip: bn:, strap
shirt: ta:, t-shirt
introduce: zh:, introduction, zh:, presentation, sw:, establish, sw:, initiate, ar:, render, ar:, provision, vi:, recommend, vi:, referral, ru:, inject, cy:, deliver, cy:, delivery, pl:, depict, pl:, portray, te:, contact, ko:, insert
sofa: ar:, armchair
sweep: ar:, wipe, vi:, scan
thief: 
channel: jv:, drain
reform: hi:, improvement, hi:, correction, sw:, evolution, cy:, amend, bn:, amendment, pa:, refine, ko:, revision, mr:, update
thirst: mr:, thirsty
threatening: hi:, threat, sw:, threaten, te:, frightening
palm: 
encourage: zh:, encouragement, sw:, inspire, id:, drive, id:, push, id:, promote, vi:, incentive, cy:, urge, he:, cheer
speaker: sw:, spokesperson, bn:, lecturer
threshold: te:, entrance, te:, admission
induce: sw:, lobby, ar:, urge, id:, cause, tr:, warn, ta:, excite, fi:, pose, sr:, tempt, lt:, evoke, he:, soak, ko:, derive, ko:, induction, mr:, affix
neat: ar:, tidy, tr:, clean, jv:, good, jv:, wonderful, jv:, fancy, jv:, beautifully, jv:, nicely
session: zh:, meeting, zh:, conference, mr:, semester
torture: sw:, suffering, bn:, anguish, te:, violence, ko:, rack, ko:, adviser
damp: sw:, dirt, id:, wet, ru:, muggy
traveller: zh:, visitor, zh:, traveler, zh:, tourist, hi:, passenger, pa:, voyage, pa:, travel
mill: id:, factory, id:, manufacturing, ta:, plant, bn:, faucet, jv:, brewery, ko:, wheat
map: de:, card, ta:, diagram, ta:, graph, sr:, fare, sr:, ticket, te:, symbol, te:, icon, ko:, leadership
fountain: pt:, source, pa:, waterfall, ko:, fraction
collar: ar:, surround, bn:, zone
replace: zh:, replacement, id:, displace, vi:, spare, vi:, alternative, vi:, substitute, vi:, substitution, vi:, displacement, tr:, alter, tr:, vary, tr:, amend, pl:, sub, pa:, modify, he:, switch, jv:, relieve, jv:, adapt, te:, compensate
deliberately: zh:, intentional, sw:, deliberate, de:, aware, de:, conscious, id:, purposive, jv:, accidental
beer: pt:, pint
velvet: 
positively: hi:, positive, vi:, actively, ta:, favour, ta:, favor, ko:, entirely, ko:, totally
gravity: ta:, attraction, ta:, crush, pa:, seriously
sermon: pl:, preach, te:, discourse, te:, lecture
partner: hi:, fellow, hi:, associate, sw:, girlfriend, sw:, boyfriend, id:, pair, id:, mate, tr:, common, tr:, joint, ta:, shareholder, pa:, colleague, pa:, spouse
abuse: ta:, mistaken, ta:, wrongly, te:, damn
flock: sw:, group, sw:, herd, id:, swarm, ko:, tycoon
thirteen: pa:, thirty
justify: de:, warrant, vi:, plead, vi:, advocate, fa:, justification, cy:, justified, pa:, legitimate, mr:, adjust
manuscript: sw:, bill, id:, script, ko:, plaintiff
friday: ta:, silver, ta:, venus
brush: vi:, comb
download: ar:, upload
cream: vi:, ice-cream
monster: id:, giant, id:, monstrous
frozen: cy:, freeze
pot: sw:, pan, fa:, vase, fr:, jar, el:, container, bn:, cooker, te:, pat, mr:, vessel
rice: 
behaviour: zh:, behavior, zh:, behavioral, sw:, character, sw:, habit, sw:, characteristic, sw:, tendency, de:, conduct
coin: pt:, currency, pa:, penny
revenue: he:, income
insist: hi:, loud, hi:, thrust, hi:, assert, sw:, underline, sw:, emphasize, id:, persist, tr:, insistence, fi:, require, pa:, emphasis, pa:, traction, pa:, stressed, ja:, argue, ja:, allege
leap: 
apple: ko:, apology, ko:, apologize
discuss: zh:, discussion, sw:, negotiate, tr:, argue, jv:, hash, mr:, talk
background: 
transcribe: tr:, adapt, sr:, rewrite, bn:, simulate
entertainment: zh:, recreation, hi:, entertainer, sw:, leisure, sw:, entertaining, vi:, entertain, tr:, fun, ta:, hobby, bn:, relaxation, te:, amuse, ko:, hospitality
virus: 
childish: sw:, soprano
robe: sw:, garment, tr:, dress, it:, gown, cy:, uniform, cy:, outfit, bn:, wardrobe
reflect: sw:, contemplation, sw:, meditation, sw:, meditate, pa:, reveal, jv:, projection, jv:, depict
convert: hi:, alter, sw:, transform, ar:, switch, ar:, mutation, bn:, transition, ja:, transformation
outline: zh:, profile, zh:, contour, sw:, summary, de:, sketch, sv:, expose, sv:, overview, tr:, draft
opera: 
elbow: tr:, bracket
attachment: id:, appendix, ta:, connection, ta:, patch, ta:, link, ta:, connector
repair: hi:, restoration, id:, improvement, fa:, reconstruct, fi:, correction, he:, amend, mr:, amendment
fist: sw:, punch, ar:, grip
suspicious: sw:, suspicion, tr:, suspect
scripture: zh:, bible, de:, typeface, el:, script
pit: sw:, hole, ta:, excavation, cy:, pool, pa:, ditch, he:, boron
disorder: sw:, chaos, sw:, anarchy, sw:, unrest, de:, disturbance, id:, mess, ru:, upsetting, fi:, interference, ja:, fault, ja:, obstacle
applause: tr:, clap, ta:, applaud, cy:, approval
binary: fa:, dyadic
abbey: sv:, monastery
arrow: 
tend: id:, liable, fi:, usually, fi:, normally, bn:, orientation, jv:, plenty, te:, consist, ko:, defend, mr:, trend
elaborate: hi:, detailed, sw:, define, sw:, clarify, sv:, develop, id:, complicated, id:, tricky, ru:, work-out
loyalty: zh:, devoted, zh:, loyal, sw:, trust, sw:, faithfully, sw:, honestly, sw:, distrust, sw:, credibility, el:, faith, el:, belief
tremble: zh:, shiver, bn:, vibration
exile: tr:, shoot, ta:, abroad, ja:, asylum
mechanical: zh:, machinery, zh:, mechanic, tr:, mechanics, el:, engineer
successfully: ja:, nicely, jv:, succeed, jv:, unsuccessful, jv:, outcome
trap: sw:, grip, sv:, convict
cake: sw:, pastry, de:, pie, id:, cookie, pl:, dough
sir: zh:, mr, zh:, mister, de:, lord, fa:, gentleman
hesitate: hi:, hesitation, sw:, knock, ar:, haunt, ar:, frequency, pl:, hover
seventeen: 
feminine: hi:, feminine-, sw:, female, id:, lady, mr:, delicate
honey: 
stake: zh:, bet, de:, proportion, tr:, pile, ru:, share, ru:, fraction, fi:, contribution, he:, gamble, jv:, shareholder
brick: vi:, tile
legend: ar:, myth
harvest: hi:, crop, bn:, crops
stove: sv:, cooker, ru:, slab, sr:, oven, ko:, fireplace
rebel: zh:, revolt, ta:, rebellion, te:, coup
old-fashioned: id:, ancient
swell: zh:, inflate, vi:, swollen, fa:, inflation, cy:, swelling, cy:, enlarge
improve: zh:, raise, zh:, enhance, id:, fix, id:, remedy, fi:, cure, fi:, heal, cy:, improvement, jv:, add, jv:, add-, ko:, circulate
bowl: 
stare: it:, fix, mr:, gaze
industrial: sw:, manufacturing, sw:, industrialization, id:, industry
dressing: ar:, sauce, ru:, bandage
theme: zh:, topic, zh:, motif, hi:, subject, el:, issue, pl:, motive
ascetic: 
manager: hi:, steward, sv:, chief, sv:, boss, ar:, administrator, vi:, director, fa:, moderator, fi:, leader, fi:, executive
drag: hi:, draw, de:, pull, sv:, haul, ar:, withdraw, ar:, revoke, vi:, scissors, ta:, traction, bn:, drawer, ja:, drug
chorus: sv:, drive
rational: zh:, justified, sw:, logic, sw:, logical, sw:, unreasonable, vi:, sensible, fa:, reasonably, el:, reasonable, jv:, apparent
processing: el:, edit, he:, processor, mr:, process, mr:, processes, mr:, procedure
wolf: 
carpet: zh:, rug
antiquity: ja:, ancient, jv:, era
fertile: he:, fourier
whistle: sw:, flute
cheese: 
bite: hi:, chop, hi:, carve, fa:, sting, ja:, morsel, ja:, sip, mr:, harm, mr:, deprivation
cathedral: 
wander: zh:, stroll, de:, migrate, sv:, hike, bn:, depart, pa:, distortion
navy: de:, marine, ru:, fleet
mask: hi:, facade, sv:, worm
pencil: sw:, pen
vegetable: sw:, vegetarian
trousers: hi:, trouser, sw:, pants
corruption: ta:, scandal, cy:, pollution
cabinet: sv:, cupboard, ar:, closet, ar:, wardrobe, it:, toilet
soup: 
surgeon: sw:, surgery, sw:, surgical, ta:, operation, he:, analyst
allowance: sv:, replacement, sv:, substitute, sv:, compensation, ar:, apposition, fr:, allocation, pl:, appendix
spy: jv:, perceive
reckless: hi:, careless, hi:, untidy, pa:, negligence, ko:, unreasonable
gossip: sw:, rumour, sw:, rumor, ko:, chat
systems: pa:, system
token: 
abstract: de:, summary, el:, syllabus
accent: hi:, pronounce, hi:, pronunciation, ar:, dialect, ru:, emphasis
sincerely: hi:, honestly, id:, seriously, vi:, sincere, tr:, faithfully
approve: sw:, adopt, sv:, authorise, vi:, approving, tr:, confirm, tr:, affirm, ta:, consent, ta:, approval, ta:, endorse, fi:, accept, sr:, grant, jv:, favorable, mr:, sanction
architecture: te:, structure, te:, construction, te:, texture
crack: hi:, crevice, id:, cracked, fa:, depart, fa:, quit, pl:, fracture
pavement: hi:, curb, sw:, pitch, sw:, slime, sv:, sidewalk, ta:, walkway, ko:, packaging
decisive: de:, crucial, sv:, vital, id:, determine, vi:, decide, cy:, assertive, jv:, assign, jv:, specify, ko:, final, ko:, critical, mr:, coup
negative: fr:, adverse, ko:, denial, ko:, negation, ko:, negate
festival: sw:, concert, te:, epiphany, mr:, celebration
treason: 
hunter: bn:, predator
snake: hi:, reptile
battery: 
detective: ta:, deduction, it:, investigator
swim: sw:, swimming
envelope: ar:, circumstance, tr:, adverb
cigarette: sw:, smoking, ko:, weed
motor: hi:, automobile, ar:, engine, vi:, motive, fa:, motorbike, jv:, motorcycle
volunteer: sw:, dedicate, tr:, voluntary, te:, charity
reaction: zh:, reactive, hi:, response, hi:, respond, hi:, react, hi:, feedback, te:, exposure, ko:, reactor
baggage: zh:, luggage, sw:, freight, id:, trunk, fa:, suitcase, pa:, logistic
deaf: 
juice: ta:, extract
sexual: sw:, sex, vi:, sexuality
diamond: pa:, gem
echo: 
identity: hi:, identify, hi:, identification, ta:, symbolic, pa:, acquaintance, pa:, identifiable, te:, recognition
ambassador: ta:, messenger, ta:, diplomat, ko:, metabolism
lazy: de:, rotten
momentane-aspect: 
drift: sv:, operation, ar:, deflection, el:, tendency, el:, trend, bn:, flow, pa:, stance
imaginary: vi:, fancy, vi:, imagine, ta:, imagination, ta:, fiction, ta:, fantasy, mr:, subjective
ray: de:, beam, fr:, aisle, fr:, radius, he:, fund
climbing: sw:, rise, sw:, plant, sw:, sow, sw:, climb, vi:, creep
ink: vi:, toner
memorable: ar:, prominent
noisy: hi:, noise, sw:, shout, de:, loud, de:, aloud
senate: cy:, parliament
transport: zh:, carriage, zh:, transportation, zh:, haul, ta:, traffic, pt:, shuttle, el:, transfer, el:, metaphor, bn:, conduction
coffin: ko:, tract
swallow: pl:, sip, ko:, lot
indulge: sw:, pursue, el:, satisfy, pa:, incorporate, pa:, embed, pa:, deploy
agricultural: hi:, agriculture, sw:, farming, ta:, farm
swing: 
meadow: id:, pasture, fr:, pre, it:, lawn
complex: zh:, complicated, zh:, complicate, hi:, sophisticated, vi:, compound, ru:, tricky
resignation: zh:, resign, id:, retirement, jv:, backwards, jv:, retreat, te:, quit
humble-register: 
pepper: 
pony: 
candidate: pt:, applicant, el:, prospective, te:, recruit
fox: 
chimney: hi:, fireplace, sr:, stack
jurisdiction: sw:, authority, tr:, judgment, tr:, judgement, sr:, competence
former-deceased: 
democratic: mr:, democracy
blanket: de:, ceiling, fr:, cover, fr:, rug, fr:, coverage
pig: ru:, sow
ivory: pa:, elephant
lighter: ja:, writer
observer: hi:, supervisor, ta:, visitor, mr:, inspector
nails: hi:, nail, ja:, claw
bee: 
actor: zh:, actress, zh:, performer, it:, plaintiff
sweat: ko:, stitch
polish: tr:, dialect, ko:, shine
illusion: sw:, fraud
uncertainty: zh:, uncertain, tr:, ambiguity
secondary: zh:, minor
rural: ar:, provincial, id:, countryside, fa:, villager
circulation: zh:, loop, zh:, cycling, zh:, cyclic, hi:, prevalence, hi:, diffusion, sw:, circle, sw:, cycle, sw:, frequency, sw:, rotation, sw:, rotate, de:, traffic, fa:, sightsee, te:, conduction
groan: 
resemble: zh:, similar, ar:, similarity, fi:, remind, bn:, corresponding, pa:, like
quote: hi:, extract, hi:, quotation, ta:, unquote, fi:, lend, fi:, borrow, fi:, loan, pa:, reference, ja:, estimate, ko:, cite
sack: zh:, dismiss, zh:, dismissal, ru:, bag
annoyance: ar:, disturbance, id:, interference, id:, interruption, tr:, hardship, fr:, boredom, el:, bother, jv:, noise, jv:, disturbing
needle: sw:, injection, sr:, pin, ko:, pointer
controlled: fa:, control
barrier: sw:, restriction, id:, constraint, ta:, restricted, ta:, ban, ta:, prohibit, fa:, obstacle, bn:, block, bn:, interruption, pa:, handicap, mr:, disturb
rely: fr:, count, fr:, reckon, pt:, depend, pa:, trust, pa:, assurance, pa:, reliance, jv:, dependent, ko:, dependence
chicken: hi:, hen
barrel: zh:, bucket
habitual-aspect: 
expert: zh:, specialist, it:, experienced, el:, special, el:, specific, bn:, specialize
impress: tr:, affect, ru:, impression, ta:, attract, pa:, impressed
van: vi:, valve
nod: mr:, nap
definition: sw:, commentary, ar:, identification, tr:, description, ru:, determination, bn:, connotation, ko:, justice
birthday: id:, anniversary
hammer: 
fragrant: bn:, perfume
trivial: ar:, petty, tr:, unimportant, pa:, slight, pa:, marginal
dig: sv:, excavate, ar:, drill, fa:, excavation
pet: jv:, essence, te:, foster
skull: 
legislature: sw:, parliament, sr:, legislation, pa:, legislative
heel: pt:, jump, bn:, ankle
frown: 
patent: ko:, license, ko:, licence
billion: 
chemical: zh:, chemistry, sw:, chemicals, pt:, chemist, mr:, chemotherapy
pulse: de:, impulse, pt:, wrist, it:, momentum, mr:, lace
pilot: sw:, experiment, sw:, experimental, bn:, driver
knot: hi:, lump, de:, node, ar:, hold, ar:, contract, ar:, conclude, ar:, decade, fa:, knit, pl:, junction, te:, raw, te:, crude, mr:, prejudice
skirt: de:, rock
depression: hi:, recession, hi:, slump, sw:, sorrow, sw:, grief, sw:, sadness, sw:, depressed, ta:, stress
technical: zh:, technique, zh:, technology, de:, technically, ta:, tech, pa:, advanced
vehicle: sw:, drive, sw:, car, sw:, cart, tr:, means, mr:, automobile
scope: hi:, expansions, he:, domain, he:, realm, ja:, range, ko:, reach, ko:, extent
vegetation: mr:, plant
sunrise: 
contribute: hi:, contribution, sw:, donate, fa:, partnership
hook: id:, relate, id:, connect, id:, correlate, fa:, bracket
tiger: 
sleeve: sv:, arm, ko:, retail
highway: sw:, road
militia: 
integrity: mr:, concentration
transparent: sw:, transparency, id:, clear, id:, clearly, id:, evident, id:, obvious, id:, obviously, id:, unclear, vi:, explicit, vi:, straightforward
nineteen: 
counting: pa:, count, ja:, aggregate, te:, calculation, ko:, computation
qualified: zh:, eligible, zh:, qualification, hi:, able, ta:, merit, ta:, deserve, ta:, qualify, fr:, skilled, fi:, competent, fi:, valid, pa:, competence
organic: pa:, fossil, ko:, essential
theology: 
float: hi:, boat, de:, hover, fr:, fleet
witch: 
studio: sw:, label, fa:, workshop, it:, study
champagne: 
banner: sw:, flag, tr:, poster, fi:, ticket
divorce: zh:, divorced
bolt: ar:, lightning, ta:, nail, fa:, twist, fa:, screw
vein: hi:, nerve
passive: sw:, audience, fa:, disabled
gravel: te:, aggregate
planet: ko:, primary, mr:, constellation
shelf: zh:, rack, ta:, cupboard
fan: 
tropical: ko:, passionate
phase: zh:, photographic, id:, stage, vi:, period, ta:, construct, fi:, step
arbitrary: ta:, spontaneous, ja:, optional, jv:, treaty, jv:, accord, mr:, uncontrolled
ecstasy: ar:, trance, tr:, enthusiasm, pa:, pleasure, pa:, happiness
mercury: pa:, temperature
suicide: 
reporter: zh:, journalist
deprive: zh:, deprivation, id:, revoke, fa:, exclude, lt:, subtract, he:, negate, ja:, rob
balcony: zh:, terrace, jv:, attic
fork: ja:, folk
employee: sw:, worker, sw:, laborer, ar:, working, ar:, factor, it:, dependent, el:, clerk, pa:, personnel, jv:, labor, jv:, labour, mr:, staff
employer: ta:, boss, jv:, landlord, te:, owner
width: sw:, broadly, ar:, supply, id:, wide, cy:, semi
flaming: 
irritated: sv:, annoyed, vi:, excited, ta:, irritate, fa:, provoke, fa:, stimulation, te:, bored, ko:, stimulus, ko:, stimulate, ko:, incentive, ko:, motivation
classic: hi:, classical, bn:, optimum
monkey: bn:, chimpanzee
acceptable: zh:, accept, sw:, acceptance, pl:, plausible
signature: 
singer: fa:, reader
orthodox: hi:, conservative, ko:, conventional, ko:, traditional
nursery: tr:, plantation
adoption: zh:, employ, zh:, adopt, de:, acceptance, de:, assumption, fi:, approval, pl:, party, lt:, reception, lt:, admission, pa:, lap, ko:, quantum
reluctance: sw:, hesitation, de:, dislike
import: el:, introduction, ko:, income
torch: 
grammar: vi:, grammatical
deposit: hi:, accumulate
colonial: te:, immigrant
yacht: hi:, ferry, ta:, boat
frighten: hi:, scare, de:, terrify, fa:, deter, el:, alarm, cy:, alarmed, pl:, haunt
consequential: zh:, consequence, de:, episode, tr:, important, tr:, considerable, tr:, leading, tr:, prominent, tr:, considerably, tr:, significant, tr:, substantial, sr:, meaningful, ja:, indirect
extinct: fr:, missing, cy:, disappear, mr:, dead
dome: 
thickness: 
stubborn: lt:, assertive
muscle: 
magnitude: sw:, size, ar:, bulk, vi:, amplitude, fa:, gauge, cy:, quantity, pa:, intensity
rub: 
toast: ta:, snack
mouse: sw:, rat
syllable: sr:, typeface, te:, alphabet
neutral: zh:, neuter, pa:, fair, pa:, secular
detect: tr:, assess, bn:, identification, he:, recognize, he:, identify, ja:, detection, te:, locate, ko:, retrieve, mr:, find
flourish: zh:, prosperity, zh:, prosper, zh:, boom, el:, jewel, el:, gem, pa:, flower
impose: ar:, force, ar:, enforce, fi:, determine
anonymous: 
formal-register: 
calf: ar:, hurry
manual: hi:, guide, sw:, blueprint, sw:, guideline, ar:, booklet, vi:, brand, ru:, leadership, it:, textbook, sr:, instruction, lt:, leader, lt:, supervisor, pa:, document, pa:, documentation, ko:, operation, ko:, manufacturing
anticipation: zh:, expected, zh:, prospective, sw:, expect, de:, expectation, ar:, anticipate, vi:, prediction, vi:, predict, fa:, forecast, el:, provision
melt: sw:, evaporate, id:, thaw, it:, fusion, jv:, unite, te:, soluble
umbrella: ar:, parachute, bn:, fungus
boot: ar:, shoe, lt:, trunk
mineral: sw:, iodine, sw:, nutrient, ar:, metal, pa:, manganese
truce: hi:, ceasefire
duck: 
soap: 
doll: tr:, baby, ta:, toy
villa: sr:, fairy, ko:, lodge
sewing: sw:, stitch, sw:, sew
reconcile: sw:, mediate, sv:, unite, sv:, unify, ja:, adjust, ko:, adjustment
kettle: 
rabbit: 
conductor: de:, ladder, de:, superintendent, pt:, driver, cy:, leader
player: id:, performer
insect: hi:, pest, pa:, worm, ko:, bug
restaurant: 
radical: zh:, militant, ar:, extremist, vi:, progressive, pa:, revolutionary, he:, extreme, mr:, whole, mr:, throughout, mr:, entire, mr:, absolute, mr:, integrate
resident: zh:, inhabitant, tr:, native, tr:, domestic, tr:, indigenous, ko:, tenant, mr:, residential
dragon: de:, kite
auditory-evidential: 
linger: vi:, prolonged
lid: zh:, cover, sv:, cap, fi:, deck, jv:, valve
mayor: ko:, market
hardware: sw:, material
creative: 
minority: ja:, few, ko:, decimal
trench: zh:, ditch, fi:, excavation
orchestra: 
bacon: 
prosecution: vi:, prosecute, ta:, case, ta:, suit, ta:, litigation, fr:, pursuit, he:, claim, mr:, plaintiff
disadvantage: hi:, loss, hi:, deprivation, vi:, adverse, ru:, flaw, pt:, handicap, bn:, difficulty
fabric: zh:, cloth, hi:, clothing, sw:, towel, ar:, canvas, ru:, tissue, ko:, relief, ko:, structure
musician: hi:, composer, ar:, musical
mentally: de:, spiritual, de:, mental, vi:, morale, ta:, mana, fa:, subjective, mr:, psychological, mr:, cognitive, mr:, psychiatric
improper: pa:, mistaken, pa:, unacceptable, pa:, flawed, he:, incongruous, jv:, expected, te:, illegal, ko:, inadequate, ko:, inappropriate, mr:, unfair
architect: 
wed: 
lemon: 
cough: zh:, coughing
fertility: sw:, reproduction, pa:, breed, pa:, genital
random: zh:, randomly, zh:, randomize, de:, accidental, lt:, casual, te:, spontaneous, te:, stochastic
spoon: de:, bucket
diary: tr:, daily, fr:, newspaper, fr:, journal, el:, calendar
balloon: 
inferential-evidential: 
publisher: fr:, editor, bn:, publishing
ash: ta:, gray, ta:, grey
expletive: tr:, swearing
revive: ar:, revival
susceptible: id:, vulnerable, vi:, sensitive, fr:, sensible, el:, emotional, pl:, liable
tunnel: ta:, subway
puzzle: id:, confuse, id:, confusing
mechanism: sw:, procedure, sw:, routine, sw:, systematic, ar:, machinery, he:, apparatus, te:, approach, te:, policy
mathematics: zh:, math, sw:, mathematical, mr:, infinity
fade: 
balanced: sw:, ratio, sw:, correlation, sw:, proportion, ta:, consistent, pl:, sustainable
sublative-case: 
dip: hi:, dive, vi:, embed, ru:, drop, ru:, tumble, ru:, incidence, fa:, slope, fa:, incline, fa:, gradient, fr:, soak, pa:, decline, pa:, slump, mr:, slant
unit: de:, unity, sv:, entity, ar:, module, ta:, beak, fi:, singular
monopoly: vi:, exclusive
gambling: zh:, gamble, de:, game, de:, match, de:, clearance, ko:, betting
submarine: 
regardless: 
earthquake: sw:, convulsion
laboratory: zh:, lab
comments: bn:, comment, pa:, remark, pa:, commentary, ko:, reply
undergo: he:, pass, jv:, experienced, ko:, receive
self-control: 
embassy: 
chairman: he:, chairperson, mr:, president
invent: zh:, invention
declarative-mood: 
glove: 
kneel: 
geography: 
investment: zh:, invest, fa:, venture
analogy: hi:, equality, hi:, similarity, hi:, affinity, hi:, kinship, el:, ratio
hawk: zh:, eagle, te:, hack
psychology: jv:, physiological, ko:, psychological
scrap: id:, cancel, ta:, rubbish, ta:, garbage, pt:, fragment, he:, fling, he:, hurl
pirate: fr:, hacker
role: ta:, share, ta:, stock, ta:, participant, bn:, introduction, te:, character, mr:, stance
dose: fa:, quantity, pa:, diet, he:, quotient, he:, ration
salmon: 
pudding: cy:, dessert
magnetic: ar:, attractive, ko:, myself
pump: pt:, bomb, he:, vacuum
oxygen: 
fringe: zh:, edge, zh:, brink, zh:, marginal, ta:, margin, cy:, peripheral, mr:, border, mr:, boundary
certificate: sr:, confirmation
medal: 
rhetoric: 
rung: id:, stair, fi:, tread, he:, step
scrape: zh:, scratch, ar:, graze, ko:, offend
login: jv:, invasion, te:, log
telescope: sw:, microscope
necklace: hi:, defeat, pt:, paste, he:, chain
spelling: ta:, spell
surf: 
whiskey: 
camel: 
amateur: 
adult: id:, mature, ta:, age, ta:, aged
biography: ko:, electricity
donkey: 
perspective: mr:, outlook
pro: ja:, professional, te:, positive, te:, adaptive
monthly: mr:, magazine
vacation: hi:, leave, hi:, holiday, sr:, rest
click: sv:, clique, ru:, snap, he:, knock
oval: 
elastic: ar:, rubber, fi:, flexible
dictionary: tr:, lexical, lt:, vocabulary, ko:, pre
partition: zh:, divide, hi:, division, hi:, breakdown, hi:, break-down, sw:, count, tr:, compartment, ru:, section, pa:, fragment, pa:, component, pa:, components
ham: hi:, thigh
rainbow: 
organism: zh:, creature, sw:, creation
spit: sw:, mate, cy:, tongue
outlet: tr:, exit, fa:, socket, fr:, output, pt:, departure, it:, grip, lt:, slot
tank: ar:, reservoir, fi:, container, el:, vat
butterfly: 
chart: de:, diagram, id:, graph, tr:, graphic, tr:, graphics, lt:, scheme, bn:, catalogue, bn:, catalog
twin: zh:, double, ta:, dual, te:, couple, ko:, pair
insulting: zh:, insult, hi:, disgrace, hi:, offence, hi:, offend, hi:, offense, sw:, verbal, it:, offensive
independently: de:, independent, ta:, freely, pl:, apart, bn:, loosely, mr:, separately
marsh: 
nightmare: sw:, dream
jam: pt:, jelly, he:, compress
listener: pa:, listen
museum: 
stability: ko:, stabilize
disclose: de:, announce, sv:, reveal, ar:, detection, id:, expose, id:, undo, ta:, publish, sr:, discover, ko:, distinguish, mr:, apparent
aggressive: sw:, disturb, sw:, mess, ta:, occupation, ta:, aggression, el:, offensive, pa:, bomber
friction: te:, confrontation
participation: tr:, attendance, bn:, participate, ko:, involvement
pier: mr:, pathway
spider: mr:, fisher
potato: 
maker: he:, manufacturer, he:, producer, te:, preparation, te:, manufacture, te:, manufacturing
greed: bn:, hunger, bn:, appetite
premature: sw:, early
multiply: ar:, hit, id:, breed, pa:, multiplication, he:, double
statistics: zh:, statistical, sw:, figure, pa:, statistic
nomination: zh:, nominate, sw:, appointment, sw:, selection, fa:, engagement
trillion: 
affirmative-mood: 
applications: zh:, app, pa:, processes, jv:, apply, jv:, application
nominal: pa:, graze, he:, specified, he:, par
dissatisfaction: 
infection: zh:, infect, zh:, infected, hi:, transition, sw:, transmission, ta:, infectious
shrug: de:, twitch
football: zh:, soccer, it:, kick, it:, calcium
pioneer: ar:, major, tr:, avant-garde
abnormal: zh:, unusual, zh:, unusually, ru:, crackpot, ta:, extraordinary, pa:, exaggerated, te:, phenomenal, ko:, ideal, mr:, singular
omission: hi:, default, hi:, gaffe, sw:, deficiency, id:, negligence, tr:, neglect, fa:, elimination
squeeze: zh:, crowded, de:, push, id:, knead, ta:, reduction, fa:, thrust, fa:, pressure, fr:, crush, pt:, grasp, pt:, grip
percentage: te:, cent, te:, percent
ideophone: 
lever: 
withdrawal: hi:, return, hi:, regression, de:, retreat, sv:, socket, id:, recall, ru:, conclusion, ru:, inference, ru:, output, ru:, implication, cy:, withdraw, jv:, total
senator: 
ant: 
pregnant: sw:, maternal, pa:, conceive
everyday: ko:, daily
precipitate: zh:, precipitation, zh:, sediment, hi:, velocity, ar:, urgent, sr:, accelerate
variable: sw:, vary, pa:, variables, jv:, global, ko:, mobile
curly: zh:, curl, vi:, hurl, ta:, scroll, ta:, helix
sulphur: zh:, sulfur, fi:, broken
continental: zh:, continent
dictate: bn:, instruction, ko:, command
frog: 
exessive-case: 
grind: ta:, half, ta:, semi
irrealis-mood: 
indoors: vi:, indoor, fr:, inside, fi:, within
exploit: zh:, utilize, sw:, absorb, fr:, achievement, pt:, explore, te:, robbery, mr:, absorption
geological: te:, underground
passport: 
immoral: tr:, vicious, fa:, rotten
biscuit: zh:, cookie
cooperation: zh:, cooperate, sw:, partnership, sw:, integration, fa:, assist, te:, contribution
forge: hi:, make, sw:, utter, ar:, formation, tr:, create, tr:, compose, tr:, generate, fi:, falsify, pa:, font, te:, replicate
atom: zh:, atomic, sw:, particle, el:, individual
aids: sw:, aid, sw:, relief
fastidious: fr:, delicate, it:, annoying
pyramid: 
unlawful: sv:, illegal, pa:, non
shyness: zh:, shy, el:, contraction
lute: sv:, slant
astronomy: 
maze: jv:, ambiguity
scholarship: sw:, sponsorship, ko:, award
fibre: zh:, fiber, lt:, bundle, jv:, prejudice
cricket: 
pigeon: 
adaptation: zh:, adapt, ru:, fixture, fa:, compliance, cy:, modification, cy:, adjust, pa:, optimization, ja:, adaptive, ko:, accommodation
disapproval: zh:, disapprove, zh:, disapproving, vi:, opposition, vi:, opposed, vi:, protest, vi:, counter, vi:, opponent, vi:, opposing, fa:, refuse, fa:, trace, fa:, reject, fa:, dismiss, fa:, veto, pa:, offend, he:, tutor, jv:, agree, jv:, disagree
operator: jv:, carrier
triangle: 
treasurer: zh:, cashier
hydrogen: 
printer: 
choke: ja:, chalk
chronic: sw:, resistant, pa:, serious, pa:, severe, jv:, greatly, jv:, extreme, mr:, acute, mr:, intensify
cope: hi:, encounter, sw:, adapt, sw:, confront, sw:, offset, ar:, overcome, ta:, tackle, fa:, contrastive, ja:, deal, jv:, accomplish
dilemma: jv:, confused, jv:, confusing
symptom: sw:, indication, ar:, offer, ar:, display, ar:, exhibit, ar:, presentation, id:, phenomenon, bn:, diagnostic, bn:, syndrome, te:, characteristic
bicycle: zh:, bike, sw:, cycling, sv:, cycle, mr:, ride
engineering: sv:, technique, vi:, technically, el:, mechanics
spiral: zh:, helix, ta:, spin
camera: ru:, chamber
dancer: 
migration: zh:, migrate, sw:, immigration
tennis: 
addicted: sv:, dependent, sv:, dependence, sv:, reliance, te:, slave
weave: zh:, braid, hi:, knit, hi:, knitting, fa:, tissue, fa:, texture
spine: 
fry: te:, boil
facilitate: zh:, promote, zh:, stimulation, zh:, acceleration, sv:, foster, tr:, ease, bn:, simplify, pa:, facility, pa:, utility, he:, relieve
stab: de:, sting, de:, pierce, sv:, grab, ru:, attempt, ru:, attempted
password: el:, signal, el:, cue, el:, slogan, jv:, my, ko:, code
hemisphere: sw:, pointed, sw:, tip
depressing: hi:, disappointing, vi:, depressed, vi:, discourage, ta:, grief, pa:, provoke
strategy: zh:, strategic, bn:, strategies, mr:, policy
patrol: ar:, periodical, te:, petrol
glacier: 
halfway: zh:, half, zh:, partly, zh:, semi
memorandum: sw:, treaty, sw:, contract, sw:, convention, sw:, accord, ar:, warrant, mr:, representation
cone: 
symmetry: 
defendant: fa:, advocate, bn:, opposing
mosque: 
exhaust: he:, emission, ko:, eject
chess: 
nucleus: zh:, nuclear, sw:, cell, sw:, essence, id:, core, vi:, central, ta:, embryo, ta:, fetal, he:, kernel, jv:, substance
cherry: 
stumble: ar:, tumble
truck: sw:, lorry, cy:, freighter, ja:, track
wireless: ja:, radio
auction: zh:, sale
sieve: he:, debug
unsteady: zh:, unstable, zh:, instability, de:, uncertain, ar:, uneasy, bn:, restless
suck: tr:, absorb, tr:, soak
unfriendly: de:, unkind, tr:, hostile, el:, adverse, ko:, harmful
census: cy:, calculation
tiptoe: sv:, toe, ta:, ready, ta:, willing
relax: zh:, relaxing, vi:, relaxed, cy:, relaxation, te:, leisure, mr:, relieve
continuity: vi:, constantly, ta:, continuation, fa:, conjunction
bubble: 
guitar: ko:, etc.
bias: bn:, preference, pa:, prejudice, he:, deflection
shiny: vi:, bright, vi:, a.m., tr:, brilliant
whichever: zh:, any, it:, whatever, lt:, which, bn:, whoever, ko:, among, ko:, underwater
knitted: id:, knitting, vi:, knit, tr:, braid
soar: sw:, hike, sv:, hover, ar:, throat, el:, flight, jv:, famous, mr:, plane, mr:, aircraft, mr:, airplane, mr:, airline
pronoun-marker: 
spice: sv:, zest
bail: sw:, bond, id:, assurance, ru:, pledge, fa:, guarantee, bn:, sponsor, ko:, jewel, ko:, gem
tease: id:, tempt, tr:, annoy, tr:, irritate, cy:, fascinate
java: 
recipe: hi:, method, sw:, stimulus, de:, prescription, vi:, formula, fa:, instruction, pa:, consonant
plow: hi:, solve, id:, hijack
gutter: hi:, drain
comet: ar:, offender
innovation: ta:, discovery, ta:, invention
medieval: id:, mid
decorative: zh:, decoration, zh:, decorate, sw:, cosmetic
plastic: 
footnote: 
dairy: sw:, milk, jv:, ordinary, jv:, regular
golf: 
zero: hi:, null, bn:, vacant
zip: zh:, compress
trigger: 
chip: hi:, piece, hi:, fragment, hi:, slice, hi:, chunk
oppress: de:, suppress, de:, repress, ru:, depress, pt:, overwhelm, pa:, mistreat
yawn: id:, evaporate
inequality: 
mole: lt:, clay
pottery: pa:, soil, pa:, clay
housewife: 
irrational: bn:, unreasonable
miner: fr:, minor
yeast: ar:, enzyme, el:, dough, el:, pastry
intercept: he:, inhibit, jv:, tackle
premium: fr:, bonus, pt:, prize, pt:, award
option: hi:, alternative, hi:, substitute, sv:, alternate, ar:, cucumber, id:, choice, id:, selection, ru:, variant, bn:, prefer, jv:, preference, jv:, optional, mr:, substitution, mr:, amused
graduate: sv:, exam, id:, pass
bankruptcy: it:, failure
irrigation: 
capitalist: sw:, capitalism
elasticity: ar:, flexibility
geometry: zh:, geometric
shark: 
storage: sw:, preserve, sw:, conserve, ar:, store, ta:, saving
hopefully: pa:, prospect, pa:, expectation, pa:, optimism
realism: 
ambulance: 
wallet: zh:, purse, fr:, portfolio
grimace: ar:, mug, el:, grin, lt:, wriggle
scientist: hi:, scientific, sv:, scholar, sv:, researcher, sv:, investigator, pa:, biologist
gut: de:, bowel
equanimity: 
realistic: zh:, actual, sw:, true, sw:, really, sw:, actually, sw:, truly, sw:, sincere, ar:, pragmatic, jv:, real, jv:, explicit
irrelevant: hi:, contradictory, vi:, inappropriate, ta:, incongruous, fi:, unimportant
bean: id:, nut, id:, peanut, fa:, cereal
informal: pa:, formal, pa:, formally
granddaughter: sw:, grandson, sw:, grandchild, vi:, niece, tr:, descendent
steak: el:, chop
nitrogen: 
mutter: tr:, whisper
berry: id:, pluck, fr:, bay
analyze: ar:, parse, vi:, analytic, bn:, analyse, pa:, analysis
contrasting: zh:, contrast, vi:, contrastive, ta:, contradictory, el:, opposed, el:, contrary, jv:, distinguish, jv:, discriminate, jv:, differentiate, te:, distinct, te:, diverse
fireworks: bn:, bet, bn:, betting, ko:, flame
pop: ar:, snap, ar:, bang
undress: he:, strip, te:, clothes
complement: zh:, supplementary, id:, equip, lt:, addition, he:, complementary
pegative-case: 
cancer: 
pawn: ar:, mortgage, ta:, soldier, fa:, pledge
leak: ar:, spill, it:, loss, cy:, drop
density: sw:, crowded, ar:, intensity
chew: 
complexity: bn:, complication
talkative: de:, communicative, te:, agile
acquit: id:, exempt, ta:, liberation, sr:, rid, sr:, relieve, he:, merit
polar: vi:, extreme, vi:, pole
discount: hi:, exemption, ar:, sale, lt:, concession, he:, assumption
taxi: zh:, cab
hierarchy: sw:, leadership, vi:, system, pa:, recursion
snarl: 
naive: te:, linear, mr:, plain
presidency: vi:, presidential
buyer: sr:, customer
gallon: 
mosquito: 
deplore: el:, mourn, sr:, condemn, lt:, regret
deviation: tr:, deflection, ta:, distortion, fa:, offset, jv:, something
mosaic: bn:, diverse
plug: de:, connector, tr:, voucher
pregnancy: sw:, conception, sw:, conceive, ar:, carry, ar:, load
grocery: 
communist: 
amaze: id:, surprising, id:, amazing, id:, stunning, tr:, mislead, tr:, confuse, tr:, stun, fa:, confound, mr:, amazed
prosecutive-case: 
dictator: 
preoccupation: de:, employment, tr:, anxiety, pt:, worry, it:, concern
satellite: jv:, probe
approximate: zh:, approximation, sw:, approximately, fa:, approximative, pa:, almost, pa:, practically, pa:, circa, jv:, roughly
unemployed: sw:, employment
implement: vi:, implementation, pa:, enforce, pa:, enforcement, te:, execution, te:, execute
bulb: fa:, onion, ja:, valve
supporter: sw:, assistant, fr:, endure, pt:, bracket
lotus: mr:, lily
chloride: 
bacteria: zh:, fungus, ar:, bacterial
lattice: jv:, pattern
biological: pa:, creature, pa:, biology
feign: zh:, pretend, el:, simulate
byte: 
secretion: zh:, secrete
ballet: fa:, fin, te:, ballot
urine: ru:, piss
garlic: 
middle-class: 
laundry: ta:, washing
characterize: bn:, distinguish, mr:, characterization
strawberry: 
notebook: ko:, laptop
transcendental: 
album: 
baseball: 
piracy: 
buffet: 
participle: lt:, participant, lt:, entrant
garage: 
diagnosis: zh:, diagnostic, zh:, diagnose, sw:, cognitive, fa:, recognize
extort: zh:, blackmail, tr:, pluck, pl:, constrain, ja:, coerce
phosphorus: 
structural: vi:, structure, ta:, configuration, ta:, config, pa:, institutional
glue: zh:, gum
thesis: zh:, dissertation
artisan: sw:, mechanic, sw:, plumber
banana: bn:, tissue
rib: fa:, gear
nickel: 
currently: sw:, now, sw:, present, sw:, current, he:, nowadays, jv:, queue
bus: sw:, let
censor: zh:, censorship, bn:, critic
missile: de:, rocket
sausage: el:, hotdog
manipulation: zh:, operate, zh:, manipulate, zh:, operational, tr:, trick, tr:, cheat, cy:, handle, ja:, operation, jv:, fraud
tomato: 
reinforce: sw:, consolidate, sw:, intensify, fi:, confirm, pa:, strong, pa:, strengthen
convex: 
potassium: 
algebra: jv:, algebraic
jewellery: 
optical: ar:, visual
unemployment: bn:, bakery
disarm: sw:, arms, sw:, weapon, sw:, armed
solo: ta:, separate, ta:, phenomenal, ta:, discrete, pt:, soil, fi:, alone
browser: tr:, scanner
historic-tense: 
capability: ta:, efficiency, ta:, potentially, pa:, capacity, pa:, quotient, ja:, ability, ja:, competence, ko:, literacy
spectrum: 
sodium: 
hysteria: te:, convulsion
trustee: pt:, administrator, he:, loyal
hostage: hi:, mortgage, tr:, pledge
athlete: ar:, mathematical, ar:, athletic
wrinkle: sw:, defect, pa:, commit
comprise: ru:, incorporate, cy:, contents, bn:, constitute, bn:, construct, pa:, involved, pa:, engage, pa:, involve, pa:, inclusion, ja:, consist, jv:, contain, ko:, achieve, mr:, include
clip: de:, staple, de:, bracket, el:, stapler
priority: sw:, attention, te:, preference, mr:, prefer
rape: hi:, outrage, fa:, exceed, fa:, aggression
monitor: sw:, track, sv:, supervise, tr:, watch, tr:, pursue
constituency: zh:, voter, zh:, electorate, pa:, mild
cultural: zh:, culture
gender: vi:, compute, bn:, sex, pa:, penis, he:, species, ko:, sexuality
platinum: 
dual-number: 
specialty: zh:, vocational, hi:, characteristic, hi:, trait, id:, particular, id:, special, tr:, expertise, ta:, specialist, te:, separate, te:, exclusive, ko:, specialize
lung: 
super: fa:, phenomenal, fa:, enormously, fa:, incredibly, ko:, supervisor
trolley: de:, carriage, de:, cart, sv:, wagon
mushroom: de:, fungus, jv:, mold
locally: zh:, local
incite: fa:, excite, fa:, annoy
gasoline: zh:, petrol
pumpkin: tr:, squash, fi:, marrow
kidney: ko:, height, ko:, extension
loot: zh:, robbery, zh:, looting, de:, prey, tr:, spoil, fa:, rob, it:, haul
arsenic: 
snail: ar:, helix
infinitesimal: 
socialist: sw:, kinship
filter: 
widen: zh:, expand, hi:, wide, sw:, add, sw:, raise, sw:, enhance, de:, extend, vi:, broadly, cy:, expansion
controversial: sw:, controversy, sw:, contradiction, sw:, ambiguous, sw:, confusing, sw:, ambiguity, lt:, contradictory
leash: hi:, lease, hi:, strap
jockey: 
pneumonia: 
situate: ja:, put
intersection: zh:, crossing, sw:, junction, sw:, ordinal
solidarity: zh:, unite, zh:, rally, sw:, affinity, ta:, unity, ta:, similarity, ko:, era
hinge: ar:, detailed, ru:, loop, he:, axis
longitudinal: vi:, vertical, pa:, prolonged, ko:, species
dividend: sw:, allocation
obtuse: mr:, slow
skate: ar:, ski
crouch: mr:, bend
exponent: zh:, index, zh:, exponential, jv:, fragment
disability: sw:, handicap, ar:, inability, id:, defect, id:, imperfect, id:, disabled, id:, flaw
championship: pa:, champion, pa:, winner, mr:, tournament
photographer: ta:, photographic
digital: zh:, figure, zh:, numeral, fr:, numerical
bitch: 
eyelid: 
subconscious: 
eyebrow: 
sneeze: 
hilarious: ar:, cheerful, ar:, fun, vi:, glad, fa:, funny, pt:, amused, pt:, amusing, pt:, entertaining, cy:, humorous, sr:, ridiculous, pa:, pleasing
refugee: fa:, immigrant
protein: zh:, egg-white
dump: hi:, pile, hi:, stack, id:, banish, fa:, rubbish, fa:, garbage, jv:, hurl
evolve: ko:, evolution, mr:, develop
vomit: 
gene: zh:, genetically, ta:, genetic
freshman: 
merge: hi:, fusion, sw:, unite, sw:, unify, ar:, combine, ar:, consolidate, ar:, integration, tr:, converge, pl:, connect
sociology: 
mobility: vi:, mobile, vi:, portable, ta:, movement, ta:, motion
regional: id:, county, id:, area, id:, zone, vi:, ward, vi:, sphere, vi:, sector, el:, peripheral, te:, provincial
motion-uphill: 
dilute: hi:, thin, mr:, mild
retrospective: vi:, past, ta:, introspection
inversion: hi:, invert, ar:, contrary, ta:, reciprocal, ta:, inverse, bn:, disaster, ko:, conduction
tv: zh:, television, sw:, film
cube: mr:, solid
syntax: zh:, syntactic, el:, pension, mr:, layout
productivity: pl:, performance, pl:, output
carrot: 
molecular: zh:, molecule, zh:, numerator, ta:, substrate, mr:, nuclear, mr:, atomic
conglomerate: zh:, clique, hi:, group, hi:, cluster
accountant: sv:, auditor
differentiation: zh:, discrimination, hi:, discriminate, vi:, distinguish, vi:, differentiate, fa:, break-down, pa:, difference, pa:, contrast, pa:, variations, pa:, variance
availability: sw:, access, sw:, acquisition, ta:, get, ta:, available, bn:, attendance, ko:, effectiveness
orgy: 
solvent: vi:, dissolve
phosphate: 
primer: vi:, bait, ta:, acquaintance, ta:, introduction, jv:, firstly
comma: id:, coma, el:, party
premise: 
motion-downhill: 
donor: sr:, presenter
psychologist: 
chlorine: ko:, goat
keyboard: 
elite: te:, superior
parenthesis: pa:, bracket
rugby: 
ulcer: sw:, sore, fa:, wound, fa:, trauma, sr:, boil
inflected: 
nibble: 
abortion: zh:, miscarriage
sweater: fa:, jacket
evolutionary: zh:, developmental, vi:, evolution, pa:, development, pa:, progression
notation: zh:, sign, zh:, symbol, id:, note
bounce: hi:, boom, sr:, jump
dissection: cy:, allocate, pl:, section, te:, division, te:, divide
cache: fr:, lurking
antimony: 
superessive-case: 
tumor: zh:, tumour, el:, bulk
alpha: 
navel: tr:, belly, fi:, pole
immune: sw:, breathing, pl:, resistant
abridge: id:, limit, id:, confine, id:, restrict, bn:, summarize, mr:, compact
captivate: ar:, capture, tr:, fascinate, he:, hunt, mr:, attract
sock: 
movie: zh:, film, zh:, cinema, el:, ribbon, el:, tape, el:, stripe
cosmos: zh:, universe
pollute: zh:, pollution, fa:, infect
gregarious: 
aluminum: zh:, aluminium
oscillation: fa:, fluctuation, ko:, vibration
alphabetical: cy:, alphabet
horoscope: 
tangent: 
dolphin: 
killer: 
resonance: ta:, vibration
indicator: ta:, posture, fa:, index, fa:, criteria, el:, index-finger, pl:, gauge
dioxide: 
bureaucracy: zh:, bureaucratic
distort: sw:, mislead, sv:, scramble, pa:, deteriorate, he:, falsify, he:, skew, ko:, distortion
galaxy: ta:, constellation
clinical: 
radium: pt:, radio
refrigerator: zh:, fridge
harmonic: bn:, musical, jv:, compliance
archaeological: vi:, archaeology, vi:, archeology, ta:, fossil
specification: zh:, norm, zh:, standardize, mr:, detail
interpolation: 
leaflet: de:, booklet, ar:, bulletin, fa:, handout, cy:, sheet
incompleteness: te:, imperfect
anthropology: 
tasty: hi:, delicious
transitive: vi:, excuse
cower: 
simulation: zh:, simulate, bn:, badge
vagina: el:, bay, bn:, cell
ion: 
tourism: sw:, tourist, vi:, travel, ta:, picnic
trigonometry: 
kidnap: de:, hijack, ta:, conduction, fi:, snatch
overlap: sw:, interaction, sw:, interactive
finder: 
oust: de:, displace, ar:, expel, ar:, eject, ar:, deport, he:, banish
hairdresser: 
folklore: sw:, wheat, te:, folk
capillary: 
nationalism: sw:, nationality
buttocks: zh:, hip
sublimate: mr:, pure, mr:, refine
buffer: 
frustration: hi:, despair, hi:, disappointment, sw:, confused, el:, cancel, bn:, defeat, te:, disappointed, te:, disappoint, te:, disappointing
cobalt: 
subtraction: pa:, subtract
motion-upriver: 
coordinates: sw:, ordinate, mr:, coordinate, mr:, coordination
anus: 
redundancy: ar:, plenty, vi:, residual, tr:, excess, cy:, dismiss, cy:, dismissal, lt:, exemption, ko:, surplus
video: 
boycott: ar:, county, vi:, ostracize, ta:, neglect
quiz: sw:, attempt, fa:, exam, pt:, questionnaire
guerrilla: 
magnesium: 
radar: 
qualitative: sw:, quality, ta:, characteristic
reliability: tr:, credibility
rectangle: 
generalize: zh:, generalization, pa:, build, pa:, create, pa:, compose
anymore: pa:, now, jv:, again
curfew: 
formulation: vi:, build, vi:, construct, vi:, constructive, ru:, wording, ta:, creation, ta:, formation, cy:, formulate, pa:, establishment
reincarnation: te:, rebirth
ignite: 
uranium: 
taxpayer: pa:, tax
integrated: ta:, integral
opine: hi:, view, hi:, opinion, fa:, remark
gamma: 
server: 
motion-downriver: 
coefficient: ar:, grade, vi:, factor, ja:, modulus
bismuth: 
postcard: pa:, post, pa:, postgraduate
digress: hi:, retreat, sv:, depart
morphological: sw:, genetic, id:, morphology
evaluation: ar:, assess, bn:, assessment, bn:, evaluate, pa:, inquiry, pa:, investigate, pa:, enquiry, pa:, probe, ko:, par
jeans: 
database: 
calculator: vi:, computing
investor: 
x-ray: 
agenda: pl:, program, pl:, programme, pl:, curriculum
visa: 
infrastructure: pa:, fundamental, pa:, basic, pa:, fundamentally
detector: 
splice: ar:, affix, pt:, amend, el:, attach, el:, connect
bromine: 
silicon: fi:, pi
hiccup: 
pastel: ta:, pale
zoo: 
clinic: 
yoga: hi:, sum
bookstore: it:, bookcase, pa:, shop
retailer: zh:, dealer, sw:, seller, jv:, shop, jv:, nearby
behead: pa:, timely
yeah: hi:, yes, id:, ya, he:, sincere
jazz: 
tungsten: 
terrorist: hi:, militant, vi:, terror, pa:, extremist
conceptual: sw:, fancy, sw:, notion, sw:, concept, sw:, assumption, sw:, paradigm, ta:, conception, jv:, draft
cartesian: 
dribble: ar:, slime
alimony: 
programmer: sw:, app
input: 
makeup: zh:, make-up, ta:, cosmetic, it:, trick, sr:, compensate
vaccine: hi:, commentary, sw:, coverage, pa:, injection
axiomatic: 
heroin: 
folder: 
cathode: 
flu: ta:, fever, it:, influence
ideology: zh:, thought
parking: 
snapshot: 
anticlimax: de:, disappointment
selenium: 
cortex: sv:, bark, ar:, shell, sr:, peel
equivalence: ar:, equality
vertex: 
airport: 
amputate: tr:, interrupt
imposter: 
chromium: 
litre: zh:, liter
dashboard: vi:, panel, fi:, dash
hormone: 
perforate: tr:, pierce
animism: 
polygon: ta:, angle
feminist: 
conjugate: el:, incline, lt:, connected, he:, steer
euro: 
algorithm: 
laser: 
drugstore: 
millimeter: zh:, millimetre
flex: sv:, bend, vi:, curved, tr:, flexible, ta:, favorable, el:, cable
anode: 
nuance: sr:, shade
snuggle: sr:, embrace
part-time: 
sensitivity: 
mainframe: 
demonstrator: te:, appearance, te:, display, te:, performance, te:, demonstration, te:, presentation
helium: 
bilingual: 
gerund: 
plasma: 
chromosome: 
integer: pa:, digit, pa:, numeral
kilometre: zh:, kilometer
fax: 
genetics: tr:, genetic, tr:, genetically
freckle: 
broccoli: 
permutation: bn:, format, bn:, array, bn:, layout, he:, apposition
spam: 
vector: it:, carrier
tactic: hi:, device, sw:, approach, sw:, technique, sw:, methodology, ko:, fetch
alright: pa:, recover, pa:, correctly, pa:, fasten, pa:, valid, pa:, okay
vitamin: 
cadmium: 
graphical: bn:, graphic, jv:, graphics
manually: mr:, itself
titanium: 
splurge: ar:, brag
helicopter: 
tellurium: vi:, scandium, vi:, lanthanum
deadline: lt:, term
align: pa:, consistent, ko:, array
analog: 
centimetre: zh:, centimeter
molybdenum: 
lithium: 
multimedia: 
calorie: 
robot: 
homework: jv:, peer
logarithm: 
instal: zh:, mount, zh:, install, ar:, synthesis
glyph: tr:, relief
ecology: zh:, ecological, pa:, environmental
sophisticate: sr:, spoil
template: mr:, mold
euclidean: 
kilogram: 
overeat: 
divisor: 
freeware: 
eavesdrop: 
haircut: 
iridium: 
racism: sw:, racial
bandwidth: fa:, broadband
optimal: zh:, top, zh:, optimum, bn:, favorable, pa:, suited, pa:, adjust, pa:, adapt, pa:, compatible, pa:, adaptive, te:, proper, te:, correct, te:, sensible
hypotenuse: fa:, chord, he:, slant
desktop: 
headquarter: hi:, headquarters, sr:, seat
misplace: de:, embarrassed, sr:, lose
cerium: 
partitive-case: 
cassette: sw:, tape
supermarket: lt:, mall
willpower: zh:, volition, tr:, will
dimensional: hi:, size, hi:, shape, id:, dimension, vi:, spatial
offline: 
encryption: zh:, cryptography, zh:, encrypt, de:, coding
synchronize: zh:, sync, ta:, integrate, pa:, contemporary
seminar: 
semantic: hi:, meaning, hi:, connotation, ta:, subject, ta:, object, ta:, material, ta:, substance, pa:, sense, pa:, meaningful
disco: 
neon: 
real-time: 
osmium: 
lifestyle: sw:, life, sw:, lifetime, sw:, survival, ta:, living, ta:, career
firewall: 
cosine: pa:, calculation, pa:, computation
artifact: 
plutonium: 
workstation: 
yttrium: 
augmentative: 
username: 
right-wing: 
argon: 
socialize: ru:, communicate, lt:, interact
globalization: 
secant: 
wavelength: jv:, wave
encode: sv:, code
recycle: 
asymptote: 
decode: ko:, satisfy, ko:, solve
restart: sv:, reboot, pa:, operational
hepatitis: 
proton: 
diskette: pa:, disc
milligram: 
pixel: 
tantalum: 
solute: 
genocide: 
gallium: 
pop-up: 
zirconium: 
nonlinear: 
pesticide: 
polynomial: 
beryllium: 
neuron: 
predicative: el:, assertive
router: 
factorial: de:, faculty
widget: sr:, supplement
neutron: 
niobium: 
germanium: 
metalloid: zh:, nonmetal
prolative-case: 
biodiversity: 
industrialize: zh:, industrialization, ta:, industry
joystick: 
antibiotic: 
actinium: 
astronaut: ta:, space
decompress: te:, expand, te:, enhance
extrapolation: 
extraterrestrial: el:, alien
octet: 
open-source: 
marathon: 
plug-in: 
topology: 
gigabyte: 
ionize: 
si-units: 
camping: sw:, camp
finite-verb: 
krypton: 
gnomic-mood: 
shift-key: 
squares: pa:, square
salesperson: hi:, dealer, hi:, seller, vi:, clerk
rhenium: 
cell-phone: zh:, cellphone, sv:, mobile-phone, fr:, portable, fr:, laptop, pl:, cell
sideways: id:, aside
modal-case: 
junk-mail: 
railcar: 
clip-art: 
bookmark: 
hafnium: 
home-page: 
lative-case: 
nth-root: 
flowchart: 
middle-voice: 
old-age: zh:, elderly
rounding: pa:, rounded
rhodium-atom: vi:, terbium-atom, vi:, thulium-atom, vi:, thorium-atom, vi:, fluorine-atom, vi:, rubidium-atom, vi:, thallium-atom, vi:, vanadium-atom, vi:, polonium-atom, vi:, strontium-atom, vi:, ruthenium-atom
bad-tempered: ar:, rough
oblique-case: 
patient-case: 
prehodiernal: 
bald: cy:, bare, ko:, raw
goal-trigger: 
praseodymium: 
paralyzed: 
complain: zh:, complaint
to-case: fr:, at-case, it:, randomly, bn:, from-case
radiation: fa:, glow, ko:, emission
indium: 
actor-role: 
euphoria: hi:, enthusiasm, hi:, zeal, fa:, satisfaction, fa:, consent, te:, pleasure, te:, joy, te:, happiness, te:, delight
caps-lock: 
whitespace: 
dramatically: pa:, dramatic
chauvinist: 
web-site: zh:, website, sw:, site
houseplant: 
civil-rights: 
protactinium: 
projective: 
binary-value: 
goalkeeper: 
retail-store: 
status-bar: 
microphone: fr:, micro
human-body: 
swear-in: 
mail-carrier: 
centric-case: 
trojan-horse: 
scroll-bar: 
triple-point: 
read-only: 
wisecrack: id:, joke, ko:, oral
impermanence: ta:, unstable, bn:, instability
poet: 
phonological: 
hypnothize: 
trial-number: 
receptor: cy:, receptionist
verb-affix: 
non-human: 
flow-current: 
that-which: fa:, that, fa:, which, fa:, whom, fa:, whose
clause-tail: 
upside-down: id:, inverse, ta:, reverse
for-example: 
ip-address: 
in-language: 
individually: hi:, personally, vi:, individual, vi:, personal, ru:, separately, pa:, separate, pa:, distinct, pa:, differ, pa:, differently, pa:, spatial
pro-sentence: fr:, pro-phrase
epidemiology: ko:, mechanics, ko:, dynamics
legislate: zh:, legislation, zh:, legislative, id:, arrange, id:, organize
striped: zh:, stripe, ar:, scheme, ar:, planner, ar:, blueprint
strikebreaker: 
astatine: 
overcharge: 
else-if: 
angles: bn:, angle, te:, pointed
wear-out: 
citation-form: 
ergative-case: 
suburb: sw:, hamlet, tr:, commuter, fa:, countryside
common-gender: 
supercomputer: 
direct-object: sw:, indirect-object
motorist: zh:, driver
statistically: de:, statistical, mr:, numerical
lutetium: 
rationality: hi:, consciousness, el:, logic
passive-voice: 
causative: 
cesium: 
search-engine: 
toolbar: 
automatically: jv:, automatic
californium: 
mendelevium: 
agent-trigger: 
color-blind: 
comic-strip: 
teminal: bn:, terminal
dot-matrix: 
samarium: 
short-circuit: 
compile: jv:, collect
agentive-case: 
accident: hi:, crash, hi:, casualty, sw:, accidental, ar:, incident, id:, wreck
fractals: 
multal-number: 
to-close: vi:, closed, vi:, shut, fa:, close, fi:, exclude
broad: hi:, vast, hi:, extensive, hi:, comprehensive, sw:, wide, de:, broadly, pt:, ample, cy:, widely, cy:, widespread, jv:, big, jv:, angle
adessive-case: 
cooperative: hi:, colleague, vi:, cooperate, mr:, fellow, mr:, associate
eulers-number: 
laser-printer: 
trans-numeral: 
blog: zh:, blogger
combinatorial: vi:, combinatorics
pythagoras: 
abessive-case: 
locative-case: 
swimming-pool: de:, pool, ru:, basin
cybercrime: jv:, dangerous, jv:, harmful
post-office: de:, post, de:, mail
malware: 
inhibition: zh:, restrain, zh:, curb, zh:, inhibit, hi:, prohibit, bn:, veto, pa:, deter, ko:, forbid
spyware: 
recording: zh:, record, de:, inclusion, tr:, register, tr:, registration, ru:, entry, ta:, log
interviewer: fa:, interview
clip-board: 
xenon: 
spreadsheet: 
nth-power: 
movie-theater: de:, cinema
inbox: 
per-cent: zh:, percent, vi:, cent
aerosol: he:, spray
distributor: 
dynamical: vi:, dynamics, ja:, mechanics, ko:, dynamic
one-second: 
subtend: fr:, underlie
brownian: 
star-gender: 
galaxy-gender: 
cardboard: sw:, card, de:, carton
computability: 
one-another: zh:, another, hi:, each-other, pt:, else
police-officer: 
primary-object: 
animate-gender: 
evitative-case: 
vehicle-gender: 
data-mining: 
possessed-case: 
americium: 
mineral-gender: 
domain-name: 
imaginary-unit: 
neptunium: 
verbal-noun: 
mathematicians: 
posessive-case: hi:, postessive-case
modeling: 
final-particle: 
flash-drive: 
floppy-disk: 
firefighter: 
critical-point: 
empathetic-joy: 
word-processor: 
prime-minister: 
virtual-memory: 
adverbial-case: 
ethium: 
shorts: 
fool-around: 
equations: bn:, equation
subessive-case: 
log-out: 
spammer: 
antessive-case: 
crosswalk: ar:, pathway, el:, walkway
user-interface: 
ghostwriter: 
computer-virus: 
facilitator: zh:, presenter, de:, moderator
rehabilitation: 
auxiliary-verb: 
first-hand: cy:, direct
motherboard: he:, whether
patient-trigger: 
runtime: 
collective-noun: 
koran: jv:, newspaper
business-person: ta:, businessperson
transitive-verb: 
cloud-computing: 
virtual-machine: 
absolutive-case: 
virtual-reality: 
past-perfective: 
impersonal-verb: 
crastinal-tense: 
reflexive-voice: 
abstract-gender: 
different-event: 
exocentric-case: 
second-language: 
artistic-gender: 
self-confidence: 
research-gender: 
indirect-speech: 
locality-gender: 
physics: zh:, physical, zh:, physically
universe-gender: 
closure: zh:, close, zh:, closed, zh:, shut, pa:, off, pa:, cease, pa:, quit, pa:, halt
superlative-case: 
matching: zh:, match, de:, vote, de:, ballot, id:, suit, id:, appropriate, id:, accord, id:, correspond, vi:, suitable, vi:, suited, vi:, coincide, pa:, mail, he:, corresponding, he:, compatible
computer-program: 
antibody: 
full-time: 
propositive-mood: 
associative-case: 
inanimate-gender: 
text-editor: 
planetary-gender: 
operating-system: 
grammatical-case: 
electric-current: 
reciprocal-voice: 
flatware: 
core-benefactive: 
web-host: 
radian: 
applicative-voice: 
phoneme: 
successive-clause: 
notebook-computer: 
gas-pedal: 
antipassive-voice: 
folk-music: 
terabyte: 
social-networking: 
negotiation: zh:, negotiate, hi:, talk, hi:, conversation, hi:, chat, hi:, interaction, hi:, interact, fi:, consultation, pa:, communicate, pa:, dialogue
nonremittal: id:, flat, ja:, obscure, ja:, ambiguous
morpheme: 
linker: zh:, link, sr:, conjunction
neodymium: 
radiation-sickness: 
present-participle: 
necessitative-mood: 
existential-clause: 
excessive-duration: 
passive-participle: 
grammatical-object: 
continutive-aspect: 
singulative-number: 
luminous-intensity: 
superlative-degree: 
blue-jean: 
elective-quantifier: 
supercritical-fluid: 
epenthetic-morpheme: 
postpositional-case: 
negatory-quantifier: 
connective-particle: 
netium: 
universal-quantifier: 
air-force: 
allocutive-agreement: 
computer-programming: 
assertive-quantifier: 
frequentative-aspect: 
distributive-pronoun: 
alternative-quantifier: 
phishing: 
scalar: 
counterfactual-conditional: 
